DIRECCION,Fecha,Instalaciones,Activaciones_automaticas,Activaciones_manuales,PorcAM
CENTRO 1,2023-04-24,830,825,5,0.00602409638554217
CENTRO 1,2023-04-25,921,915,6,0.00651465798045603
CENTRO 1,2023-04-26,804,800,4,0.00497512437810945
CENTRO 1,2023-04-27,627,621,6,0.00956937799043062
CENTRO 1,2023-04-28,837,827,10,0.01194743130227
CENTRO 1,2023-04-29,992,981,11,0.0110887096774194
CENTRO 1,2023-04-30,865,848,17,0.0196531791907514
CENTRO 1,2023-05-01,846,833,13,0.0153664302600473
CENTRO 1,2023-05-02,755,745,10,0.0132450331125828
CENTRO 1,2023-05-03,654,644,10,0.0152905198776758
CENTRO 1,2023-05-04,596,588,8,0.0134228187919463
CENTRO 1,2023-05-05,704,696,8,0.0113636363636364
CENTRO 1,2023-05-06,748,738,10,0.0133689839572193
CENTRO 1,2023-05-07,581,572,9,0.0154905335628227
CENTRO 1,2023-05-08,646,638,8,0.0123839009287926
CENTRO 1,2023-05-09,652,633,19,0.0291411042944785
CENTRO 1,2023-05-10,609,593,16,0.0262725779967159
CENTRO 1,2023-05-11,606,600,6,0.0099009900990099
CENTRO 1,2023-05-12,622,616,6,0.00964630225080386
CENTRO 1,2023-05-13,947,931,16,0.0168954593453009
CENTRO 1,2023-05-14,1051,1040,11,0.0104662226450999
CENTRO 1,2023-05-15,1150,1132,18,0.0156521739130435
CENTRO 1,2023-05-16,1213,1198,15,0.0123660346248969
CENTRO 1,2023-05-17,931,914,17,0.0182599355531686
CENTRO 1,2023-05-18,712,700,12,0.0168539325842697
CENTRO 1,2023-05-19,753,740,13,0.0172642762284197
CENTRO 1,2023-05-20,925,904,21,0.0227027027027027
CENTRO 1,2023-05-21,839,831,8,0.00953516090584029
CENTRO 1,2023-05-22,800,790,10,0.0125
CENTRO 1,2023-05-23,751,735,16,0.0213049267643142
CENTRO 1,2023-05-24,703,686,17,0.0241820768136558
CENTRO 1,2023-05-25,713,700,13,0.0182328190743338
CENTRO 1,2023-05-26,881,865,16,0.018161180476731
CENTRO 1,2023-05-27,875,850,25,0.0285714285714286
CENTRO 1,2023-05-28,790,782,8,0.010126582278481
CENTRO 1,2023-05-29,725,717,8,0.0110344827586207
CENTRO 1,2023-05-30,862,845,17,0.0197215777262181
CENTRO 1,2023-05-31,961,946,15,0.0156087408949011
CENTRO 1,2023-06-01,675,662,13,0.0192592592592593
CENTRO 1,2023-06-02,634,622,12,0.0189274447949527
CENTRO 1,2023-06-03,858,849,9,0.0104895104895105
CENTRO 1,2023-06-04,873,858,15,0.0171821305841924
CENTRO 1,2023-06-05,855,835,20,0.0233918128654971
CENTRO 1,2023-06-06,690,681,9,0.0130434782608696
CENTRO 1,2023-06-07,646,630,16,0.0247678018575851
CENTRO 1,2023-06-08,605,593,12,0.0198347107438017
CENTRO 1,2023-06-09,707,695,12,0.016973125884017
CENTRO 1,2023-06-10,885,865,20,0.0225988700564972
CENTRO 1,2023-06-11,786,770,16,0.0203562340966921
CENTRO 1,2023-06-12,760,743,17,0.0223684210526316
CENTRO 1,2023-06-13,759,748,11,0.0144927536231884
CENTRO 1,2023-06-14,779,766,13,0.0166880616174583
CENTRO 1,2023-06-15,780,761,19,0.0243589743589744
CENTRO 1,2023-06-16,804,789,15,0.0186567164179104
CENTRO 1,2023-06-17,942,922,20,0.0212314225053079
CENTRO 1,2023-06-18,691,681,10,0.0144717800289436
CENTRO 1,2023-06-19,783,775,8,0.0102171136653895
CENTRO 1,2023-06-20,808,797,11,0.0136138613861386
CENTRO 1,2023-06-21,712,695,17,0.023876404494382
CENTRO 1,2023-06-22,678,664,14,0.0206489675516224
CENTRO 1,2023-06-23,746,724,22,0.0294906166219839
CENTRO 1,2023-06-24,856,836,20,0.0233644859813084
CENTRO 1,2023-06-25,698,680,18,0.0257879656160458
CENTRO 1,2023-06-26,756,742,14,0.0185185185185185
CENTRO 1,2023-06-27,662,651,11,0.0166163141993958
CENTRO 1,2023-06-28,714,699,15,0.0210084033613445
CENTRO 1,2023-06-29,766,749,17,0.0221932114882507
CENTRO 1,2023-06-30,581,538,43,0.0740103270223752
CENTRO 1,2023-07-01,917,902,15,0.0163576881134133
CENTRO 1,2023-07-02,727,714,13,0.0178817056396149
CENTRO 1,2023-07-03,740,726,14,0.0189189189189189
CENTRO 1,2023-07-04,672,656,16,0.0238095238095238
CENTRO 1,2023-07-05,731,720,11,0.0150478796169631
CENTRO 1,2023-07-06,601,584,17,0.0282861896838602
CENTRO 1,2023-07-07,763,746,17,0.0222804718217562
CENTRO 1,2023-07-08,797,776,21,0.0263488080301129
CENTRO 1,2023-07-09,697,684,13,0.0186513629842181
CENTRO 1,2023-07-10,715,700,15,0.020979020979021
CENTRO 1,2023-07-11,712,694,18,0.0252808988764045
CENTRO 1,2023-07-12,732,712,20,0.0273224043715847
CENTRO 1,2023-07-13,655,633,22,0.033587786259542
CENTRO 1,2023-07-14,733,712,21,0.0286493860845839
CENTRO 1,2023-07-15,873,858,15,0.0171821305841924
CENTRO 1,2023-07-16,733,715,18,0.0245566166439291
CENTRO 1,2023-07-17,754,735,19,0.0251989389920424
CENTRO 1,2023-07-18,787,773,14,0.0177890724269377
CENTRO 1,2023-07-19,686,662,24,0.0349854227405248
CENTRO 1,2023-07-20,791,778,13,0.0164348925410872
CENTRO 1,2023-07-21,694,683,11,0.015850144092219
CENTRO 1,2023-07-22,836,820,16,0.0191387559808612
CENTRO 1,2023-07-23,757,740,17,0.0224570673712021
CENTRO 1,2023-07-24,701,688,13,0.0185449358059914
CENTRO 1,2023-07-25,789,767,22,0.0278833967046895
CENTRO 1,2023-07-26,901,885,16,0.0177580466148724
CENTRO 1,2023-07-27,827,813,14,0.0169286577992745
CENTRO 1,2023-07-28,832,818,14,0.0168269230769231
CENTRO 1,2023-07-29,894,886,8,0.00894854586129754
CENTRO 1,2023-07-30,927,908,19,0.0204962243797195
CENTRO 1,2023-07-31,991,975,16,0.0161453077699294
CENTRO 1,2023-08-01,807,783,24,0.0297397769516729
CENTRO 1,2023-08-02,737,719,18,0.0244233378561737
CENTRO 1,2023-08-03,709,660,49,0.0691114245416079
CENTRO 1,2023-08-04,818,796,22,0.0268948655256724
CENTRO 1,2023-08-05,879,855,24,0.0273037542662116
CENTRO 1,2023-08-06,769,746,23,0.0299089726918075
CENTRO 1,2023-08-07,762,747,15,0.0196850393700787
CENTRO 1,2023-08-08,742,721,21,0.0283018867924528
CENTRO 1,2023-08-09,782,754,28,0.0358056265984655
CENTRO 1,2023-08-10,732,710,22,0.0300546448087432
CENTRO 1,2023-08-11,802,788,14,0.0174563591022444
CENTRO 1,2023-08-12,819,796,23,0.0280830280830281
CENTRO 1,2023-08-13,874,832,42,0.0480549199084668
CENTRO 1,2023-08-14,791,768,23,0.0290771175726928
CENTRO 1,2023-08-15,934,914,20,0.0214132762312634
CENTRO 1,2023-08-16,839,819,20,0.0238379022646007
CENTRO 1,2023-08-17,739,722,17,0.0230040595399188
CENTRO 1,2023-08-18,793,779,14,0.0176544766708701
CENTRO 1,2023-08-19,829,811,18,0.0217129071170084
CENTRO 1,2023-08-20,766,747,19,0.0248041775456919
CENTRO 1,2023-08-21,710,709,1,0.00140845070422535
CENTRO 1,2023-08-22,746,745,1,0.00134048257372654
CENTRO 1,2023-08-23,751,749,2,0.00266311584553928
CENTRO 1,2023-08-24,762,760,2,0.0026246719160105
CENTRO 1,2023-08-25,829,829,0,0
CENTRO 1,2023-08-26,1009,1007,2,0.00198216055500496
CENTRO 1,2023-08-27,952,951,1,0.00105042016806723
CENTRO 1,2023-08-28,894,892,2,0.00223713646532438
CENTRO 1,2023-08-29,913,911,2,0.00219058050383352
CENTRO 1,2023-08-30,862,860,2,0.00232018561484919
CENTRO 1,2023-08-31,775,768,7,0.00903225806451613
CENTRO 1,2023-09-01,736,734,2,0.00271739130434783
CENTRO 1,2023-09-02,795,792,3,0.00377358490566038
CENTRO 1,2023-09-03,743,740,3,0.00403768506056528
CENTRO 1,2023-09-04,726,725,1,0.00137741046831956
CENTRO 1,2023-09-05,704,702,2,0.00284090909090909
CENTRO 1,2023-09-06,716,715,1,0.00139664804469274
CENTRO 1,2023-09-07,793,789,4,0.00504413619167718
CENTRO 1,2023-09-08,650,649,1,0.00153846153846154
CENTRO 1,2023-09-09,804,804,0,0
CENTRO 1,2023-09-10,768,766,2,0.00260416666666667
CENTRO 1,2023-09-11,670,669,1,0.00149253731343284
CENTRO 1,2023-09-12,619,616,3,0.00484652665589661
CENTRO 1,2023-09-13,625,624,1,0.0016
CENTRO 1,2023-09-14,647,645,2,0.00309119010819165
CENTRO 1,2023-09-15,575,569,6,0.0104347826086957
CENTRO 1,2023-09-16,622,618,4,0.00643086816720257
CENTRO 1,2023-09-17,695,693,2,0.00287769784172662
CENTRO 1,2023-09-18,686,685,1,0.00145772594752187
CENTRO 1,2023-09-19,647,643,4,0.00618238021638331
CENTRO 1,2023-09-20,518,516,2,0.00386100386100386
CENTRO 1,2023-09-21,702,698,4,0.0056980056980057
CENTRO 1,2023-09-22,866,864,2,0.0023094688221709
CENTRO 1,2023-09-23,851,850,1,0.00117508813160987
CENTRO 1,2023-09-24,875,873,2,0.00228571428571429
CENTRO 1,2023-09-25,743,741,2,0.00269179004037685
CENTRO 1,2023-09-26,731,728,3,0.00410396716826265
CENTRO 1,2023-09-27,694,691,3,0.00432276657060519
CENTRO 1,2023-09-28,817,811,6,0.00734394124847001
CENTRO 1,2023-09-29,896,893,3,0.00334821428571429
CENTRO 1,2023-09-30,1088,1081,7,0.00643382352941176
CENTRO 1,2023-10-01,745,741,4,0.00536912751677852
CENTRO 1,2023-10-02,718,716,2,0.00278551532033426
CENTRO 1,2023-10-03,663,643,20,0.0301659125188537
CENTRO 1,2023-10-04,660,645,15,0.0227272727272727
CENTRO 1,2023-10-05,656,634,22,0.0335365853658537
CENTRO 1,2023-10-06,731,702,29,0.039671682626539
CENTRO 1,2023-10-07,848,823,25,0.0294811320754717
CENTRO 1,2023-10-08,764,742,22,0.0287958115183246
CENTRO 1,2023-10-09,727,704,23,0.031636863823934
CENTRO 1,2023-10-10,603,586,17,0.0281923714759536
CENTRO 1,2023-10-11,619,604,15,0.024232633279483
CENTRO 1,2023-10-12,583,568,15,0.0257289879931389
CENTRO 1,2023-10-13,675,657,18,0.0266666666666667
CENTRO 1,2023-10-14,864,845,19,0.0219907407407407
CENTRO 1,2023-10-15,862,836,26,0.0301624129930394
CENTRO 1,2023-10-16,820,802,18,0.0219512195121951
CENTRO 1,2023-10-17,762,737,25,0.0328083989501312
CENTRO 1,2023-10-18,678,655,23,0.0339233038348083
CENTRO 1,2023-10-19,709,690,19,0.0267983074753173
CENTRO 1,2023-10-20,734,718,16,0.0217983651226158
CENTRO 1,2023-10-21,916,893,23,0.0251091703056769
CENTRO 1,2023-10-22,806,777,29,0.0359801488833747
CENTRO 1,2023-10-23,785,764,21,0.0267515923566879
CENTRO 1,2023-10-24,726,702,24,0.0330578512396694
CENTRO 1,2023-10-25,626,605,21,0.0335463258785942
CENTRO 1,2023-10-26,599,582,17,0.0283806343906511
CENTRO 1,2023-10-27,650,630,20,0.0307692307692308
CENTRO 1,2023-10-28,796,777,19,0.0238693467336683
CENTRO 1,2023-10-29,756,737,19,0.0251322751322751
CENTRO 1,2023-10-30,729,692,37,0.0507544581618656
CENTRO 1,2023-10-31,958,931,27,0.0281837160751566
CENTRO 1,2023-11-01,725,700,25,0.0344827586206897
CENTRO 1,2023-11-02,676,659,17,0.0251479289940828
CENTRO 1,2023-11-03,650,629,21,0.0323076923076923
CENTRO 1,2023-11-04,898,876,22,0.0244988864142539
CENTRO 1,2023-11-05,937,905,32,0.0341515474919957
CENTRO 1,2023-11-06,897,875,22,0.0245261984392419
CENTRO 1,2023-11-07,929,901,28,0.0301399354144241
CENTRO 1,2023-11-08,875,852,23,0.0262857142857143
CENTRO 1,2023-11-09,786,760,26,0.0330788804071247
CENTRO 1,2023-11-10,807,793,14,0.0173482032218092
CENTRO 1,2023-11-11,1003,981,22,0.0219341974077767
CENTRO 1,2023-11-12,893,875,18,0.0201567749160134
CENTRO 1,2023-11-13,902,859,43,0.0476718403547672
CENTRO 1,2023-11-14,935,906,29,0.0310160427807487
CENTRO 1,2023-11-15,985,961,24,0.0243654822335025
CENTRO 1,2023-11-16,1085,1055,30,0.0276497695852535
CENTRO 1,2023-11-17,1139,1121,18,0.0158033362598771
CENTRO 1,2023-11-18,1287,1252,35,0.0271950271950272
CENTRO 1,2023-11-19,1301,1267,34,0.0261337432744043
CENTRO 1,2023-11-20,1290,1263,27,0.0209302325581395
CENTRO 1,2023-11-21,1078,1050,28,0.025974025974026
CENTRO 1,2023-11-22,919,893,26,0.0282916213275299
CENTRO 1,2023-11-23,883,859,24,0.0271800679501699
CENTRO 1,2023-11-24,916,886,30,0.0327510917030568
CENTRO 1,2023-11-25,1046,1027,19,0.0181644359464627
CENTRO 1,2023-11-26,943,917,26,0.0275715800636267
CENTRO 1,2023-11-27,978,942,36,0.0368098159509202
CENTRO 1,2023-11-28,1007,982,25,0.0248262164846077
CENTRO 1,2023-11-29,998,964,34,0.0340681362725451
CENTRO 1,2023-11-30,1201,1151,50,0.0416319733555371
CENTRO 1,2023-12-01,907,867,40,0.0441014332965821
CENTRO 1,2023-12-02,1044,997,47,0.0450191570881226
CENTRO 1,2023-12-03,1039,1002,37,0.0356111645813282
CENTRO 1,2023-12-04,947,913,34,0.0359028511087645
CENTRO 1,2023-12-05,853,816,37,0.0433763188745604
CENTRO 1,2023-12-06,856,825,31,0.036214953271028
CENTRO 1,2023-12-07,901,872,29,0.0321864594894562
CENTRO 1,2023-12-08,790,773,17,0.0215189873417722
CENTRO 1,2023-12-09,996,964,32,0.0321285140562249
CENTRO 1,2023-12-10,980,945,35,0.0357142857142857
CENTRO 1,2023-12-11,841,820,21,0.0249702734839477
CENTRO 1,2023-12-12,896,873,23,0.0256696428571429
CENTRO 1,2023-12-13,804,773,31,0.0385572139303483
CENTRO 1,2023-12-14,709,685,24,0.0338504936530324
CENTRO 1,2023-12-15,945,916,29,0.0306878306878307
CENTRO 1,2023-12-16,1075,1044,31,0.0288372093023256
CENTRO 1,2023-12-17,924,888,36,0.038961038961039
CENTRO 1,2023-12-18,954,925,29,0.030398322851153
CENTRO 1,2023-12-19,931,899,32,0.0343716433941998
CENTRO 1,2023-12-20,951,918,33,0.0347003154574132
CENTRO 1,2023-12-21,951,925,26,0.0273396424815983
CENTRO 1,2023-12-22,836,808,28,0.0334928229665072
CENTRO 1,2023-12-23,911,882,29,0.0318331503841932
CENTRO 1,2023-12-24,667,641,26,0.0389805097451274
CENTRO 1,2023-12-25,260,249,11,0.0423076923076923
CENTRO 1,2023-12-26,760,734,26,0.0342105263157895
CENTRO 1,2023-12-27,964,942,22,0.0228215767634855
CENTRO 1,2023-12-28,955,933,22,0.0230366492146597
CENTRO 1,2023-12-29,937,903,34,0.0362860192102455
CENTRO 1,2023-12-30,939,915,24,0.0255591054313099
CENTRO 1,2023-12-31,586,572,14,0.0238907849829352
CENTRO 1,2024-01-01,174,166,8,0.0459770114942529
CENTRO 1,2024-01-02,712,690,22,0.0308988764044944
CENTRO 1,2024-01-03,911,896,15,0.0164654226125137
CENTRO 1,2024-01-04,871,844,27,0.0309988518943743
CENTRO 1,2024-01-05,885,869,16,0.0180790960451977
CENTRO 1,2024-01-06,829,803,26,0.0313630880579011
CENTRO 1,2024-01-07,868,852,16,0.0184331797235023
CENTRO 1,2024-01-08,887,854,33,0.0372040586245772
CENTRO 1,2024-01-09,943,920,23,0.024390243902439
CENTRO 1,2024-01-10,889,861,28,0.031496062992126
CENTRO 1,2024-01-11,947,926,21,0.0221752903907075
CENTRO 1,2024-01-12,941,918,23,0.024442082890542
CENTRO 1,2024-01-13,1058,1031,27,0.0255198487712665
CENTRO 1,2024-01-14,1039,1012,27,0.0259865255052935
CENTRO 1,2024-01-15,977,951,26,0.0266120777891505
CENTRO 1,2024-01-16,998,973,25,0.0250501002004008
CENTRO 1,2024-01-17,859,830,29,0.0337601862630966
CENTRO 1,2024-01-18,948,931,17,0.0179324894514768
CENTRO 1,2024-01-19,855,835,20,0.0233918128654971
CENTRO 1,2024-01-20,971,943,28,0.0288362512873326
CENTRO 1,2024-01-21,868,850,18,0.0207373271889401
CENTRO 1,2024-01-22,846,823,23,0.0271867612293144
CENTRO 1,2024-01-23,886,856,30,0.0338600451467269
CENTRO 1,2024-01-24,905,871,34,0.0375690607734807
CENTRO 1,2024-01-25,813,789,24,0.029520295202952
CENTRO 1,2024-01-26,788,760,28,0.0355329949238579
CENTRO 1,2024-01-27,994,972,22,0.0221327967806841
CENTRO 1,2024-01-28,850,823,27,0.0317647058823529
CENTRO 1,2024-01-29,853,831,22,0.0257913247362251
CENTRO 1,2024-01-30,858,819,39,0.0454545454545455
CENTRO 1,2024-01-31,1018,992,26,0.0255402750491159
CENTRO 1,2024-02-01,884,850,34,0.0384615384615385
CENTRO 1,2024-02-02,799,784,15,0.0187734668335419
CENTRO 1,2024-02-03,937,916,21,0.0224119530416222
CENTRO 1,2024-02-04,874,854,20,0.022883295194508
CENTRO 1,2024-02-05,893,872,21,0.0235162374020157
CENTRO 1,2024-02-06,912,886,26,0.0285087719298246
CENTRO 1,2024-02-07,818,791,27,0.0330073349633252
CENTRO 1,2024-02-08,791,767,24,0.0303413400758533
CENTRO 1,2024-02-09,792,768,24,0.0303030303030303
CENTRO 1,2024-02-10,946,922,24,0.025369978858351
CENTRO 1,2024-02-11,774,745,29,0.0374677002583979
CENTRO 1,2024-02-12,697,675,22,0.0315638450502152
CENTRO 1,2024-02-13,809,789,20,0.0247218788627936
CENTRO 1,2024-02-14,690,668,22,0.0318840579710145
CENTRO 1,2024-02-15,781,762,19,0.0243277848911652
CENTRO 1,2024-02-16,897,876,21,0.0234113712374582
CENTRO 1,2024-02-17,996,975,21,0.0210843373493976
CENTRO 1,2024-02-18,1023,1003,20,0.0195503421309873
CENTRO 1,2024-02-19,920,898,22,0.0239130434782609
CENTRO 1,2024-02-20,862,844,18,0.0208816705336427
CENTRO 1,2024-02-21,882,860,22,0.0249433106575964
CENTRO 1,2024-02-22,857,838,19,0.0221703617269545
CENTRO 1,2024-02-23,633,579,54,0.0853080568720379
CENTRO 1,2024-02-24,1089,1064,25,0.0229568411386593
CENTRO 1,2024-02-25,918,901,17,0.0185185185185185
CENTRO 1,2024-02-26,930,901,29,0.0311827956989247
CENTRO 1,2024-02-27,940,918,22,0.0234042553191489
CENTRO 1,2024-02-28,892,865,27,0.0302690582959641
CENTRO 1,2024-02-29,985,966,19,0.0192893401015228
CENTRO 1,2024-03-01,882,866,16,0.018140589569161
CENTRO 1,2024-03-02,1027,1006,21,0.0204479065238559
CENTRO 1,2024-03-03,914,897,17,0.0185995623632385
CENTRO 1,2024-03-04,863,844,19,0.0220162224797219
CENTRO 1,2024-03-05,837,813,24,0.028673835125448
CENTRO 1,2024-03-06,845,820,25,0.029585798816568
CENTRO 1,2024-03-07,830,816,14,0.0168674698795181
CENTRO 1,2024-03-08,841,819,22,0.0261593341260404
CENTRO 1,2024-03-09,996,981,15,0.0150602409638554
CENTRO 1,2024-03-10,892,874,18,0.0201793721973094
CENTRO 1,2024-03-11,919,898,21,0.0228509249183896
CENTRO 1,2024-03-12,799,779,20,0.0250312891113892
CENTRO 1,2024-03-13,744,713,31,0.0416666666666667
CENTRO 1,2024-03-14,690,678,12,0.0173913043478261
CENTRO 1,2024-03-15,896,870,26,0.0290178571428571
CENTRO 1,2024-03-16,1060,1033,27,0.0254716981132075
CENTRO 1,2024-03-17,919,896,23,0.0250272034820457
CENTRO 1,2024-03-18,1007,972,35,0.0347567030784508
CENTRO 1,2024-03-19,721,710,11,0.0152565880721221
CENTRO 1,2024-03-20,739,725,14,0.0189445196211096
CENTRO 1,2024-03-21,694,676,18,0.0259365994236311
CENTRO 1,2024-03-22,716,698,18,0.0251396648044693
CENTRO 1,2024-03-23,933,922,11,0.0117899249732047
CENTRO 1,2024-03-24,697,679,18,0.0258249641319943
CENTRO 1,2024-03-25,759,736,23,0.0303030303030303
CENTRO 1,2024-03-26,871,851,20,0.0229621125143513
CENTRO 1,2024-03-27,885,859,26,0.0293785310734463
CENTRO 1,2024-03-28,1017,995,22,0.0216322517207473
CENTRO 1,2024-03-29,855,819,36,0.0421052631578947
CENTRO 1,2024-03-30,851,824,27,0.0317273795534665
CENTRO 1,2024-03-31,815,790,25,0.0306748466257669
CENTRO 1,2024-04-01,865,835,30,0.0346820809248555
CENTRO 1,2024-04-02,767,743,24,0.0312907431551499
CENTRO 1,2024-04-03,792,792,0,0
CENTRO 1,2024-04-04,760,760,0,0
CENTRO 1,2024-04-05,762,733,29,0.0380577427821522
CENTRO 1,2024-04-06,866,850,16,0.0184757505773672
CENTRO 1,2024-04-07,675,648,27,0.04
CENTRO 1,2024-04-08,676,658,18,0.0266272189349112
CENTRO 1,2024-04-09,727,702,25,0.0343878954607978
CENTRO 1,2024-04-10,751,723,28,0.0372836218375499
CENTRO 1,2024-04-11,682,670,12,0.0175953079178886
CENTRO 1,2024-04-12,769,747,22,0.0286085825747724
CENTRO 1,2024-04-13,836,816,20,0.0239234449760766
CENTRO 1,2024-04-14,835,818,17,0.0203592814371257
CENTRO 1,2024-04-15,897,879,18,0.020066889632107
CENTRO 1,2024-04-16,950,879,71,0.0747368421052632
CENTRO 1,2024-04-17,802,759,43,0.0536159600997506
CENTRO 1,2024-04-18,698,675,23,0.0329512893982808
CENTRO 1,2024-04-19,671,630,41,0.0611028315946349
CENTRO 1,2024-04-20,870,839,31,0.035632183908046
CENTRO 1,2024-04-21,769,746,23,0.0299089726918075
CENTRO 1,2024-04-22,470,452,18,0.0382978723404255
CENTRO 1,2024-04-23,941,875,66,0.0701381509032944
CENTRO 2,2023-04-24,662,617,45,0.06797583081571
CENTRO 2,2023-04-25,753,698,55,0.0730411686586985
CENTRO 2,2023-04-26,642,605,37,0.0576323987538941
CENTRO 2,2023-04-27,587,545,42,0.0715502555366269
CENTRO 2,2023-04-28,689,638,51,0.0740203193033382
CENTRO 2,2023-04-29,910,843,67,0.0736263736263736
CENTRO 2,2023-04-30,681,629,52,0.0763582966226138
CENTRO 2,2023-05-01,536,479,57,0.10634328358209
CENTRO 2,2023-05-02,694,639,55,0.0792507204610951
CENTRO 2,2023-05-03,581,538,43,0.0740103270223752
CENTRO 2,2023-05-04,622,582,40,0.0643086816720257
CENTRO 2,2023-05-05,644,604,40,0.062111801242236
CENTRO 2,2023-05-06,657,606,51,0.0776255707762557
CENTRO 2,2023-05-07,510,485,25,0.0490196078431373
CENTRO 2,2023-05-08,582,543,39,0.0670103092783505
CENTRO 2,2023-05-09,566,526,40,0.0706713780918728
CENTRO 2,2023-05-10,584,534,50,0.0856164383561644
CENTRO 2,2023-05-11,545,504,41,0.0752293577981651
CENTRO 2,2023-05-12,630,575,55,0.0873015873015873
CENTRO 2,2023-05-13,848,803,45,0.0530660377358491
CENTRO 2,2023-05-14,750,703,47,0.0626666666666667
CENTRO 2,2023-05-15,955,880,75,0.0785340314136126
CENTRO 2,2023-05-16,941,867,74,0.0786397449521785
CENTRO 2,2023-05-17,875,804,71,0.0811428571428571
CENTRO 2,2023-05-18,654,614,40,0.0611620795107034
CENTRO 2,2023-05-19,555,509,46,0.0828828828828829
CENTRO 2,2023-05-20,770,718,52,0.0675324675324675
CENTRO 2,2023-05-21,625,583,42,0.0672
CENTRO 2,2023-05-22,737,694,43,0.0583446404341927
CENTRO 2,2023-05-23,609,575,34,0.0558292282430213
CENTRO 2,2023-05-24,607,569,38,0.0626029654036244
CENTRO 2,2023-05-25,652,600,52,0.0797546012269939
CENTRO 2,2023-05-26,674,624,50,0.0741839762611276
CENTRO 2,2023-05-27,752,699,53,0.0704787234042553
CENTRO 2,2023-05-28,562,525,37,0.0658362989323843
CENTRO 2,2023-05-29,699,639,60,0.0858369098712446
CENTRO 2,2023-05-30,780,699,81,0.103846153846154
CENTRO 2,2023-05-31,823,753,70,0.0850546780072904
CENTRO 2,2023-06-01,673,615,58,0.0861812778603269
CENTRO 2,2023-06-02,599,541,58,0.0968280467445743
CENTRO 2,2023-06-03,670,611,59,0.0880597014925373
CENTRO 2,2023-06-04,596,552,44,0.0738255033557047
CENTRO 2,2023-06-05,640,569,71,0.1109375
CENTRO 2,2023-06-06,581,542,39,0.0671256454388985
CENTRO 2,2023-06-07,597,547,50,0.0837520938023451
CENTRO 2,2023-06-08,629,580,49,0.0779014308426073
CENTRO 2,2023-06-09,613,554,59,0.0962479608482871
CENTRO 2,2023-06-10,670,616,54,0.0805970149253731
CENTRO 2,2023-06-11,552,515,37,0.0670289855072464
CENTRO 2,2023-06-12,621,564,57,0.0917874396135266
CENTRO 2,2023-06-13,567,513,54,0.0952380952380952
CENTRO 2,2023-06-14,715,659,56,0.0783216783216783
CENTRO 2,2023-06-15,688,639,49,0.0712209302325581
CENTRO 2,2023-06-16,690,638,52,0.0753623188405797
CENTRO 2,2023-06-17,733,675,58,0.0791268758526603
CENTRO 2,2023-06-18,540,506,34,0.062962962962963
CENTRO 2,2023-06-19,632,583,49,0.0775316455696203
CENTRO 2,2023-06-20,626,581,45,0.0718849840255591
CENTRO 2,2023-06-21,632,584,48,0.0759493670886076
CENTRO 2,2023-06-22,577,539,38,0.0658578856152513
CENTRO 2,2023-06-23,632,580,52,0.0822784810126582
CENTRO 2,2023-06-24,731,683,48,0.0656634746922025
CENTRO 2,2023-06-25,521,490,31,0.0595009596928983
CENTRO 2,2023-06-26,599,565,34,0.0567612687813022
CENTRO 2,2023-06-27,579,558,21,0.0362694300518135
CENTRO 2,2023-06-28,588,566,22,0.0374149659863946
CENTRO 2,2023-06-29,635,587,48,0.0755905511811024
CENTRO 2,2023-06-30,464,396,68,0.146551724137931
CENTRO 2,2023-07-01,708,671,37,0.0522598870056497
CENTRO 2,2023-07-02,444,432,12,0.027027027027027
CENTRO 2,2023-07-03,637,611,26,0.0408163265306122
CENTRO 2,2023-07-04,540,516,24,0.0444444444444444
CENTRO 2,2023-07-05,442,420,22,0.0497737556561086
CENTRO 2,2023-07-06,447,426,21,0.0469798657718121
CENTRO 2,2023-07-07,642,623,19,0.029595015576324
CENTRO 2,2023-07-08,741,716,25,0.0337381916329285
CENTRO 2,2023-07-09,547,525,22,0.0402193784277879
CENTRO 2,2023-07-10,599,573,26,0.0434056761268781
CENTRO 2,2023-07-11,623,594,29,0.0465489566613162
CENTRO 2,2023-07-12,555,525,30,0.0540540540540541
CENTRO 2,2023-07-13,553,522,31,0.0560578661844485
CENTRO 2,2023-07-14,551,526,25,0.0453720508166969
CENTRO 2,2023-07-15,696,671,25,0.0359195402298851
CENTRO 2,2023-07-16,561,544,17,0.0303030303030303
CENTRO 2,2023-07-17,616,594,22,0.0357142857142857
CENTRO 2,2023-07-18,604,584,20,0.033112582781457
CENTRO 2,2023-07-19,620,597,23,0.0370967741935484
CENTRO 2,2023-07-20,694,662,32,0.0461095100864553
CENTRO 2,2023-07-21,620,596,24,0.0387096774193548
CENTRO 2,2023-07-22,706,684,22,0.0311614730878187
CENTRO 2,2023-07-23,505,488,17,0.0336633663366337
CENTRO 2,2023-07-24,610,584,26,0.0426229508196721
CENTRO 2,2023-07-25,644,620,24,0.0372670807453416
CENTRO 2,2023-07-26,621,597,24,0.0386473429951691
CENTRO 2,2023-07-27,662,640,22,0.0332326283987915
CENTRO 2,2023-07-28,761,736,25,0.0328515111695138
CENTRO 2,2023-07-29,764,739,25,0.0327225130890052
CENTRO 2,2023-07-30,631,615,16,0.0253565768621236
CENTRO 2,2023-07-31,722,698,24,0.0332409972299169
CENTRO 2,2023-08-01,735,707,28,0.0380952380952381
CENTRO 2,2023-08-02,713,682,31,0.0434782608695652
CENTRO 2,2023-08-03,719,599,120,0.166898470097357
CENTRO 2,2023-08-04,657,630,27,0.0410958904109589
CENTRO 2,2023-08-05,786,750,36,0.0458015267175573
CENTRO 2,2023-08-06,629,613,16,0.0254372019077901
CENTRO 2,2023-08-07,656,634,22,0.0335365853658537
CENTRO 2,2023-08-08,670,647,23,0.0343283582089552
CENTRO 2,2023-08-09,676,644,32,0.0473372781065089
CENTRO 2,2023-08-10,624,599,25,0.0400641025641026
CENTRO 2,2023-08-11,697,664,33,0.0473457675753228
CENTRO 2,2023-08-12,749,731,18,0.0240320427236315
CENTRO 2,2023-08-13,618,598,20,0.0323624595469256
CENTRO 2,2023-08-14,584,555,29,0.0496575342465753
CENTRO 2,2023-08-15,803,777,26,0.0323785803237858
CENTRO 2,2023-08-16,653,631,22,0.0336906584992343
CENTRO 2,2023-08-17,649,617,32,0.049306625577812
CENTRO 2,2023-08-18,720,689,31,0.0430555555555556
CENTRO 2,2023-08-19,773,746,27,0.0349288486416559
CENTRO 2,2023-08-20,578,556,22,0.0380622837370242
CENTRO 2,2023-08-21,626,621,5,0.00798722044728434
CENTRO 2,2023-08-22,608,606,2,0.00328947368421053
CENTRO 2,2023-08-23,628,618,10,0.0159235668789809
CENTRO 2,2023-08-24,669,656,13,0.0194319880418535
CENTRO 2,2023-08-25,704,694,10,0.0142045454545455
CENTRO 2,2023-08-26,798,792,6,0.0075187969924812
CENTRO 2,2023-08-27,686,682,4,0.00583090379008746
CENTRO 2,2023-08-28,687,679,8,0.0116448326055313
CENTRO 2,2023-08-29,659,649,10,0.0151745068285281
CENTRO 2,2023-08-30,694,687,7,0.0100864553314121
CENTRO 2,2023-08-31,635,626,9,0.0141732283464567
CENTRO 2,2023-09-01,649,644,5,0.00770416024653313
CENTRO 2,2023-09-02,754,748,6,0.00795755968169761
CENTRO 2,2023-09-03,590,588,2,0.00338983050847458
CENTRO 2,2023-09-04,594,591,3,0.00505050505050505
CENTRO 2,2023-09-05,663,661,2,0.00301659125188537
CENTRO 2,2023-09-06,585,578,7,0.011965811965812
CENTRO 2,2023-09-07,543,541,2,0.00368324125230203
CENTRO 2,2023-09-08,521,516,5,0.00959692898272553
CENTRO 2,2023-09-09,722,720,2,0.00277008310249307
CENTRO 2,2023-09-10,567,566,1,0.0017636684303351
CENTRO 2,2023-09-11,581,572,9,0.0154905335628227
CENTRO 2,2023-09-12,614,608,6,0.00977198697068404
CENTRO 2,2023-09-13,485,473,12,0.0247422680412371
CENTRO 2,2023-09-14,519,507,12,0.023121387283237
CENTRO 2,2023-09-15,643,632,11,0.0171073094867807
CENTRO 2,2023-09-16,484,478,6,0.012396694214876
CENTRO 2,2023-09-17,552,544,8,0.0144927536231884
CENTRO 2,2023-09-18,622,618,4,0.00643086816720257
CENTRO 2,2023-09-19,604,596,8,0.0132450331125828
CENTRO 2,2023-09-20,584,575,9,0.0154109589041096
CENTRO 2,2023-09-21,657,642,15,0.0228310502283105
CENTRO 2,2023-09-22,667,652,15,0.0224887556221889
CENTRO 2,2023-09-23,772,763,9,0.0116580310880829
CENTRO 2,2023-09-24,573,565,8,0.0139616055846422
CENTRO 2,2023-09-25,609,597,12,0.0197044334975369
CENTRO 2,2023-09-26,636,630,6,0.00943396226415094
CENTRO 2,2023-09-27,580,576,4,0.00689655172413793
CENTRO 2,2023-09-28,660,651,9,0.0136363636363636
CENTRO 2,2023-09-29,717,701,16,0.0223152022315202
CENTRO 2,2023-09-30,881,858,23,0.0261066969353008
CENTRO 2,2023-10-01,541,531,10,0.0184842883548983
CENTRO 2,2023-10-02,583,575,8,0.0137221269296741
CENTRO 2,2023-10-03,600,581,19,0.0316666666666667
CENTRO 2,2023-10-04,545,524,21,0.0385321100917431
CENTRO 2,2023-10-05,526,504,22,0.0418250950570342
CENTRO 2,2023-10-06,590,567,23,0.0389830508474576
CENTRO 2,2023-10-07,635,623,12,0.0188976377952756
CENTRO 2,2023-10-08,497,472,25,0.0503018108651912
CENTRO 2,2023-10-09,541,520,21,0.0388170055452865
CENTRO 2,2023-10-10,538,524,14,0.0260223048327138
CENTRO 2,2023-10-11,532,500,32,0.0601503759398496
CENTRO 2,2023-10-12,472,453,19,0.0402542372881356
CENTRO 2,2023-10-13,467,445,22,0.0471092077087794
CENTRO 2,2023-10-14,698,672,26,0.0372492836676218
CENTRO 2,2023-10-15,562,549,13,0.0231316725978648
CENTRO 2,2023-10-16,640,621,19,0.0296875
CENTRO 2,2023-10-17,592,579,13,0.0219594594594595
CENTRO 2,2023-10-18,578,556,22,0.0380622837370242
CENTRO 2,2023-10-19,570,548,22,0.0385964912280702
CENTRO 2,2023-10-20,552,537,15,0.0271739130434783
CENTRO 2,2023-10-21,635,616,19,0.0299212598425197
CENTRO 2,2023-10-22,505,492,13,0.0257425742574257
CENTRO 2,2023-10-23,531,507,24,0.0451977401129944
CENTRO 2,2023-10-24,542,527,15,0.0276752767527675
CENTRO 2,2023-10-25,531,516,15,0.0282485875706215
CENTRO 2,2023-10-26,569,555,14,0.0246045694200351
CENTRO 2,2023-10-27,567,556,11,0.0194003527336861
CENTRO 2,2023-10-28,670,651,19,0.0283582089552239
CENTRO 2,2023-10-29,536,522,14,0.0261194029850746
CENTRO 2,2023-10-30,568,549,19,0.0334507042253521
CENTRO 2,2023-10-31,676,653,23,0.0340236686390533
CENTRO 2,2023-11-01,617,601,16,0.0259319286871961
CENTRO 2,2023-11-02,546,531,15,0.0274725274725275
CENTRO 2,2023-11-03,569,555,14,0.0246045694200351
CENTRO 2,2023-11-04,644,629,15,0.0232919254658385
CENTRO 2,2023-11-05,575,561,14,0.0243478260869565
CENTRO 2,2023-11-06,606,592,14,0.0231023102310231
CENTRO 2,2023-11-07,629,602,27,0.0429252782193959
CENTRO 2,2023-11-08,639,622,17,0.02660406885759
CENTRO 2,2023-11-09,593,579,14,0.0236087689713322
CENTRO 2,2023-11-10,603,580,23,0.0381426202321725
CENTRO 2,2023-11-11,713,693,20,0.0280504908835905
CENTRO 2,2023-11-12,571,556,15,0.0262697022767075
CENTRO 2,2023-11-13,633,609,24,0.037914691943128
CENTRO 2,2023-11-14,662,640,22,0.0332326283987915
CENTRO 2,2023-11-15,682,666,16,0.0234604105571848
CENTRO 2,2023-11-16,670,648,22,0.0328358208955224
CENTRO 2,2023-11-17,768,741,27,0.03515625
CENTRO 2,2023-11-18,915,889,26,0.0284153005464481
CENTRO 2,2023-11-19,643,628,15,0.0233281493001555
CENTRO 2,2023-11-20,771,751,20,0.0259403372243839
CENTRO 2,2023-11-21,737,714,23,0.0312075983717775
CENTRO 2,2023-11-22,706,685,21,0.0297450424929178
CENTRO 2,2023-11-23,695,677,18,0.0258992805755396
CENTRO 2,2023-11-24,653,634,19,0.0290964777947933
CENTRO 2,2023-11-25,775,759,16,0.0206451612903226
CENTRO 2,2023-11-26,631,612,19,0.0301109350237718
CENTRO 2,2023-11-27,696,677,19,0.0272988505747126
CENTRO 2,2023-11-28,727,705,22,0.0302613480055021
CENTRO 2,2023-11-29,668,618,50,0.0748502994011976
CENTRO 2,2023-11-30,838,790,48,0.0572792362768496
CENTRO 2,2023-12-01,720,692,28,0.0388888888888889
CENTRO 2,2023-12-02,721,688,33,0.0457697642163662
CENTRO 2,2023-12-03,658,627,31,0.047112462006079
CENTRO 2,2023-12-04,635,613,22,0.0346456692913386
CENTRO 2,2023-12-05,654,615,39,0.0596330275229358
CENTRO 2,2023-12-06,614,590,24,0.0390879478827362
CENTRO 2,2023-12-07,563,542,21,0.0373001776198934
CENTRO 2,2023-12-08,632,603,29,0.0458860759493671
CENTRO 2,2023-12-09,717,693,24,0.0334728033472803
CENTRO 2,2023-12-10,538,529,9,0.016728624535316
CENTRO 2,2023-12-11,609,588,21,0.0344827586206897
CENTRO 2,2023-12-12,707,673,34,0.0480905233380481
CENTRO 2,2023-12-13,547,531,16,0.0292504570383912
CENTRO 2,2023-12-14,567,541,26,0.0458553791887125
CENTRO 2,2023-12-15,615,601,14,0.0227642276422764
CENTRO 2,2023-12-16,693,679,14,0.0202020202020202
CENTRO 2,2023-12-17,544,533,11,0.0202205882352941
CENTRO 2,2023-12-18,670,654,16,0.0238805970149254
CENTRO 2,2023-12-19,717,698,19,0.0264993026499303
CENTRO 2,2023-12-20,724,698,26,0.0359116022099447
CENTRO 2,2023-12-21,682,664,18,0.0263929618768328
CENTRO 2,2023-12-22,648,632,16,0.0246913580246914
CENTRO 2,2023-12-23,705,680,25,0.0354609929078014
CENTRO 2,2023-12-24,380,371,9,0.0236842105263158
CENTRO 2,2023-12-25,174,167,7,0.0402298850574713
CENTRO 2,2023-12-26,567,548,19,0.0335097001763668
CENTRO 2,2023-12-27,753,733,20,0.0265604249667995
CENTRO 2,2023-12-28,750,729,21,0.028
CENTRO 2,2023-12-29,703,686,17,0.0241820768136558
CENTRO 2,2023-12-30,699,683,16,0.0228898426323319
CENTRO 2,2023-12-31,334,327,7,0.0209580838323353
CENTRO 2,2024-01-01,134,132,2,0.0149253731343284
CENTRO 2,2024-01-02,587,572,15,0.0255536626916525
CENTRO 2,2024-01-03,773,757,16,0.0206985769728331
CENTRO 2,2024-01-04,707,689,18,0.0254596888260255
CENTRO 2,2024-01-05,649,627,22,0.0338983050847458
CENTRO 2,2024-01-06,689,673,16,0.02322206095791
CENTRO 2,2024-01-07,525,515,10,0.019047619047619
CENTRO 2,2024-01-08,665,646,19,0.0285714285714286
CENTRO 2,2024-01-09,645,626,19,0.0294573643410853
CENTRO 2,2024-01-10,673,657,16,0.0237741456166419
CENTRO 2,2024-01-11,642,625,17,0.0264797507788162
CENTRO 2,2024-01-12,671,649,22,0.0327868852459016
CENTRO 2,2024-01-13,799,775,24,0.0300375469336671
CENTRO 2,2024-01-14,659,644,15,0.0227617602427921
CENTRO 2,2024-01-15,761,736,25,0.0328515111695138
CENTRO 2,2024-01-16,755,728,27,0.0357615894039735
CENTRO 2,2024-01-17,705,683,22,0.0312056737588652
CENTRO 2,2024-01-18,702,685,17,0.0242165242165242
CENTRO 2,2024-01-19,640,618,22,0.034375
CENTRO 2,2024-01-20,716,690,26,0.0363128491620112
CENTRO 2,2024-01-21,587,574,13,0.0221465076660988
CENTRO 2,2024-01-22,679,656,23,0.0338733431516937
CENTRO 2,2024-01-23,643,633,10,0.015552099533437
CENTRO 2,2024-01-24,650,629,21,0.0323076923076923
CENTRO 2,2024-01-25,651,629,22,0.0337941628264209
CENTRO 2,2024-01-26,677,656,21,0.0310192023633678
CENTRO 2,2024-01-27,785,770,15,0.0191082802547771
CENTRO 2,2024-01-28,605,590,15,0.0247933884297521
CENTRO 2,2024-01-29,706,681,25,0.0354107648725212
CENTRO 2,2024-01-30,661,636,25,0.037821482602118
CENTRO 2,2024-01-31,737,717,20,0.0271370420624152
CENTRO 2,2024-02-01,645,624,21,0.0325581395348837
CENTRO 2,2024-02-02,661,650,11,0.0166414523449319
CENTRO 2,2024-02-03,752,730,22,0.0292553191489362
CENTRO 2,2024-02-04,587,574,13,0.0221465076660988
CENTRO 2,2024-02-05,639,627,12,0.0187793427230047
CENTRO 2,2024-02-06,669,640,29,0.0433482810164425
CENTRO 2,2024-02-07,679,655,24,0.0353460972017673
CENTRO 2,2024-02-08,633,611,22,0.0347551342812006
CENTRO 2,2024-02-09,641,620,21,0.0327613104524181
CENTRO 2,2024-02-10,788,778,10,0.0126903553299492
CENTRO 2,2024-02-11,515,501,14,0.0271844660194175
CENTRO 2,2024-02-12,512,479,33,0.064453125
CENTRO 2,2024-02-13,636,623,13,0.020440251572327
CENTRO 2,2024-02-14,573,558,15,0.0261780104712042
CENTRO 2,2024-02-15,605,588,17,0.028099173553719
CENTRO 2,2024-02-16,651,628,23,0.0353302611367127
CENTRO 2,2024-02-17,761,746,15,0.0197109067017083
CENTRO 2,2024-02-18,622,607,15,0.0241157556270096
CENTRO 2,2024-02-19,636,611,25,0.0393081761006289
CENTRO 2,2024-02-20,634,622,12,0.0189274447949527
CENTRO 2,2024-02-21,617,600,17,0.0275526742301459
CENTRO 2,2024-02-22,666,655,11,0.0165165165165165
CENTRO 2,2024-02-23,482,431,51,0.105809128630705
CENTRO 2,2024-02-24,786,773,13,0.0165394402035623
CENTRO 2,2024-02-25,565,556,9,0.015929203539823
CENTRO 2,2024-02-26,694,676,18,0.0259365994236311
CENTRO 2,2024-02-27,707,691,16,0.0226308345120226
CENTRO 2,2024-02-28,733,708,25,0.034106412005457
CENTRO 2,2024-02-29,762,743,19,0.0249343832020997
CENTRO 2,2024-03-01,660,643,17,0.0257575757575758
CENTRO 2,2024-03-02,806,795,11,0.0136476426799007
CENTRO 2,2024-03-03,649,640,9,0.0138674884437596
CENTRO 2,2024-03-04,690,674,16,0.0231884057971014
CENTRO 2,2024-03-05,721,699,22,0.0305131761442441
CENTRO 2,2024-03-06,678,660,18,0.0265486725663717
CENTRO 2,2024-03-07,645,628,17,0.0263565891472868
CENTRO 2,2024-03-08,657,637,20,0.030441400304414
CENTRO 2,2024-03-09,766,752,14,0.0182767624020888
CENTRO 2,2024-03-10,594,585,9,0.0151515151515152
CENTRO 2,2024-03-11,648,638,10,0.0154320987654321
CENTRO 2,2024-03-12,623,611,12,0.0192616372391653
CENTRO 2,2024-03-13,612,602,10,0.0163398692810458
CENTRO 2,2024-03-14,616,600,16,0.025974025974026
CENTRO 2,2024-03-15,663,650,13,0.0196078431372549
CENTRO 2,2024-03-16,816,793,23,0.0281862745098039
CENTRO 2,2024-03-17,584,566,18,0.0308219178082192
CENTRO 2,2024-03-18,610,598,12,0.019672131147541
CENTRO 2,2024-03-19,604,590,14,0.0231788079470199
CENTRO 2,2024-03-20,605,589,16,0.0264462809917355
CENTRO 2,2024-03-21,572,560,12,0.020979020979021
CENTRO 2,2024-03-22,567,542,25,0.0440917107583774
CENTRO 2,2024-03-23,696,681,15,0.021551724137931
CENTRO 2,2024-03-24,491,472,19,0.0386965376782077
CENTRO 2,2024-03-25,600,579,21,0.035
CENTRO 2,2024-03-26,650,626,24,0.0369230769230769
CENTRO 2,2024-03-27,682,665,17,0.0249266862170088
CENTRO 2,2024-03-28,795,778,17,0.0213836477987421
CENTRO 2,2024-03-29,641,629,12,0.0187207488299532
CENTRO 2,2024-03-30,565,550,15,0.0265486725663717
CENTRO 2,2024-03-31,461,452,9,0.0195227765726681
CENTRO 2,2024-04-01,618,597,21,0.0339805825242718
CENTRO 2,2024-04-02,679,660,19,0.0279823269513991
CENTRO 2,2024-04-03,617,617,0,0
CENTRO 2,2024-04-04,616,616,0,0
CENTRO 2,2024-04-05,600,580,20,0.0333333333333333
CENTRO 2,2024-04-06,691,680,11,0.0159189580318379
CENTRO 2,2024-04-07,466,453,13,0.0278969957081545
CENTRO 2,2024-04-08,538,524,14,0.0260223048327138
CENTRO 2,2024-04-09,576,568,8,0.0138888888888889
CENTRO 2,2024-04-10,552,536,16,0.0289855072463768
CENTRO 2,2024-04-11,582,561,21,0.0360824742268041
CENTRO 2,2024-04-12,564,545,19,0.0336879432624113
CENTRO 2,2024-04-13,649,633,16,0.024653312788906
CENTRO 2,2024-04-14,517,506,11,0.0212765957446809
CENTRO 2,2024-04-15,635,620,15,0.0236220472440945
CENTRO 2,2024-04-16,727,679,48,0.0660247592847318
CENTRO 2,2024-04-17,653,620,33,0.0505359877488515
CENTRO 2,2024-04-18,597,573,24,0.0402010050251256
CENTRO 2,2024-04-19,552,526,26,0.0471014492753623
CENTRO 2,2024-04-20,674,648,26,0.0385756676557863
CENTRO 2,2024-04-21,493,488,5,0.0101419878296146
CENTRO 2,2024-04-22,310,296,14,0.0451612903225806
CENTRO 2,2024-04-23,718,677,41,0.0571030640668524
NORESTE-FRONTERA,2023-04-24,645,630,15,0.0232558139534884
NORESTE-FRONTERA,2023-04-25,769,740,29,0.0377113133940182
NORESTE-FRONTERA,2023-04-26,693,675,18,0.025974025974026
NORESTE-FRONTERA,2023-04-27,609,590,19,0.0311986863711002
NORESTE-FRONTERA,2023-04-28,727,702,25,0.0343878954607978
NORESTE-FRONTERA,2023-04-29,850,819,31,0.0364705882352941
NORESTE-FRONTERA,2023-04-30,649,624,25,0.0385208012326656
NORESTE-FRONTERA,2023-05-01,538,522,16,0.0297397769516729
NORESTE-FRONTERA,2023-05-02,620,601,19,0.0306451612903226
NORESTE-FRONTERA,2023-05-03,588,572,16,0.0272108843537415
NORESTE-FRONTERA,2023-05-04,628,605,23,0.036624203821656
NORESTE-FRONTERA,2023-05-05,711,682,29,0.0407876230661041
NORESTE-FRONTERA,2023-05-06,736,713,23,0.03125
NORESTE-FRONTERA,2023-05-07,567,552,15,0.0264550264550265
NORESTE-FRONTERA,2023-05-08,581,554,27,0.0464716006884682
NORESTE-FRONTERA,2023-05-09,653,628,25,0.0382848392036753
NORESTE-FRONTERA,2023-05-10,587,555,32,0.0545144804088586
NORESTE-FRONTERA,2023-05-11,610,579,31,0.0508196721311475
NORESTE-FRONTERA,2023-05-12,652,624,28,0.0429447852760736
NORESTE-FRONTERA,2023-05-13,851,815,36,0.0423031727379553
NORESTE-FRONTERA,2023-05-14,794,764,30,0.0377833753148615
NORESTE-FRONTERA,2023-05-15,874,840,34,0.0389016018306636
NORESTE-FRONTERA,2023-05-16,925,894,31,0.0335135135135135
NORESTE-FRONTERA,2023-05-17,850,810,40,0.0470588235294118
NORESTE-FRONTERA,2023-05-18,582,564,18,0.0309278350515464
NORESTE-FRONTERA,2023-05-19,727,695,32,0.0440165061898212
NORESTE-FRONTERA,2023-05-20,742,715,27,0.0363881401617251
NORESTE-FRONTERA,2023-05-21,696,661,35,0.0502873563218391
NORESTE-FRONTERA,2023-05-22,707,679,28,0.0396039603960396
NORESTE-FRONTERA,2023-05-23,663,643,20,0.0301659125188537
NORESTE-FRONTERA,2023-05-24,639,608,31,0.0485133020344288
NORESTE-FRONTERA,2023-05-25,645,603,42,0.0651162790697674
NORESTE-FRONTERA,2023-05-26,527,495,32,0.0607210626185958
NORESTE-FRONTERA,2023-05-27,647,600,47,0.0726429675425039
NORESTE-FRONTERA,2023-05-28,548,513,35,0.0638686131386861
NORESTE-FRONTERA,2023-05-29,608,575,33,0.0542763157894737
NORESTE-FRONTERA,2023-05-30,584,545,39,0.0667808219178082
NORESTE-FRONTERA,2023-05-31,634,592,42,0.0662460567823344
NORESTE-FRONTERA,2023-06-01,484,447,37,0.0764462809917355
NORESTE-FRONTERA,2023-06-02,551,517,34,0.0617059891107078
NORESTE-FRONTERA,2023-06-03,605,579,26,0.0429752066115702
NORESTE-FRONTERA,2023-06-04,530,508,22,0.0415094339622641
NORESTE-FRONTERA,2023-06-05,554,525,29,0.0523465703971119
NORESTE-FRONTERA,2023-06-06,584,557,27,0.0462328767123288
NORESTE-FRONTERA,2023-06-07,632,601,31,0.0490506329113924
NORESTE-FRONTERA,2023-06-08,569,539,30,0.0527240773286467
NORESTE-FRONTERA,2023-06-09,613,589,24,0.0391517128874388
NORESTE-FRONTERA,2023-06-10,687,655,32,0.0465793304221252
NORESTE-FRONTERA,2023-06-11,540,519,21,0.0388888888888889
NORESTE-FRONTERA,2023-06-12,614,589,25,0.0407166123778502
NORESTE-FRONTERA,2023-06-13,630,600,30,0.0476190476190476
NORESTE-FRONTERA,2023-06-14,612,582,30,0.0490196078431373
NORESTE-FRONTERA,2023-06-15,603,572,31,0.0514096185737977
NORESTE-FRONTERA,2023-06-16,598,560,38,0.0635451505016722
NORESTE-FRONTERA,2023-06-17,692,663,29,0.0419075144508671
NORESTE-FRONTERA,2023-06-18,437,416,21,0.0480549199084668
NORESTE-FRONTERA,2023-06-19,592,561,31,0.0523648648648649
NORESTE-FRONTERA,2023-06-20,542,513,29,0.0535055350553506
NORESTE-FRONTERA,2023-06-21,578,545,33,0.0570934256055363
NORESTE-FRONTERA,2023-06-22,624,603,21,0.0336538461538462
NORESTE-FRONTERA,2023-06-23,643,604,39,0.0606531881804044
NORESTE-FRONTERA,2023-06-24,700,664,36,0.0514285714285714
NORESTE-FRONTERA,2023-06-25,535,513,22,0.0411214953271028
NORESTE-FRONTERA,2023-06-26,602,574,28,0.0465116279069767
NORESTE-FRONTERA,2023-06-27,661,626,35,0.0529500756429652
NORESTE-FRONTERA,2023-06-28,542,518,24,0.044280442804428
NORESTE-FRONTERA,2023-06-29,601,583,18,0.0299500831946755
NORESTE-FRONTERA,2023-06-30,341,324,17,0.0498533724340176
NORESTE-FRONTERA,2023-07-01,620,607,13,0.0209677419354839
NORESTE-FRONTERA,2023-07-02,417,406,11,0.026378896882494
NORESTE-FRONTERA,2023-07-03,555,541,14,0.0252252252252252
NORESTE-FRONTERA,2023-07-04,621,602,19,0.0305958132045089
NORESTE-FRONTERA,2023-07-05,397,387,10,0.0251889168765743
NORESTE-FRONTERA,2023-07-06,491,477,14,0.0285132382892057
NORESTE-FRONTERA,2023-07-07,593,582,11,0.0185497470489039
NORESTE-FRONTERA,2023-07-08,645,631,14,0.0217054263565891
NORESTE-FRONTERA,2023-07-09,541,538,3,0.0055452865064695
NORESTE-FRONTERA,2023-07-10,537,523,14,0.0260707635009311
NORESTE-FRONTERA,2023-07-11,594,579,15,0.0252525252525253
NORESTE-FRONTERA,2023-07-12,612,598,14,0.0228758169934641
NORESTE-FRONTERA,2023-07-13,635,618,17,0.0267716535433071
NORESTE-FRONTERA,2023-07-14,617,603,14,0.0226904376012966
NORESTE-FRONTERA,2023-07-15,733,709,24,0.0327421555252387
NORESTE-FRONTERA,2023-07-16,466,464,2,0.00429184549356223
NORESTE-FRONTERA,2023-07-17,618,604,14,0.0226537216828479
NORESTE-FRONTERA,2023-07-18,641,634,7,0.0109204368174727
NORESTE-FRONTERA,2023-07-19,579,570,9,0.0155440414507772
NORESTE-FRONTERA,2023-07-20,637,624,13,0.0204081632653061
NORESTE-FRONTERA,2023-07-21,728,712,16,0.021978021978022
NORESTE-FRONTERA,2023-07-22,764,750,14,0.0183246073298429
NORESTE-FRONTERA,2023-07-23,504,501,3,0.00595238095238095
NORESTE-FRONTERA,2023-07-24,569,552,17,0.0298769771528998
NORESTE-FRONTERA,2023-07-25,642,629,13,0.0202492211838006
NORESTE-FRONTERA,2023-07-26,651,637,14,0.021505376344086
NORESTE-FRONTERA,2023-07-27,680,670,10,0.0147058823529412
NORESTE-FRONTERA,2023-07-28,737,722,15,0.0203527815468114
NORESTE-FRONTERA,2023-07-29,744,730,14,0.0188172043010753
NORESTE-FRONTERA,2023-07-30,507,499,8,0.0157790927021696
NORESTE-FRONTERA,2023-07-31,593,576,17,0.0286677908937605
NORESTE-FRONTERA,2023-08-01,596,573,23,0.0385906040268456
NORESTE-FRONTERA,2023-08-02,719,697,22,0.0305980528511822
NORESTE-FRONTERA,2023-08-03,640,544,96,0.15
NORESTE-FRONTERA,2023-08-04,659,630,29,0.0440060698027314
NORESTE-FRONTERA,2023-08-05,732,705,27,0.0368852459016393
NORESTE-FRONTERA,2023-08-06,497,476,21,0.0422535211267606
NORESTE-FRONTERA,2023-08-07,585,561,24,0.041025641025641
NORESTE-FRONTERA,2023-08-08,601,580,21,0.0349417637271215
NORESTE-FRONTERA,2023-08-09,586,566,20,0.0341296928327645
NORESTE-FRONTERA,2023-08-10,573,549,24,0.0418848167539267
NORESTE-FRONTERA,2023-08-11,691,666,25,0.0361794500723589
NORESTE-FRONTERA,2023-08-12,631,599,32,0.0507131537242472
NORESTE-FRONTERA,2023-08-13,424,406,18,0.0424528301886792
NORESTE-FRONTERA,2023-08-14,543,524,19,0.0349907918968692
NORESTE-FRONTERA,2023-08-15,657,639,18,0.0273972602739726
NORESTE-FRONTERA,2023-08-16,653,633,20,0.0306278713629403
NORESTE-FRONTERA,2023-08-17,705,678,27,0.0382978723404255
NORESTE-FRONTERA,2023-08-18,796,781,15,0.0188442211055276
NORESTE-FRONTERA,2023-08-19,886,833,53,0.0598194130925508
NORESTE-FRONTERA,2023-08-20,589,566,23,0.0390492359932088
NORESTE-FRONTERA,2023-08-21,570,551,19,0.0333333333333333
NORESTE-FRONTERA,2023-08-22,572,551,21,0.0367132867132867
NORESTE-FRONTERA,2023-08-23,686,647,39,0.0568513119533528
NORESTE-FRONTERA,2023-08-24,646,612,34,0.0526315789473684
NORESTE-FRONTERA,2023-08-25,792,750,42,0.053030303030303
NORESTE-FRONTERA,2023-08-26,894,859,35,0.0391498881431767
NORESTE-FRONTERA,2023-08-27,667,634,33,0.0494752623688156
NORESTE-FRONTERA,2023-08-28,640,611,29,0.0453125
NORESTE-FRONTERA,2023-08-29,629,606,23,0.0365659777424483
NORESTE-FRONTERA,2023-08-30,578,567,11,0.0190311418685121
NORESTE-FRONTERA,2023-08-31,622,609,13,0.0209003215434084
NORESTE-FRONTERA,2023-09-01,585,577,8,0.0136752136752137
NORESTE-FRONTERA,2023-09-02,641,634,7,0.0109204368174727
NORESTE-FRONTERA,2023-09-03,549,540,9,0.0163934426229508
NORESTE-FRONTERA,2023-09-04,583,577,6,0.0102915951972556
NORESTE-FRONTERA,2023-09-05,668,659,9,0.0134730538922156
NORESTE-FRONTERA,2023-09-06,663,658,5,0.00754147812971342
NORESTE-FRONTERA,2023-09-07,569,565,4,0.0070298769771529
NORESTE-FRONTERA,2023-09-08,599,594,5,0.00834724540901502
NORESTE-FRONTERA,2023-09-09,702,687,15,0.0213675213675214
NORESTE-FRONTERA,2023-09-10,510,507,3,0.00588235294117647
NORESTE-FRONTERA,2023-09-11,558,552,6,0.010752688172043
NORESTE-FRONTERA,2023-09-12,624,614,10,0.016025641025641
NORESTE-FRONTERA,2023-09-13,616,608,8,0.012987012987013
NORESTE-FRONTERA,2023-09-14,515,511,4,0.00776699029126214
NORESTE-FRONTERA,2023-09-15,665,650,15,0.0225563909774436
NORESTE-FRONTERA,2023-09-16,488,482,6,0.0122950819672131
NORESTE-FRONTERA,2023-09-17,498,491,7,0.0140562248995984
NORESTE-FRONTERA,2023-09-18,564,557,7,0.0124113475177305
NORESTE-FRONTERA,2023-09-19,441,439,2,0.00453514739229025
NORESTE-FRONTERA,2023-09-20,372,369,3,0.00806451612903226
NORESTE-FRONTERA,2023-09-21,390,374,16,0.041025641025641
NORESTE-FRONTERA,2023-09-22,624,613,11,0.0176282051282051
NORESTE-FRONTERA,2023-09-23,693,681,12,0.0173160173160173
NORESTE-FRONTERA,2023-09-24,522,515,7,0.0134099616858238
NORESTE-FRONTERA,2023-09-25,570,560,10,0.0175438596491228
NORESTE-FRONTERA,2023-09-26,581,566,15,0.0258175559380379
NORESTE-FRONTERA,2023-09-27,580,567,13,0.0224137931034483
NORESTE-FRONTERA,2023-09-28,638,622,16,0.0250783699059561
NORESTE-FRONTERA,2023-09-29,641,615,26,0.0405616224648986
NORESTE-FRONTERA,2023-09-30,717,697,20,0.0278940027894003
NORESTE-FRONTERA,2023-10-01,480,462,18,0.0375
NORESTE-FRONTERA,2023-10-02,530,518,12,0.0226415094339623
NORESTE-FRONTERA,2023-10-03,425,412,13,0.0305882352941176
NORESTE-FRONTERA,2023-10-04,634,606,28,0.0441640378548896
NORESTE-FRONTERA,2023-10-05,496,478,18,0.0362903225806452
NORESTE-FRONTERA,2023-10-06,570,553,17,0.0298245614035088
NORESTE-FRONTERA,2023-10-07,651,626,25,0.0384024577572965
NORESTE-FRONTERA,2023-10-08,473,454,19,0.040169133192389
NORESTE-FRONTERA,2023-10-09,538,517,21,0.0390334572490706
NORESTE-FRONTERA,2023-10-10,473,465,8,0.0169133192389006
NORESTE-FRONTERA,2023-10-11,535,520,15,0.0280373831775701
NORESTE-FRONTERA,2023-10-12,448,432,16,0.0357142857142857
NORESTE-FRONTERA,2023-10-13,421,410,11,0.0261282660332542
NORESTE-FRONTERA,2023-10-14,571,555,16,0.0280210157618214
NORESTE-FRONTERA,2023-10-15,476,464,12,0.0252100840336134
NORESTE-FRONTERA,2023-10-16,567,553,14,0.0246913580246914
NORESTE-FRONTERA,2023-10-17,582,571,11,0.0189003436426117
NORESTE-FRONTERA,2023-10-18,640,623,17,0.0265625
NORESTE-FRONTERA,2023-10-19,588,577,11,0.0187074829931973
NORESTE-FRONTERA,2023-10-20,581,564,17,0.0292598967297762
NORESTE-FRONTERA,2023-10-21,682,667,15,0.0219941348973607
NORESTE-FRONTERA,2023-10-22,478,470,8,0.0167364016736402
NORESTE-FRONTERA,2023-10-23,544,523,21,0.0386029411764706
NORESTE-FRONTERA,2023-10-24,540,523,17,0.0314814814814815
NORESTE-FRONTERA,2023-10-25,563,550,13,0.0230905861456483
NORESTE-FRONTERA,2023-10-26,600,582,18,0.03
NORESTE-FRONTERA,2023-10-27,571,556,15,0.0262697022767075
NORESTE-FRONTERA,2023-10-28,686,674,12,0.0174927113702624
NORESTE-FRONTERA,2023-10-29,458,446,12,0.0262008733624454
NORESTE-FRONTERA,2023-10-30,459,450,9,0.0196078431372549
NORESTE-FRONTERA,2023-10-31,488,479,9,0.0184426229508197
NORESTE-FRONTERA,2023-11-01,555,541,14,0.0252252252252252
NORESTE-FRONTERA,2023-11-02,574,562,12,0.0209059233449477
NORESTE-FRONTERA,2023-11-03,641,627,14,0.0218408736349454
NORESTE-FRONTERA,2023-11-04,694,675,19,0.0273775216138329
NORESTE-FRONTERA,2023-11-05,522,511,11,0.0210727969348659
NORESTE-FRONTERA,2023-11-06,592,580,12,0.0202702702702703
NORESTE-FRONTERA,2023-11-07,634,620,14,0.0220820189274448
NORESTE-FRONTERA,2023-11-08,641,631,10,0.015600624024961
NORESTE-FRONTERA,2023-11-09,654,641,13,0.0198776758409786
NORESTE-FRONTERA,2023-11-10,615,609,6,0.00975609756097561
NORESTE-FRONTERA,2023-11-11,766,748,18,0.0234986945169713
NORESTE-FRONTERA,2023-11-12,414,404,10,0.0241545893719807
NORESTE-FRONTERA,2023-11-13,621,603,18,0.0289855072463768
NORESTE-FRONTERA,2023-11-14,679,665,14,0.0206185567010309
NORESTE-FRONTERA,2023-11-15,607,593,14,0.0230642504118616
NORESTE-FRONTERA,2023-11-16,598,576,22,0.0367892976588629
NORESTE-FRONTERA,2023-11-17,768,752,16,0.0208333333333333
NORESTE-FRONTERA,2023-11-18,878,864,14,0.0159453302961276
NORESTE-FRONTERA,2023-11-19,623,612,11,0.0176565008025682
NORESTE-FRONTERA,2023-11-20,605,591,14,0.0231404958677686
NORESTE-FRONTERA,2023-11-21,630,616,14,0.0222222222222222
NORESTE-FRONTERA,2023-11-22,614,598,16,0.0260586319218241
NORESTE-FRONTERA,2023-11-23,727,711,16,0.0220082530949106
NORESTE-FRONTERA,2023-11-24,749,730,19,0.0253671562082777
NORESTE-FRONTERA,2023-11-25,796,780,16,0.0201005025125628
NORESTE-FRONTERA,2023-11-26,745,727,18,0.0241610738255034
NORESTE-FRONTERA,2023-11-27,605,596,9,0.0148760330578512
NORESTE-FRONTERA,2023-11-28,714,706,8,0.0112044817927171
NORESTE-FRONTERA,2023-11-29,729,690,39,0.0534979423868313
NORESTE-FRONTERA,2023-11-30,752,719,33,0.0438829787234043
NORESTE-FRONTERA,2023-12-01,631,612,19,0.0301109350237718
NORESTE-FRONTERA,2023-12-02,830,802,28,0.0337349397590361
NORESTE-FRONTERA,2023-12-03,691,673,18,0.0260492040520984
NORESTE-FRONTERA,2023-12-04,662,634,28,0.0422960725075529
NORESTE-FRONTERA,2023-12-05,696,671,25,0.0359195402298851
NORESTE-FRONTERA,2023-12-06,678,651,27,0.0398230088495575
NORESTE-FRONTERA,2023-12-07,724,702,22,0.0303867403314917
NORESTE-FRONTERA,2023-12-08,800,779,21,0.02625
NORESTE-FRONTERA,2023-12-09,826,801,25,0.0302663438256659
NORESTE-FRONTERA,2023-12-10,675,649,26,0.0385185185185185
NORESTE-FRONTERA,2023-12-11,531,514,17,0.032015065913371
NORESTE-FRONTERA,2023-12-12,674,647,27,0.0400593471810089
NORESTE-FRONTERA,2023-12-13,602,589,13,0.0215946843853821
NORESTE-FRONTERA,2023-12-14,600,582,18,0.03
NORESTE-FRONTERA,2023-12-15,607,586,21,0.0345963756177924
NORESTE-FRONTERA,2023-12-16,715,693,22,0.0307692307692308
NORESTE-FRONTERA,2023-12-17,552,537,15,0.0271739130434783
NORESTE-FRONTERA,2023-12-18,621,603,18,0.0289855072463768
NORESTE-FRONTERA,2023-12-19,720,702,18,0.025
NORESTE-FRONTERA,2023-12-20,779,756,23,0.0295250320924262
NORESTE-FRONTERA,2023-12-21,691,663,28,0.040520984081042
NORESTE-FRONTERA,2023-12-22,748,731,17,0.0227272727272727
NORESTE-FRONTERA,2023-12-23,783,764,19,0.0242656449553001
NORESTE-FRONTERA,2023-12-24,462,458,4,0.00865800865800866
NORESTE-FRONTERA,2023-12-25,170,170,0,0
NORESTE-FRONTERA,2023-12-26,588,577,11,0.0187074829931973
NORESTE-FRONTERA,2023-12-27,760,739,21,0.0276315789473684
NORESTE-FRONTERA,2023-12-28,749,731,18,0.0240320427236315
NORESTE-FRONTERA,2023-12-29,823,802,21,0.0255164034021871
NORESTE-FRONTERA,2023-12-30,771,760,11,0.0142671854734112
NORESTE-FRONTERA,2023-12-31,396,387,9,0.0227272727272727
NORESTE-FRONTERA,2024-01-01,83,82,1,0.0120481927710843
NORESTE-FRONTERA,2024-01-02,499,487,12,0.0240480961923848
NORESTE-FRONTERA,2024-01-03,770,753,17,0.0220779220779221
NORESTE-FRONTERA,2024-01-04,702,687,15,0.0213675213675214
NORESTE-FRONTERA,2024-01-05,769,748,21,0.0273081924577373
NORESTE-FRONTERA,2024-01-06,894,865,29,0.0324384787472036
NORESTE-FRONTERA,2024-01-07,586,576,10,0.0170648464163823
NORESTE-FRONTERA,2024-01-08,588,577,11,0.0187074829931973
NORESTE-FRONTERA,2024-01-09,639,619,20,0.0312989045383412
NORESTE-FRONTERA,2024-01-10,671,654,17,0.0253353204172876
NORESTE-FRONTERA,2024-01-11,655,647,8,0.0122137404580153
NORESTE-FRONTERA,2024-01-12,776,759,17,0.0219072164948454
NORESTE-FRONTERA,2024-01-13,806,795,11,0.0136476426799007
NORESTE-FRONTERA,2024-01-14,627,619,8,0.0127591706539075
NORESTE-FRONTERA,2024-01-15,668,646,22,0.0329341317365269
NORESTE-FRONTERA,2024-01-16,697,681,16,0.0229555236728838
NORESTE-FRONTERA,2024-01-17,729,705,24,0.0329218106995885
NORESTE-FRONTERA,2024-01-18,735,718,17,0.0231292517006803
NORESTE-FRONTERA,2024-01-19,682,665,17,0.0249266862170088
NORESTE-FRONTERA,2024-01-20,761,743,18,0.0236530880420499
NORESTE-FRONTERA,2024-01-21,613,597,16,0.0261011419249592
NORESTE-FRONTERA,2024-01-22,655,640,15,0.0229007633587786
NORESTE-FRONTERA,2024-01-23,703,676,27,0.0384068278805121
NORESTE-FRONTERA,2024-01-24,659,644,15,0.0227617602427921
NORESTE-FRONTERA,2024-01-25,733,717,16,0.0218281036834925
NORESTE-FRONTERA,2024-01-26,727,700,27,0.0371389270976616
NORESTE-FRONTERA,2024-01-27,795,777,18,0.0226415094339623
NORESTE-FRONTERA,2024-01-28,570,556,14,0.0245614035087719
NORESTE-FRONTERA,2024-01-29,653,632,21,0.0321592649310873
NORESTE-FRONTERA,2024-01-30,565,547,18,0.031858407079646
NORESTE-FRONTERA,2024-01-31,693,676,17,0.0245310245310245
NORESTE-FRONTERA,2024-02-01,639,621,18,0.028169014084507
NORESTE-FRONTERA,2024-02-02,657,637,20,0.030441400304414
NORESTE-FRONTERA,2024-02-03,729,706,23,0.0315500685871056
NORESTE-FRONTERA,2024-02-04,551,542,9,0.0163339382940109
NORESTE-FRONTERA,2024-02-05,488,481,7,0.014344262295082
NORESTE-FRONTERA,2024-02-06,616,604,12,0.0194805194805195
NORESTE-FRONTERA,2024-02-07,662,646,16,0.0241691842900302
NORESTE-FRONTERA,2024-02-08,724,721,3,0.00414364640883978
NORESTE-FRONTERA,2024-02-09,664,651,13,0.019578313253012
NORESTE-FRONTERA,2024-02-10,776,763,13,0.0167525773195876
NORESTE-FRONTERA,2024-02-11,534,528,6,0.0112359550561798
NORESTE-FRONTERA,2024-02-12,516,502,14,0.0271317829457364
NORESTE-FRONTERA,2024-02-13,678,668,10,0.0147492625368732
NORESTE-FRONTERA,2024-02-14,620,606,14,0.0225806451612903
NORESTE-FRONTERA,2024-02-15,607,596,11,0.0181219110378913
NORESTE-FRONTERA,2024-02-16,665,651,14,0.0210526315789474
NORESTE-FRONTERA,2024-02-17,599,587,12,0.0200333889816361
NORESTE-FRONTERA,2024-02-18,646,639,7,0.0108359133126935
NORESTE-FRONTERA,2024-02-19,595,583,12,0.0201680672268908
NORESTE-FRONTERA,2024-02-20,678,668,10,0.0147492625368732
NORESTE-FRONTERA,2024-02-21,673,662,11,0.0163447251114413
NORESTE-FRONTERA,2024-02-22,754,746,8,0.0106100795755968
NORESTE-FRONTERA,2024-02-23,549,488,61,0.111111111111111
NORESTE-FRONTERA,2024-02-24,833,821,12,0.014405762304922
NORESTE-FRONTERA,2024-02-25,589,582,7,0.0118845500848896
NORESTE-FRONTERA,2024-02-26,675,661,14,0.0207407407407407
NORESTE-FRONTERA,2024-02-27,676,665,11,0.0162721893491124
NORESTE-FRONTERA,2024-02-28,609,598,11,0.0180623973727422
NORESTE-FRONTERA,2024-02-29,697,680,17,0.024390243902439
NORESTE-FRONTERA,2024-03-01,658,640,18,0.027355623100304
NORESTE-FRONTERA,2024-03-02,714,704,10,0.0140056022408964
NORESTE-FRONTERA,2024-03-03,556,549,7,0.012589928057554
NORESTE-FRONTERA,2024-03-04,605,591,14,0.0231404958677686
NORESTE-FRONTERA,2024-03-05,601,588,13,0.021630615640599
NORESTE-FRONTERA,2024-03-06,677,664,13,0.0192023633677991
NORESTE-FRONTERA,2024-03-07,678,668,10,0.0147492625368732
NORESTE-FRONTERA,2024-03-08,644,630,14,0.0217391304347826
NORESTE-FRONTERA,2024-03-09,756,742,14,0.0185185185185185
NORESTE-FRONTERA,2024-03-10,569,559,10,0.0175746924428823
NORESTE-FRONTERA,2024-03-11,584,576,8,0.0136986301369863
NORESTE-FRONTERA,2024-03-12,566,563,3,0.00530035335689046
NORESTE-FRONTERA,2024-03-13,628,617,11,0.017515923566879
NORESTE-FRONTERA,2024-03-14,648,640,8,0.0123456790123457
NORESTE-FRONTERA,2024-03-15,669,659,10,0.0149476831091181
NORESTE-FRONTERA,2024-03-16,763,753,10,0.0131061598951507
NORESTE-FRONTERA,2024-03-17,575,563,12,0.0208695652173913
NORESTE-FRONTERA,2024-03-18,469,461,8,0.0170575692963753
NORESTE-FRONTERA,2024-03-19,593,580,13,0.0219224283305228
NORESTE-FRONTERA,2024-03-20,626,614,12,0.0191693290734824
NORESTE-FRONTERA,2024-03-21,580,571,9,0.0155172413793103
NORESTE-FRONTERA,2024-03-22,634,619,15,0.0236593059936909
NORESTE-FRONTERA,2024-03-23,712,695,17,0.023876404494382
NORESTE-FRONTERA,2024-03-24,491,483,8,0.0162932790224033
NORESTE-FRONTERA,2024-03-25,611,598,13,0.0212765957446809
NORESTE-FRONTERA,2024-03-26,677,664,13,0.0192023633677991
NORESTE-FRONTERA,2024-03-27,703,690,13,0.0184921763869132
NORESTE-FRONTERA,2024-03-28,809,790,19,0.0234857849196539
NORESTE-FRONTERA,2024-03-29,728,710,18,0.0247252747252747
NORESTE-FRONTERA,2024-03-30,653,638,15,0.0229709035222052
NORESTE-FRONTERA,2024-03-31,472,457,15,0.0317796610169492
NORESTE-FRONTERA,2024-04-01,607,595,12,0.0197693574958814
NORESTE-FRONTERA,2024-04-02,644,629,15,0.0232919254658385
NORESTE-FRONTERA,2024-04-03,631,631,0,0
NORESTE-FRONTERA,2024-04-04,622,622,0,0
NORESTE-FRONTERA,2024-04-05,687,673,14,0.0203784570596798
NORESTE-FRONTERA,2024-04-06,733,729,4,0.00545702592087312
NORESTE-FRONTERA,2024-04-07,527,518,9,0.0170777988614801
NORESTE-FRONTERA,2024-04-08,529,522,7,0.0132325141776938
NORESTE-FRONTERA,2024-04-09,594,582,12,0.0202020202020202
NORESTE-FRONTERA,2024-04-10,606,592,14,0.0231023102310231
NORESTE-FRONTERA,2024-04-11,609,603,6,0.00985221674876847
NORESTE-FRONTERA,2024-04-12,644,632,12,0.0186335403726708
NORESTE-FRONTERA,2024-04-13,789,775,14,0.017743979721166
NORESTE-FRONTERA,2024-04-14,581,575,6,0.0103270223752151
NORESTE-FRONTERA,2024-04-15,641,629,12,0.0187207488299532
NORESTE-FRONTERA,2024-04-16,643,601,42,0.0653188180404355
NORESTE-FRONTERA,2024-04-17,721,678,43,0.0596393897364771
NORESTE-FRONTERA,2024-04-18,609,596,13,0.0213464696223317
NORESTE-FRONTERA,2024-04-19,613,580,33,0.0538336052202284
NORESTE-FRONTERA,2024-04-20,706,682,24,0.0339943342776204
NORESTE-FRONTERA,2024-04-21,472,460,12,0.0254237288135593
NORESTE-FRONTERA,2024-04-22,306,292,14,0.0457516339869281
NORESTE-FRONTERA,2024-04-23,819,776,43,0.0525030525030525
NORTE-PACIFICO,2023-04-24,453,438,15,0.033112582781457
NORTE-PACIFICO,2023-04-25,589,551,38,0.0645161290322581
NORTE-PACIFICO,2023-04-26,491,454,37,0.0753564154786151
NORTE-PACIFICO,2023-04-27,439,413,26,0.0592255125284738
NORTE-PACIFICO,2023-04-28,576,537,39,0.0677083333333333
NORTE-PACIFICO,2023-04-29,669,624,45,0.0672645739910314
NORTE-PACIFICO,2023-04-30,438,411,27,0.0616438356164384
NORTE-PACIFICO,2023-05-01,373,345,28,0.0750670241286863
NORTE-PACIFICO,2023-05-02,459,438,21,0.0457516339869281
NORTE-PACIFICO,2023-05-03,451,432,19,0.0421286031042129
NORTE-PACIFICO,2023-05-04,478,452,26,0.0543933054393305
NORTE-PACIFICO,2023-05-05,514,481,33,0.0642023346303502
NORTE-PACIFICO,2023-05-06,540,514,26,0.0481481481481481
NORTE-PACIFICO,2023-05-07,406,387,19,0.0467980295566502
NORTE-PACIFICO,2023-05-08,483,454,29,0.0600414078674948
NORTE-PACIFICO,2023-05-09,522,502,20,0.0383141762452107
NORTE-PACIFICO,2023-05-10,419,401,18,0.0429594272076372
NORTE-PACIFICO,2023-05-11,487,469,18,0.0369609856262834
NORTE-PACIFICO,2023-05-12,479,460,19,0.0396659707724426
NORTE-PACIFICO,2023-05-13,715,678,37,0.0517482517482517
NORTE-PACIFICO,2023-05-14,520,490,30,0.0576923076923077
NORTE-PACIFICO,2023-05-15,603,567,36,0.0597014925373134
NORTE-PACIFICO,2023-05-16,601,558,43,0.0715474209650582
NORTE-PACIFICO,2023-05-17,538,489,49,0.0910780669144981
NORTE-PACIFICO,2023-05-18,461,429,32,0.06941431670282
NORTE-PACIFICO,2023-05-19,453,415,38,0.0838852097130243
NORTE-PACIFICO,2023-05-20,601,564,37,0.0615640599001664
NORTE-PACIFICO,2023-05-21,491,462,29,0.0590631364562118
NORTE-PACIFICO,2023-05-22,497,468,29,0.0583501006036217
NORTE-PACIFICO,2023-05-23,461,420,41,0.0889370932754881
NORTE-PACIFICO,2023-05-24,475,455,20,0.0421052631578947
NORTE-PACIFICO,2023-05-25,506,466,40,0.0790513833992095
NORTE-PACIFICO,2023-05-26,589,533,56,0.0950764006791171
NORTE-PACIFICO,2023-05-27,665,590,75,0.112781954887218
NORTE-PACIFICO,2023-05-28,402,370,32,0.0796019900497512
NORTE-PACIFICO,2023-05-29,548,518,30,0.0547445255474453
NORTE-PACIFICO,2023-05-30,495,452,43,0.0868686868686869
NORTE-PACIFICO,2023-05-31,586,536,50,0.0853242320819113
NORTE-PACIFICO,2023-06-01,439,412,27,0.061503416856492
NORTE-PACIFICO,2023-06-02,441,406,35,0.0793650793650794
NORTE-PACIFICO,2023-06-03,585,527,58,0.0991452991452991
NORTE-PACIFICO,2023-06-04,439,387,52,0.118451025056948
NORTE-PACIFICO,2023-06-05,453,423,30,0.0662251655629139
NORTE-PACIFICO,2023-06-06,495,463,32,0.0646464646464646
NORTE-PACIFICO,2023-06-07,464,421,43,0.0926724137931035
NORTE-PACIFICO,2023-06-08,497,470,27,0.0543259557344064
NORTE-PACIFICO,2023-06-09,519,470,49,0.0944123314065511
NORTE-PACIFICO,2023-06-10,632,580,52,0.0822784810126582
NORTE-PACIFICO,2023-06-11,500,449,51,0.102
NORTE-PACIFICO,2023-06-12,515,477,38,0.0737864077669903
NORTE-PACIFICO,2023-06-13,589,550,39,0.066213921901528
NORTE-PACIFICO,2023-06-14,533,504,29,0.0544090056285178
NORTE-PACIFICO,2023-06-15,506,475,31,0.0612648221343874
NORTE-PACIFICO,2023-06-16,504,469,35,0.0694444444444444
NORTE-PACIFICO,2023-06-17,608,566,42,0.0690789473684211
NORTE-PACIFICO,2023-06-18,433,392,41,0.0946882217090069
NORTE-PACIFICO,2023-06-19,539,504,35,0.0649350649350649
NORTE-PACIFICO,2023-06-20,474,449,25,0.0527426160337553
NORTE-PACIFICO,2023-06-21,517,481,36,0.0696324951644101
NORTE-PACIFICO,2023-06-22,410,379,31,0.075609756097561
NORTE-PACIFICO,2023-06-23,415,397,18,0.0433734939759036
NORTE-PACIFICO,2023-06-24,544,521,23,0.0422794117647059
NORTE-PACIFICO,2023-06-25,401,370,31,0.0773067331670823
NORTE-PACIFICO,2023-06-26,438,416,22,0.0502283105022831
NORTE-PACIFICO,2023-06-27,489,468,21,0.0429447852760736
NORTE-PACIFICO,2023-06-28,476,461,15,0.0315126050420168
NORTE-PACIFICO,2023-06-29,450,436,14,0.0311111111111111
NORTE-PACIFICO,2023-06-30,320,287,33,0.103125
NORTE-PACIFICO,2023-07-01,538,514,24,0.0446096654275093
NORTE-PACIFICO,2023-07-02,333,319,14,0.042042042042042
NORTE-PACIFICO,2023-07-03,426,411,15,0.0352112676056338
NORTE-PACIFICO,2023-07-04,391,383,8,0.020460358056266
NORTE-PACIFICO,2023-07-05,297,287,10,0.0336700336700337
NORTE-PACIFICO,2023-07-06,292,281,11,0.0376712328767123
NORTE-PACIFICO,2023-07-07,288,286,2,0.00694444444444444
NORTE-PACIFICO,2023-07-08,465,458,7,0.0150537634408602
NORTE-PACIFICO,2023-07-09,419,414,5,0.0119331742243437
NORTE-PACIFICO,2023-07-10,462,442,20,0.0432900432900433
NORTE-PACIFICO,2023-07-11,377,366,11,0.0291777188328912
NORTE-PACIFICO,2023-07-12,443,428,15,0.0338600451467269
NORTE-PACIFICO,2023-07-13,381,369,12,0.031496062992126
NORTE-PACIFICO,2023-07-14,396,380,16,0.0404040404040404
NORTE-PACIFICO,2023-07-15,436,421,15,0.0344036697247706
NORTE-PACIFICO,2023-07-16,302,289,13,0.043046357615894
NORTE-PACIFICO,2023-07-17,429,418,11,0.0256410256410256
NORTE-PACIFICO,2023-07-18,413,401,12,0.0290556900726392
NORTE-PACIFICO,2023-07-19,428,411,17,0.0397196261682243
NORTE-PACIFICO,2023-07-20,491,481,10,0.0203665987780041
NORTE-PACIFICO,2023-07-21,484,473,11,0.0227272727272727
NORTE-PACIFICO,2023-07-22,522,509,13,0.024904214559387
NORTE-PACIFICO,2023-07-23,342,328,14,0.0409356725146199
NORTE-PACIFICO,2023-07-24,428,420,8,0.0186915887850467
NORTE-PACIFICO,2023-07-25,482,471,11,0.0228215767634855
NORTE-PACIFICO,2023-07-26,452,436,16,0.0353982300884956
NORTE-PACIFICO,2023-07-27,456,451,5,0.0109649122807018
NORTE-PACIFICO,2023-07-28,520,508,12,0.0230769230769231
NORTE-PACIFICO,2023-07-29,540,528,12,0.0222222222222222
NORTE-PACIFICO,2023-07-30,380,372,8,0.0210526315789474
NORTE-PACIFICO,2023-07-31,446,432,14,0.031390134529148
NORTE-PACIFICO,2023-08-01,471,452,19,0.0403397027600849
NORTE-PACIFICO,2023-08-02,459,437,22,0.0479302832244009
NORTE-PACIFICO,2023-08-03,477,402,75,0.157232704402516
NORTE-PACIFICO,2023-08-04,486,461,25,0.051440329218107
NORTE-PACIFICO,2023-08-05,499,480,19,0.0380761523046092
NORTE-PACIFICO,2023-08-06,393,371,22,0.0559796437659033
NORTE-PACIFICO,2023-08-07,426,411,15,0.0352112676056338
NORTE-PACIFICO,2023-08-08,453,438,15,0.033112582781457
NORTE-PACIFICO,2023-08-09,450,436,14,0.0311111111111111
NORTE-PACIFICO,2023-08-10,446,416,30,0.0672645739910314
NORTE-PACIFICO,2023-08-11,546,527,19,0.0347985347985348
NORTE-PACIFICO,2023-08-12,509,469,40,0.0785854616895874
NORTE-PACIFICO,2023-08-13,413,387,26,0.062953995157385
NORTE-PACIFICO,2023-08-14,410,392,18,0.0439024390243902
NORTE-PACIFICO,2023-08-15,450,429,21,0.0466666666666667
NORTE-PACIFICO,2023-08-16,390,368,22,0.0564102564102564
NORTE-PACIFICO,2023-08-17,415,402,13,0.0313253012048193
NORTE-PACIFICO,2023-08-18,486,463,23,0.0473251028806584
NORTE-PACIFICO,2023-08-19,513,495,18,0.0350877192982456
NORTE-PACIFICO,2023-08-20,192,186,6,0.03125
NORTE-PACIFICO,2023-08-21,329,323,6,0.0182370820668693
NORTE-PACIFICO,2023-08-22,419,410,9,0.0214797136038186
NORTE-PACIFICO,2023-08-23,414,402,12,0.0289855072463768
NORTE-PACIFICO,2023-08-24,459,451,8,0.0174291938997821
NORTE-PACIFICO,2023-08-25,445,430,15,0.0337078651685393
NORTE-PACIFICO,2023-08-26,534,518,16,0.0299625468164794
NORTE-PACIFICO,2023-08-27,421,417,4,0.00950118764845606
NORTE-PACIFICO,2023-08-28,487,475,12,0.0246406570841889
NORTE-PACIFICO,2023-08-29,442,441,1,0.00226244343891403
NORTE-PACIFICO,2023-08-30,453,451,2,0.00441501103752759
NORTE-PACIFICO,2023-08-31,514,511,3,0.00583657587548638
NORTE-PACIFICO,2023-09-01,375,369,6,0.016
NORTE-PACIFICO,2023-09-02,531,527,4,0.00753295668549906
NORTE-PACIFICO,2023-09-03,393,390,3,0.00763358778625954
NORTE-PACIFICO,2023-09-04,441,440,1,0.00226757369614512
NORTE-PACIFICO,2023-09-05,469,465,4,0.00852878464818763
NORTE-PACIFICO,2023-09-06,466,462,4,0.00858369098712446
NORTE-PACIFICO,2023-09-07,433,433,0,0
NORTE-PACIFICO,2023-09-08,505,500,5,0.0099009900990099
NORTE-PACIFICO,2023-09-09,561,555,6,0.0106951871657754
NORTE-PACIFICO,2023-09-10,408,405,3,0.00735294117647059
NORTE-PACIFICO,2023-09-11,432,427,5,0.0115740740740741
NORTE-PACIFICO,2023-09-12,459,459,0,0
NORTE-PACIFICO,2023-09-13,432,429,3,0.00694444444444444
NORTE-PACIFICO,2023-09-14,409,405,4,0.0097799511002445
NORTE-PACIFICO,2023-09-15,442,440,2,0.00452488687782805
NORTE-PACIFICO,2023-09-16,368,364,4,0.0108695652173913
NORTE-PACIFICO,2023-09-17,401,399,2,0.00498753117206983
NORTE-PACIFICO,2023-09-18,493,492,1,0.00202839756592292
NORTE-PACIFICO,2023-09-19,477,473,4,0.00838574423480084
NORTE-PACIFICO,2023-09-20,420,417,3,0.00714285714285714
NORTE-PACIFICO,2023-09-21,478,472,6,0.0125523012552301
NORTE-PACIFICO,2023-09-22,491,482,9,0.0183299389002037
NORTE-PACIFICO,2023-09-23,573,562,11,0.0191972076788831
NORTE-PACIFICO,2023-09-24,413,408,5,0.0121065375302663
NORTE-PACIFICO,2023-09-25,417,411,6,0.0143884892086331
NORTE-PACIFICO,2023-09-26,460,454,6,0.0130434782608696
NORTE-PACIFICO,2023-09-27,446,442,4,0.00896860986547085
NORTE-PACIFICO,2023-09-28,474,471,3,0.00632911392405063
NORTE-PACIFICO,2023-09-29,489,484,5,0.0102249488752556
NORTE-PACIFICO,2023-09-30,562,559,3,0.00533807829181495
NORTE-PACIFICO,2023-10-01,368,365,3,0.00815217391304348
NORTE-PACIFICO,2023-10-02,371,368,3,0.00808625336927224
NORTE-PACIFICO,2023-10-03,458,447,11,0.0240174672489083
NORTE-PACIFICO,2023-10-04,449,439,10,0.022271714922049
NORTE-PACIFICO,2023-10-05,462,456,6,0.012987012987013
NORTE-PACIFICO,2023-10-06,522,502,20,0.0383141762452107
NORTE-PACIFICO,2023-10-07,546,532,14,0.0256410256410256
NORTE-PACIFICO,2023-10-08,417,405,12,0.0287769784172662
NORTE-PACIFICO,2023-10-09,425,418,7,0.0164705882352941
NORTE-PACIFICO,2023-10-10,426,415,11,0.0258215962441315
NORTE-PACIFICO,2023-10-11,390,382,8,0.0205128205128205
NORTE-PACIFICO,2023-10-12,423,413,10,0.0236406619385343
NORTE-PACIFICO,2023-10-13,436,420,16,0.036697247706422
NORTE-PACIFICO,2023-10-14,502,490,12,0.0239043824701195
NORTE-PACIFICO,2023-10-15,417,411,6,0.0143884892086331
NORTE-PACIFICO,2023-10-16,437,425,12,0.0274599542334096
NORTE-PACIFICO,2023-10-17,429,422,7,0.0163170163170163
NORTE-PACIFICO,2023-10-18,389,377,12,0.0308483290488432
NORTE-PACIFICO,2023-10-19,431,423,8,0.0185614849187935
NORTE-PACIFICO,2023-10-20,455,446,9,0.0197802197802198
NORTE-PACIFICO,2023-10-21,553,543,10,0.0180831826401447
NORTE-PACIFICO,2023-10-22,350,340,10,0.0285714285714286
NORTE-PACIFICO,2023-10-23,369,359,10,0.02710027100271
NORTE-PACIFICO,2023-10-24,435,424,11,0.0252873563218391
NORTE-PACIFICO,2023-10-25,424,406,18,0.0424528301886792
NORTE-PACIFICO,2023-10-26,441,435,6,0.0136054421768707
NORTE-PACIFICO,2023-10-27,463,453,10,0.0215982721382289
NORTE-PACIFICO,2023-10-28,483,479,4,0.0082815734989648
NORTE-PACIFICO,2023-10-29,343,334,9,0.0262390670553936
NORTE-PACIFICO,2023-10-30,388,377,11,0.0283505154639175
NORTE-PACIFICO,2023-10-31,425,419,6,0.0141176470588235
NORTE-PACIFICO,2023-11-01,453,447,6,0.0132450331125828
NORTE-PACIFICO,2023-11-02,491,480,11,0.0224032586558045
NORTE-PACIFICO,2023-11-03,436,423,13,0.0298165137614679
NORTE-PACIFICO,2023-11-04,569,557,12,0.0210896309314587
NORTE-PACIFICO,2023-11-05,427,421,6,0.0140515222482436
NORTE-PACIFICO,2023-11-06,473,462,11,0.0232558139534884
NORTE-PACIFICO,2023-11-07,517,507,10,0.0193423597678917
NORTE-PACIFICO,2023-11-08,523,510,13,0.0248565965583174
NORTE-PACIFICO,2023-11-09,505,493,12,0.0237623762376238
NORTE-PACIFICO,2023-11-10,521,511,10,0.0191938579654511
NORTE-PACIFICO,2023-11-11,598,590,8,0.0133779264214047
NORTE-PACIFICO,2023-11-12,460,445,15,0.0326086956521739
NORTE-PACIFICO,2023-11-13,456,444,12,0.0263157894736842
NORTE-PACIFICO,2023-11-14,514,501,13,0.0252918287937743
NORTE-PACIFICO,2023-11-15,484,475,9,0.0185950413223141
NORTE-PACIFICO,2023-11-16,524,511,13,0.0248091603053435
NORTE-PACIFICO,2023-11-17,508,500,8,0.015748031496063
NORTE-PACIFICO,2023-11-18,644,631,13,0.0201863354037267
NORTE-PACIFICO,2023-11-19,475,465,10,0.0210526315789474
NORTE-PACIFICO,2023-11-20,431,421,10,0.0232018561484919
NORTE-PACIFICO,2023-11-21,546,530,16,0.0293040293040293
NORTE-PACIFICO,2023-11-22,495,484,11,0.0222222222222222
NORTE-PACIFICO,2023-11-23,553,540,13,0.0235081374321881
NORTE-PACIFICO,2023-11-24,573,565,8,0.0139616055846422
NORTE-PACIFICO,2023-11-25,612,599,13,0.0212418300653595
NORTE-PACIFICO,2023-11-26,448,446,2,0.00446428571428571
NORTE-PACIFICO,2023-11-27,444,434,10,0.0225225225225225
NORTE-PACIFICO,2023-11-28,522,511,11,0.0210727969348659
NORTE-PACIFICO,2023-11-29,504,489,15,0.0297619047619048
NORTE-PACIFICO,2023-11-30,474,466,8,0.0168776371308017
NORTE-PACIFICO,2023-12-01,516,502,14,0.0271317829457364
NORTE-PACIFICO,2023-12-02,619,607,12,0.0193861066235864
NORTE-PACIFICO,2023-12-03,476,466,10,0.0210084033613445
NORTE-PACIFICO,2023-12-04,502,483,19,0.0378486055776892
NORTE-PACIFICO,2023-12-05,538,519,19,0.0353159851301115
NORTE-PACIFICO,2023-12-06,520,506,14,0.0269230769230769
NORTE-PACIFICO,2023-12-07,527,514,13,0.0246679316888046
NORTE-PACIFICO,2023-12-08,544,534,10,0.0183823529411765
NORTE-PACIFICO,2023-12-09,559,552,7,0.0125223613595707
NORTE-PACIFICO,2023-12-10,480,471,9,0.01875
NORTE-PACIFICO,2023-12-11,480,474,6,0.0125
NORTE-PACIFICO,2023-12-12,496,488,8,0.0161290322580645
NORTE-PACIFICO,2023-12-13,504,494,10,0.0198412698412698
NORTE-PACIFICO,2023-12-14,458,446,12,0.0262008733624454
NORTE-PACIFICO,2023-12-15,477,466,11,0.0230607966457023
NORTE-PACIFICO,2023-12-16,539,530,9,0.0166975881261596
NORTE-PACIFICO,2023-12-17,449,442,7,0.0155902004454343
NORTE-PACIFICO,2023-12-18,483,474,9,0.0186335403726708
NORTE-PACIFICO,2023-12-19,548,539,9,0.0164233576642336
NORTE-PACIFICO,2023-12-20,536,517,19,0.0354477611940298
NORTE-PACIFICO,2023-12-21,579,565,14,0.0241796200345423
NORTE-PACIFICO,2023-12-22,481,471,10,0.0207900207900208
NORTE-PACIFICO,2023-12-23,529,523,6,0.0113421550094518
NORTE-PACIFICO,2023-12-24,249,244,5,0.0200803212851406
NORTE-PACIFICO,2023-12-25,34,33,1,0.0294117647058824
NORTE-PACIFICO,2023-12-26,499,490,9,0.0180360721442886
NORTE-PACIFICO,2023-12-27,510,497,13,0.0254901960784314
NORTE-PACIFICO,2023-12-28,543,529,14,0.0257826887661142
NORTE-PACIFICO,2023-12-29,543,536,7,0.0128913443830571
NORTE-PACIFICO,2023-12-30,521,510,11,0.0211132437619962
NORTE-PACIFICO,2023-12-31,240,237,3,0.0125
NORTE-PACIFICO,2024-01-01,29,29,0,0
NORTE-PACIFICO,2024-01-02,440,431,9,0.0204545454545455
NORTE-PACIFICO,2024-01-03,473,464,9,0.0190274841437632
NORTE-PACIFICO,2024-01-04,547,537,10,0.0182815356489945
NORTE-PACIFICO,2024-01-05,581,567,14,0.0240963855421687
NORTE-PACIFICO,2024-01-06,633,619,14,0.0221169036334913
NORTE-PACIFICO,2024-01-07,469,463,6,0.0127931769722814
NORTE-PACIFICO,2024-01-08,439,426,13,0.0296127562642369
NORTE-PACIFICO,2024-01-09,591,576,15,0.0253807106598985
NORTE-PACIFICO,2024-01-10,563,552,11,0.019538188277087
NORTE-PACIFICO,2024-01-11,447,433,14,0.0313199105145414
NORTE-PACIFICO,2024-01-12,558,547,11,0.0197132616487455
NORTE-PACIFICO,2024-01-13,646,634,12,0.0185758513931889
NORTE-PACIFICO,2024-01-14,479,472,7,0.0146137787056367
NORTE-PACIFICO,2024-01-15,399,381,18,0.0451127819548872
NORTE-PACIFICO,2024-01-16,625,612,13,0.0208
NORTE-PACIFICO,2024-01-17,525,517,8,0.0152380952380952
NORTE-PACIFICO,2024-01-18,604,593,11,0.0182119205298013
NORTE-PACIFICO,2024-01-19,528,512,16,0.0303030303030303
NORTE-PACIFICO,2024-01-20,521,513,8,0.0153550863723608
NORTE-PACIFICO,2024-01-21,459,453,6,0.0130718954248366
NORTE-PACIFICO,2024-01-22,318,309,9,0.0283018867924528
NORTE-PACIFICO,2024-01-23,513,506,7,0.01364522417154
NORTE-PACIFICO,2024-01-24,535,511,24,0.0448598130841121
NORTE-PACIFICO,2024-01-25,485,478,7,0.0144329896907217
NORTE-PACIFICO,2024-01-26,555,546,9,0.0162162162162162
NORTE-PACIFICO,2024-01-27,624,611,13,0.0208333333333333
NORTE-PACIFICO,2024-01-28,442,437,5,0.0113122171945701
NORTE-PACIFICO,2024-01-29,425,416,9,0.0211764705882353
NORTE-PACIFICO,2024-01-30,492,480,12,0.024390243902439
NORTE-PACIFICO,2024-01-31,515,506,9,0.0174757281553398
NORTE-PACIFICO,2024-02-01,334,326,8,0.0239520958083832
NORTE-PACIFICO,2024-02-02,545,533,12,0.0220183486238532
NORTE-PACIFICO,2024-02-03,592,576,16,0.027027027027027
NORTE-PACIFICO,2024-02-04,523,509,14,0.0267686424474187
NORTE-PACIFICO,2024-02-05,342,338,4,0.0116959064327485
NORTE-PACIFICO,2024-02-06,473,461,12,0.025369978858351
NORTE-PACIFICO,2024-02-07,527,512,15,0.0284629981024668
NORTE-PACIFICO,2024-02-08,500,493,7,0.014
NORTE-PACIFICO,2024-02-09,498,488,10,0.0200803212851406
NORTE-PACIFICO,2024-02-10,652,638,14,0.0214723926380368
NORTE-PACIFICO,2024-02-11,450,441,9,0.02
NORTE-PACIFICO,2024-02-12,388,379,9,0.0231958762886598
NORTE-PACIFICO,2024-02-13,550,543,7,0.0127272727272727
NORTE-PACIFICO,2024-02-14,477,475,2,0.00419287211740042
NORTE-PACIFICO,2024-02-15,408,403,5,0.0122549019607843
NORTE-PACIFICO,2024-02-16,562,550,12,0.0213523131672598
NORTE-PACIFICO,2024-02-17,653,649,4,0.00612557427258806
NORTE-PACIFICO,2024-02-18,500,496,4,0.008
NORTE-PACIFICO,2024-02-19,484,478,6,0.012396694214876
NORTE-PACIFICO,2024-02-20,544,530,14,0.0257352941176471
NORTE-PACIFICO,2024-02-21,518,508,10,0.0193050193050193
NORTE-PACIFICO,2024-02-22,517,504,13,0.0251450676982592
NORTE-PACIFICO,2024-02-23,325,281,44,0.135384615384615
NORTE-PACIFICO,2024-02-24,674,665,9,0.013353115727003
NORTE-PACIFICO,2024-02-25,433,426,7,0.0161662817551963
NORTE-PACIFICO,2024-02-26,465,458,7,0.0150537634408602
NORTE-PACIFICO,2024-02-27,504,489,15,0.0297619047619048
NORTE-PACIFICO,2024-02-28,482,464,18,0.037344398340249
NORTE-PACIFICO,2024-02-29,511,502,9,0.0176125244618395
NORTE-PACIFICO,2024-03-01,507,500,7,0.0138067061143984
NORTE-PACIFICO,2024-03-02,563,556,7,0.0124333925399645
NORTE-PACIFICO,2024-03-03,447,442,5,0.0111856823266219
NORTE-PACIFICO,2024-03-04,478,469,9,0.0188284518828452
NORTE-PACIFICO,2024-03-05,485,478,7,0.0144329896907217
NORTE-PACIFICO,2024-03-06,496,491,5,0.0100806451612903
NORTE-PACIFICO,2024-03-07,519,511,8,0.0154142581888247
NORTE-PACIFICO,2024-03-08,555,543,12,0.0216216216216216
NORTE-PACIFICO,2024-03-09,586,580,6,0.0102389078498294
NORTE-PACIFICO,2024-03-10,449,443,6,0.0133630289532294
NORTE-PACIFICO,2024-03-11,475,464,11,0.0231578947368421
NORTE-PACIFICO,2024-03-12,549,539,10,0.0182149362477231
NORTE-PACIFICO,2024-03-13,453,439,14,0.0309050772626932
NORTE-PACIFICO,2024-03-14,477,468,9,0.0188679245283019
NORTE-PACIFICO,2024-03-15,474,466,8,0.0168776371308017
NORTE-PACIFICO,2024-03-16,584,577,7,0.011986301369863
NORTE-PACIFICO,2024-03-17,441,436,5,0.0113378684807256
NORTE-PACIFICO,2024-03-18,362,354,8,0.0220994475138122
NORTE-PACIFICO,2024-03-19,500,489,11,0.022
NORTE-PACIFICO,2024-03-20,459,448,11,0.0239651416122004
NORTE-PACIFICO,2024-03-21,471,467,4,0.00849256900212314
NORTE-PACIFICO,2024-03-22,462,452,10,0.0216450216450216
NORTE-PACIFICO,2024-03-23,559,549,10,0.0178890876565295
NORTE-PACIFICO,2024-03-24,305,299,6,0.019672131147541
NORTE-PACIFICO,2024-03-25,392,381,11,0.0280612244897959
NORTE-PACIFICO,2024-03-26,538,525,13,0.0241635687732342
NORTE-PACIFICO,2024-03-27,513,503,10,0.0194931773879142
NORTE-PACIFICO,2024-03-28,552,539,13,0.0235507246376812
NORTE-PACIFICO,2024-03-29,536,524,12,0.0223880597014925
NORTE-PACIFICO,2024-03-30,357,352,5,0.0140056022408964
NORTE-PACIFICO,2024-03-31,328,321,7,0.0213414634146341
NORTE-PACIFICO,2024-04-01,464,451,13,0.0280172413793103
NORTE-PACIFICO,2024-04-02,502,491,11,0.0219123505976096
NORTE-PACIFICO,2024-04-03,425,425,0,0
NORTE-PACIFICO,2024-04-04,452,452,0,0
NORTE-PACIFICO,2024-04-05,516,508,8,0.0155038759689922
NORTE-PACIFICO,2024-04-06,561,555,6,0.0106951871657754
NORTE-PACIFICO,2024-04-07,374,363,11,0.0294117647058824
NORTE-PACIFICO,2024-04-08,455,444,11,0.0241758241758242
NORTE-PACIFICO,2024-04-09,472,459,13,0.0275423728813559
NORTE-PACIFICO,2024-04-10,427,416,11,0.0257611241217799
NORTE-PACIFICO,2024-04-11,514,505,9,0.0175097276264591
NORTE-PACIFICO,2024-04-12,539,524,15,0.0278293135435993
NORTE-PACIFICO,2024-04-13,567,551,16,0.0282186948853616
NORTE-PACIFICO,2024-04-14,375,369,6,0.016
NORTE-PACIFICO,2024-04-15,466,457,9,0.01931330472103
NORTE-PACIFICO,2024-04-16,493,464,29,0.0588235294117647
NORTE-PACIFICO,2024-04-17,442,417,25,0.0565610859728507
NORTE-PACIFICO,2024-04-18,431,420,11,0.0255220417633411
NORTE-PACIFICO,2024-04-19,492,471,21,0.0426829268292683
NORTE-PACIFICO,2024-04-20,550,536,14,0.0254545454545455
NORTE-PACIFICO,2024-04-21,365,359,6,0.0164383561643836
NORTE-PACIFICO,2024-04-22,193,185,8,0.0414507772020725
NORTE-PACIFICO,2024-04-23,621,567,54,0.0869565217391304
OCCIDENTE-BAJIO,2023-04-24,541,504,37,0.0683918669131238
OCCIDENTE-BAJIO,2023-04-25,655,603,52,0.0793893129770992
OCCIDENTE-BAJIO,2023-04-26,567,521,46,0.0811287477954145
OCCIDENTE-BAJIO,2023-04-27,458,427,31,0.0676855895196507
OCCIDENTE-BAJIO,2023-04-28,588,533,55,0.0935374149659864
OCCIDENTE-BAJIO,2023-04-29,734,670,64,0.0871934604904632
OCCIDENTE-BAJIO,2023-04-30,439,401,38,0.0865603644646925
OCCIDENTE-BAJIO,2023-05-01,455,415,40,0.0879120879120879
OCCIDENTE-BAJIO,2023-05-02,504,467,37,0.0734126984126984
OCCIDENTE-BAJIO,2023-05-03,468,429,39,0.0833333333333333
OCCIDENTE-BAJIO,2023-05-04,475,423,52,0.109473684210526
OCCIDENTE-BAJIO,2023-05-05,527,480,47,0.0891840607210626
OCCIDENTE-BAJIO,2023-05-06,550,501,49,0.0890909090909091
OCCIDENTE-BAJIO,2023-05-07,322,302,20,0.062111801242236
OCCIDENTE-BAJIO,2023-05-08,449,410,39,0.0868596881959911
OCCIDENTE-BAJIO,2023-05-09,499,465,34,0.0681362725450902
OCCIDENTE-BAJIO,2023-05-10,412,373,39,0.0946601941747573
OCCIDENTE-BAJIO,2023-05-11,436,404,32,0.073394495412844
OCCIDENTE-BAJIO,2023-05-12,418,387,31,0.0741626794258373
OCCIDENTE-BAJIO,2023-05-13,647,585,62,0.0958268933539413
OCCIDENTE-BAJIO,2023-05-14,529,492,37,0.0699432892249527
OCCIDENTE-BAJIO,2023-05-15,664,608,56,0.0843373493975904
OCCIDENTE-BAJIO,2023-05-16,778,675,103,0.132390745501285
OCCIDENTE-BAJIO,2023-05-17,611,550,61,0.0998363338788871
OCCIDENTE-BAJIO,2023-05-18,537,495,42,0.0782122905027933
OCCIDENTE-BAJIO,2023-05-19,497,439,58,0.116700201207243
OCCIDENTE-BAJIO,2023-05-20,676,610,66,0.0976331360946746
OCCIDENTE-BAJIO,2023-05-21,464,416,48,0.103448275862069
OCCIDENTE-BAJIO,2023-05-22,518,463,55,0.106177606177606
OCCIDENTE-BAJIO,2023-05-23,526,477,49,0.0931558935361217
OCCIDENTE-BAJIO,2023-05-24,536,471,65,0.121268656716418
OCCIDENTE-BAJIO,2023-05-25,547,477,70,0.127970749542962
OCCIDENTE-BAJIO,2023-05-26,558,497,61,0.109318996415771
OCCIDENTE-BAJIO,2023-05-27,680,602,78,0.114705882352941
OCCIDENTE-BAJIO,2023-05-28,463,396,67,0.144708423326134
OCCIDENTE-BAJIO,2023-05-29,521,439,82,0.157389635316699
OCCIDENTE-BAJIO,2023-05-30,654,553,101,0.154434250764526
OCCIDENTE-BAJIO,2023-05-31,751,653,98,0.130492676431425
OCCIDENTE-BAJIO,2023-06-01,604,523,81,0.134105960264901
OCCIDENTE-BAJIO,2023-06-02,530,463,67,0.126415094339623
OCCIDENTE-BAJIO,2023-06-03,634,570,64,0.100946372239748
OCCIDENTE-BAJIO,2023-06-04,470,416,54,0.114893617021277
OCCIDENTE-BAJIO,2023-06-05,534,467,67,0.125468164794007
OCCIDENTE-BAJIO,2023-06-06,563,514,49,0.0870337477797513
OCCIDENTE-BAJIO,2023-06-07,516,457,59,0.114341085271318
OCCIDENTE-BAJIO,2023-06-08,541,486,55,0.101663585951941
OCCIDENTE-BAJIO,2023-06-09,527,482,45,0.0853889943074004
OCCIDENTE-BAJIO,2023-06-10,653,592,61,0.0934150076569678
OCCIDENTE-BAJIO,2023-06-11,428,389,39,0.0911214953271028
OCCIDENTE-BAJIO,2023-06-12,524,463,61,0.116412213740458
OCCIDENTE-BAJIO,2023-06-13,556,492,64,0.115107913669065
OCCIDENTE-BAJIO,2023-06-14,569,523,46,0.0808435852372583
OCCIDENTE-BAJIO,2023-06-15,567,522,45,0.0793650793650794
OCCIDENTE-BAJIO,2023-06-16,565,521,44,0.0778761061946903
OCCIDENTE-BAJIO,2023-06-17,601,544,57,0.0948419301164725
OCCIDENTE-BAJIO,2023-06-18,398,363,35,0.0879396984924623
OCCIDENTE-BAJIO,2023-06-19,512,463,49,0.095703125
OCCIDENTE-BAJIO,2023-06-20,516,470,46,0.0891472868217054
OCCIDENTE-BAJIO,2023-06-21,544,497,47,0.0863970588235294
OCCIDENTE-BAJIO,2023-06-22,505,467,38,0.0752475247524752
OCCIDENTE-BAJIO,2023-06-23,433,401,32,0.0739030023094688
OCCIDENTE-BAJIO,2023-06-24,561,519,42,0.0748663101604278
OCCIDENTE-BAJIO,2023-06-25,374,354,20,0.053475935828877
OCCIDENTE-BAJIO,2023-06-26,491,458,33,0.0672097759674134
OCCIDENTE-BAJIO,2023-06-27,550,522,28,0.0509090909090909
OCCIDENTE-BAJIO,2023-06-28,527,492,35,0.0664136622390892
OCCIDENTE-BAJIO,2023-06-29,512,476,36,0.0703125
OCCIDENTE-BAJIO,2023-06-30,362,269,93,0.256906077348066
OCCIDENTE-BAJIO,2023-07-01,638,594,44,0.0689655172413793
OCCIDENTE-BAJIO,2023-07-02,406,384,22,0.0541871921182266
OCCIDENTE-BAJIO,2023-07-03,502,484,18,0.0358565737051793
OCCIDENTE-BAJIO,2023-07-04,560,527,33,0.0589285714285714
OCCIDENTE-BAJIO,2023-07-05,400,368,32,0.08
OCCIDENTE-BAJIO,2023-07-06,298,275,23,0.0771812080536913
OCCIDENTE-BAJIO,2023-07-07,497,474,23,0.0462776659959759
OCCIDENTE-BAJIO,2023-07-08,810,772,38,0.0469135802469136
OCCIDENTE-BAJIO,2023-07-09,435,412,23,0.0528735632183908
OCCIDENTE-BAJIO,2023-07-10,521,494,27,0.0518234165067179
OCCIDENTE-BAJIO,2023-07-11,551,511,40,0.0725952813067151
OCCIDENTE-BAJIO,2023-07-12,551,516,35,0.0635208711433757
OCCIDENTE-BAJIO,2023-07-13,504,467,37,0.0734126984126984
OCCIDENTE-BAJIO,2023-07-14,476,450,26,0.0546218487394958
OCCIDENTE-BAJIO,2023-07-15,836,794,42,0.0502392344497608
OCCIDENTE-BAJIO,2023-07-16,358,341,17,0.0474860335195531
OCCIDENTE-BAJIO,2023-07-17,509,478,31,0.0609037328094303
OCCIDENTE-BAJIO,2023-07-18,497,472,25,0.0503018108651912
OCCIDENTE-BAJIO,2023-07-19,514,489,25,0.0486381322957198
OCCIDENTE-BAJIO,2023-07-20,632,601,31,0.0490506329113924
OCCIDENTE-BAJIO,2023-07-21,567,542,25,0.0440917107583774
OCCIDENTE-BAJIO,2023-07-22,770,730,40,0.051948051948052
OCCIDENTE-BAJIO,2023-07-23,400,385,15,0.0375
OCCIDENTE-BAJIO,2023-07-24,454,435,19,0.0418502202643172
OCCIDENTE-BAJIO,2023-07-25,589,551,38,0.0645161290322581
OCCIDENTE-BAJIO,2023-07-26,580,534,46,0.0793103448275862
OCCIDENTE-BAJIO,2023-07-27,552,535,17,0.0307971014492754
OCCIDENTE-BAJIO,2023-07-28,602,562,40,0.0664451827242525
OCCIDENTE-BAJIO,2023-07-29,738,699,39,0.0528455284552846
OCCIDENTE-BAJIO,2023-07-30,447,410,37,0.0827740492170022
OCCIDENTE-BAJIO,2023-07-31,625,595,30,0.048
OCCIDENTE-BAJIO,2023-08-01,624,578,46,0.0737179487179487
OCCIDENTE-BAJIO,2023-08-02,613,578,35,0.0570962479608483
OCCIDENTE-BAJIO,2023-08-03,549,433,116,0.211293260473588
OCCIDENTE-BAJIO,2023-08-04,538,492,46,0.0855018587360595
OCCIDENTE-BAJIO,2023-08-05,645,610,35,0.0542635658914729
OCCIDENTE-BAJIO,2023-08-06,426,404,22,0.0516431924882629
OCCIDENTE-BAJIO,2023-08-07,517,499,18,0.034816247582205
OCCIDENTE-BAJIO,2023-08-08,565,551,14,0.0247787610619469
OCCIDENTE-BAJIO,2023-08-09,576,545,31,0.0538194444444444
OCCIDENTE-BAJIO,2023-08-10,623,591,32,0.0513643659711075
OCCIDENTE-BAJIO,2023-08-11,643,611,32,0.0497667185069984
OCCIDENTE-BAJIO,2023-08-12,687,648,39,0.0567685589519651
OCCIDENTE-BAJIO,2023-08-13,441,412,29,0.0657596371882086
OCCIDENTE-BAJIO,2023-08-14,533,506,27,0.050656660412758
OCCIDENTE-BAJIO,2023-08-15,678,638,40,0.0589970501474926
OCCIDENTE-BAJIO,2023-08-16,629,601,28,0.0445151033386327
OCCIDENTE-BAJIO,2023-08-17,592,556,36,0.0608108108108108
OCCIDENTE-BAJIO,2023-08-18,604,575,29,0.0480132450331126
OCCIDENTE-BAJIO,2023-08-19,696,657,39,0.0560344827586207
OCCIDENTE-BAJIO,2023-08-20,443,421,22,0.0496613995485327
OCCIDENTE-BAJIO,2023-08-21,549,529,20,0.0364298724954463
OCCIDENTE-BAJIO,2023-08-22,584,566,18,0.0308219178082192
OCCIDENTE-BAJIO,2023-08-23,566,541,25,0.0441696113074205
OCCIDENTE-BAJIO,2023-08-24,591,568,23,0.038917089678511
OCCIDENTE-BAJIO,2023-08-25,637,623,14,0.021978021978022
OCCIDENTE-BAJIO,2023-08-26,733,708,25,0.034106412005457
OCCIDENTE-BAJIO,2023-08-27,478,462,16,0.0334728033472803
OCCIDENTE-BAJIO,2023-08-28,550,532,18,0.0327272727272727
OCCIDENTE-BAJIO,2023-08-29,646,627,19,0.0294117647058824
OCCIDENTE-BAJIO,2023-08-30,554,543,11,0.01985559566787
OCCIDENTE-BAJIO,2023-08-31,596,576,20,0.0335570469798658
OCCIDENTE-BAJIO,2023-09-01,541,526,15,0.0277264325323475
OCCIDENTE-BAJIO,2023-09-02,594,584,10,0.0168350168350168
OCCIDENTE-BAJIO,2023-09-03,414,406,8,0.0193236714975845
OCCIDENTE-BAJIO,2023-09-04,481,471,10,0.0207900207900208
OCCIDENTE-BAJIO,2023-09-05,584,575,9,0.0154109589041096
OCCIDENTE-BAJIO,2023-09-06,544,528,16,0.0294117647058824
OCCIDENTE-BAJIO,2023-09-07,570,553,17,0.0298245614035088
OCCIDENTE-BAJIO,2023-09-08,531,523,8,0.0150659133709981
OCCIDENTE-BAJIO,2023-09-09,598,586,12,0.020066889632107
OCCIDENTE-BAJIO,2023-09-10,386,378,8,0.0207253886010363
OCCIDENTE-BAJIO,2023-09-11,510,497,13,0.0254901960784314
OCCIDENTE-BAJIO,2023-09-12,543,535,8,0.0147329650092081
OCCIDENTE-BAJIO,2023-09-13,542,531,11,0.0202952029520295
OCCIDENTE-BAJIO,2023-09-14,534,519,15,0.0280898876404494
OCCIDENTE-BAJIO,2023-09-15,614,602,12,0.0195439739413681
OCCIDENTE-BAJIO,2023-09-16,537,527,10,0.0186219739292365
OCCIDENTE-BAJIO,2023-09-17,410,403,7,0.0170731707317073
OCCIDENTE-BAJIO,2023-09-18,525,515,10,0.019047619047619
OCCIDENTE-BAJIO,2023-09-19,543,525,18,0.0331491712707182
OCCIDENTE-BAJIO,2023-09-20,446,437,9,0.0201793721973094
OCCIDENTE-BAJIO,2023-09-21,492,479,13,0.0264227642276423
OCCIDENTE-BAJIO,2023-09-22,540,523,17,0.0314814814814815
OCCIDENTE-BAJIO,2023-09-23,641,624,17,0.0265210608424337
OCCIDENTE-BAJIO,2023-09-24,376,369,7,0.0186170212765957
OCCIDENTE-BAJIO,2023-09-25,486,475,11,0.0226337448559671
OCCIDENTE-BAJIO,2023-09-26,525,511,14,0.0266666666666667
OCCIDENTE-BAJIO,2023-09-27,518,506,12,0.0231660231660232
OCCIDENTE-BAJIO,2023-09-28,564,546,18,0.0319148936170213
OCCIDENTE-BAJIO,2023-09-29,603,583,20,0.033167495854063
OCCIDENTE-BAJIO,2023-09-30,736,708,28,0.0380434782608696
OCCIDENTE-BAJIO,2023-10-01,432,420,12,0.0277777777777778
OCCIDENTE-BAJIO,2023-10-02,500,486,14,0.028
OCCIDENTE-BAJIO,2023-10-03,499,478,21,0.0420841683366733
OCCIDENTE-BAJIO,2023-10-04,461,438,23,0.0498915401301518
OCCIDENTE-BAJIO,2023-10-05,471,445,26,0.0552016985138004
OCCIDENTE-BAJIO,2023-10-06,490,463,27,0.0551020408163265
OCCIDENTE-BAJIO,2023-10-07,616,593,23,0.0373376623376623
OCCIDENTE-BAJIO,2023-10-08,386,369,17,0.0440414507772021
OCCIDENTE-BAJIO,2023-10-09,515,491,24,0.0466019417475728
OCCIDENTE-BAJIO,2023-10-10,432,408,24,0.0555555555555556
OCCIDENTE-BAJIO,2023-10-11,414,386,28,0.0676328502415459
OCCIDENTE-BAJIO,2023-10-12,449,425,24,0.0534521158129176
OCCIDENTE-BAJIO,2023-10-13,415,388,27,0.0650602409638554
OCCIDENTE-BAJIO,2023-10-14,516,492,24,0.0465116279069767
OCCIDENTE-BAJIO,2023-10-15,404,385,19,0.047029702970297
OCCIDENTE-BAJIO,2023-10-16,517,496,21,0.0406189555125725
OCCIDENTE-BAJIO,2023-10-17,444,434,10,0.0225225225225225
OCCIDENTE-BAJIO,2023-10-18,480,456,24,0.05
OCCIDENTE-BAJIO,2023-10-19,454,434,20,0.0440528634361234
OCCIDENTE-BAJIO,2023-10-20,523,501,22,0.0420650095602294
OCCIDENTE-BAJIO,2023-10-21,605,586,19,0.031404958677686
OCCIDENTE-BAJIO,2023-10-22,402,395,7,0.0174129353233831
OCCIDENTE-BAJIO,2023-10-23,468,454,14,0.0299145299145299
OCCIDENTE-BAJIO,2023-10-24,491,476,15,0.0305498981670061
OCCIDENTE-BAJIO,2023-10-25,498,484,14,0.0281124497991968
OCCIDENTE-BAJIO,2023-10-26,474,450,24,0.0506329113924051
OCCIDENTE-BAJIO,2023-10-27,484,470,14,0.0289256198347107
OCCIDENTE-BAJIO,2023-10-28,533,518,15,0.0281425891181989
OCCIDENTE-BAJIO,2023-10-29,328,322,6,0.0182926829268293
OCCIDENTE-BAJIO,2023-10-30,480,462,18,0.0375
OCCIDENTE-BAJIO,2023-10-31,600,578,22,0.0366666666666667
OCCIDENTE-BAJIO,2023-11-01,545,529,16,0.0293577981651376
OCCIDENTE-BAJIO,2023-11-02,538,524,14,0.0260223048327138
OCCIDENTE-BAJIO,2023-11-03,491,474,17,0.0346232179226069
OCCIDENTE-BAJIO,2023-11-04,588,572,16,0.0272108843537415
OCCIDENTE-BAJIO,2023-11-05,418,409,9,0.0215311004784689
OCCIDENTE-BAJIO,2023-11-06,513,491,22,0.0428849902534113
OCCIDENTE-BAJIO,2023-11-07,595,587,8,0.0134453781512605
OCCIDENTE-BAJIO,2023-11-08,532,506,26,0.0488721804511278
OCCIDENTE-BAJIO,2023-11-09,494,473,21,0.0425101214574899
OCCIDENTE-BAJIO,2023-11-10,499,481,18,0.0360721442885772
OCCIDENTE-BAJIO,2023-11-11,660,636,24,0.0363636363636364
OCCIDENTE-BAJIO,2023-11-12,415,405,10,0.0240963855421687
OCCIDENTE-BAJIO,2023-11-13,550,532,18,0.0327272727272727
OCCIDENTE-BAJIO,2023-11-14,594,572,22,0.037037037037037
OCCIDENTE-BAJIO,2023-11-15,594,579,15,0.0252525252525253
OCCIDENTE-BAJIO,2023-11-16,553,529,24,0.0433996383363472
OCCIDENTE-BAJIO,2023-11-17,581,563,18,0.0309810671256454
OCCIDENTE-BAJIO,2023-11-18,732,716,16,0.0218579234972678
OCCIDENTE-BAJIO,2023-11-19,472,461,11,0.0233050847457627
OCCIDENTE-BAJIO,2023-11-20,587,567,20,0.0340715502555366
OCCIDENTE-BAJIO,2023-11-21,616,593,23,0.0373376623376623
OCCIDENTE-BAJIO,2023-11-22,548,532,16,0.0291970802919708
OCCIDENTE-BAJIO,2023-11-23,562,542,20,0.0355871886120996
OCCIDENTE-BAJIO,2023-11-24,613,594,19,0.0309951060358891
OCCIDENTE-BAJIO,2023-11-25,652,637,15,0.0230061349693252
OCCIDENTE-BAJIO,2023-11-26,441,427,14,0.0317460317460317
OCCIDENTE-BAJIO,2023-11-27,522,503,19,0.0363984674329502
OCCIDENTE-BAJIO,2023-11-28,605,579,26,0.0429752066115702
OCCIDENTE-BAJIO,2023-11-29,607,570,37,0.0609555189456343
OCCIDENTE-BAJIO,2023-11-30,638,616,22,0.0344827586206897
OCCIDENTE-BAJIO,2023-12-01,557,529,28,0.0502692998204668
OCCIDENTE-BAJIO,2023-12-02,619,590,29,0.0468497576736672
OCCIDENTE-BAJIO,2023-12-03,443,420,23,0.0519187358916479
OCCIDENTE-BAJIO,2023-12-04,543,520,23,0.0423572744014733
OCCIDENTE-BAJIO,2023-12-05,595,566,29,0.0487394957983193
OCCIDENTE-BAJIO,2023-12-06,605,579,26,0.0429752066115702
OCCIDENTE-BAJIO,2023-12-07,510,492,18,0.0352941176470588
OCCIDENTE-BAJIO,2023-12-08,568,547,21,0.0369718309859155
OCCIDENTE-BAJIO,2023-12-09,620,587,33,0.0532258064516129
OCCIDENTE-BAJIO,2023-12-10,441,428,13,0.0294784580498866
OCCIDENTE-BAJIO,2023-12-11,476,454,22,0.046218487394958
OCCIDENTE-BAJIO,2023-12-12,572,546,26,0.0454545454545455
OCCIDENTE-BAJIO,2023-12-13,513,491,22,0.0428849902534113
OCCIDENTE-BAJIO,2023-12-14,527,504,23,0.0436432637571157
OCCIDENTE-BAJIO,2023-12-15,484,464,20,0.0413223140495868
OCCIDENTE-BAJIO,2023-12-16,658,637,21,0.0319148936170213
OCCIDENTE-BAJIO,2023-12-17,449,439,10,0.022271714922049
OCCIDENTE-BAJIO,2023-12-18,594,572,22,0.037037037037037
OCCIDENTE-BAJIO,2023-12-19,579,553,26,0.0449050086355786
OCCIDENTE-BAJIO,2023-12-20,614,584,30,0.0488599348534202
OCCIDENTE-BAJIO,2023-12-21,567,543,24,0.0423280423280423
OCCIDENTE-BAJIO,2023-12-22,580,562,18,0.0310344827586207
OCCIDENTE-BAJIO,2023-12-23,606,590,16,0.0264026402640264
OCCIDENTE-BAJIO,2023-12-24,324,314,10,0.0308641975308642
OCCIDENTE-BAJIO,2023-12-25,112,108,4,0.0357142857142857
OCCIDENTE-BAJIO,2023-12-26,470,457,13,0.0276595744680851
OCCIDENTE-BAJIO,2023-12-27,606,587,19,0.0313531353135314
OCCIDENTE-BAJIO,2023-12-28,649,628,21,0.0323574730354391
OCCIDENTE-BAJIO,2023-12-29,639,618,21,0.0328638497652582
OCCIDENTE-BAJIO,2023-12-30,668,654,14,0.0209580838323353
OCCIDENTE-BAJIO,2023-12-31,347,344,3,0.00864553314121038
OCCIDENTE-BAJIO,2024-01-01,116,111,5,0.0431034482758621
OCCIDENTE-BAJIO,2024-01-02,483,472,11,0.0227743271221532
OCCIDENTE-BAJIO,2024-01-03,684,668,16,0.0233918128654971
OCCIDENTE-BAJIO,2024-01-04,608,588,20,0.0328947368421053
OCCIDENTE-BAJIO,2024-01-05,610,588,22,0.0360655737704918
OCCIDENTE-BAJIO,2024-01-06,641,626,15,0.0234009360374415
OCCIDENTE-BAJIO,2024-01-07,412,398,14,0.0339805825242718
OCCIDENTE-BAJIO,2024-01-08,616,588,28,0.0454545454545455
OCCIDENTE-BAJIO,2024-01-09,678,654,24,0.0353982300884956
OCCIDENTE-BAJIO,2024-01-10,605,586,19,0.031404958677686
OCCIDENTE-BAJIO,2024-01-11,633,615,18,0.028436018957346
OCCIDENTE-BAJIO,2024-01-12,607,595,12,0.0197693574958814
OCCIDENTE-BAJIO,2024-01-13,693,664,29,0.0418470418470418
OCCIDENTE-BAJIO,2024-01-14,482,465,17,0.0352697095435685
OCCIDENTE-BAJIO,2024-01-15,587,566,21,0.0357751277683135
OCCIDENTE-BAJIO,2024-01-16,648,630,18,0.0277777777777778
OCCIDENTE-BAJIO,2024-01-17,627,607,20,0.0318979266347687
OCCIDENTE-BAJIO,2024-01-18,578,562,16,0.027681660899654
OCCIDENTE-BAJIO,2024-01-19,580,554,26,0.0448275862068966
OCCIDENTE-BAJIO,2024-01-20,654,642,12,0.018348623853211
OCCIDENTE-BAJIO,2024-01-21,412,398,14,0.0339805825242718
OCCIDENTE-BAJIO,2024-01-22,474,455,19,0.040084388185654
OCCIDENTE-BAJIO,2024-01-23,561,541,20,0.035650623885918
OCCIDENTE-BAJIO,2024-01-24,592,565,27,0.0456081081081081
OCCIDENTE-BAJIO,2024-01-25,550,534,16,0.0290909090909091
OCCIDENTE-BAJIO,2024-01-26,590,571,19,0.0322033898305085
OCCIDENTE-BAJIO,2024-01-27,652,634,18,0.0276073619631902
OCCIDENTE-BAJIO,2024-01-28,423,411,12,0.0283687943262411
OCCIDENTE-BAJIO,2024-01-29,534,515,19,0.0355805243445693
OCCIDENTE-BAJIO,2024-01-30,593,566,27,0.045531197301855
OCCIDENTE-BAJIO,2024-01-31,612,589,23,0.0375816993464052
OCCIDENTE-BAJIO,2024-02-01,518,502,16,0.0308880308880309
OCCIDENTE-BAJIO,2024-02-02,554,526,28,0.0505415162454874
OCCIDENTE-BAJIO,2024-02-03,657,633,24,0.0365296803652968
OCCIDENTE-BAJIO,2024-02-04,430,423,7,0.0162790697674419
OCCIDENTE-BAJIO,2024-02-05,449,434,15,0.0334075723830735
OCCIDENTE-BAJIO,2024-02-06,588,570,18,0.0306122448979592
OCCIDENTE-BAJIO,2024-02-07,604,587,17,0.0281456953642384
OCCIDENTE-BAJIO,2024-02-08,541,535,6,0.011090573012939
OCCIDENTE-BAJIO,2024-02-09,564,554,10,0.0177304964539007
OCCIDENTE-BAJIO,2024-02-10,628,615,13,0.0207006369426752
OCCIDENTE-BAJIO,2024-02-11,379,369,10,0.0263852242744063
OCCIDENTE-BAJIO,2024-02-12,408,389,19,0.0465686274509804
OCCIDENTE-BAJIO,2024-02-13,564,539,25,0.0443262411347518
OCCIDENTE-BAJIO,2024-02-14,490,477,13,0.026530612244898
OCCIDENTE-BAJIO,2024-02-15,525,515,10,0.019047619047619
OCCIDENTE-BAJIO,2024-02-16,479,470,9,0.0187891440501044
OCCIDENTE-BAJIO,2024-02-17,653,631,22,0.0336906584992343
OCCIDENTE-BAJIO,2024-02-18,467,459,8,0.0171306209850107
OCCIDENTE-BAJIO,2024-02-19,568,553,15,0.0264084507042254
OCCIDENTE-BAJIO,2024-02-20,565,549,16,0.0283185840707965
OCCIDENTE-BAJIO,2024-02-21,590,570,20,0.0338983050847458
OCCIDENTE-BAJIO,2024-02-22,583,572,11,0.0188679245283019
OCCIDENTE-BAJIO,2024-02-23,422,346,76,0.180094786729858
OCCIDENTE-BAJIO,2024-02-24,741,716,25,0.0337381916329285
OCCIDENTE-BAJIO,2024-02-25,449,441,8,0.0178173719376392
OCCIDENTE-BAJIO,2024-02-26,535,520,15,0.0280373831775701
OCCIDENTE-BAJIO,2024-02-27,659,635,24,0.0364188163884674
OCCIDENTE-BAJIO,2024-02-28,549,530,19,0.034608378870674
OCCIDENTE-BAJIO,2024-02-29,643,619,24,0.0373250388802488
OCCIDENTE-BAJIO,2024-03-01,617,601,16,0.0259319286871961
OCCIDENTE-BAJIO,2024-03-02,743,722,21,0.0282637954239569
OCCIDENTE-BAJIO,2024-03-03,451,442,9,0.0199556541019956
OCCIDENTE-BAJIO,2024-03-04,570,560,10,0.0175438596491228
OCCIDENTE-BAJIO,2024-03-05,612,591,21,0.0343137254901961
OCCIDENTE-BAJIO,2024-03-06,610,593,17,0.0278688524590164
OCCIDENTE-BAJIO,2024-03-07,576,567,9,0.015625
OCCIDENTE-BAJIO,2024-03-08,624,605,19,0.0304487179487179
OCCIDENTE-BAJIO,2024-03-09,655,642,13,0.0198473282442748
OCCIDENTE-BAJIO,2024-03-10,435,425,10,0.0229885057471264
OCCIDENTE-BAJIO,2024-03-11,547,527,20,0.036563071297989
OCCIDENTE-BAJIO,2024-03-12,573,560,13,0.0226876090750436
OCCIDENTE-BAJIO,2024-03-13,529,511,18,0.0340264650283554
OCCIDENTE-BAJIO,2024-03-14,486,471,15,0.0308641975308642
OCCIDENTE-BAJIO,2024-03-15,635,619,16,0.0251968503937008
OCCIDENTE-BAJIO,2024-03-16,674,657,17,0.0252225519287834
OCCIDENTE-BAJIO,2024-03-17,450,441,9,0.02
OCCIDENTE-BAJIO,2024-03-18,476,464,12,0.0252100840336134
OCCIDENTE-BAJIO,2024-03-19,543,526,17,0.0313075506445672
OCCIDENTE-BAJIO,2024-03-20,592,573,19,0.0320945945945946
OCCIDENTE-BAJIO,2024-03-21,500,478,22,0.044
OCCIDENTE-BAJIO,2024-03-22,534,514,20,0.0374531835205993
OCCIDENTE-BAJIO,2024-03-23,595,582,13,0.0218487394957983
OCCIDENTE-BAJIO,2024-03-24,419,410,9,0.0214797136038186
OCCIDENTE-BAJIO,2024-03-25,525,502,23,0.0438095238095238
OCCIDENTE-BAJIO,2024-03-26,645,618,27,0.0418604651162791
OCCIDENTE-BAJIO,2024-03-27,615,602,13,0.0211382113821138
OCCIDENTE-BAJIO,2024-03-28,662,647,15,0.0226586102719033
OCCIDENTE-BAJIO,2024-03-29,450,435,15,0.0333333333333333
OCCIDENTE-BAJIO,2024-03-30,533,518,15,0.0281425891181989
OCCIDENTE-BAJIO,2024-03-31,403,393,10,0.0248138957816377
OCCIDENTE-BAJIO,2024-04-01,564,553,11,0.0195035460992908
OCCIDENTE-BAJIO,2024-04-02,584,568,16,0.0273972602739726
OCCIDENTE-BAJIO,2024-04-03,530,530,0,0
OCCIDENTE-BAJIO,2024-04-04,537,537,0,0
OCCIDENTE-BAJIO,2024-04-05,546,527,19,0.0347985347985348
OCCIDENTE-BAJIO,2024-04-06,616,598,18,0.0292207792207792
OCCIDENTE-BAJIO,2024-04-07,347,335,12,0.0345821325648415
OCCIDENTE-BAJIO,2024-04-08,486,472,14,0.0288065843621399
OCCIDENTE-BAJIO,2024-04-09,539,513,26,0.0482374768089054
OCCIDENTE-BAJIO,2024-04-10,555,530,25,0.045045045045045
OCCIDENTE-BAJIO,2024-04-11,497,485,12,0.0241448692152917
OCCIDENTE-BAJIO,2024-04-12,581,563,18,0.0309810671256454
OCCIDENTE-BAJIO,2024-04-13,680,667,13,0.0191176470588235
OCCIDENTE-BAJIO,2024-04-14,400,393,7,0.0175
OCCIDENTE-BAJIO,2024-04-15,580,565,15,0.0258620689655172
OCCIDENTE-BAJIO,2024-04-16,619,571,48,0.0775444264943457
OCCIDENTE-BAJIO,2024-04-17,555,523,32,0.0576576576576577
OCCIDENTE-BAJIO,2024-04-18,538,515,23,0.0427509293680297
OCCIDENTE-BAJIO,2024-04-19,492,460,32,0.0650406504065041
OCCIDENTE-BAJIO,2024-04-20,613,591,22,0.0358890701468189
OCCIDENTE-BAJIO,2024-04-21,360,353,7,0.0194444444444444
OCCIDENTE-BAJIO,2024-04-22,271,255,16,0.0590405904059041
OCCIDENTE-BAJIO,2024-04-23,734,674,60,0.0817438692098093
ORIENTE,2023-04-24,352,342,10,0.0284090909090909
ORIENTE,2023-04-25,469,437,32,0.0682302771855011
ORIENTE,2023-04-26,384,369,15,0.0390625
ORIENTE,2023-04-27,304,282,22,0.0723684210526316
ORIENTE,2023-04-28,407,377,30,0.0737100737100737
ORIENTE,2023-04-29,479,455,24,0.0501043841336117
ORIENTE,2023-04-30,395,378,17,0.0430379746835443
ORIENTE,2023-05-01,322,309,13,0.0403726708074534
ORIENTE,2023-05-02,326,313,13,0.0398773006134969
ORIENTE,2023-05-03,326,315,11,0.0337423312883436
ORIENTE,2023-05-04,306,290,16,0.0522875816993464
ORIENTE,2023-05-05,336,322,14,0.0416666666666667
ORIENTE,2023-05-06,365,352,13,0.0356164383561644
ORIENTE,2023-05-07,211,200,11,0.0521327014218009
ORIENTE,2023-05-08,266,251,15,0.056390977443609
ORIENTE,2023-05-09,356,339,17,0.047752808988764
ORIENTE,2023-05-10,288,274,14,0.0486111111111111
ORIENTE,2023-05-11,290,272,18,0.0620689655172414
ORIENTE,2023-05-12,281,272,9,0.0320284697508897
ORIENTE,2023-05-13,454,429,25,0.0550660792951542
ORIENTE,2023-05-14,423,406,17,0.0401891252955083
ORIENTE,2023-05-15,513,490,23,0.0448343079922027
ORIENTE,2023-05-16,545,520,25,0.0458715596330275
ORIENTE,2023-05-17,432,405,27,0.0625
ORIENTE,2023-05-18,307,293,14,0.0456026058631922
ORIENTE,2023-05-19,314,295,19,0.0605095541401274
ORIENTE,2023-05-20,438,413,25,0.0570776255707763
ORIENTE,2023-05-21,372,355,17,0.0456989247311828
ORIENTE,2023-05-22,354,332,22,0.0621468926553672
ORIENTE,2023-05-23,353,337,16,0.0453257790368272
ORIENTE,2023-05-24,341,327,14,0.0410557184750733
ORIENTE,2023-05-25,371,355,16,0.0431266846361186
ORIENTE,2023-05-26,385,361,24,0.0623376623376623
ORIENTE,2023-05-27,433,401,32,0.0739030023094688
ORIENTE,2023-05-28,263,239,24,0.091254752851711
ORIENTE,2023-05-29,345,326,19,0.0550724637681159
ORIENTE,2023-05-30,404,378,26,0.0643564356435644
ORIENTE,2023-05-31,483,461,22,0.0455486542443064
ORIENTE,2023-06-01,375,352,23,0.0613333333333333
ORIENTE,2023-06-02,308,294,14,0.0454545454545455
ORIENTE,2023-06-03,349,332,17,0.0487106017191977
ORIENTE,2023-06-04,352,326,26,0.0738636363636364
ORIENTE,2023-06-05,326,316,10,0.0306748466257669
ORIENTE,2023-06-06,298,288,10,0.0335570469798658
ORIENTE,2023-06-07,292,275,17,0.0582191780821918
ORIENTE,2023-06-08,311,296,15,0.0482315112540193
ORIENTE,2023-06-09,323,310,13,0.0402476780185759
ORIENTE,2023-06-10,403,389,14,0.0347394540942928
ORIENTE,2023-06-11,338,325,13,0.0384615384615385
ORIENTE,2023-06-12,303,291,12,0.0396039603960396
ORIENTE,2023-06-13,309,297,12,0.0388349514563107
ORIENTE,2023-06-14,347,330,17,0.0489913544668588
ORIENTE,2023-06-15,397,382,15,0.0377833753148615
ORIENTE,2023-06-16,351,337,14,0.0398860398860399
ORIENTE,2023-06-17,379,362,17,0.0448548812664908
ORIENTE,2023-06-18,333,321,12,0.036036036036036
ORIENTE,2023-06-19,374,366,8,0.0213903743315508
ORIENTE,2023-06-20,400,389,11,0.0275
ORIENTE,2023-06-21,354,339,15,0.0423728813559322
ORIENTE,2023-06-22,308,291,17,0.0551948051948052
ORIENTE,2023-06-23,312,300,12,0.0384615384615385
ORIENTE,2023-06-24,336,327,9,0.0267857142857143
ORIENTE,2023-06-25,327,317,10,0.0305810397553517
ORIENTE,2023-06-26,322,309,13,0.0403726708074534
ORIENTE,2023-06-27,389,379,10,0.025706940874036
ORIENTE,2023-06-28,331,317,14,0.0422960725075529
ORIENTE,2023-06-29,382,368,14,0.0366492146596859
ORIENTE,2023-06-30,303,275,28,0.0924092409240924
ORIENTE,2023-07-01,441,425,16,0.036281179138322
ORIENTE,2023-07-02,246,236,10,0.040650406504065
ORIENTE,2023-07-03,359,353,6,0.0167130919220056
ORIENTE,2023-07-04,331,319,12,0.0362537764350453
ORIENTE,2023-07-05,348,334,14,0.0402298850574713
ORIENTE,2023-07-06,324,307,17,0.0524691358024691
ORIENTE,2023-07-07,366,349,17,0.046448087431694
ORIENTE,2023-07-08,417,408,9,0.0215827338129496
ORIENTE,2023-07-09,303,295,8,0.0264026402640264
ORIENTE,2023-07-10,318,309,9,0.0283018867924528
ORIENTE,2023-07-11,360,347,13,0.0361111111111111
ORIENTE,2023-07-12,337,329,8,0.0237388724035608
ORIENTE,2023-07-13,307,293,14,0.0456026058631922
ORIENTE,2023-07-14,339,329,10,0.0294985250737463
ORIENTE,2023-07-15,413,405,8,0.0193704600484262
ORIENTE,2023-07-16,318,311,7,0.0220125786163522
ORIENTE,2023-07-17,317,304,13,0.0410094637223975
ORIENTE,2023-07-18,303,294,9,0.0297029702970297
ORIENTE,2023-07-19,319,313,6,0.0188087774294671
ORIENTE,2023-07-20,370,359,11,0.0297297297297297
ORIENTE,2023-07-21,332,326,6,0.0180722891566265
ORIENTE,2023-07-22,339,331,8,0.023598820058997
ORIENTE,2023-07-23,289,281,8,0.027681660899654
ORIENTE,2023-07-24,346,337,9,0.0260115606936416
ORIENTE,2023-07-25,360,353,7,0.0194444444444444
ORIENTE,2023-07-26,349,337,12,0.0343839541547278
ORIENTE,2023-07-27,357,346,11,0.030812324929972
ORIENTE,2023-07-28,371,362,9,0.0242587601078167
ORIENTE,2023-07-29,457,443,14,0.0306345733041575
ORIENTE,2023-07-30,349,343,6,0.0171919770773639
ORIENTE,2023-07-31,465,458,7,0.0150537634408602
ORIENTE,2023-08-01,389,368,21,0.0539845758354756
ORIENTE,2023-08-02,356,344,12,0.0337078651685393
ORIENTE,2023-08-03,364,318,46,0.126373626373626
ORIENTE,2023-08-04,302,291,11,0.0364238410596026
ORIENTE,2023-08-05,364,358,6,0.0164835164835165
ORIENTE,2023-08-06,286,279,7,0.0244755244755245
ORIENTE,2023-08-07,355,349,6,0.0169014084507042
ORIENTE,2023-08-08,353,342,11,0.0311614730878187
ORIENTE,2023-08-09,390,378,12,0.0307692307692308
ORIENTE,2023-08-10,408,403,5,0.0122549019607843
ORIENTE,2023-08-11,385,380,5,0.012987012987013
ORIENTE,2023-08-12,387,374,13,0.0335917312661499
ORIENTE,2023-08-13,307,296,11,0.0358306188925081
ORIENTE,2023-08-14,375,368,7,0.0186666666666667
ORIENTE,2023-08-15,376,371,5,0.0132978723404255
ORIENTE,2023-08-16,405,394,11,0.0271604938271605
ORIENTE,2023-08-17,393,372,21,0.0534351145038168
ORIENTE,2023-08-18,398,386,12,0.0301507537688442
ORIENTE,2023-08-19,409,400,9,0.0220048899755501
ORIENTE,2023-08-20,298,288,10,0.0335570469798658
ORIENTE,2023-08-21,323,319,4,0.0123839009287926
ORIENTE,2023-08-22,339,338,1,0.00294985250737463
ORIENTE,2023-08-23,330,327,3,0.00909090909090909
ORIENTE,2023-08-24,371,366,5,0.0134770889487871
ORIENTE,2023-08-25,412,406,6,0.0145631067961165
ORIENTE,2023-08-26,412,408,4,0.00970873786407767
ORIENTE,2023-08-27,303,299,4,0.0132013201320132
ORIENTE,2023-08-28,356,354,2,0.00561797752808989
ORIENTE,2023-08-29,364,362,2,0.00549450549450549
ORIENTE,2023-08-30,359,357,2,0.00557103064066852
ORIENTE,2023-08-31,365,364,1,0.00273972602739726
ORIENTE,2023-09-01,308,301,7,0.0227272727272727
ORIENTE,2023-09-02,321,321,0,0
ORIENTE,2023-09-03,264,263,1,0.00378787878787879
ORIENTE,2023-09-04,334,333,1,0.0029940119760479
ORIENTE,2023-09-05,380,379,1,0.00263157894736842
ORIENTE,2023-09-06,341,340,1,0.00293255131964809
ORIENTE,2023-09-07,311,308,3,0.00964630225080386
ORIENTE,2023-09-08,317,314,3,0.00946372239747634
ORIENTE,2023-09-09,371,369,2,0.00539083557951483
ORIENTE,2023-09-10,262,261,1,0.00381679389312977
ORIENTE,2023-09-11,299,297,2,0.00668896321070234
ORIENTE,2023-09-12,370,366,4,0.0108108108108108
ORIENTE,2023-09-13,309,305,4,0.0129449838187702
ORIENTE,2023-09-14,369,367,2,0.00542005420054201
ORIENTE,2023-09-15,426,422,4,0.00938967136150235
ORIENTE,2023-09-16,313,310,3,0.00958466453674121
ORIENTE,2023-09-17,258,257,1,0.00387596899224806
ORIENTE,2023-09-18,338,338,0,0
ORIENTE,2023-09-19,341,339,2,0.00586510263929619
ORIENTE,2023-09-20,287,286,1,0.00348432055749129
ORIENTE,2023-09-21,309,306,3,0.00970873786407767
ORIENTE,2023-09-22,314,313,1,0.00318471337579618
ORIENTE,2023-09-23,374,372,2,0.0053475935828877
ORIENTE,2023-09-24,304,302,2,0.00657894736842105
ORIENTE,2023-09-25,346,344,2,0.00578034682080925
ORIENTE,2023-09-26,375,372,3,0.008
ORIENTE,2023-09-27,315,314,1,0.00317460317460317
ORIENTE,2023-09-28,330,329,1,0.00303030303030303
ORIENTE,2023-09-29,415,412,3,0.0072289156626506
ORIENTE,2023-09-30,506,503,3,0.00592885375494071
ORIENTE,2023-10-01,309,308,1,0.00323624595469256
ORIENTE,2023-10-02,299,296,3,0.0100334448160535
ORIENTE,2023-10-03,301,295,6,0.0199335548172757
ORIENTE,2023-10-04,306,301,5,0.0163398692810458
ORIENTE,2023-10-05,300,296,4,0.0133333333333333
ORIENTE,2023-10-06,356,345,11,0.0308988764044944
ORIENTE,2023-10-07,351,344,7,0.0199430199430199
ORIENTE,2023-10-08,236,229,7,0.0296610169491525
ORIENTE,2023-10-09,266,259,7,0.0263157894736842
ORIENTE,2023-10-10,256,249,7,0.02734375
ORIENTE,2023-10-11,300,292,8,0.0266666666666667
ORIENTE,2023-10-12,272,269,3,0.0110294117647059
ORIENTE,2023-10-13,323,314,9,0.0278637770897833
ORIENTE,2023-10-14,375,365,10,0.0266666666666667
ORIENTE,2023-10-15,286,283,3,0.0104895104895105
ORIENTE,2023-10-16,341,337,4,0.0117302052785924
ORIENTE,2023-10-17,296,288,8,0.027027027027027
ORIENTE,2023-10-18,309,299,10,0.0323624595469256
ORIENTE,2023-10-19,318,312,6,0.0188679245283019
ORIENTE,2023-10-20,306,294,12,0.0392156862745098
ORIENTE,2023-10-21,416,407,9,0.0216346153846154
ORIENTE,2023-10-22,309,303,6,0.0194174757281553
ORIENTE,2023-10-23,344,336,8,0.0232558139534884
ORIENTE,2023-10-24,322,315,7,0.0217391304347826
ORIENTE,2023-10-25,271,264,7,0.025830258302583
ORIENTE,2023-10-26,316,305,11,0.0348101265822785
ORIENTE,2023-10-27,307,293,14,0.0456026058631922
ORIENTE,2023-10-28,373,360,13,0.0348525469168901
ORIENTE,2023-10-29,267,257,10,0.0374531835205993
ORIENTE,2023-10-30,293,290,3,0.0102389078498294
ORIENTE,2023-10-31,402,395,7,0.0174129353233831
ORIENTE,2023-11-01,321,309,12,0.0373831775700935
ORIENTE,2023-11-02,259,254,5,0.0193050193050193
ORIENTE,2023-11-03,270,263,7,0.0259259259259259
ORIENTE,2023-11-04,311,305,6,0.0192926045016077
ORIENTE,2023-11-05,274,270,4,0.0145985401459854
ORIENTE,2023-11-06,347,335,12,0.0345821325648415
ORIENTE,2023-11-07,338,332,6,0.0177514792899408
ORIENTE,2023-11-08,326,319,7,0.0214723926380368
ORIENTE,2023-11-09,336,326,10,0.0297619047619048
ORIENTE,2023-11-10,334,325,9,0.0269461077844311
ORIENTE,2023-11-11,389,381,8,0.0205655526992288
ORIENTE,2023-11-12,284,274,10,0.0352112676056338
ORIENTE,2023-11-13,293,283,10,0.0341296928327645
ORIENTE,2023-11-14,382,376,6,0.0157068062827225
ORIENTE,2023-11-15,402,391,11,0.027363184079602
ORIENTE,2023-11-16,365,358,7,0.0191780821917808
ORIENTE,2023-11-17,392,382,10,0.0255102040816327
ORIENTE,2023-11-18,410,404,6,0.0146341463414634
ORIENTE,2023-11-19,342,332,10,0.0292397660818713
ORIENTE,2023-11-20,349,342,7,0.0200573065902579
ORIENTE,2023-11-21,339,332,7,0.0206489675516224
ORIENTE,2023-11-22,311,306,5,0.0160771704180064
ORIENTE,2023-11-23,337,329,8,0.0237388724035608
ORIENTE,2023-11-24,338,329,9,0.0266272189349112
ORIENTE,2023-11-25,397,394,3,0.00755667506297229
ORIENTE,2023-11-26,260,254,6,0.0230769230769231
ORIENTE,2023-11-27,345,339,6,0.0173913043478261
ORIENTE,2023-11-28,339,330,9,0.0265486725663717
ORIENTE,2023-11-29,391,369,22,0.0562659846547315
ORIENTE,2023-11-30,476,459,17,0.0357142857142857
ORIENTE,2023-12-01,373,359,14,0.0375335120643432
ORIENTE,2023-12-02,412,403,9,0.0218446601941748
ORIENTE,2023-12-03,316,304,12,0.0379746835443038
ORIENTE,2023-12-04,324,317,7,0.0216049382716049
ORIENTE,2023-12-05,359,349,10,0.0278551532033426
ORIENTE,2023-12-06,391,381,10,0.0255754475703325
ORIENTE,2023-12-07,389,376,13,0.0334190231362468
ORIENTE,2023-12-08,410,398,12,0.0292682926829268
ORIENTE,2023-12-09,410,400,10,0.024390243902439
ORIENTE,2023-12-10,282,271,11,0.0390070921985816
ORIENTE,2023-12-11,333,328,5,0.015015015015015
ORIENTE,2023-12-12,362,354,8,0.0220994475138122
ORIENTE,2023-12-13,329,323,6,0.0182370820668693
ORIENTE,2023-12-14,329,317,12,0.0364741641337386
ORIENTE,2023-12-15,347,337,10,0.0288184438040346
ORIENTE,2023-12-16,396,389,7,0.0176767676767677
ORIENTE,2023-12-17,348,335,13,0.0373563218390805
ORIENTE,2023-12-18,399,391,8,0.0200501253132832
ORIENTE,2023-12-19,425,408,17,0.04
ORIENTE,2023-12-20,358,349,9,0.0251396648044693
ORIENTE,2023-12-21,422,413,9,0.0213270142180095
ORIENTE,2023-12-22,380,373,7,0.0184210526315789
ORIENTE,2023-12-23,432,418,14,0.0324074074074074
ORIENTE,2023-12-24,239,232,7,0.0292887029288703
ORIENTE,2023-12-25,85,85,0,0
ORIENTE,2023-12-26,334,330,4,0.0119760479041916
ORIENTE,2023-12-27,415,405,10,0.0240963855421687
ORIENTE,2023-12-28,417,408,9,0.0215827338129496
ORIENTE,2023-12-29,406,393,13,0.0320197044334975
ORIENTE,2023-12-30,415,404,11,0.0265060240963855
ORIENTE,2023-12-31,174,170,4,0.0229885057471264
ORIENTE,2024-01-01,74,70,4,0.0540540540540541
ORIENTE,2024-01-02,276,270,6,0.0217391304347826
ORIENTE,2024-01-03,359,351,8,0.0222841225626741
ORIENTE,2024-01-04,378,373,5,0.0132275132275132
ORIENTE,2024-01-05,371,360,11,0.0296495956873315
ORIENTE,2024-01-06,386,380,6,0.0155440414507772
ORIENTE,2024-01-07,263,258,5,0.0190114068441065
ORIENTE,2024-01-08,358,350,8,0.0223463687150838
ORIENTE,2024-01-09,418,403,15,0.0358851674641148
ORIENTE,2024-01-10,422,414,8,0.018957345971564
ORIENTE,2024-01-11,385,372,13,0.0337662337662338
ORIENTE,2024-01-12,393,386,7,0.0178117048346056
ORIENTE,2024-01-13,460,449,11,0.0239130434782609
ORIENTE,2024-01-14,379,372,7,0.0184696569920844
ORIENTE,2024-01-15,417,402,15,0.0359712230215827
ORIENTE,2024-01-16,467,453,14,0.0299785867237687
ORIENTE,2024-01-17,442,434,8,0.0180995475113122
ORIENTE,2024-01-18,403,393,10,0.0248138957816377
ORIENTE,2024-01-19,334,324,10,0.029940119760479
ORIENTE,2024-01-20,404,396,8,0.0198019801980198
ORIENTE,2024-01-21,279,273,6,0.021505376344086
ORIENTE,2024-01-22,356,346,10,0.0280898876404494
ORIENTE,2024-01-23,340,332,8,0.0235294117647059
ORIENTE,2024-01-24,358,349,9,0.0251396648044693
ORIENTE,2024-01-25,317,310,7,0.0220820189274448
ORIENTE,2024-01-26,334,325,9,0.0269461077844311
ORIENTE,2024-01-27,370,362,8,0.0216216216216216
ORIENTE,2024-01-28,270,263,7,0.0259259259259259
ORIENTE,2024-01-29,333,325,8,0.024024024024024
ORIENTE,2024-01-30,369,358,11,0.029810298102981
ORIENTE,2024-01-31,463,452,11,0.0237580993520518
ORIENTE,2024-02-01,356,348,8,0.0224719101123595
ORIENTE,2024-02-02,340,329,11,0.0323529411764706
ORIENTE,2024-02-03,382,370,12,0.031413612565445
ORIENTE,2024-02-04,307,304,3,0.00977198697068404
ORIENTE,2024-02-05,341,334,7,0.0205278592375367
ORIENTE,2024-02-06,344,335,9,0.0261627906976744
ORIENTE,2024-02-07,356,345,11,0.0308988764044944
ORIENTE,2024-02-08,352,349,3,0.00852272727272727
ORIENTE,2024-02-09,343,334,9,0.0262390670553936
ORIENTE,2024-02-10,371,360,11,0.0296495956873315
ORIENTE,2024-02-11,241,227,14,0.0580912863070539
ORIENTE,2024-02-12,310,300,10,0.032258064516129
ORIENTE,2024-02-13,338,328,10,0.029585798816568
ORIENTE,2024-02-14,309,303,6,0.0194174757281553
ORIENTE,2024-02-15,350,346,4,0.0114285714285714
ORIENTE,2024-02-16,352,344,8,0.0227272727272727
ORIENTE,2024-02-17,343,335,8,0.0233236151603499
ORIENTE,2024-02-18,342,334,8,0.0233918128654971
ORIENTE,2024-02-19,355,343,12,0.0338028169014084
ORIENTE,2024-02-20,377,364,13,0.0344827586206897
ORIENTE,2024-02-21,416,402,14,0.0336538461538462
ORIENTE,2024-02-22,338,334,4,0.0118343195266272
ORIENTE,2024-02-23,221,197,24,0.108597285067873
ORIENTE,2024-02-24,459,442,17,0.037037037037037
ORIENTE,2024-02-25,276,266,10,0.036231884057971
ORIENTE,2024-02-26,326,313,13,0.0398773006134969
ORIENTE,2024-02-27,370,358,12,0.0324324324324324
ORIENTE,2024-02-28,393,383,10,0.0254452926208651
ORIENTE,2024-02-29,417,406,11,0.026378896882494
ORIENTE,2024-03-01,379,374,5,0.0131926121372032
ORIENTE,2024-03-02,380,372,8,0.0210526315789474
ORIENTE,2024-03-03,311,303,8,0.0257234726688103
ORIENTE,2024-03-04,387,379,8,0.020671834625323
ORIENTE,2024-03-05,372,362,10,0.0268817204301075
ORIENTE,2024-03-06,351,344,7,0.0199430199430199
ORIENTE,2024-03-07,360,356,4,0.0111111111111111
ORIENTE,2024-03-08,350,343,7,0.02
ORIENTE,2024-03-09,378,368,10,0.0264550264550265
ORIENTE,2024-03-10,274,268,6,0.0218978102189781
ORIENTE,2024-03-11,329,325,4,0.0121580547112462
ORIENTE,2024-03-12,358,345,13,0.0363128491620112
ORIENTE,2024-03-13,297,290,7,0.0235690235690236
ORIENTE,2024-03-14,279,270,9,0.032258064516129
ORIENTE,2024-03-15,310,300,10,0.032258064516129
ORIENTE,2024-03-16,358,350,8,0.0223463687150838
ORIENTE,2024-03-17,257,249,8,0.0311284046692607
ORIENTE,2024-03-18,327,317,10,0.0305810397553517
ORIENTE,2024-03-19,348,340,8,0.0229885057471264
ORIENTE,2024-03-20,304,296,8,0.0263157894736842
ORIENTE,2024-03-21,326,320,6,0.0184049079754601
ORIENTE,2024-03-22,319,307,12,0.0376175548589342
ORIENTE,2024-03-23,325,320,5,0.0153846153846154
ORIENTE,2024-03-24,222,213,9,0.0405405405405405
ORIENTE,2024-03-25,303,292,11,0.0363036303630363
ORIENTE,2024-03-26,341,330,11,0.032258064516129
ORIENTE,2024-03-27,311,298,13,0.0418006430868167
ORIENTE,2024-03-28,371,355,16,0.0431266846361186
ORIENTE,2024-03-29,329,317,12,0.0364741641337386
ORIENTE,2024-03-30,314,308,6,0.0191082802547771
ORIENTE,2024-03-31,247,235,12,0.048582995951417
ORIENTE,2024-04-01,342,326,16,0.0467836257309941
ORIENTE,2024-04-02,342,329,13,0.0380116959064327
ORIENTE,2024-04-03,274,274,0,0
ORIENTE,2024-04-04,330,330,0,0
ORIENTE,2024-04-05,366,355,11,0.0300546448087432
ORIENTE,2024-04-06,342,328,14,0.0409356725146199
ORIENTE,2024-04-07,228,221,7,0.0307017543859649
ORIENTE,2024-04-08,304,290,14,0.0460526315789474
ORIENTE,2024-04-09,301,291,10,0.0332225913621262
ORIENTE,2024-04-10,314,299,15,0.0477707006369427
ORIENTE,2024-04-11,274,268,6,0.0218978102189781
ORIENTE,2024-04-12,323,315,8,0.0247678018575851
ORIENTE,2024-04-13,329,309,20,0.060790273556231
ORIENTE,2024-04-14,250,245,5,0.02
ORIENTE,2024-04-15,360,351,9,0.025
ORIENTE,2024-04-16,398,372,26,0.0653266331658292
ORIENTE,2024-04-17,291,274,17,0.0584192439862543
ORIENTE,2024-04-18,289,275,14,0.0484429065743945
ORIENTE,2024-04-19,319,307,12,0.0376175548589342
ORIENTE,2024-04-20,329,318,11,0.033434650455927
ORIENTE,2024-04-21,229,217,12,0.0524017467248908
ORIENTE,2024-04-22,216,201,15,0.0694444444444444
ORIENTE,2024-04-23,433,404,29,0.0669745958429561
SURESTE,2023-04-24,242,235,7,0.0289256198347107
SURESTE,2023-04-25,275,267,8,0.0290909090909091
SURESTE,2023-04-26,243,234,9,0.037037037037037
SURESTE,2023-04-27,213,205,8,0.0375586854460094
SURESTE,2023-04-28,223,215,8,0.0358744394618834
SURESTE,2023-04-29,295,287,8,0.0271186440677966
SURESTE,2023-04-30,216,206,10,0.0462962962962963
SURESTE,2023-05-01,223,214,9,0.0403587443946188
SURESTE,2023-05-02,194,188,6,0.0309278350515464
SURESTE,2023-05-03,169,163,6,0.0355029585798817
SURESTE,2023-05-04,135,129,6,0.0444444444444444
SURESTE,2023-05-05,194,189,5,0.0257731958762887
SURESTE,2023-05-06,210,206,4,0.019047619047619
SURESTE,2023-05-07,157,151,6,0.0382165605095541
SURESTE,2023-05-08,163,158,5,0.0306748466257669
SURESTE,2023-05-09,171,168,3,0.0175438596491228
SURESTE,2023-05-10,151,140,11,0.0728476821192053
SURESTE,2023-05-11,158,147,11,0.069620253164557
SURESTE,2023-05-12,200,196,4,0.02
SURESTE,2023-05-13,275,268,7,0.0254545454545455
SURESTE,2023-05-14,230,221,9,0.0391304347826087
SURESTE,2023-05-15,240,235,5,0.0208333333333333
SURESTE,2023-05-16,287,274,13,0.0452961672473868
SURESTE,2023-05-17,216,206,10,0.0462962962962963
SURESTE,2023-05-18,183,174,9,0.0491803278688525
SURESTE,2023-05-19,189,183,6,0.0317460317460317
SURESTE,2023-05-20,253,249,4,0.0158102766798419
SURESTE,2023-05-21,225,218,7,0.0311111111111111
SURESTE,2023-05-22,198,188,10,0.0505050505050505
SURESTE,2023-05-23,203,194,9,0.0443349753694581
SURESTE,2023-05-24,202,196,6,0.0297029702970297
SURESTE,2023-05-25,187,177,10,0.053475935828877
SURESTE,2023-05-26,205,198,7,0.0341463414634146
SURESTE,2023-05-27,237,233,4,0.0168776371308017
SURESTE,2023-05-28,155,154,1,0.00645161290322581
SURESTE,2023-05-29,204,196,8,0.0392156862745098
SURESTE,2023-05-30,237,234,3,0.0126582278481013
SURESTE,2023-05-31,216,207,9,0.0416666666666667
SURESTE,2023-06-01,199,190,9,0.0452261306532663
SURESTE,2023-06-02,198,192,6,0.0303030303030303
SURESTE,2023-06-03,206,203,3,0.0145631067961165
SURESTE,2023-06-04,207,200,7,0.0338164251207729
SURESTE,2023-06-05,193,190,3,0.0155440414507772
SURESTE,2023-06-06,182,172,10,0.0549450549450549
SURESTE,2023-06-07,166,154,12,0.072289156626506
SURESTE,2023-06-08,183,181,2,0.0109289617486339
SURESTE,2023-06-09,180,173,7,0.0388888888888889
SURESTE,2023-06-10,221,208,13,0.0588235294117647
SURESTE,2023-06-11,217,210,7,0.032258064516129
SURESTE,2023-06-12,170,165,5,0.0294117647058824
SURESTE,2023-06-13,156,154,2,0.0128205128205128
SURESTE,2023-06-14,186,181,5,0.0268817204301075
SURESTE,2023-06-15,193,189,4,0.0207253886010363
SURESTE,2023-06-16,177,173,4,0.0225988700564972
SURESTE,2023-06-17,257,250,7,0.0272373540856031
SURESTE,2023-06-18,218,213,5,0.0229357798165138
SURESTE,2023-06-19,203,198,5,0.0246305418719212
SURESTE,2023-06-20,209,201,8,0.0382775119617225
SURESTE,2023-06-21,212,202,10,0.0471698113207547
SURESTE,2023-06-22,184,174,10,0.0543478260869565
SURESTE,2023-06-23,159,151,8,0.050314465408805
SURESTE,2023-06-24,182,180,2,0.010989010989011
SURESTE,2023-06-25,196,190,6,0.0306122448979592
SURESTE,2023-06-26,203,199,4,0.0197044334975369
SURESTE,2023-06-27,193,186,7,0.0362694300518135
SURESTE,2023-06-28,194,189,5,0.0257731958762887
SURESTE,2023-06-29,207,203,4,0.0193236714975845
SURESTE,2023-06-30,124,112,12,0.0967741935483871
SURESTE,2023-07-01,231,224,7,0.0303030303030303
SURESTE,2023-07-02,204,204,0,0
SURESTE,2023-07-03,206,199,7,0.0339805825242718
SURESTE,2023-07-04,187,183,4,0.0213903743315508
SURESTE,2023-07-05,174,169,5,0.028735632183908
SURESTE,2023-07-06,167,163,4,0.0239520958083832
SURESTE,2023-07-07,228,221,7,0.0307017543859649
SURESTE,2023-07-08,242,236,6,0.0247933884297521
SURESTE,2023-07-09,208,204,4,0.0192307692307692
SURESTE,2023-07-10,270,262,8,0.0296296296296296
SURESTE,2023-07-11,221,218,3,0.0135746606334842
SURESTE,2023-07-12,210,205,5,0.0238095238095238
SURESTE,2023-07-13,198,192,6,0.0303030303030303
SURESTE,2023-07-14,199,195,4,0.0201005025125628
SURESTE,2023-07-15,222,218,4,0.018018018018018
SURESTE,2023-07-16,207,205,2,0.00966183574879227
SURESTE,2023-07-17,222,217,5,0.0225225225225225
SURESTE,2023-07-18,196,192,4,0.0204081632653061
SURESTE,2023-07-19,172,167,5,0.0290697674418605
SURESTE,2023-07-20,235,229,6,0.025531914893617
SURESTE,2023-07-21,189,183,6,0.0317460317460317
SURESTE,2023-07-22,228,226,2,0.0087719298245614
SURESTE,2023-07-23,200,198,2,0.01
SURESTE,2023-07-24,207,206,1,0.00483091787439614
SURESTE,2023-07-25,216,208,8,0.037037037037037
SURESTE,2023-07-26,209,203,6,0.0287081339712919
SURESTE,2023-07-27,181,176,5,0.0276243093922652
SURESTE,2023-07-28,201,197,4,0.0199004975124378
SURESTE,2023-07-29,264,262,2,0.00757575757575758
SURESTE,2023-07-30,217,216,1,0.00460829493087558
SURESTE,2023-07-31,271,267,4,0.014760147601476
SURESTE,2023-08-01,213,206,7,0.0328638497652582
SURESTE,2023-08-02,214,211,3,0.014018691588785
SURESTE,2023-08-03,181,159,22,0.121546961325967
SURESTE,2023-08-04,191,186,5,0.0261780104712042
SURESTE,2023-08-05,201,190,11,0.054726368159204
SURESTE,2023-08-06,202,200,2,0.0099009900990099
SURESTE,2023-08-07,200,192,8,0.04
SURESTE,2023-08-08,181,175,6,0.0331491712707182
SURESTE,2023-08-09,205,202,3,0.0146341463414634
SURESTE,2023-08-10,198,194,4,0.0202020202020202
SURESTE,2023-08-11,178,165,13,0.0730337078651685
SURESTE,2023-08-12,201,193,8,0.0398009950248756
SURESTE,2023-08-13,217,210,7,0.032258064516129
SURESTE,2023-08-14,187,180,7,0.0374331550802139
SURESTE,2023-08-15,198,195,3,0.0151515151515152
SURESTE,2023-08-16,209,203,6,0.0287081339712919
SURESTE,2023-08-17,195,185,10,0.0512820512820513
SURESTE,2023-08-18,252,245,7,0.0277777777777778
SURESTE,2023-08-19,236,228,8,0.0338983050847458
SURESTE,2023-08-20,211,204,7,0.033175355450237
SURESTE,2023-08-21,199,199,0,0
SURESTE,2023-08-22,178,175,3,0.0168539325842697
SURESTE,2023-08-23,178,177,1,0.00561797752808989
SURESTE,2023-08-24,219,218,1,0.0045662100456621
SURESTE,2023-08-25,209,206,3,0.0143540669856459
SURESTE,2023-08-26,241,238,3,0.012448132780083
SURESTE,2023-08-27,199,199,0,0
SURESTE,2023-08-28,209,204,5,0.0239234449760766
SURESTE,2023-08-29,207,206,1,0.00483091787439614
SURESTE,2023-08-30,198,197,1,0.00505050505050505
SURESTE,2023-08-31,200,199,1,0.005
SURESTE,2023-09-01,191,191,0,0
SURESTE,2023-09-02,203,201,2,0.00985221674876847
SURESTE,2023-09-03,176,175,1,0.00568181818181818
SURESTE,2023-09-04,162,161,1,0.00617283950617284
SURESTE,2023-09-05,223,222,1,0.00448430493273543
SURESTE,2023-09-06,202,201,1,0.00495049504950495
SURESTE,2023-09-07,228,227,1,0.0043859649122807
SURESTE,2023-09-08,220,220,0,0
SURESTE,2023-09-09,225,224,1,0.00444444444444444
SURESTE,2023-09-10,180,180,0,0
SURESTE,2023-09-11,202,200,2,0.0099009900990099
SURESTE,2023-09-12,234,233,1,0.00427350427350427
SURESTE,2023-09-13,211,209,2,0.00947867298578199
SURESTE,2023-09-14,204,202,2,0.00980392156862745
SURESTE,2023-09-15,222,220,2,0.00900900900900901
SURESTE,2023-09-16,207,206,1,0.00483091787439614
SURESTE,2023-09-17,169,168,1,0.00591715976331361
SURESTE,2023-09-18,189,189,0,0
SURESTE,2023-09-19,189,188,1,0.00529100529100529
SURESTE,2023-09-20,182,179,3,0.0164835164835165
SURESTE,2023-09-21,187,186,1,0.0053475935828877
SURESTE,2023-09-22,196,195,1,0.00510204081632653
SURESTE,2023-09-23,224,222,2,0.00892857142857143
SURESTE,2023-09-24,180,178,2,0.0111111111111111
SURESTE,2023-09-25,192,190,2,0.0104166666666667
SURESTE,2023-09-26,205,204,1,0.0048780487804878
SURESTE,2023-09-27,212,212,0,0
SURESTE,2023-09-28,188,186,2,0.0106382978723404
SURESTE,2023-09-29,238,237,1,0.00420168067226891
SURESTE,2023-09-30,249,248,1,0.00401606425702811
SURESTE,2023-10-01,196,196,0,0
SURESTE,2023-10-02,198,198,0,0
SURESTE,2023-10-03,195,192,3,0.0153846153846154
SURESTE,2023-10-04,167,164,3,0.0179640718562874
SURESTE,2023-10-05,176,172,4,0.0227272727272727
SURESTE,2023-10-06,187,182,5,0.0267379679144385
SURESTE,2023-10-07,199,196,3,0.0150753768844221
SURESTE,2023-10-08,156,152,4,0.0256410256410256
SURESTE,2023-10-09,162,158,4,0.0246913580246914
SURESTE,2023-10-10,155,149,6,0.0387096774193548
SURESTE,2023-10-11,176,169,7,0.0397727272727273
SURESTE,2023-10-12,144,142,2,0.0138888888888889
SURESTE,2023-10-13,180,179,1,0.00555555555555556
SURESTE,2023-10-14,189,189,0,0
SURESTE,2023-10-15,174,170,4,0.0229885057471264
SURESTE,2023-10-16,179,177,2,0.0111731843575419
SURESTE,2023-10-17,189,182,7,0.037037037037037
SURESTE,2023-10-18,214,207,7,0.0327102803738318
SURESTE,2023-10-19,193,188,5,0.0259067357512953
SURESTE,2023-10-20,197,193,4,0.0203045685279188
SURESTE,2023-10-21,212,207,5,0.0235849056603774
SURESTE,2023-10-22,160,151,9,0.05625
SURESTE,2023-10-23,144,140,4,0.0277777777777778
SURESTE,2023-10-24,174,168,6,0.0344827586206897
SURESTE,2023-10-25,181,177,4,0.0220994475138122
SURESTE,2023-10-26,189,183,6,0.0317460317460317
SURESTE,2023-10-27,195,189,6,0.0307692307692308
SURESTE,2023-10-28,214,213,1,0.00467289719626168
SURESTE,2023-10-29,146,142,4,0.0273972602739726
SURESTE,2023-10-30,209,202,7,0.0334928229665072
SURESTE,2023-10-31,211,207,4,0.018957345971564
SURESTE,2023-11-01,202,199,3,0.0148514851485149
SURESTE,2023-11-02,184,181,3,0.016304347826087
SURESTE,2023-11-03,197,192,5,0.0253807106598985
SURESTE,2023-11-04,185,178,7,0.0378378378378378
SURESTE,2023-11-05,174,171,3,0.0172413793103448
SURESTE,2023-11-06,200,193,7,0.035
SURESTE,2023-11-07,211,209,2,0.00947867298578199
SURESTE,2023-11-08,229,220,9,0.0393013100436681
SURESTE,2023-11-09,217,214,3,0.0138248847926267
SURESTE,2023-11-10,190,187,3,0.0157894736842105
SURESTE,2023-11-11,223,220,3,0.0134529147982063
SURESTE,2023-11-12,218,215,3,0.0137614678899083
SURESTE,2023-11-13,203,195,8,0.0394088669950739
SURESTE,2023-11-14,229,223,6,0.0262008733624454
SURESTE,2023-11-15,275,260,15,0.0545454545454545
SURESTE,2023-11-16,240,233,7,0.0291666666666667
SURESTE,2023-11-17,232,224,8,0.0344827586206897
SURESTE,2023-11-18,285,279,6,0.0210526315789474
SURESTE,2023-11-19,246,238,8,0.032520325203252
SURESTE,2023-11-20,256,254,2,0.0078125
SURESTE,2023-11-21,234,229,5,0.0213675213675214
SURESTE,2023-11-22,212,206,6,0.0283018867924528
SURESTE,2023-11-23,228,225,3,0.0131578947368421
SURESTE,2023-11-24,201,196,5,0.0248756218905473
SURESTE,2023-11-25,237,230,7,0.029535864978903
SURESTE,2023-11-26,209,205,4,0.0191387559808612
SURESTE,2023-11-27,242,236,6,0.0247933884297521
SURESTE,2023-11-28,242,237,5,0.0206611570247934
SURESTE,2023-11-29,247,239,8,0.0323886639676113
SURESTE,2023-11-30,263,255,8,0.0304182509505703
SURESTE,2023-12-01,223,212,11,0.0493273542600897
SURESTE,2023-12-02,238,233,5,0.0210084033613445
SURESTE,2023-12-03,164,160,4,0.024390243902439
SURESTE,2023-12-04,180,179,1,0.00555555555555556
SURESTE,2023-12-05,199,192,7,0.0351758793969849
SURESTE,2023-12-06,209,204,5,0.0239234449760766
SURESTE,2023-12-07,227,222,5,0.0220264317180617
SURESTE,2023-12-08,232,224,8,0.0344827586206897
SURESTE,2023-12-09,248,242,6,0.0241935483870968
SURESTE,2023-12-10,195,188,7,0.0358974358974359
SURESTE,2023-12-11,196,191,5,0.0255102040816327
SURESTE,2023-12-12,198,191,7,0.0353535353535354
SURESTE,2023-12-13,197,194,3,0.0152284263959391
SURESTE,2023-12-14,213,205,8,0.0375586854460094
SURESTE,2023-12-15,177,174,3,0.0169491525423729
SURESTE,2023-12-16,212,210,2,0.00943396226415094
SURESTE,2023-12-17,199,197,2,0.0100502512562814
SURESTE,2023-12-18,210,202,8,0.0380952380952381
SURESTE,2023-12-19,240,238,2,0.00833333333333333
SURESTE,2023-12-20,210,203,7,0.0333333333333333
SURESTE,2023-12-21,224,218,6,0.0267857142857143
SURESTE,2023-12-22,202,200,2,0.0099009900990099
SURESTE,2023-12-23,246,240,6,0.024390243902439
SURESTE,2023-12-24,176,172,4,0.0227272727272727
SURESTE,2023-12-25,60,60,0,0
SURESTE,2023-12-26,203,200,3,0.0147783251231527
SURESTE,2023-12-27,250,244,6,0.024
SURESTE,2023-12-28,252,248,4,0.0158730158730159
SURESTE,2023-12-29,225,222,3,0.0133333333333333
SURESTE,2023-12-30,262,259,3,0.0114503816793893
SURESTE,2023-12-31,110,108,2,0.0181818181818182
SURESTE,2024-01-01,42,41,1,0.0238095238095238
SURESTE,2024-01-02,174,172,2,0.0114942528735632
SURESTE,2024-01-03,231,228,3,0.012987012987013
SURESTE,2024-01-04,219,214,5,0.0228310502283105
SURESTE,2024-01-05,214,210,4,0.0186915887850467
SURESTE,2024-01-06,242,237,5,0.0206611570247934
SURESTE,2024-01-07,170,166,4,0.0235294117647059
SURESTE,2024-01-08,220,214,6,0.0272727272727273
SURESTE,2024-01-09,208,205,3,0.0144230769230769
SURESTE,2024-01-10,209,208,1,0.00478468899521531
SURESTE,2024-01-11,229,224,5,0.0218340611353712
SURESTE,2024-01-12,217,213,4,0.0184331797235023
SURESTE,2024-01-13,241,236,5,0.020746887966805
SURESTE,2024-01-14,214,209,5,0.0233644859813084
SURESTE,2024-01-15,238,229,9,0.0378151260504202
SURESTE,2024-01-16,226,222,4,0.0176991150442478
SURESTE,2024-01-17,200,198,2,0.01
SURESTE,2024-01-18,192,190,2,0.0104166666666667
SURESTE,2024-01-19,235,230,5,0.0212765957446809
SURESTE,2024-01-20,219,216,3,0.0136986301369863
SURESTE,2024-01-21,176,171,5,0.0284090909090909
SURESTE,2024-01-22,184,183,1,0.00543478260869565
SURESTE,2024-01-23,226,218,8,0.0353982300884956
SURESTE,2024-01-24,268,256,12,0.0447761194029851
SURESTE,2024-01-25,215,210,5,0.0232558139534884
SURESTE,2024-01-26,235,230,5,0.0212765957446809
SURESTE,2024-01-27,233,226,7,0.0300429184549356
SURESTE,2024-01-28,193,188,5,0.0259067357512953
SURESTE,2024-01-29,186,180,6,0.032258064516129
SURESTE,2024-01-30,177,168,9,0.0508474576271186
SURESTE,2024-01-31,212,204,8,0.0377358490566038
SURESTE,2024-02-01,220,217,3,0.0136363636363636
SURESTE,2024-02-02,200,192,8,0.04
SURESTE,2024-02-03,242,232,10,0.0413223140495868
SURESTE,2024-02-04,186,182,4,0.021505376344086
SURESTE,2024-02-05,173,168,5,0.0289017341040462
SURESTE,2024-02-06,202,200,2,0.0099009900990099
SURESTE,2024-02-07,206,204,2,0.00970873786407767
SURESTE,2024-02-08,204,199,5,0.0245098039215686
SURESTE,2024-02-09,220,215,5,0.0227272727272727
SURESTE,2024-02-10,188,182,6,0.0319148936170213
SURESTE,2024-02-11,157,154,3,0.0191082802547771
SURESTE,2024-02-12,162,158,4,0.0246913580246914
SURESTE,2024-02-13,220,217,3,0.0136363636363636
SURESTE,2024-02-14,191,182,9,0.0471204188481675
SURESTE,2024-02-15,226,221,5,0.0221238938053097
SURESTE,2024-02-16,208,205,3,0.0144230769230769
SURESTE,2024-02-17,207,204,3,0.0144927536231884
SURESTE,2024-02-18,161,158,3,0.0186335403726708
SURESTE,2024-02-19,205,199,6,0.0292682926829268
SURESTE,2024-02-20,199,195,4,0.0201005025125628
SURESTE,2024-02-21,231,227,4,0.0173160173160173
SURESTE,2024-02-22,203,196,7,0.0344827586206897
SURESTE,2024-02-23,155,135,20,0.129032258064516
SURESTE,2024-02-24,258,248,10,0.0387596899224806
SURESTE,2024-02-25,185,183,2,0.0108108108108108
SURESTE,2024-02-26,220,211,9,0.0409090909090909
SURESTE,2024-02-27,223,216,7,0.031390134529148
SURESTE,2024-02-28,217,212,5,0.0230414746543779
SURESTE,2024-02-29,219,211,8,0.0365296803652968
SURESTE,2024-03-01,227,222,5,0.0220264317180617
SURESTE,2024-03-02,250,244,6,0.024
SURESTE,2024-03-03,176,169,7,0.0397727272727273
SURESTE,2024-03-04,201,197,4,0.0199004975124378
SURESTE,2024-03-05,188,182,6,0.0319148936170213
SURESTE,2024-03-06,182,175,7,0.0384615384615385
SURESTE,2024-03-07,189,182,7,0.037037037037037
SURESTE,2024-03-08,208,199,9,0.0432692307692308
SURESTE,2024-03-09,215,209,6,0.027906976744186
SURESTE,2024-03-10,166,165,1,0.00602409638554217
SURESTE,2024-03-11,194,185,9,0.0463917525773196
SURESTE,2024-03-12,199,193,6,0.0301507537688442
SURESTE,2024-03-13,178,165,13,0.0730337078651685
SURESTE,2024-03-14,178,169,9,0.050561797752809
SURESTE,2024-03-15,212,205,7,0.0330188679245283
SURESTE,2024-03-16,236,228,8,0.0338983050847458
SURESTE,2024-03-17,147,143,4,0.0272108843537415
SURESTE,2024-03-18,165,162,3,0.0181818181818182
SURESTE,2024-03-19,198,189,9,0.0454545454545455
SURESTE,2024-03-20,180,176,4,0.0222222222222222
SURESTE,2024-03-21,160,156,4,0.025
SURESTE,2024-03-22,167,163,4,0.0239520958083832
SURESTE,2024-03-23,222,210,12,0.0540540540540541
SURESTE,2024-03-24,154,151,3,0.0194805194805195
SURESTE,2024-03-25,171,162,9,0.0526315789473684
SURESTE,2024-03-26,213,205,8,0.0375586854460094
SURESTE,2024-03-27,169,166,3,0.0177514792899408
SURESTE,2024-03-28,227,223,4,0.0176211453744493
SURESTE,2024-03-29,196,187,9,0.0459183673469388
SURESTE,2024-03-30,179,175,4,0.0223463687150838
SURESTE,2024-03-31,132,130,2,0.0151515151515152
SURESTE,2024-04-01,168,165,3,0.0178571428571429
SURESTE,2024-04-02,213,211,2,0.00938967136150235
SURESTE,2024-04-03,187,187,0,0
SURESTE,2024-04-04,177,177,0,0
SURESTE,2024-04-05,194,190,4,0.0206185567010309
SURESTE,2024-04-06,192,184,8,0.0416666666666667
SURESTE,2024-04-07,137,136,1,0.0072992700729927
SURESTE,2024-04-08,170,166,4,0.0235294117647059
SURESTE,2024-04-09,174,167,7,0.0402298850574713
SURESTE,2024-04-10,181,170,11,0.0607734806629834
SURESTE,2024-04-11,164,157,7,0.0426829268292683
SURESTE,2024-04-12,185,181,4,0.0216216216216216
SURESTE,2024-04-13,226,222,4,0.0176991150442478
SURESTE,2024-04-14,143,139,4,0.027972027972028
SURESTE,2024-04-15,194,189,5,0.0257731958762887
SURESTE,2024-04-16,206,198,8,0.0388349514563107
SURESTE,2024-04-17,208,198,10,0.0480769230769231
SURESTE,2024-04-18,190,185,5,0.0263157894736842
SURESTE,2024-04-19,166,155,11,0.0662650602409639
SURESTE,2024-04-20,203,194,9,0.0443349753694581
SURESTE,2024-04-21,149,144,5,0.0335570469798658
SURESTE,2024-04-22,96,92,4,0.0416666666666667
SURESTE,2024-04-23,215,193,22,0.102325581395349