DIRECCION,Fecha,Instalaciones,Activaciones_automaticas,Ativaciones_manuales,&ActM
CENTRO,2023-01-02,897,609,288,0.321070234113712
CENTRO,2023-01-03,1090,753,337,0.309174311926605
CENTRO,2023-01-04,1146,803,343,0.299301919720768
CENTRO,2023-01-05,1122,750,372,0.331550802139037
CENTRO,2023-01-06,1069,756,313,0.292797006548176
CENTRO,2023-01-07,1298,877,421,0.324345146379045
CENTRO,2023-01-08,1047,757,290,0.276981852913085
CENTRO,2023-01-09,1120,752,368,0.328571428571429
CENTRO,2023-01-10,1198,816,382,0.318864774624374
CENTRO,2023-01-11,1173,779,394,0.335890878090367
CENTRO,2023-01-12,1170,764,406,0.347008547008547
CENTRO,2023-01-13,1169,763,406,0.347305389221557
CENTRO,2023-01-14,1384,910,474,0.342485549132948
CENTRO,2023-01-15,1243,809,434,0.349155269509252
CENTRO,2023-01-16,1169,621,548,0.468776732249786
CENTRO,2023-01-17,1135,577,558,0.491629955947137
CENTRO,2023-01-18,1142,590,552,0.483362521891419
CENTRO,2023-01-19,1073,639,434,0.404473438956198
CENTRO,2023-01-20,1139,689,450,0.395083406496927
CENTRO,2023-01-21,1297,718,579,0.446414803392444
CENTRO,2023-01-22,1063,630,433,0.407337723424271
CENTRO,2023-01-23,1074,623,451,0.419925512104283
CENTRO,2023-01-24,1104,618,486,0.440217391304348
CENTRO,2023-01-25,1102,628,474,0.430127041742287
CENTRO,2023-01-26,1174,639,535,0.455706984667802
CENTRO,2023-01-27,1165,645,520,0.446351931330472
CENTRO,2023-01-28,1398,747,651,0.465665236051502
CENTRO,2023-01-29,1145,655,490,0.427947598253275
CENTRO,2023-01-30,1253,680,573,0.457302474062251
CENTRO,2023-01-31,1401,778,623,0.444682369735903
CENTRO,2023-02-01,1194,690,504,0.422110552763819
CENTRO,2023-02-02,1187,699,488,0.411120471777591
CENTRO,2023-02-03,1139,650,489,0.429323968393327
CENTRO,2023-02-04,1431,816,615,0.429769392033543
CENTRO,2023-02-05,1077,627,450,0.417827298050139
CENTRO,2023-02-06,1257,710,547,0.435163086714399
CENTRO,2023-02-07,1169,607,562,0.480752780153978
CENTRO,2023-02-08,1117,555,562,0.50313339301701
CENTRO,2023-02-09,1086,581,505,0.465009208103131
CENTRO,2023-02-10,1115,559,556,0.498654708520179
CENTRO,2023-02-11,1274,633,641,0.503139717425432
CENTRO,2023-02-12,1020,515,505,0.495098039215686
CENTRO,2023-02-13,1093,551,542,0.495882891125343
CENTRO,2023-02-14,1060,567,493,0.465094339622642
CENTRO,2023-02-15,1138,613,525,0.461335676625659
CENTRO,2023-02-16,1113,590,523,0.469901168014376
CENTRO,2023-02-17,1089,567,522,0.479338842975207
CENTRO,2023-02-18,1384,689,695,0.502167630057804
CENTRO,2023-02-19,1138,583,555,0.487697715289982
CENTRO,2023-02-20,1147,625,522,0.455100261551874
CENTRO,2023-02-21,1108,734,374,0.337545126353791
CENTRO,2023-02-22,1079,744,335,0.31047265987025
CENTRO,2023-02-23,1057,768,289,0.273415326395459
CENTRO,2023-02-24,1108,794,314,0.283393501805054
CENTRO,2023-02-25,1326,929,397,0.299396681749623
CENTRO,2023-02-26,1093,762,331,0.302836230558097
CENTRO,2023-02-27,1187,819,368,0.310025273799495
CENTRO,2023-02-28,1341,951,390,0.29082774049217
CENTRO,2023-03-01,1145,801,344,0.300436681222707
CENTRO,2023-03-02,1093,762,331,0.302836230558097
CENTRO,2023-03-03,1271,930,341,0.268292682926829
CENTRO,2023-03-04,1458,1034,424,0.290809327846365
CENTRO,2023-03-05,1230,824,406,0.330081300813008
CENTRO,2023-03-06,1092,785,307,0.281135531135531
CENTRO,2023-03-07,1194,858,336,0.281407035175879
CENTRO,2023-03-08,1212,926,286,0.235973597359736
CENTRO,2023-03-09,1173,925,248,0.211423699914749
CENTRO,2023-03-10,1061,876,185,0.174363807728558
CENTRO,2023-03-11,1318,1076,242,0.18361153262519
CENTRO,2023-03-12,1043,849,194,0.186001917545542
CENTRO,2023-03-13,1136,916,220,0.193661971830986
CENTRO,2023-03-14,1223,1020,203,0.165985282093213
CENTRO,2023-03-15,1195,1073,122,0.102092050209205
CENTRO,2023-03-16,1380,1262,118,0.0855072463768116
CENTRO,2023-03-17,1750,1607,143,0.0817142857142857
CENTRO,2023-03-18,1905,1737,168,0.0881889763779528
CENTRO,2023-03-19,1679,1546,133,0.0792138177486599
CENTRO,2023-03-20,1911,1777,134,0.0701203558346415
CENTRO,2023-03-21,1462,1401,61,0.0417236662106703
CENTRO,2023-03-22,1330,1271,59,0.0443609022556391
CENTRO,2023-03-23,1285,1231,54,0.0420233463035019
CENTRO,2023-03-24,1309,1265,44,0.0336134453781513
CENTRO,2023-03-25,1571,1522,49,0.0311903246339911
CENTRO,2023-03-26,1405,1364,41,0.0291814946619217
CENTRO,2023-03-27,1137,1105,32,0.0281442392260334
CENTRO,2023-03-28,1012,986,26,0.0256916996047431
CENTRO,2023-03-29,1123,1102,21,0.018699910952805
CENTRO,2023-03-30,1400,1356,44,0.0314285714285714
CENTRO,2023-03-31,1882,1823,59,0.0313496280552604
CENTRO,2023-04-01,1603,1568,35,0.0218340611353712
CENTRO,2023-04-02,1264,1228,36,0.0284810126582278
CENTRO,2023-04-03,1547,1512,35,0.0226244343891403
CENTRO,2023-04-04,1173,1141,32,0.0272804774083546
CENTRO,2023-04-05,1196,1137,59,0.0493311036789298
CENTRO,2023-04-06,1276,1253,23,0.018025078369906
CENTRO,2023-04-07,984,974,10,0.0101626016260163
CENTRO,2023-04-08,832,819,13,0.015625
CENTRO,2023-04-09,745,732,13,0.0174496644295302
CENTRO,2023-04-10,961,942,19,0.0197710718002081
CENTRO,2023-04-11,1087,1052,35,0.0321987120515179
CENTRO,2023-04-12,1183,1152,31,0.0262045646661031
CENTRO,2023-04-13,1116,1093,23,0.0206093189964158
CENTRO,2023-04-14,1354,1311,43,0.0317577548005908
CENTRO,2023-04-15,1765,1694,71,0.0402266288951841
CENTRO,2023-04-16,1670,1640,30,0.0179640718562874
CENTRO,2023-04-17,1490,1456,34,0.0228187919463087
CENTRO,2023-04-18,1269,1216,53,0.0417651694247439
CENTRO,2023-04-19,1181,1145,36,0.0304826418289585
CENTRO,2023-04-20,1102,1065,37,0.0335753176043557
CENTRO,2023-04-21,1266,1236,30,0.023696682464455
CENTRO,2023-04-22,1432,1398,34,0.0237430167597765
CENTRO,2023-04-23,1270,1242,28,0.0220472440944882
CENTRO,2023-04-24,1390,1351,39,0.0280575539568345
NORESTE-FRONTERA,2023-01-02,423,325,98,0.231678486997636
NORESTE-FRONTERA,2023-01-03,505,386,119,0.235643564356436
NORESTE-FRONTERA,2023-01-04,530,381,149,0.281132075471698
NORESTE-FRONTERA,2023-01-05,527,429,98,0.18595825426945
NORESTE-FRONTERA,2023-01-06,600,451,149,0.248333333333333
NORESTE-FRONTERA,2023-01-07,650,487,163,0.250769230769231
NORESTE-FRONTERA,2023-01-08,393,290,103,0.262086513994911
NORESTE-FRONTERA,2023-01-09,533,388,145,0.272045028142589
NORESTE-FRONTERA,2023-01-10,535,416,119,0.222429906542056
NORESTE-FRONTERA,2023-01-11,538,417,121,0.224907063197026
NORESTE-FRONTERA,2023-01-12,487,373,114,0.234086242299795
NORESTE-FRONTERA,2023-01-13,557,447,110,0.197486535008977
NORESTE-FRONTERA,2023-01-14,617,491,126,0.204213938411669
NORESTE-FRONTERA,2023-01-15,396,317,79,0.19949494949495
NORESTE-FRONTERA,2023-01-16,514,391,123,0.239299610894942
NORESTE-FRONTERA,2023-01-17,520,398,122,0.234615384615385
NORESTE-FRONTERA,2023-01-18,472,369,103,0.218220338983051
NORESTE-FRONTERA,2023-01-19,480,374,106,0.220833333333333
NORESTE-FRONTERA,2023-01-20,525,425,100,0.19047619047619
NORESTE-FRONTERA,2023-01-21,638,508,130,0.203761755485893
NORESTE-FRONTERA,2023-01-22,331,250,81,0.244712990936556
NORESTE-FRONTERA,2023-01-23,440,341,99,0.225
NORESTE-FRONTERA,2023-01-24,479,388,91,0.189979123173278
NORESTE-FRONTERA,2023-01-25,487,378,109,0.223819301848049
NORESTE-FRONTERA,2023-01-26,461,342,119,0.258134490238612
NORESTE-FRONTERA,2023-01-27,502,391,111,0.221115537848606
NORESTE-FRONTERA,2023-01-28,681,456,225,0.330396475770925
NORESTE-FRONTERA,2023-01-29,400,286,114,0.285
NORESTE-FRONTERA,2023-01-30,498,379,119,0.238955823293173
NORESTE-FRONTERA,2023-01-31,500,390,110,0.22
NORESTE-FRONTERA,2023-02-01,449,363,86,0.191536748329621
NORESTE-FRONTERA,2023-02-02,507,389,118,0.232741617357002
NORESTE-FRONTERA,2023-02-03,517,401,116,0.224371373307544
NORESTE-FRONTERA,2023-02-04,673,522,151,0.224368499257058
NORESTE-FRONTERA,2023-02-05,428,333,95,0.22196261682243
NORESTE-FRONTERA,2023-02-06,434,356,78,0.179723502304147
NORESTE-FRONTERA,2023-02-07,503,406,97,0.192842942345924
NORESTE-FRONTERA,2023-02-08,486,395,91,0.187242798353909
NORESTE-FRONTERA,2023-02-09,524,424,100,0.190839694656489
NORESTE-FRONTERA,2023-02-10,516,421,95,0.184108527131783
NORESTE-FRONTERA,2023-02-11,632,462,170,0.268987341772152
NORESTE-FRONTERA,2023-02-12,458,358,100,0.218340611353712
NORESTE-FRONTERA,2023-02-13,479,371,108,0.225469728601253
NORESTE-FRONTERA,2023-02-14,472,368,104,0.220338983050847
NORESTE-FRONTERA,2023-02-15,517,415,102,0.197292069632495
NORESTE-FRONTERA,2023-02-16,541,436,105,0.194085027726433
NORESTE-FRONTERA,2023-02-17,562,435,127,0.225978647686833
NORESTE-FRONTERA,2023-02-18,707,547,160,0.226308345120226
NORESTE-FRONTERA,2023-02-19,444,333,111,0.25
NORESTE-FRONTERA,2023-02-20,485,373,112,0.230927835051546
NORESTE-FRONTERA,2023-02-21,495,375,120,0.242424242424242
NORESTE-FRONTERA,2023-02-22,521,390,131,0.251439539347409
NORESTE-FRONTERA,2023-02-23,497,369,128,0.257545271629779
NORESTE-FRONTERA,2023-02-24,497,359,138,0.277665995975855
NORESTE-FRONTERA,2023-02-25,727,486,241,0.331499312242091
NORESTE-FRONTERA,2023-02-26,437,331,106,0.242562929061785
NORESTE-FRONTERA,2023-02-27,513,374,139,0.270955165692008
NORESTE-FRONTERA,2023-02-28,623,458,165,0.264847512038523
NORESTE-FRONTERA,2023-03-01,576,438,138,0.239583333333333
NORESTE-FRONTERA,2023-03-02,612,453,159,0.259803921568627
NORESTE-FRONTERA,2023-03-03,651,488,163,0.250384024577573
NORESTE-FRONTERA,2023-03-04,757,539,218,0.287978863936592
NORESTE-FRONTERA,2023-03-05,384,273,111,0.2890625
NORESTE-FRONTERA,2023-03-06,501,379,122,0.243512974051896
NORESTE-FRONTERA,2023-03-07,584,436,148,0.253424657534247
NORESTE-FRONTERA,2023-03-08,612,448,164,0.26797385620915
NORESTE-FRONTERA,2023-03-09,571,477,94,0.164623467600701
NORESTE-FRONTERA,2023-03-10,618,516,102,0.16504854368932
NORESTE-FRONTERA,2023-03-11,772,638,134,0.173575129533679
NORESTE-FRONTERA,2023-03-12,488,403,85,0.174180327868852
NORESTE-FRONTERA,2023-03-13,535,453,82,0.153271028037383
NORESTE-FRONTERA,2023-03-14,621,515,106,0.170692431561997
NORESTE-FRONTERA,2023-03-15,564,521,43,0.076241134751773
NORESTE-FRONTERA,2023-03-16,645,607,38,0.0589147286821705
NORESTE-FRONTERA,2023-03-17,744,685,59,0.0793010752688172
NORESTE-FRONTERA,2023-03-18,937,875,62,0.0661686232657417
NORESTE-FRONTERA,2023-03-19,571,530,41,0.0718038528896672
NORESTE-FRONTERA,2023-03-20,642,594,48,0.0747663551401869
NORESTE-FRONTERA,2023-03-21,701,666,35,0.0499286733238231
NORESTE-FRONTERA,2023-03-22,664,639,25,0.0376506024096386
NORESTE-FRONTERA,2023-03-23,683,657,26,0.0380673499267936
NORESTE-FRONTERA,2023-03-24,700,666,34,0.0485714285714286
NORESTE-FRONTERA,2023-03-25,777,737,40,0.0514800514800515
NORESTE-FRONTERA,2023-03-26,501,469,32,0.063872255489022
NORESTE-FRONTERA,2023-03-27,620,596,24,0.0387096774193548
NORESTE-FRONTERA,2023-03-28,493,477,16,0.0324543610547667
NORESTE-FRONTERA,2023-03-29,596,562,34,0.0570469798657718
NORESTE-FRONTERA,2023-03-30,678,643,35,0.051622418879056
NORESTE-FRONTERA,2023-03-31,939,904,35,0.0372736954206603
NORESTE-FRONTERA,2023-04-01,745,721,24,0.0322147651006711
NORESTE-FRONTERA,2023-04-02,440,421,19,0.0431818181818182
NORESTE-FRONTERA,2023-04-03,678,661,17,0.0250737463126844
NORESTE-FRONTERA,2023-04-04,591,583,8,0.0135363790186125
NORESTE-FRONTERA,2023-04-05,533,517,16,0.0300187617260788
NORESTE-FRONTERA,2023-04-06,613,607,6,0.00978792822185971
NORESTE-FRONTERA,2023-04-07,580,NA,NA,NA
NORESTE-FRONTERA,2023-04-08,542,541,1,0.0018450184501845
NORESTE-FRONTERA,2023-04-09,322,NA,NA,NA
NORESTE-FRONTERA,2023-04-10,474,467,7,0.0147679324894515
NORESTE-FRONTERA,2023-04-11,565,559,6,0.0106194690265487
NORESTE-FRONTERA,2023-04-12,525,519,6,0.0114285714285714
NORESTE-FRONTERA,2023-04-13,513,505,8,0.0155945419103314
NORESTE-FRONTERA,2023-04-14,683,673,10,0.0146412884333821
NORESTE-FRONTERA,2023-04-15,841,819,22,0.0261593341260404
NORESTE-FRONTERA,2023-04-16,533,522,11,0.0206378986866792
NORESTE-FRONTERA,2023-04-17,643,631,12,0.0186625194401244
NORESTE-FRONTERA,2023-04-18,636,622,14,0.0220125786163522
NORESTE-FRONTERA,2023-04-19,562,549,13,0.0231316725978648
NORESTE-FRONTERA,2023-04-20,571,554,17,0.0297723292469352
NORESTE-FRONTERA,2023-04-21,698,679,19,0.0272206303724928
NORESTE-FRONTERA,2023-04-22,733,710,23,0.0313778990450205
NORESTE-FRONTERA,2023-04-23,541,532,9,0.0166358595194085
NORESTE-FRONTERA,2023-04-24,622,608,14,0.022508038585209
NORTE-PACIFICO,2023-01-02,342,224,118,0.345029239766082
NORTE-PACIFICO,2023-01-03,415,260,155,0.373493975903614
NORTE-PACIFICO,2023-01-04,428,268,160,0.373831775700935
NORTE-PACIFICO,2023-01-05,391,220,171,0.437340153452685
NORTE-PACIFICO,2023-01-06,414,246,168,0.405797101449275
NORTE-PACIFICO,2023-01-07,527,343,184,0.349146110056926
NORTE-PACIFICO,2023-01-08,424,275,149,0.351415094339623
NORTE-PACIFICO,2023-01-09,419,288,131,0.312649164677804
NORTE-PACIFICO,2023-01-10,471,295,176,0.373673036093418
NORTE-PACIFICO,2023-01-11,441,276,165,0.374149659863946
NORTE-PACIFICO,2023-01-12,455,294,161,0.353846153846154
NORTE-PACIFICO,2023-01-13,489,314,175,0.357873210633947
NORTE-PACIFICO,2023-01-14,480,323,157,0.327083333333333
NORTE-PACIFICO,2023-01-15,352,246,106,0.301136363636364
NORTE-PACIFICO,2023-01-16,343,222,121,0.352769679300292
NORTE-PACIFICO,2023-01-17,384,260,124,0.322916666666667
NORTE-PACIFICO,2023-01-18,377,182,195,0.517241379310345
NORTE-PACIFICO,2023-01-19,430,178,252,0.586046511627907
NORTE-PACIFICO,2023-01-20,412,165,247,0.599514563106796
NORTE-PACIFICO,2023-01-21,479,147,332,0.693110647181628
NORTE-PACIFICO,2023-01-22,370,99,271,0.732432432432432
NORTE-PACIFICO,2023-01-23,401,114,287,0.71571072319202
NORTE-PACIFICO,2023-01-24,436,129,307,0.704128440366973
NORTE-PACIFICO,2023-01-25,416,122,294,0.706730769230769
NORTE-PACIFICO,2023-01-26,413,97,316,0.765133171912833
NORTE-PACIFICO,2023-01-27,455,118,337,0.740659340659341
NORTE-PACIFICO,2023-01-28,478,111,367,0.767782426778243
NORTE-PACIFICO,2023-01-29,368,108,260,0.706521739130435
NORTE-PACIFICO,2023-01-30,400,102,298,0.745
NORTE-PACIFICO,2023-01-31,460,146,314,0.682608695652174
NORTE-PACIFICO,2023-02-01,402,126,276,0.686567164179104
NORTE-PACIFICO,2023-02-02,432,127,305,0.706018518518518
NORTE-PACIFICO,2023-02-03,425,124,301,0.708235294117647
NORTE-PACIFICO,2023-02-04,511,141,370,0.724070450097847
NORTE-PACIFICO,2023-02-05,354,86,268,0.757062146892655
NORTE-PACIFICO,2023-02-06,439,115,324,0.738041002277904
NORTE-PACIFICO,2023-02-07,437,133,304,0.695652173913043
NORTE-PACIFICO,2023-02-08,436,138,298,0.68348623853211
NORTE-PACIFICO,2023-02-09,424,121,303,0.714622641509434
NORTE-PACIFICO,2023-02-10,544,141,403,0.740808823529412
NORTE-PACIFICO,2023-02-11,526,133,393,0.747148288973384
NORTE-PACIFICO,2023-02-12,331,77,254,0.767371601208459
NORTE-PACIFICO,2023-02-13,384,101,283,0.736979166666667
NORTE-PACIFICO,2023-02-14,384,103,281,0.731770833333333
NORTE-PACIFICO,2023-02-15,457,135,322,0.704595185995624
NORTE-PACIFICO,2023-02-16,417,124,293,0.702637889688249
NORTE-PACIFICO,2023-02-17,467,111,356,0.762312633832976
NORTE-PACIFICO,2023-02-18,548,145,403,0.735401459854015
NORTE-PACIFICO,2023-02-19,302,64,238,0.788079470198676
NORTE-PACIFICO,2023-02-20,454,109,345,0.759911894273128
NORTE-PACIFICO,2023-02-21,463,129,334,0.721382289416847
NORTE-PACIFICO,2023-02-22,419,120,299,0.713603818615752
NORTE-PACIFICO,2023-02-23,382,127,255,0.667539267015707
NORTE-PACIFICO,2023-02-24,442,152,290,0.656108597285068
NORTE-PACIFICO,2023-02-25,424,131,293,0.691037735849057
NORTE-PACIFICO,2023-02-26,322,96,226,0.701863354037267
NORTE-PACIFICO,2023-02-27,438,136,302,0.689497716894977
NORTE-PACIFICO,2023-02-28,434,148,286,0.658986175115207
NORTE-PACIFICO,2023-03-01,328,116,212,0.646341463414634
NORTE-PACIFICO,2023-03-02,445,135,310,0.696629213483146
NORTE-PACIFICO,2023-03-03,507,163,344,0.678500986193294
NORTE-PACIFICO,2023-03-04,636,184,452,0.710691823899371
NORTE-PACIFICO,2023-03-05,449,123,326,0.726057906458797
NORTE-PACIFICO,2023-03-06,407,135,272,0.668304668304668
NORTE-PACIFICO,2023-03-07,434,152,282,0.649769585253456
NORTE-PACIFICO,2023-03-08,508,153,355,0.698818897637795
NORTE-PACIFICO,2023-03-09,466,211,255,0.547210300429185
NORTE-PACIFICO,2023-03-10,374,196,178,0.475935828877005
NORTE-PACIFICO,2023-03-11,572,280,292,0.510489510489511
NORTE-PACIFICO,2023-03-12,402,192,210,0.522388059701492
NORTE-PACIFICO,2023-03-13,397,217,180,0.453400503778338
NORTE-PACIFICO,2023-03-14,409,254,155,0.378973105134474
NORTE-PACIFICO,2023-03-15,371,309,62,0.16711590296496
NORTE-PACIFICO,2023-03-16,397,336,61,0.153652392947103
NORTE-PACIFICO,2023-03-17,514,432,82,0.159533073929961
NORTE-PACIFICO,2023-03-18,564,473,91,0.161347517730496
NORTE-PACIFICO,2023-03-19,404,340,64,0.158415841584158
NORTE-PACIFICO,2023-03-20,450,373,77,0.171111111111111
NORTE-PACIFICO,2023-03-21,365,316,49,0.134246575342466
NORTE-PACIFICO,2023-03-22,406,352,54,0.133004926108374
NORTE-PACIFICO,2023-03-23,426,368,58,0.136150234741784
NORTE-PACIFICO,2023-03-24,487,428,59,0.121149897330595
NORTE-PACIFICO,2023-03-25,572,507,65,0.113636363636364
NORTE-PACIFICO,2023-03-26,459,404,55,0.119825708061002
NORTE-PACIFICO,2023-03-27,354,320,34,0.096045197740113
NORTE-PACIFICO,2023-03-28,395,356,39,0.0987341772151899
NORTE-PACIFICO,2023-03-29,428,390,38,0.088785046728972
NORTE-PACIFICO,2023-03-30,488,444,44,0.0901639344262295
NORTE-PACIFICO,2023-03-31,559,506,53,0.0948121645796064
NORTE-PACIFICO,2023-04-01,574,522,52,0.0905923344947735
NORTE-PACIFICO,2023-04-02,360,329,31,0.0861111111111111
NORTE-PACIFICO,2023-04-03,480,442,38,0.0791666666666667
NORTE-PACIFICO,2023-04-04,496,467,29,0.0584677419354839
NORTE-PACIFICO,2023-04-05,451,416,35,0.0776053215077605
NORTE-PACIFICO,2023-04-06,444,414,30,0.0675675675675676
NORTE-PACIFICO,2023-04-07,388,367,21,0.0541237113402062
NORTE-PACIFICO,2023-04-08,381,362,19,0.0498687664041995
NORTE-PACIFICO,2023-04-09,259,242,17,0.0656370656370656
NORTE-PACIFICO,2023-04-10,400,372,28,0.07
NORTE-PACIFICO,2023-04-11,450,418,32,0.0711111111111111
NORTE-PACIFICO,2023-04-12,446,422,24,0.0538116591928251
NORTE-PACIFICO,2023-04-13,445,426,19,0.0426966292134831
NORTE-PACIFICO,2023-04-14,491,454,37,0.0753564154786151
NORTE-PACIFICO,2023-04-15,678,645,33,0.0486725663716814
NORTE-PACIFICO,2023-04-16,550,524,26,0.0472727272727273
NORTE-PACIFICO,2023-04-17,474,453,21,0.0443037974683544
NORTE-PACIFICO,2023-04-18,457,442,15,0.0328227571115974
NORTE-PACIFICO,2023-04-19,429,410,19,0.0442890442890443
NORTE-PACIFICO,2023-04-20,424,403,21,0.0495283018867925
NORTE-PACIFICO,2023-04-21,456,424,32,0.0701754385964912
NORTE-PACIFICO,2023-04-22,543,516,27,0.0497237569060773
NORTE-PACIFICO,2023-04-23,385,364,21,0.0545454545454545
NORTE-PACIFICO,2023-04-24,436,422,14,0.0321100917431193
OCCIDENTE-BAJIO,2023-01-02,421,263,158,0.375296912114014
OCCIDENTE-BAJIO,2023-01-03,568,366,202,0.355633802816901
OCCIDENTE-BAJIO,2023-01-04,538,337,201,0.37360594795539
OCCIDENTE-BAJIO,2023-01-05,513,325,188,0.366471734892788
OCCIDENTE-BAJIO,2023-01-06,551,362,189,0.343012704174229
OCCIDENTE-BAJIO,2023-01-07,631,412,219,0.347068145800317
OCCIDENTE-BAJIO,2023-01-08,350,239,111,0.317142857142857
OCCIDENTE-BAJIO,2023-01-09,545,354,191,0.35045871559633
OCCIDENTE-BAJIO,2023-01-10,598,398,200,0.334448160535117
OCCIDENTE-BAJIO,2023-01-11,606,396,210,0.346534653465347
OCCIDENTE-BAJIO,2023-01-12,544,366,178,0.327205882352941
OCCIDENTE-BAJIO,2023-01-13,565,357,208,0.368141592920354
OCCIDENTE-BAJIO,2023-01-14,652,449,203,0.311349693251534
OCCIDENTE-BAJIO,2023-01-15,422,296,126,0.298578199052133
OCCIDENTE-BAJIO,2023-01-16,546,364,182,0.333333333333333
OCCIDENTE-BAJIO,2023-01-17,593,408,185,0.311973018549747
OCCIDENTE-BAJIO,2023-01-18,498,343,155,0.311244979919679
OCCIDENTE-BAJIO,2023-01-19,524,360,164,0.312977099236641
OCCIDENTE-BAJIO,2023-01-20,529,328,201,0.379962192816635
OCCIDENTE-BAJIO,2023-01-21,596,251,345,0.578859060402685
OCCIDENTE-BAJIO,2023-01-22,384,174,210,0.546875
OCCIDENTE-BAJIO,2023-01-23,499,222,277,0.555110220440882
OCCIDENTE-BAJIO,2023-01-24,556,232,324,0.58273381294964
OCCIDENTE-BAJIO,2023-01-25,544,255,289,0.53125
OCCIDENTE-BAJIO,2023-01-26,562,236,326,0.580071174377224
OCCIDENTE-BAJIO,2023-01-27,574,269,305,0.531358885017422
OCCIDENTE-BAJIO,2023-01-28,663,312,351,0.529411764705882
OCCIDENTE-BAJIO,2023-01-29,396,181,215,0.542929292929293
OCCIDENTE-BAJIO,2023-01-30,592,256,336,0.567567567567568
OCCIDENTE-BAJIO,2023-01-31,668,318,350,0.523952095808383
OCCIDENTE-BAJIO,2023-02-01,536,249,287,0.53544776119403
OCCIDENTE-BAJIO,2023-02-02,591,225,366,0.619289340101523
OCCIDENTE-BAJIO,2023-02-03,583,272,311,0.533447684391081
OCCIDENTE-BAJIO,2023-02-04,637,285,352,0.552590266875981
OCCIDENTE-BAJIO,2023-02-05,376,174,202,0.537234042553192
OCCIDENTE-BAJIO,2023-02-06,546,251,295,0.54029304029304
OCCIDENTE-BAJIO,2023-02-07,615,279,336,0.546341463414634
OCCIDENTE-BAJIO,2023-02-08,537,232,305,0.567970204841713
OCCIDENTE-BAJIO,2023-02-09,524,254,270,0.515267175572519
OCCIDENTE-BAJIO,2023-02-10,542,263,279,0.514760147601476
OCCIDENTE-BAJIO,2023-02-11,609,297,312,0.512315270935961
OCCIDENTE-BAJIO,2023-02-12,347,158,189,0.544668587896254
OCCIDENTE-BAJIO,2023-02-13,467,214,253,0.541755888650964
OCCIDENTE-BAJIO,2023-02-14,484,205,279,0.576446280991736
OCCIDENTE-BAJIO,2023-02-15,494,235,259,0.524291497975709
OCCIDENTE-BAJIO,2023-02-16,565,230,335,0.592920353982301
OCCIDENTE-BAJIO,2023-02-17,528,192,336,0.636363636363636
OCCIDENTE-BAJIO,2023-02-18,674,313,361,0.535608308605341
OCCIDENTE-BAJIO,2023-02-19,366,165,201,0.549180327868853
OCCIDENTE-BAJIO,2023-02-20,478,221,257,0.53765690376569
OCCIDENTE-BAJIO,2023-02-21,574,283,291,0.506968641114983
OCCIDENTE-BAJIO,2023-02-22,519,298,221,0.425818882466281
OCCIDENTE-BAJIO,2023-02-23,472,290,182,0.385593220338983
OCCIDENTE-BAJIO,2023-02-24,498,328,170,0.34136546184739
OCCIDENTE-BAJIO,2023-02-25,651,443,208,0.319508448540707
OCCIDENTE-BAJIO,2023-02-26,320,190,130,0.40625
OCCIDENTE-BAJIO,2023-02-27,489,333,156,0.319018404907975
OCCIDENTE-BAJIO,2023-02-28,585,402,183,0.312820512820513
OCCIDENTE-BAJIO,2023-03-01,523,345,178,0.340344168260038
OCCIDENTE-BAJIO,2023-03-02,552,358,194,0.351449275362319
OCCIDENTE-BAJIO,2023-03-03,538,359,179,0.33271375464684
OCCIDENTE-BAJIO,2023-03-04,617,406,211,0.341977309562399
OCCIDENTE-BAJIO,2023-03-05,325,214,111,0.341538461538462
OCCIDENTE-BAJIO,2023-03-06,436,293,143,0.327981651376147
OCCIDENTE-BAJIO,2023-03-07,536,376,160,0.298507462686567
OCCIDENTE-BAJIO,2023-03-08,526,393,133,0.252851711026616
OCCIDENTE-BAJIO,2023-03-09,478,422,56,0.117154811715481
OCCIDENTE-BAJIO,2023-03-10,465,403,62,0.133333333333333
OCCIDENTE-BAJIO,2023-03-11,586,492,94,0.160409556313993
OCCIDENTE-BAJIO,2023-03-12,377,328,49,0.129973474801061
OCCIDENTE-BAJIO,2023-03-13,441,383,58,0.131519274376417
OCCIDENTE-BAJIO,2023-03-14,520,447,73,0.140384615384615
OCCIDENTE-BAJIO,2023-03-15,537,483,54,0.100558659217877
OCCIDENTE-BAJIO,2023-03-16,578,534,44,0.0761245674740484
OCCIDENTE-BAJIO,2023-03-17,681,606,75,0.110132158590308
OCCIDENTE-BAJIO,2023-03-18,829,727,102,0.123039806996381
OCCIDENTE-BAJIO,2023-03-19,506,462,44,0.0869565217391304
OCCIDENTE-BAJIO,2023-03-20,652,588,64,0.098159509202454
OCCIDENTE-BAJIO,2023-03-21,611,565,46,0.0752864157119476
OCCIDENTE-BAJIO,2023-03-22,561,526,35,0.0623885918003565
OCCIDENTE-BAJIO,2023-03-23,519,490,29,0.0558766859344894
OCCIDENTE-BAJIO,2023-03-24,550,515,35,0.0636363636363636
OCCIDENTE-BAJIO,2023-03-25,687,648,39,0.0567685589519651
OCCIDENTE-BAJIO,2023-03-26,451,424,27,0.0598669623059867
OCCIDENTE-BAJIO,2023-03-27,456,431,25,0.0548245614035088
OCCIDENTE-BAJIO,2023-03-28,467,446,21,0.0449678800856531
OCCIDENTE-BAJIO,2023-03-29,551,516,35,0.0635208711433757
OCCIDENTE-BAJIO,2023-03-30,599,554,45,0.0751252086811352
OCCIDENTE-BAJIO,2023-03-31,838,781,57,0.0680190930787589
OCCIDENTE-BAJIO,2023-04-01,680,648,32,0.0470588235294118
OCCIDENTE-BAJIO,2023-04-02,340,325,15,0.0441176470588235
OCCIDENTE-BAJIO,2023-04-03,553,536,17,0.0307414104882459
OCCIDENTE-BAJIO,2023-04-04,632,592,40,0.0632911392405063
OCCIDENTE-BAJIO,2023-04-05,519,472,47,0.0905587668593449
OCCIDENTE-BAJIO,2023-04-06,520,488,32,0.0615384615384615
OCCIDENTE-BAJIO,2023-04-07,396,371,25,0.0631313131313131
OCCIDENTE-BAJIO,2023-04-08,306,293,13,0.042483660130719
OCCIDENTE-BAJIO,2023-04-09,224,216,8,0.0357142857142857
OCCIDENTE-BAJIO,2023-04-10,443,415,28,0.0632054176072235
OCCIDENTE-BAJIO,2023-04-11,513,468,45,0.087719298245614
OCCIDENTE-BAJIO,2023-04-12,507,461,46,0.0907297830374754
OCCIDENTE-BAJIO,2023-04-13,448,412,36,0.0803571428571429
OCCIDENTE-BAJIO,2023-04-14,547,510,37,0.0676416819012797
OCCIDENTE-BAJIO,2023-04-15,764,703,61,0.0798429319371728
OCCIDENTE-BAJIO,2023-04-16,445,421,24,0.0539325842696629
OCCIDENTE-BAJIO,2023-04-17,504,475,29,0.0575396825396825
OCCIDENTE-BAJIO,2023-04-18,551,482,69,0.125226860254083
OCCIDENTE-BAJIO,2023-04-19,517,464,53,0.102514506769826
OCCIDENTE-BAJIO,2023-04-20,502,469,33,0.0657370517928287
OCCIDENTE-BAJIO,2023-04-21,495,450,45,0.0909090909090909
OCCIDENTE-BAJIO,2023-04-22,609,561,48,0.0788177339901478
OCCIDENTE-BAJIO,2023-04-23,379,348,31,0.0817941952506596
OCCIDENTE-BAJIO,2023-04-24,547,508,39,0.0712979890310786
ORIENTE-SUR,2023-01-02,274,197,77,0.281021897810219
ORIENTE-SUR,2023-01-03,406,253,153,0.376847290640394
ORIENTE-SUR,2023-01-04,467,293,174,0.372591006423983
ORIENTE-SUR,2023-01-05,462,302,160,0.346320346320346
ORIENTE-SUR,2023-01-06,439,299,140,0.318906605922551
ORIENTE-SUR,2023-01-07,429,311,118,0.275058275058275
ORIENTE-SUR,2023-01-08,339,223,116,0.342182890855457
ORIENTE-SUR,2023-01-09,409,281,128,0.312958435207824
ORIENTE-SUR,2023-01-10,471,292,179,0.380042462845011
ORIENTE-SUR,2023-01-11,476,308,168,0.352941176470588
ORIENTE-SUR,2023-01-12,421,269,152,0.36104513064133
ORIENTE-SUR,2023-01-13,373,247,126,0.337801608579088
ORIENTE-SUR,2023-01-14,466,303,163,0.349785407725322
ORIENTE-SUR,2023-01-15,388,251,137,0.353092783505155
ORIENTE-SUR,2023-01-16,427,192,235,0.550351288056206
ORIENTE-SUR,2023-01-17,437,209,228,0.521739130434783
ORIENTE-SUR,2023-01-18,402,210,192,0.477611940298507
ORIENTE-SUR,2023-01-19,399,239,160,0.401002506265664
ORIENTE-SUR,2023-01-20,412,226,186,0.451456310679612
ORIENTE-SUR,2023-01-21,448,243,205,0.457589285714286
ORIENTE-SUR,2023-01-22,368,207,161,0.4375
ORIENTE-SUR,2023-01-23,422,221,201,0.476303317535545
ORIENTE-SUR,2023-01-24,394,197,197,0.5
ORIENTE-SUR,2023-01-25,440,237,203,0.461363636363636
ORIENTE-SUR,2023-01-26,386,189,197,0.510362694300518
ORIENTE-SUR,2023-01-27,381,196,185,0.485564304461942
ORIENTE-SUR,2023-01-28,424,218,206,0.485849056603774
ORIENTE-SUR,2023-01-29,369,174,195,0.528455284552846
ORIENTE-SUR,2023-01-30,383,189,194,0.506527415143603
ORIENTE-SUR,2023-01-31,479,246,233,0.48643006263048
ORIENTE-SUR,2023-02-01,466,230,236,0.506437768240343
ORIENTE-SUR,2023-02-02,461,242,219,0.475054229934924
ORIENTE-SUR,2023-02-03,449,214,235,0.523385300668151
ORIENTE-SUR,2023-02-04,522,255,267,0.511494252873563
ORIENTE-SUR,2023-02-05,379,180,199,0.525065963060686
ORIENTE-SUR,2023-02-06,437,203,234,0.535469107551487
ORIENTE-SUR,2023-02-07,395,202,193,0.488607594936709
ORIENTE-SUR,2023-02-08,437,235,202,0.462242562929062
ORIENTE-SUR,2023-02-09,402,210,192,0.477611940298507
ORIENTE-SUR,2023-02-10,408,205,203,0.497549019607843
ORIENTE-SUR,2023-02-11,462,239,223,0.482683982683983
ORIENTE-SUR,2023-02-12,341,165,176,0.516129032258065
ORIENTE-SUR,2023-02-13,364,178,186,0.510989010989011
ORIENTE-SUR,2023-02-14,400,178,222,0.555
ORIENTE-SUR,2023-02-15,432,205,227,0.525462962962963
ORIENTE-SUR,2023-02-16,443,212,231,0.521444695259594
ORIENTE-SUR,2023-02-17,378,182,196,0.518518518518518
ORIENTE-SUR,2023-02-18,451,243,208,0.46119733924612
ORIENTE-SUR,2023-02-19,357,163,194,0.543417366946779
ORIENTE-SUR,2023-02-20,388,211,177,0.456185567010309
ORIENTE-SUR,2023-02-21,427,239,188,0.440281030444965
ORIENTE-SUR,2023-02-22,383,203,180,0.469973890339426
ORIENTE-SUR,2023-02-23,403,233,170,0.421836228287841
ORIENTE-SUR,2023-02-24,450,276,174,0.386666666666667
ORIENTE-SUR,2023-02-25,465,283,182,0.391397849462366
ORIENTE-SUR,2023-02-26,361,214,147,0.407202216066482
ORIENTE-SUR,2023-02-27,462,260,202,0.437229437229437
ORIENTE-SUR,2023-02-28,457,263,194,0.424507658643326
ORIENTE-SUR,2023-03-01,424,225,199,0.469339622641509
ORIENTE-SUR,2023-03-02,379,217,162,0.427440633245383
ORIENTE-SUR,2023-03-03,404,261,143,0.353960396039604
ORIENTE-SUR,2023-03-04,463,251,212,0.457883369330454
ORIENTE-SUR,2023-03-05,322,181,141,0.437888198757764
ORIENTE-SUR,2023-03-06,404,253,151,0.373762376237624
ORIENTE-SUR,2023-03-07,432,284,148,0.342592592592593
ORIENTE-SUR,2023-03-08,438,320,118,0.269406392694064
ORIENTE-SUR,2023-03-09,401,320,81,0.201995012468828
ORIENTE-SUR,2023-03-10,392,339,53,0.135204081632653
ORIENTE-SUR,2023-03-11,452,379,73,0.161504424778761
ORIENTE-SUR,2023-03-12,354,292,62,0.175141242937853
ORIENTE-SUR,2023-03-13,404,339,65,0.160891089108911
ORIENTE-SUR,2023-03-14,413,361,52,0.12590799031477
ORIENTE-SUR,2023-03-15,451,398,53,0.117516629711752
ORIENTE-SUR,2023-03-16,518,479,39,0.0752895752895753
ORIENTE-SUR,2023-03-17,568,496,72,0.126760563380282
ORIENTE-SUR,2023-03-18,648,587,61,0.0941358024691358
ORIENTE-SUR,2023-03-19,440,393,47,0.106818181818182
ORIENTE-SUR,2023-03-20,558,504,54,0.0967741935483871
ORIENTE-SUR,2023-03-21,533,502,31,0.0581613508442777
ORIENTE-SUR,2023-03-22,457,430,27,0.0590809628008753
ORIENTE-SUR,2023-03-23,470,449,21,0.0446808510638298
ORIENTE-SUR,2023-03-24,498,473,25,0.0502008032128514
ORIENTE-SUR,2023-03-25,513,491,22,0.0428849902534113
ORIENTE-SUR,2023-03-26,416,393,23,0.0552884615384615
ORIENTE-SUR,2023-03-27,365,349,16,0.0438356164383562
ORIENTE-SUR,2023-03-28,389,370,19,0.0488431876606684
ORIENTE-SUR,2023-03-29,440,428,12,0.0272727272727273
ORIENTE-SUR,2023-03-30,505,484,21,0.0415841584158416
ORIENTE-SUR,2023-03-31,673,632,41,0.0609212481426449
ORIENTE-SUR,2023-04-01,538,512,26,0.0483271375464684
ORIENTE-SUR,2023-04-02,347,332,15,0.0432276657060519
ORIENTE-SUR,2023-04-03,492,478,14,0.0284552845528455
ORIENTE-SUR,2023-04-04,462,443,19,0.0411255411255411
ORIENTE-SUR,2023-04-05,386,340,46,0.119170984455959
ORIENTE-SUR,2023-04-06,432,415,17,0.0393518518518519
ORIENTE-SUR,2023-04-07,365,351,14,0.0383561643835616
ORIENTE-SUR,2023-04-08,333,319,14,0.042042042042042
ORIENTE-SUR,2023-04-09,226,219,7,0.0309734513274336
ORIENTE-SUR,2023-04-10,365,343,22,0.0602739726027397
ORIENTE-SUR,2023-04-11,405,377,28,0.0691358024691358
ORIENTE-SUR,2023-04-12,411,375,36,0.0875912408759124
ORIENTE-SUR,2023-04-13,379,364,15,0.0395778364116095
ORIENTE-SUR,2023-04-14,464,438,26,0.0560344827586207
ORIENTE-SUR,2023-04-15,640,597,43,0.0671875
ORIENTE-SUR,2023-04-16,533,517,16,0.0300187617260788
ORIENTE-SUR,2023-04-17,473,454,19,0.040169133192389
ORIENTE-SUR,2023-04-18,403,381,22,0.054590570719603
ORIENTE-SUR,2023-04-19,417,396,21,0.0503597122302158
ORIENTE-SUR,2023-04-20,437,409,28,0.0640732265446224
ORIENTE-SUR,2023-04-21,432,414,18,0.0416666666666667
ORIENTE-SUR,2023-04-22,506,479,27,0.0533596837944664
ORIENTE-SUR,2023-04-23,399,374,25,0.06265664160401
ORIENTE-SUR,2023-04-24,483,467,16,0.0331262939958592