DISTRITO,Fecha,Instalaciones,Activaciones_automaticas,Ativaciones_manuales,%ActM
AEROPUERTO,2023-01-02,14,8,6,0.428571428571429
AEROPUERTO,2023-01-03,21,6,15,0.714285714285714
AEROPUERTO,2023-01-04,24,12,12,0.5
AEROPUERTO,2023-01-05,32,17,15,0.46875
AEROPUERTO,2023-01-06,24,13,11,0.458333333333333
AEROPUERTO,2023-01-07,32,15,17,0.53125
AEROPUERTO,2023-01-08,24,10,14,0.583333333333333
AEROPUERTO,2023-01-09,22,12,10,0.454545454545455
AEROPUERTO,2023-01-10,20,8,12,0.6
AEROPUERTO,2023-01-11,24,10,14,0.583333333333333
AEROPUERTO,2023-01-12,19,10,9,0.473684210526316
AEROPUERTO,2023-01-13,37,26,11,0.297297297297297
AEROPUERTO,2023-01-14,30,23,7,0.233333333333333
AEROPUERTO,2023-01-15,29,16,13,0.448275862068966
AEROPUERTO,2023-01-16,29,20,9,0.310344827586207
AEROPUERTO,2023-01-17,22,17,5,0.227272727272727
AEROPUERTO,2023-01-18,39,25,14,0.358974358974359
AEROPUERTO,2023-01-19,25,14,11,0.44
AEROPUERTO,2023-01-20,20,16,4,0.2
AEROPUERTO,2023-01-21,33,8,25,0.757575757575758
AEROPUERTO,2023-01-22,25,9,16,0.64
AEROPUERTO,2023-01-23,29,10,19,0.655172413793103
AEROPUERTO,2023-01-24,32,12,20,0.625
AEROPUERTO,2023-01-25,20,8,12,0.6
AEROPUERTO,2023-01-26,24,8,16,0.666666666666667
AEROPUERTO,2023-01-27,24,7,17,0.708333333333333
AEROPUERTO,2023-01-28,34,11,23,0.676470588235294
AEROPUERTO,2023-01-29,25,13,12,0.48
AEROPUERTO,2023-01-30,37,18,19,0.513513513513513
AEROPUERTO,2023-01-31,36,19,17,0.472222222222222
AEROPUERTO,2023-02-01,25,12,13,0.52
AEROPUERTO,2023-02-02,25,12,13,0.52
AEROPUERTO,2023-02-03,37,14,23,0.621621621621622
AEROPUERTO,2023-02-04,27,10,17,0.62962962962963
AEROPUERTO,2023-02-05,25,14,11,0.44
AEROPUERTO,2023-02-06,28,11,17,0.607142857142857
AEROPUERTO,2023-02-07,24,14,10,0.416666666666667
AEROPUERTO,2023-02-08,31,17,14,0.451612903225806
AEROPUERTO,2023-02-09,24,9,15,0.625
AEROPUERTO,2023-02-10,26,5,21,0.807692307692308
AEROPUERTO,2023-02-11,23,6,17,0.739130434782609
AEROPUERTO,2023-02-12,22,8,14,0.636363636363636
AEROPUERTO,2023-02-13,19,18,1,0.0526315789473684
AEROPUERTO,2023-02-14,28,23,5,0.178571428571429
AEROPUERTO,2023-02-15,32,27,5,0.15625
AEROPUERTO,2023-02-16,39,29,10,0.256410256410256
AEROPUERTO,2023-02-17,28,26,2,0.0714285714285714
AEROPUERTO,2023-02-18,35,28,7,0.2
AEROPUERTO,2023-02-19,31,27,4,0.129032258064516
AEROPUERTO,2023-02-20,33,28,5,0.151515151515152
AEROPUERTO,2023-02-21,25,25,0,0
AEROPUERTO,2023-02-22,23,21,2,0.0869565217391304
AEROPUERTO,2023-02-23,20,17,3,0.15
AEROPUERTO,2023-02-24,31,30,1,0.032258064516129
AEROPUERTO,2023-02-25,36,34,2,0.0555555555555556
AEROPUERTO,2023-02-26,32,31,1,0.03125
AEROPUERTO,2023-02-27,31,31,0,0
AEROPUERTO,2023-02-28,35,34,1,0.0285714285714286
AEROPUERTO,2023-03-01,29,28,1,0.0344827586206897
AEROPUERTO,2023-03-02,22,22,0,0
AEROPUERTO,2023-03-03,26,26,0,0
AEROPUERTO,2023-03-04,38,34,4,0.105263157894737
AEROPUERTO,2023-03-05,38,31,7,0.184210526315789
AEROPUERTO,2023-03-06,24,23,1,0.0416666666666667
AEROPUERTO,2023-03-07,23,22,1,0.0434782608695652
AEROPUERTO,2023-03-08,37,37,0,0
AEROPUERTO,2023-03-09,26,25,1,0.0384615384615385
AEROPUERTO,2023-03-10,18,18,0,0
AEROPUERTO,2023-03-11,34,31,3,0.0882352941176471
AEROPUERTO,2023-03-12,21,21,0,0
AEROPUERTO,2023-03-13,27,25,2,0.0740740740740741
AEROPUERTO,2023-03-14,27,26,1,0.037037037037037
AEROPUERTO,2023-03-15,32,31,1,0.03125
AEROPUERTO,2023-03-16,29,29,0,0
AEROPUERTO,2023-03-17,52,52,0,0
AEROPUERTO,2023-03-18,53,53,0,0
AEROPUERTO,2023-03-19,40,40,0,0
AEROPUERTO,2023-03-20,44,44,0,0
AEROPUERTO,2023-03-21,33,33,0,0
AEROPUERTO,2023-03-22,26,26,0,0
AEROPUERTO,2023-03-23,37,37,0,0
AEROPUERTO,2023-03-24,36,35,1,0.0277777777777778
AEROPUERTO,2023-03-25,35,35,0,0
AEROPUERTO,2023-03-26,38,38,0,0
AEROPUERTO,2023-03-27,22,22,0,0
AEROPUERTO,2023-03-28,31,31,0,0
AEROPUERTO,2023-03-29,24,24,0,0
AEROPUERTO,2023-03-30,34,34,0,0
AEROPUERTO,2023-03-31,48,48,0,0
AEROPUERTO,2023-04-01,33,32,1,0.0303030303030303
AEROPUERTO,2023-04-02,39,38,1,0.0256410256410256
AEROPUERTO,2023-04-03,37,37,0,0
AEROPUERTO,2023-04-04,20,20,0,0
AEROPUERTO,2023-04-05,32,32,0,0
AEROPUERTO,2023-04-06,29,29,0,0
AEROPUERTO,2023-04-07,21,21,0,0
AEROPUERTO,2023-04-08,24,24,0,0
AEROPUERTO,2023-04-09,14,14,0,0
AEROPUERTO,2023-04-10,23,23,0,0
AEROPUERTO,2023-04-11,22,22,0,0
AEROPUERTO,2023-04-12,33,33,0,0
AEROPUERTO,2023-04-13,23,23,0,0
AEROPUERTO,2023-04-14,41,41,0,0
AEROPUERTO,2023-04-15,57,57,0,0
AEROPUERTO,2023-04-16,43,43,0,0
AEROPUERTO,2023-04-17,33,33,0,0
AEROPUERTO,2023-04-18,22,22,0,0
AEROPUERTO,2023-04-19,25,25,0,0
AEROPUERTO,2023-04-20,16,16,0,0
AEROPUERTO,2023-04-21,40,40,0,0
AEROPUERTO,2023-04-22,37,37,0,0
AEROPUERTO,2023-04-23,40,40,0,0
AEROPUERTO,2023-04-24,38,38,0,0
AEROPUERTO,2023-04-25,44,44,0,0
AEROPUERTO,2023-04-26,25,25,0,0
AEROPUERTO,2023-04-27,23,23,0,0
AEROPUERTO,2023-04-28,45,45,0,0
AEROPUERTO,2023-04-29,56,56,0,0
AEROPUERTO,2023-04-30,41,41,0,0
AEROPUERTO,2023-05-01,49,49,0,0
AEROPUERTO,2023-05-02,29,29,0,0
AEROPUERTO,2023-05-03,18,18,0,0
AEROPUERTO,2023-05-04,30,30,0,0
AEROPUERTO,2023-05-05,34,34,0,0
AEROPUERTO,2023-05-06,26,26,0,0
AEROPUERTO,2023-05-07,22,22,0,0
AEROPUERTO,2023-05-08,33,33,0,0
AGUASCALIENTES,2023-01-02,37,35,2,0.0540540540540541
AGUASCALIENTES,2023-01-03,46,45,1,0.0217391304347826
AGUASCALIENTES,2023-01-04,44,41,3,0.0681818181818182
AGUASCALIENTES,2023-01-05,34,33,1,0.0294117647058824
AGUASCALIENTES,2023-01-06,38,34,4,0.105263157894737
AGUASCALIENTES,2023-01-07,51,48,3,0.0588235294117647
AGUASCALIENTES,2023-01-08,23,22,1,0.0434782608695652
AGUASCALIENTES,2023-01-09,29,25,4,0.137931034482759
AGUASCALIENTES,2023-01-10,38,37,1,0.0263157894736842
AGUASCALIENTES,2023-01-11,52,49,3,0.0576923076923077
AGUASCALIENTES,2023-01-12,45,44,1,0.0222222222222222
AGUASCALIENTES,2023-01-13,38,36,2,0.0526315789473684
AGUASCALIENTES,2023-01-14,53,50,3,0.0566037735849057
AGUASCALIENTES,2023-01-15,22,20,2,0.0909090909090909
AGUASCALIENTES,2023-01-16,40,37,3,0.075
AGUASCALIENTES,2023-01-17,40,38,2,0.05
AGUASCALIENTES,2023-01-18,31,31,0,0
AGUASCALIENTES,2023-01-19,47,45,2,0.0425531914893617
AGUASCALIENTES,2023-01-20,36,35,1,0.0277777777777778
AGUASCALIENTES,2023-01-21,40,27,13,0.325
AGUASCALIENTES,2023-01-22,21,7,14,0.666666666666667
AGUASCALIENTES,2023-01-23,37,33,4,0.108108108108108
AGUASCALIENTES,2023-01-24,40,27,13,0.325
AGUASCALIENTES,2023-01-25,50,42,8,0.16
AGUASCALIENTES,2023-01-26,40,32,8,0.2
AGUASCALIENTES,2023-01-27,48,33,15,0.3125
AGUASCALIENTES,2023-01-28,65,47,18,0.276923076923077
AGUASCALIENTES,2023-01-29,21,13,8,0.380952380952381
AGUASCALIENTES,2023-01-30,43,29,14,0.325581395348837
AGUASCALIENTES,2023-01-31,66,37,29,0.439393939393939
AGUASCALIENTES,2023-02-01,35,21,14,0.4
AGUASCALIENTES,2023-02-02,40,20,20,0.5
AGUASCALIENTES,2023-02-03,50,28,22,0.44
AGUASCALIENTES,2023-02-04,50,25,25,0.5
AGUASCALIENTES,2023-02-05,24,17,7,0.291666666666667
AGUASCALIENTES,2023-02-06,41,18,23,0.560975609756098
AGUASCALIENTES,2023-02-07,49,28,21,0.428571428571429
AGUASCALIENTES,2023-02-08,43,23,20,0.465116279069767
AGUASCALIENTES,2023-02-09,44,26,18,0.409090909090909
AGUASCALIENTES,2023-02-10,45,21,24,0.533333333333333
AGUASCALIENTES,2023-02-11,52,34,18,0.346153846153846
AGUASCALIENTES,2023-02-12,21,13,8,0.380952380952381
AGUASCALIENTES,2023-02-13,43,22,21,0.488372093023256
AGUASCALIENTES,2023-02-14,42,29,13,0.30952380952381
AGUASCALIENTES,2023-02-15,43,32,11,0.255813953488372
AGUASCALIENTES,2023-02-16,39,27,12,0.307692307692308
AGUASCALIENTES,2023-02-17,42,29,13,0.30952380952381
AGUASCALIENTES,2023-02-18,56,44,12,0.214285714285714
AGUASCALIENTES,2023-02-19,21,15,6,0.285714285714286
AGUASCALIENTES,2023-02-20,35,26,9,0.257142857142857
AGUASCALIENTES,2023-02-21,43,38,5,0.116279069767442
AGUASCALIENTES,2023-02-22,43,40,3,0.0697674418604651
AGUASCALIENTES,2023-02-23,31,27,4,0.129032258064516
AGUASCALIENTES,2023-02-24,39,36,3,0.0769230769230769
AGUASCALIENTES,2023-02-25,47,38,9,0.191489361702128
AGUASCALIENTES,2023-02-26,20,14,6,0.3
AGUASCALIENTES,2023-02-27,41,35,6,0.146341463414634
AGUASCALIENTES,2023-02-28,41,34,7,0.170731707317073
AGUASCALIENTES,2023-03-01,37,32,5,0.135135135135135
AGUASCALIENTES,2023-03-02,43,38,5,0.116279069767442
AGUASCALIENTES,2023-03-03,41,34,7,0.170731707317073
AGUASCALIENTES,2023-03-04,54,47,7,0.12962962962963
AGUASCALIENTES,2023-03-05,16,11,5,0.3125
AGUASCALIENTES,2023-03-06,23,21,2,0.0869565217391304
AGUASCALIENTES,2023-03-07,25,23,2,0.08
AGUASCALIENTES,2023-03-08,43,37,6,0.13953488372093
AGUASCALIENTES,2023-03-09,36,35,1,0.0277777777777778
AGUASCALIENTES,2023-03-10,33,33,0,0
AGUASCALIENTES,2023-03-11,36,34,2,0.0555555555555556
AGUASCALIENTES,2023-03-12,9,8,1,0.111111111111111
AGUASCALIENTES,2023-03-13,26,26,0,0
AGUASCALIENTES,2023-03-14,43,43,0,0
AGUASCALIENTES,2023-03-15,45,43,2,0.0444444444444444
AGUASCALIENTES,2023-03-16,44,44,0,0
AGUASCALIENTES,2023-03-17,60,57,3,0.05
AGUASCALIENTES,2023-03-18,68,68,0,0
AGUASCALIENTES,2023-03-19,29,27,2,0.0689655172413793
AGUASCALIENTES,2023-03-20,35,33,2,0.0571428571428571
AGUASCALIENTES,2023-03-21,51,50,1,0.0196078431372549
AGUASCALIENTES,2023-03-22,41,41,0,0
AGUASCALIENTES,2023-03-23,40,40,0,0
AGUASCALIENTES,2023-03-24,47,47,0,0
AGUASCALIENTES,2023-03-25,48,44,4,0.0833333333333333
AGUASCALIENTES,2023-03-26,40,40,0,0
AGUASCALIENTES,2023-03-27,44,44,0,0
AGUASCALIENTES,2023-03-28,27,27,0,0
AGUASCALIENTES,2023-03-29,38,38,0,0
AGUASCALIENTES,2023-03-30,53,53,0,0
AGUASCALIENTES,2023-03-31,74,72,2,0.027027027027027
AGUASCALIENTES,2023-04-01,52,52,0,0
AGUASCALIENTES,2023-04-02,21,21,0,0
AGUASCALIENTES,2023-04-03,35,34,1,0.0285714285714286
AGUASCALIENTES,2023-04-04,44,44,0,0
AGUASCALIENTES,2023-04-05,32,32,0,0
AGUASCALIENTES,2023-04-06,38,38,0,0
AGUASCALIENTES,2023-04-07,19,19,0,0
AGUASCALIENTES,2023-04-08,18,17,1,0.0555555555555556
AGUASCALIENTES,2023-04-09,19,19,0,0
AGUASCALIENTES,2023-04-10,34,33,1,0.0294117647058824
AGUASCALIENTES,2023-04-11,29,28,1,0.0344827586206897
AGUASCALIENTES,2023-04-12,32,30,2,0.0625
AGUASCALIENTES,2023-04-13,31,26,5,0.161290322580645
AGUASCALIENTES,2023-04-14,45,45,0,0
AGUASCALIENTES,2023-04-15,63,58,5,0.0793650793650794
AGUASCALIENTES,2023-04-16,32,32,0,0
AGUASCALIENTES,2023-04-17,27,27,0,0
AGUASCALIENTES,2023-04-18,38,36,2,0.0526315789473684
AGUASCALIENTES,2023-04-19,26,23,3,0.115384615384615
AGUASCALIENTES,2023-04-20,41,41,0,0
AGUASCALIENTES,2023-04-21,43,43,0,0
AGUASCALIENTES,2023-04-22,40,39,1,0.025
AGUASCALIENTES,2023-04-23,18,17,1,0.0555555555555556
AGUASCALIENTES,2023-04-24,38,38,0,0
AGUASCALIENTES,2023-04-25,45,45,0,0
AGUASCALIENTES,2023-04-26,37,37,0,0
AGUASCALIENTES,2023-04-27,38,38,0,0
AGUASCALIENTES,2023-04-28,32,32,0,0
AGUASCALIENTES,2023-04-29,55,53,2,0.0363636363636364
AGUASCALIENTES,2023-04-30,25,24,1,0.04
AGUASCALIENTES,2023-05-01,26,26,0,0
AGUASCALIENTES,2023-05-02,41,40,1,0.024390243902439
AGUASCALIENTES,2023-05-03,32,30,2,0.0625
AGUASCALIENTES,2023-05-04,31,31,0,0
AGUASCALIENTES,2023-05-05,36,35,1,0.0277777777777778
AGUASCALIENTES,2023-05-06,38,37,1,0.0263157894736842
AGUASCALIENTES,2023-05-07,13,13,0,0
AGUASCALIENTES,2023-05-08,33,33,0,0
ARAGON,2023-01-02,26,24,2,0.0769230769230769
ARAGON,2023-01-03,32,30,2,0.0625
ARAGON,2023-01-04,30,30,0,0
ARAGON,2023-01-05,25,21,4,0.16
ARAGON,2023-01-06,25,24,1,0.04
ARAGON,2023-01-07,36,34,2,0.0555555555555556
ARAGON,2023-01-08,33,32,1,0.0303030303030303
ARAGON,2023-01-09,34,33,1,0.0294117647058824
ARAGON,2023-01-10,41,39,2,0.0487804878048781
ARAGON,2023-01-11,45,39,6,0.133333333333333
ARAGON,2023-01-12,46,40,6,0.130434782608696
ARAGON,2023-01-13,32,27,5,0.15625
ARAGON,2023-01-14,41,38,3,0.0731707317073171
ARAGON,2023-01-15,32,26,6,0.1875
ARAGON,2023-01-16,35,28,7,0.2
ARAGON,2023-01-17,38,36,2,0.0526315789473684
ARAGON,2023-01-18,33,29,4,0.121212121212121
ARAGON,2023-01-19,50,46,4,0.08
ARAGON,2023-01-20,45,41,4,0.0888888888888889
ARAGON,2023-01-21,35,32,3,0.0857142857142857
ARAGON,2023-01-22,40,37,3,0.075
ARAGON,2023-01-23,32,31,1,0.03125
ARAGON,2023-01-24,39,35,4,0.102564102564103
ARAGON,2023-01-25,51,43,8,0.156862745098039
ARAGON,2023-01-26,35,32,3,0.0857142857142857
ARAGON,2023-01-27,29,26,3,0.103448275862069
ARAGON,2023-01-28,40,33,7,0.175
ARAGON,2023-01-29,29,24,5,0.172413793103448
ARAGON,2023-01-30,51,44,7,0.137254901960784
ARAGON,2023-01-31,41,35,6,0.146341463414634
ARAGON,2023-02-01,46,41,5,0.108695652173913
ARAGON,2023-02-02,31,22,9,0.290322580645161
ARAGON,2023-02-03,40,36,4,0.1
ARAGON,2023-02-04,37,33,4,0.108108108108108
ARAGON,2023-02-05,35,29,6,0.171428571428571
ARAGON,2023-02-06,45,34,11,0.244444444444444
ARAGON,2023-02-07,30,26,4,0.133333333333333
ARAGON,2023-02-08,32,27,5,0.15625
ARAGON,2023-02-09,37,31,6,0.162162162162162
ARAGON,2023-02-10,27,26,1,0.037037037037037
ARAGON,2023-02-11,58,49,9,0.155172413793103
ARAGON,2023-02-12,37,34,3,0.0810810810810811
ARAGON,2023-02-13,24,22,2,0.0833333333333333
ARAGON,2023-02-14,25,22,3,0.12
ARAGON,2023-02-15,36,32,4,0.111111111111111
ARAGON,2023-02-16,38,35,3,0.0789473684210526
ARAGON,2023-02-17,35,32,3,0.0857142857142857
ARAGON,2023-02-18,41,36,5,0.121951219512195
ARAGON,2023-02-19,36,30,6,0.166666666666667
ARAGON,2023-02-20,32,31,1,0.03125
ARAGON,2023-02-21,41,41,0,0
ARAGON,2023-02-22,41,39,2,0.0487804878048781
ARAGON,2023-02-23,36,36,0,0
ARAGON,2023-02-24,30,28,2,0.0666666666666667
ARAGON,2023-02-25,54,53,1,0.0185185185185185
ARAGON,2023-02-26,36,35,1,0.0277777777777778
ARAGON,2023-02-27,25,23,2,0.08
ARAGON,2023-02-28,49,48,1,0.0204081632653061
ARAGON,2023-03-01,36,34,2,0.0555555555555556
ARAGON,2023-03-02,34,34,0,0
ARAGON,2023-03-03,31,30,1,0.032258064516129
ARAGON,2023-03-04,39,37,2,0.0512820512820513
ARAGON,2023-03-05,39,38,1,0.0256410256410256
ARAGON,2023-03-06,23,23,0,0
ARAGON,2023-03-07,42,41,1,0.0238095238095238
ARAGON,2023-03-08,43,42,1,0.0232558139534884
ARAGON,2023-03-09,42,42,0,0
ARAGON,2023-03-10,29,29,0,0
ARAGON,2023-03-11,35,35,0,0
ARAGON,2023-03-12,30,29,1,0.0333333333333333
ARAGON,2023-03-13,37,37,0,0
ARAGON,2023-03-14,38,38,0,0
ARAGON,2023-03-15,40,40,0,0
ARAGON,2023-03-16,41,40,1,0.024390243902439
ARAGON,2023-03-17,66,66,0,0
ARAGON,2023-03-18,58,58,0,0
ARAGON,2023-03-19,57,57,0,0
ARAGON,2023-03-20,63,63,0,0
ARAGON,2023-03-21,40,39,1,0.025
ARAGON,2023-03-22,39,39,0,0
ARAGON,2023-03-23,44,43,1,0.0227272727272727
ARAGON,2023-03-24,41,41,0,0
ARAGON,2023-03-25,47,47,0,0
ARAGON,2023-03-26,43,43,0,0
ARAGON,2023-03-27,29,29,0,0
ARAGON,2023-03-28,34,34,0,0
ARAGON,2023-03-29,33,33,0,0
ARAGON,2023-03-30,45,45,0,0
ARAGON,2023-03-31,55,55,0,0
ARAGON,2023-04-01,37,37,0,0
ARAGON,2023-04-02,41,41,0,0
ARAGON,2023-04-03,55,55,0,0
ARAGON,2023-04-04,23,23,0,0
ARAGON,2023-04-05,50,50,0,0
ARAGON,2023-04-06,37,37,0,0
ARAGON,2023-04-07,36,36,0,0
ARAGON,2023-04-08,22,22,0,0
ARAGON,2023-04-09,21,21,0,0
ARAGON,2023-04-10,29,29,0,0
ARAGON,2023-04-11,36,36,0,0
ARAGON,2023-04-12,38,38,0,0
ARAGON,2023-04-13,28,28,0,0
ARAGON,2023-04-14,52,52,0,0
ARAGON,2023-04-15,50,50,0,0
ARAGON,2023-04-16,61,61,0,0
ARAGON,2023-04-17,49,49,0,0
ARAGON,2023-04-18,39,39,0,0
ARAGON,2023-04-19,37,37,0,0
ARAGON,2023-04-20,40,40,0,0
ARAGON,2023-04-21,43,43,0,0
ARAGON,2023-04-22,49,49,0,0
ARAGON,2023-04-23,26,26,0,0
ARAGON,2023-04-24,50,50,0,0
ARAGON,2023-04-25,56,56,0,0
ARAGON,2023-04-26,48,48,0,0
ARAGON,2023-04-27,23,23,0,0
ARAGON,2023-04-28,41,41,0,0
ARAGON,2023-04-29,63,63,0,0
ARAGON,2023-04-30,55,55,0,0
ARAGON,2023-05-01,52,52,0,0
ARAGON,2023-05-02,40,40,0,0
ARAGON,2023-05-03,27,27,0,0
ARAGON,2023-05-04,32,32,0,0
ARAGON,2023-05-05,47,47,0,0
ARAGON,2023-05-06,38,38,0,0
ARAGON,2023-05-07,19,19,0,0
ARAGON,2023-05-08,43,43,0,0
AZCAPOTZALCO,2023-01-02,25,24,1,0.04
AZCAPOTZALCO,2023-01-03,40,32,8,0.2
AZCAPOTZALCO,2023-01-04,41,35,6,0.146341463414634
AZCAPOTZALCO,2023-01-05,35,32,3,0.0857142857142857
AZCAPOTZALCO,2023-01-06,38,37,1,0.0263157894736842
AZCAPOTZALCO,2023-01-07,32,28,4,0.125
AZCAPOTZALCO,2023-01-08,23,20,3,0.130434782608696
AZCAPOTZALCO,2023-01-09,25,21,4,0.16
AZCAPOTZALCO,2023-01-10,41,35,6,0.146341463414634
AZCAPOTZALCO,2023-01-11,35,29,6,0.171428571428571
AZCAPOTZALCO,2023-01-12,33,28,5,0.151515151515152
AZCAPOTZALCO,2023-01-13,36,31,5,0.138888888888889
AZCAPOTZALCO,2023-01-14,47,42,5,0.106382978723404
AZCAPOTZALCO,2023-01-15,32,27,5,0.15625
AZCAPOTZALCO,2023-01-16,30,13,17,0.566666666666667
AZCAPOTZALCO,2023-01-17,27,10,17,0.62962962962963
AZCAPOTZALCO,2023-01-18,33,19,14,0.424242424242424
AZCAPOTZALCO,2023-01-19,34,21,13,0.382352941176471
AZCAPOTZALCO,2023-01-20,28,21,7,0.25
AZCAPOTZALCO,2023-01-21,36,21,15,0.416666666666667
AZCAPOTZALCO,2023-01-22,27,21,6,0.222222222222222
AZCAPOTZALCO,2023-01-23,28,18,10,0.357142857142857
AZCAPOTZALCO,2023-01-24,34,25,9,0.264705882352941
AZCAPOTZALCO,2023-01-25,30,23,7,0.233333333333333
AZCAPOTZALCO,2023-01-26,37,27,10,0.27027027027027
AZCAPOTZALCO,2023-01-27,29,23,6,0.206896551724138
AZCAPOTZALCO,2023-01-28,45,31,14,0.311111111111111
AZCAPOTZALCO,2023-01-29,36,26,10,0.277777777777778
AZCAPOTZALCO,2023-01-30,38,25,13,0.342105263157895
AZCAPOTZALCO,2023-01-31,54,46,8,0.148148148148148
AZCAPOTZALCO,2023-02-01,38,27,11,0.289473684210526
AZCAPOTZALCO,2023-02-02,34,25,9,0.264705882352941
AZCAPOTZALCO,2023-02-03,25,18,7,0.28
AZCAPOTZALCO,2023-02-04,54,45,9,0.166666666666667
AZCAPOTZALCO,2023-02-05,31,22,9,0.290322580645161
AZCAPOTZALCO,2023-02-06,29,24,5,0.172413793103448
AZCAPOTZALCO,2023-02-07,40,31,9,0.225
AZCAPOTZALCO,2023-02-08,34,24,10,0.294117647058824
AZCAPOTZALCO,2023-02-09,36,31,5,0.138888888888889
AZCAPOTZALCO,2023-02-10,39,32,7,0.179487179487179
AZCAPOTZALCO,2023-02-11,31,25,6,0.193548387096774
AZCAPOTZALCO,2023-02-12,29,26,3,0.103448275862069
AZCAPOTZALCO,2023-02-13,38,32,6,0.157894736842105
AZCAPOTZALCO,2023-02-14,39,34,5,0.128205128205128
AZCAPOTZALCO,2023-02-15,31,29,2,0.0645161290322581
AZCAPOTZALCO,2023-02-16,32,30,2,0.0625
AZCAPOTZALCO,2023-02-17,34,26,8,0.235294117647059
AZCAPOTZALCO,2023-02-18,49,38,11,0.224489795918367
AZCAPOTZALCO,2023-02-19,24,19,5,0.208333333333333
AZCAPOTZALCO,2023-02-20,34,28,6,0.176470588235294
AZCAPOTZALCO,2023-02-21,35,29,6,0.171428571428571
AZCAPOTZALCO,2023-02-22,33,27,6,0.181818181818182
AZCAPOTZALCO,2023-02-23,30,24,6,0.2
AZCAPOTZALCO,2023-02-24,30,29,1,0.0333333333333333
AZCAPOTZALCO,2023-02-25,34,25,9,0.264705882352941
AZCAPOTZALCO,2023-02-26,31,29,2,0.0645161290322581
AZCAPOTZALCO,2023-02-27,43,35,8,0.186046511627907
AZCAPOTZALCO,2023-02-28,43,37,6,0.13953488372093
AZCAPOTZALCO,2023-03-01,37,29,8,0.216216216216216
AZCAPOTZALCO,2023-03-02,29,23,6,0.206896551724138
AZCAPOTZALCO,2023-03-03,38,31,7,0.184210526315789
AZCAPOTZALCO,2023-03-04,49,39,10,0.204081632653061
AZCAPOTZALCO,2023-03-05,24,20,4,0.166666666666667
AZCAPOTZALCO,2023-03-06,30,24,6,0.2
AZCAPOTZALCO,2023-03-07,33,29,4,0.121212121212121
AZCAPOTZALCO,2023-03-08,39,29,10,0.256410256410256
AZCAPOTZALCO,2023-03-09,30,28,2,0.0666666666666667
AZCAPOTZALCO,2023-03-10,33,30,3,0.0909090909090909
AZCAPOTZALCO,2023-03-11,51,44,7,0.137254901960784
AZCAPOTZALCO,2023-03-12,32,27,5,0.15625
AZCAPOTZALCO,2023-03-13,30,27,3,0.1
AZCAPOTZALCO,2023-03-14,37,32,5,0.135135135135135
AZCAPOTZALCO,2023-03-15,35,33,2,0.0571428571428571
AZCAPOTZALCO,2023-03-16,36,35,1,0.0277777777777778
AZCAPOTZALCO,2023-03-17,47,46,1,0.0212765957446809
AZCAPOTZALCO,2023-03-18,50,49,1,0.02
AZCAPOTZALCO,2023-03-19,36,33,3,0.0833333333333333
AZCAPOTZALCO,2023-03-20,51,50,1,0.0196078431372549
AZCAPOTZALCO,2023-03-21,33,32,1,0.0303030303030303
AZCAPOTZALCO,2023-03-22,34,33,1,0.0294117647058824
AZCAPOTZALCO,2023-03-23,34,34,0,0
AZCAPOTZALCO,2023-03-24,38,36,2,0.0526315789473684
AZCAPOTZALCO,2023-03-25,51,50,1,0.0196078431372549
AZCAPOTZALCO,2023-03-26,34,33,1,0.0294117647058824
AZCAPOTZALCO,2023-03-27,30,30,0,0
AZCAPOTZALCO,2023-03-28,23,22,1,0.0434782608695652
AZCAPOTZALCO,2023-03-29,30,30,0,0
AZCAPOTZALCO,2023-03-30,33,31,2,0.0606060606060606
AZCAPOTZALCO,2023-03-31,61,59,2,0.0327868852459016
AZCAPOTZALCO,2023-04-01,57,56,1,0.0175438596491228
AZCAPOTZALCO,2023-04-02,25,24,1,0.04
AZCAPOTZALCO,2023-04-03,40,40,0,0
AZCAPOTZALCO,2023-04-04,47,43,4,0.0851063829787234
AZCAPOTZALCO,2023-04-05,41,35,6,0.146341463414634
AZCAPOTZALCO,2023-04-06,26,26,0,0
AZCAPOTZALCO,2023-04-07,22,22,0,0
AZCAPOTZALCO,2023-04-08,17,17,0,0
AZCAPOTZALCO,2023-04-09,13,13,0,0
AZCAPOTZALCO,2023-04-10,31,31,0,0
AZCAPOTZALCO,2023-04-11,41,37,4,0.0975609756097561
AZCAPOTZALCO,2023-04-12,28,27,1,0.0357142857142857
AZCAPOTZALCO,2023-04-13,31,30,1,0.032258064516129
AZCAPOTZALCO,2023-04-14,32,28,4,0.125
AZCAPOTZALCO,2023-04-15,42,40,2,0.0476190476190476
AZCAPOTZALCO,2023-04-16,35,34,1,0.0285714285714286
AZCAPOTZALCO,2023-04-17,51,50,1,0.0196078431372549
AZCAPOTZALCO,2023-04-18,41,38,3,0.0731707317073171
AZCAPOTZALCO,2023-04-19,28,27,1,0.0357142857142857
AZCAPOTZALCO,2023-04-20,32,29,3,0.09375
AZCAPOTZALCO,2023-04-21,38,37,1,0.0263157894736842
AZCAPOTZALCO,2023-04-22,33,32,1,0.0303030303030303
AZCAPOTZALCO,2023-04-23,31,30,1,0.032258064516129
AZCAPOTZALCO,2023-04-24,38,36,2,0.0526315789473684
AZCAPOTZALCO,2023-04-25,39,36,3,0.0769230769230769
AZCAPOTZALCO,2023-04-26,41,37,4,0.0975609756097561
AZCAPOTZALCO,2023-04-27,36,34,2,0.0555555555555556
AZCAPOTZALCO,2023-04-28,55,50,5,0.0909090909090909
AZCAPOTZALCO,2023-04-29,71,65,6,0.0845070422535211
AZCAPOTZALCO,2023-04-30,45,43,2,0.0444444444444444
AZCAPOTZALCO,2023-05-01,26,23,3,0.115384615384615
AZCAPOTZALCO,2023-05-02,41,34,7,0.170731707317073
AZCAPOTZALCO,2023-05-03,65,62,3,0.0461538461538462
AZCAPOTZALCO,2023-05-04,24,23,1,0.0416666666666667
AZCAPOTZALCO,2023-05-05,47,42,5,0.106382978723404
AZCAPOTZALCO,2023-05-06,34,30,4,0.117647058823529
AZCAPOTZALCO,2023-05-07,31,30,1,0.032258064516129
AZCAPOTZALCO,2023-05-08,44,41,3,0.0681818181818182
CANCUN 1,2023-01-02,19,10,9,0.473684210526316
CANCUN 1,2023-01-03,23,11,12,0.521739130434783
CANCUN 1,2023-01-04,28,13,15,0.535714285714286
CANCUN 1,2023-01-05,28,13,15,0.535714285714286
CANCUN 1,2023-01-06,24,12,12,0.5
CANCUN 1,2023-01-07,32,13,19,0.59375
CANCUN 1,2023-01-08,26,11,15,0.576923076923077
CANCUN 1,2023-01-09,31,15,16,0.516129032258065
CANCUN 1,2023-01-10,31,5,26,0.838709677419355
CANCUN 1,2023-01-11,29,7,22,0.758620689655172
CANCUN 1,2023-01-12,25,13,12,0.48
CANCUN 1,2023-01-13,24,11,13,0.541666666666667
CANCUN 1,2023-01-14,32,14,18,0.5625
CANCUN 1,2023-01-15,36,18,18,0.5
CANCUN 1,2023-01-16,31,12,19,0.612903225806452
CANCUN 1,2023-01-17,25,3,22,0.88
CANCUN 1,2023-01-18,17,5,12,0.705882352941177
CANCUN 1,2023-01-19,24,14,10,0.416666666666667
CANCUN 1,2023-01-20,20,7,13,0.65
CANCUN 1,2023-01-21,26,14,12,0.461538461538462
CANCUN 1,2023-01-22,24,13,11,0.458333333333333
CANCUN 1,2023-01-23,29,7,22,0.758620689655172
CANCUN 1,2023-01-24,28,12,16,0.571428571428571
CANCUN 1,2023-01-25,33,10,23,0.696969696969697
CANCUN 1,2023-01-26,23,9,14,0.608695652173913
CANCUN 1,2023-01-27,12,2,10,0.833333333333333
CANCUN 1,2023-01-28,18,5,13,0.722222222222222
CANCUN 1,2023-01-29,19,3,16,0.842105263157895
CANCUN 1,2023-01-30,26,5,21,0.807692307692308
CANCUN 1,2023-01-31,22,8,14,0.636363636363636
CANCUN 1,2023-02-01,21,9,12,0.571428571428571
CANCUN 1,2023-02-02,32,9,23,0.71875
CANCUN 1,2023-02-03,27,7,20,0.740740740740741
CANCUN 1,2023-02-04,27,7,20,0.740740740740741
CANCUN 1,2023-02-05,31,8,23,0.741935483870968
CANCUN 1,2023-02-06,31,5,26,0.838709677419355
CANCUN 1,2023-02-07,18,5,13,0.722222222222222
CANCUN 1,2023-02-08,24,5,19,0.791666666666667
CANCUN 1,2023-02-09,20,5,15,0.75
CANCUN 1,2023-02-10,22,5,17,0.772727272727273
CANCUN 1,2023-02-11,28,5,23,0.821428571428571
CANCUN 1,2023-02-12,27,6,21,0.777777777777778
CANCUN 1,2023-02-13,20,3,17,0.85
CANCUN 1,2023-02-14,26,5,21,0.807692307692308
CANCUN 1,2023-02-15,26,8,18,0.692307692307692
CANCUN 1,2023-02-16,24,8,16,0.666666666666667
CANCUN 1,2023-02-17,27,9,18,0.666666666666667
CANCUN 1,2023-02-18,42,12,30,0.714285714285714
CANCUN 1,2023-02-19,38,9,29,0.763157894736842
CANCUN 1,2023-02-20,34,18,16,0.470588235294118
CANCUN 1,2023-02-21,30,22,8,0.266666666666667
CANCUN 1,2023-02-22,23,12,11,0.478260869565217
CANCUN 1,2023-02-23,20,10,10,0.5
CANCUN 1,2023-02-24,16,13,3,0.1875
CANCUN 1,2023-02-25,17,10,7,0.411764705882353
CANCUN 1,2023-02-26,33,21,12,0.363636363636364
CANCUN 1,2023-02-27,34,23,11,0.323529411764706
CANCUN 1,2023-02-28,25,13,12,0.48
CANCUN 1,2023-03-01,22,14,8,0.363636363636364
CANCUN 1,2023-03-02,38,20,18,0.473684210526316
CANCUN 1,2023-03-03,27,21,6,0.222222222222222
CANCUN 1,2023-03-04,38,22,16,0.421052631578947
CANCUN 1,2023-03-05,44,20,24,0.545454545454545
CANCUN 1,2023-03-06,32,22,10,0.3125
CANCUN 1,2023-03-07,39,25,14,0.358974358974359
CANCUN 1,2023-03-08,30,23,7,0.233333333333333
CANCUN 1,2023-03-09,35,24,11,0.314285714285714
CANCUN 1,2023-03-10,21,15,6,0.285714285714286
CANCUN 1,2023-03-11,35,18,17,0.485714285714286
CANCUN 1,2023-03-12,28,17,11,0.392857142857143
CANCUN 1,2023-03-13,33,23,10,0.303030303030303
CANCUN 1,2023-03-14,29,19,10,0.344827586206897
CANCUN 1,2023-03-15,25,21,4,0.16
CANCUN 1,2023-03-16,31,25,6,0.193548387096774
CANCUN 1,2023-03-17,40,34,6,0.15
CANCUN 1,2023-03-18,37,29,8,0.216216216216216
CANCUN 1,2023-03-19,28,23,5,0.178571428571429
CANCUN 1,2023-03-20,35,28,7,0.2
CANCUN 1,2023-03-21,50,48,2,0.04
CANCUN 1,2023-03-22,41,39,2,0.0487804878048781
CANCUN 1,2023-03-23,36,34,2,0.0555555555555556
CANCUN 1,2023-03-24,38,35,3,0.0789473684210526
CANCUN 1,2023-03-25,36,34,2,0.0555555555555556
CANCUN 1,2023-03-26,24,22,2,0.0833333333333333
CANCUN 1,2023-03-27,31,29,2,0.0645161290322581
CANCUN 1,2023-03-28,32,31,1,0.03125
CANCUN 1,2023-03-29,28,27,1,0.0357142857142857
CANCUN 1,2023-03-30,30,29,1,0.0333333333333333
CANCUN 1,2023-03-31,48,44,4,0.0833333333333333
CANCUN 1,2023-04-01,48,45,3,0.0625
CANCUN 1,2023-04-02,31,30,1,0.032258064516129
CANCUN 1,2023-04-03,34,34,0,0
CANCUN 1,2023-04-04,27,27,0,0
CANCUN 1,2023-04-05,21,12,9,0.428571428571429
CANCUN 1,2023-04-06,29,27,2,0.0689655172413793
CANCUN 1,2023-04-07,23,23,0,0
CANCUN 1,2023-04-08,23,23,0,0
CANCUN 1,2023-04-09,16,16,0,0
CANCUN 1,2023-04-10,25,25,0,0
CANCUN 1,2023-04-11,26,26,0,0
CANCUN 1,2023-04-12,32,31,1,0.03125
CANCUN 1,2023-04-13,27,27,0,0
CANCUN 1,2023-04-14,26,26,0,0
CANCUN 1,2023-04-15,44,42,2,0.0454545454545455
CANCUN 1,2023-04-16,33,33,0,0
CANCUN 1,2023-04-17,34,34,0,0
CANCUN 1,2023-04-18,40,40,0,0
CANCUN 1,2023-04-19,31,29,2,0.0645161290322581
CANCUN 1,2023-04-20,36,33,3,0.0833333333333333
CANCUN 1,2023-04-21,31,31,0,0
CANCUN 1,2023-04-22,31,30,1,0.032258064516129
CANCUN 1,2023-04-23,37,36,1,0.027027027027027
CANCUN 1,2023-04-24,44,43,1,0.0227272727272727
CANCUN 1,2023-04-25,45,42,3,0.0666666666666667
CANCUN 1,2023-04-26,35,35,0,0
CANCUN 1,2023-04-27,25,25,0,0
CANCUN 1,2023-04-28,33,30,3,0.0909090909090909
CANCUN 1,2023-04-29,48,46,2,0.0416666666666667
CANCUN 1,2023-04-30,41,36,5,0.121951219512195
CANCUN 1,2023-05-01,34,34,0,0
CANCUN 1,2023-05-02,33,32,1,0.0303030303030303
CANCUN 1,2023-05-03,26,23,3,0.115384615384615
CANCUN 1,2023-05-04,22,20,2,0.0909090909090909
CANCUN 1,2023-05-05,29,27,2,0.0689655172413793
CANCUN 1,2023-05-06,25,24,1,0.04
CANCUN 1,2023-05-07,30,27,3,0.1
CANCUN 1,2023-05-08,23,22,1,0.0434782608695652
CANCUN 2,2023-01-02,14,8,6,0.428571428571429
CANCUN 2,2023-01-03,25,6,19,0.76
CANCUN 2,2023-01-04,35,13,22,0.628571428571429
CANCUN 2,2023-01-05,24,10,14,0.583333333333333
CANCUN 2,2023-01-06,24,11,13,0.541666666666667
CANCUN 2,2023-01-07,20,9,11,0.55
CANCUN 2,2023-01-08,21,7,14,0.666666666666667
CANCUN 2,2023-01-09,20,8,12,0.6
CANCUN 2,2023-01-10,36,10,26,0.722222222222222
CANCUN 2,2023-01-11,29,6,23,0.793103448275862
CANCUN 2,2023-01-12,25,5,20,0.8
CANCUN 2,2023-01-13,24,7,17,0.708333333333333
CANCUN 2,2023-01-14,27,12,15,0.555555555555556
CANCUN 2,2023-01-15,24,7,17,0.708333333333333
CANCUN 2,2023-01-16,27,7,20,0.740740740740741
CANCUN 2,2023-01-17,23,5,18,0.782608695652174
CANCUN 2,2023-01-18,19,5,14,0.736842105263158
CANCUN 2,2023-01-19,26,11,15,0.576923076923077
CANCUN 2,2023-01-20,21,6,15,0.714285714285714
CANCUN 2,2023-01-21,24,10,14,0.583333333333333
CANCUN 2,2023-01-22,23,9,14,0.608695652173913
CANCUN 2,2023-01-23,33,12,21,0.636363636363636
CANCUN 2,2023-01-24,32,8,24,0.75
CANCUN 2,2023-01-25,24,2,22,0.916666666666667
CANCUN 2,2023-01-26,14,3,11,0.785714285714286
CANCUN 2,2023-01-27,18,2,16,0.888888888888889
CANCUN 2,2023-01-28,18,6,12,0.666666666666667
CANCUN 2,2023-01-29,21,2,19,0.904761904761905
CANCUN 2,2023-01-30,22,3,19,0.863636363636364
CANCUN 2,2023-01-31,35,4,31,0.885714285714286
CANCUN 2,2023-02-01,27,6,21,0.777777777777778
CANCUN 2,2023-02-02,25,6,19,0.76
CANCUN 2,2023-02-03,33,9,24,0.727272727272727
CANCUN 2,2023-02-04,32,6,26,0.8125
CANCUN 2,2023-02-05,22,4,18,0.818181818181818
CANCUN 2,2023-02-06,21,4,17,0.80952380952381
CANCUN 2,2023-02-07,31,6,25,0.806451612903226
CANCUN 2,2023-02-08,29,5,24,0.827586206896552
CANCUN 2,2023-02-09,26,6,20,0.769230769230769
CANCUN 2,2023-02-10,26,2,24,0.923076923076923
CANCUN 2,2023-02-11,28,6,22,0.785714285714286
CANCUN 2,2023-02-12,26,8,18,0.692307692307692
CANCUN 2,2023-02-13,27,7,20,0.740740740740741
CANCUN 2,2023-02-14,22,0,23,1
CANCUN 2,2023-02-15,21,3,18,0.857142857142857
CANCUN 2,2023-02-16,27,5,22,0.814814814814815
CANCUN 2,2023-02-17,19,3,16,0.842105263157895
CANCUN 2,2023-02-18,24,8,16,0.666666666666667
CANCUN 2,2023-02-19,23,3,20,0.869565217391304
CANCUN 2,2023-02-20,21,9,12,0.571428571428571
CANCUN 2,2023-02-21,27,4,23,0.851851851851852
CANCUN 2,2023-02-22,23,4,19,0.826086956521739
CANCUN 2,2023-02-23,28,12,16,0.571428571428571
CANCUN 2,2023-02-24,20,9,11,0.55
CANCUN 2,2023-02-25,22,11,11,0.5
CANCUN 2,2023-02-26,20,3,17,0.85
CANCUN 2,2023-02-27,20,7,13,0.65
CANCUN 2,2023-02-28,12,4,8,0.666666666666667
CANCUN 2,2023-03-01,15,6,9,0.6
CANCUN 2,2023-03-02,22,11,11,0.5
CANCUN 2,2023-03-03,27,14,13,0.481481481481481
CANCUN 2,2023-03-04,24,12,12,0.5
CANCUN 2,2023-03-05,21,4,17,0.80952380952381
CANCUN 2,2023-03-06,27,14,13,0.481481481481481
CANCUN 2,2023-03-07,24,16,8,0.333333333333333
CANCUN 2,2023-03-08,23,18,5,0.217391304347826
CANCUN 2,2023-03-09,32,22,10,0.3125
CANCUN 2,2023-03-10,21,13,8,0.380952380952381
CANCUN 2,2023-03-11,24,17,7,0.291666666666667
CANCUN 2,2023-03-12,24,17,7,0.291666666666667
CANCUN 2,2023-03-13,27,15,12,0.444444444444444
CANCUN 2,2023-03-14,24,18,6,0.25
CANCUN 2,2023-03-15,21,17,4,0.19047619047619
CANCUN 2,2023-03-16,14,12,2,0.142857142857143
CANCUN 2,2023-03-17,34,21,13,0.382352941176471
CANCUN 2,2023-03-18,23,20,3,0.130434782608696
CANCUN 2,2023-03-19,14,9,5,0.357142857142857
CANCUN 2,2023-03-20,22,16,6,0.272727272727273
CANCUN 2,2023-03-21,33,28,5,0.151515151515152
CANCUN 2,2023-03-22,18,14,4,0.222222222222222
CANCUN 2,2023-03-23,23,22,1,0.0434782608695652
CANCUN 2,2023-03-24,10,7,3,0.3
CANCUN 2,2023-03-25,18,18,0,0
CANCUN 2,2023-03-26,16,12,4,0.25
CANCUN 2,2023-03-27,24,21,3,0.125
CANCUN 2,2023-03-28,20,16,4,0.2
CANCUN 2,2023-03-29,23,21,2,0.0869565217391304
CANCUN 2,2023-03-30,26,24,2,0.0769230769230769
CANCUN 2,2023-03-31,23,15,8,0.347826086956522
CANCUN 2,2023-04-01,24,20,4,0.166666666666667
CANCUN 2,2023-04-02,22,21,1,0.0454545454545455
CANCUN 2,2023-04-03,22,22,0,0
CANCUN 2,2023-04-04,24,20,4,0.166666666666667
CANCUN 2,2023-04-05,20,11,9,0.45
CANCUN 2,2023-04-06,30,28,2,0.0666666666666667
CANCUN 2,2023-04-07,27,25,2,0.0740740740740741
CANCUN 2,2023-04-08,28,25,3,0.107142857142857
CANCUN 2,2023-04-09,20,18,2,0.1
CANCUN 2,2023-04-10,18,17,1,0.0555555555555556
CANCUN 2,2023-04-11,26,23,3,0.115384615384615
CANCUN 2,2023-04-12,16,12,4,0.25
CANCUN 2,2023-04-13,21,19,2,0.0952380952380952
CANCUN 2,2023-04-14,26,22,4,0.153846153846154
CANCUN 2,2023-04-15,18,17,1,0.0555555555555556
CANCUN 2,2023-04-16,30,30,0,0
CANCUN 2,2023-04-17,23,23,0,0
CANCUN 2,2023-04-18,27,25,2,0.0740740740740741
CANCUN 2,2023-04-19,29,29,0,0
CANCUN 2,2023-04-20,24,19,5,0.208333333333333
CANCUN 2,2023-04-21,25,25,0,0
CANCUN 2,2023-04-22,34,30,4,0.117647058823529
CANCUN 2,2023-04-23,6,6,0,0
CANCUN 2,2023-04-24,23,22,1,0.0434782608695652
CANCUN 2,2023-04-25,27,25,2,0.0740740740740741
CANCUN 2,2023-04-26,27,27,0,0
CANCUN 2,2023-04-27,23,18,5,0.217391304347826
CANCUN 2,2023-04-28,17,15,2,0.117647058823529
CANCUN 2,2023-04-29,27,26,1,0.037037037037037
CANCUN 2,2023-04-30,22,20,2,0.0909090909090909
CANCUN 2,2023-05-01,24,21,3,0.125
CANCUN 2,2023-05-02,26,23,3,0.115384615384615
CANCUN 2,2023-05-03,26,25,1,0.0384615384615385
CANCUN 2,2023-05-04,18,16,2,0.111111111111111
CANCUN 2,2023-05-05,26,24,2,0.0769230769230769
CANCUN 2,2023-05-06,25,23,2,0.08
CANCUN 2,2023-05-07,17,17,0,0
CANCUN 2,2023-05-08,22,19,3,0.136363636363636
CENTRO HISTORICO,2023-01-02,13,11,2,0.153846153846154
CENTRO HISTORICO,2023-01-03,13,13,0,0
CENTRO HISTORICO,2023-01-04,19,19,0,0
CENTRO HISTORICO,2023-01-05,22,20,2,0.0909090909090909
CENTRO HISTORICO,2023-01-06,19,17,2,0.105263157894737
CENTRO HISTORICO,2023-01-07,17,15,2,0.117647058823529
CENTRO HISTORICO,2023-01-08,14,13,1,0.0714285714285714
CENTRO HISTORICO,2023-01-09,21,16,5,0.238095238095238
CENTRO HISTORICO,2023-01-10,26,23,3,0.115384615384615
CENTRO HISTORICO,2023-01-11,14,12,2,0.142857142857143
CENTRO HISTORICO,2023-01-12,14,10,4,0.285714285714286
CENTRO HISTORICO,2023-01-13,20,20,0,0
CENTRO HISTORICO,2023-01-14,20,17,3,0.15
CENTRO HISTORICO,2023-01-15,24,22,2,0.0833333333333333
CENTRO HISTORICO,2023-01-16,18,9,9,0.5
CENTRO HISTORICO,2023-01-17,20,9,11,0.55
CENTRO HISTORICO,2023-01-18,19,14,5,0.263157894736842
CENTRO HISTORICO,2023-01-19,16,9,7,0.4375
CENTRO HISTORICO,2023-01-20,20,15,5,0.25
CENTRO HISTORICO,2023-01-21,20,15,5,0.25
CENTRO HISTORICO,2023-01-22,25,18,7,0.28
CENTRO HISTORICO,2023-01-23,21,9,12,0.571428571428571
CENTRO HISTORICO,2023-01-24,25,14,11,0.44
CENTRO HISTORICO,2023-01-25,18,10,8,0.444444444444444
CENTRO HISTORICO,2023-01-26,33,19,14,0.424242424242424
CENTRO HISTORICO,2023-01-27,17,12,5,0.294117647058824
CENTRO HISTORICO,2023-01-28,25,13,12,0.48
CENTRO HISTORICO,2023-01-29,23,11,12,0.521739130434783
CENTRO HISTORICO,2023-01-30,15,8,7,0.466666666666667
CENTRO HISTORICO,2023-01-31,24,14,10,0.416666666666667
CENTRO HISTORICO,2023-02-01,17,12,5,0.294117647058824
CENTRO HISTORICO,2023-02-02,23,12,11,0.478260869565217
CENTRO HISTORICO,2023-02-03,24,15,9,0.375
CENTRO HISTORICO,2023-02-04,27,19,8,0.296296296296296
CENTRO HISTORICO,2023-02-05,12,12,0,0
CENTRO HISTORICO,2023-02-06,10,8,2,0.2
CENTRO HISTORICO,2023-02-07,23,15,8,0.347826086956522
CENTRO HISTORICO,2023-02-08,19,11,8,0.421052631578947
CENTRO HISTORICO,2023-02-09,19,15,4,0.210526315789474
CENTRO HISTORICO,2023-02-10,14,9,5,0.357142857142857
CENTRO HISTORICO,2023-02-11,18,11,7,0.388888888888889
CENTRO HISTORICO,2023-02-12,13,9,4,0.307692307692308
CENTRO HISTORICO,2023-02-13,20,15,5,0.25
CENTRO HISTORICO,2023-02-14,21,18,3,0.142857142857143
CENTRO HISTORICO,2023-02-15,21,14,7,0.333333333333333
CENTRO HISTORICO,2023-02-16,24,20,4,0.166666666666667
CENTRO HISTORICO,2023-02-17,18,10,8,0.444444444444444
CENTRO HISTORICO,2023-02-18,27,17,10,0.37037037037037
CENTRO HISTORICO,2023-02-19,13,11,2,0.153846153846154
CENTRO HISTORICO,2023-02-20,22,11,11,0.5
CENTRO HISTORICO,2023-02-21,22,15,7,0.318181818181818
CENTRO HISTORICO,2023-02-22,21,10,11,0.523809523809524
CENTRO HISTORICO,2023-02-23,27,18,9,0.333333333333333
CENTRO HISTORICO,2023-02-24,22,13,9,0.409090909090909
CENTRO HISTORICO,2023-02-25,21,13,8,0.380952380952381
CENTRO HISTORICO,2023-02-26,6,5,1,0.166666666666667
CENTRO HISTORICO,2023-02-27,28,26,2,0.0714285714285714
CENTRO HISTORICO,2023-02-28,26,13,13,0.5
CENTRO HISTORICO,2023-03-01,15,11,4,0.266666666666667
CENTRO HISTORICO,2023-03-02,16,11,5,0.3125
CENTRO HISTORICO,2023-03-03,24,17,7,0.291666666666667
CENTRO HISTORICO,2023-03-04,26,20,6,0.230769230769231
CENTRO HISTORICO,2023-03-05,21,18,3,0.142857142857143
CENTRO HISTORICO,2023-03-06,18,14,4,0.222222222222222
CENTRO HISTORICO,2023-03-07,30,19,11,0.366666666666667
CENTRO HISTORICO,2023-03-08,18,11,7,0.388888888888889
CENTRO HISTORICO,2023-03-09,20,15,5,0.25
CENTRO HISTORICO,2023-03-10,27,19,8,0.296296296296296
CENTRO HISTORICO,2023-03-11,22,19,3,0.136363636363636
CENTRO HISTORICO,2023-03-12,21,18,3,0.142857142857143
CENTRO HISTORICO,2023-03-13,23,20,3,0.130434782608696
CENTRO HISTORICO,2023-03-14,24,19,5,0.208333333333333
CENTRO HISTORICO,2023-03-15,16,15,1,0.0625
CENTRO HISTORICO,2023-03-16,19,15,4,0.210526315789474
CENTRO HISTORICO,2023-03-17,28,23,5,0.178571428571429
CENTRO HISTORICO,2023-03-18,25,23,2,0.08
CENTRO HISTORICO,2023-03-19,24,22,2,0.0833333333333333
CENTRO HISTORICO,2023-03-20,34,32,2,0.0588235294117647
CENTRO HISTORICO,2023-03-21,21,20,1,0.0476190476190476
CENTRO HISTORICO,2023-03-22,23,21,2,0.0869565217391304
CENTRO HISTORICO,2023-03-23,24,24,0,0
CENTRO HISTORICO,2023-03-24,22,21,1,0.0454545454545455
CENTRO HISTORICO,2023-03-25,24,23,1,0.0416666666666667
CENTRO HISTORICO,2023-03-26,23,18,5,0.217391304347826
CENTRO HISTORICO,2023-03-27,17,17,0,0
CENTRO HISTORICO,2023-03-28,20,19,1,0.05
CENTRO HISTORICO,2023-03-29,20,20,0,0
CENTRO HISTORICO,2023-03-30,15,14,1,0.0666666666666667
CENTRO HISTORICO,2023-03-31,29,27,2,0.0689655172413793
CENTRO HISTORICO,2023-04-01,22,21,1,0.0454545454545455
CENTRO HISTORICO,2023-04-02,16,14,2,0.125
CENTRO HISTORICO,2023-04-03,19,19,0,0
CENTRO HISTORICO,2023-04-04,24,24,0,0
CENTRO HISTORICO,2023-04-05,18,16,2,0.111111111111111
CENTRO HISTORICO,2023-04-06,24,22,2,0.0833333333333333
CENTRO HISTORICO,2023-04-07,21,20,1,0.0476190476190476
CENTRO HISTORICO,2023-04-08,13,13,0,0
CENTRO HISTORICO,2023-04-09,11,9,2,0.181818181818182
CENTRO HISTORICO,2023-04-10,17,17,0,0
CENTRO HISTORICO,2023-04-11,21,20,1,0.0476190476190476
CENTRO HISTORICO,2023-04-12,18,16,2,0.111111111111111
CENTRO HISTORICO,2023-04-13,22,21,1,0.0454545454545455
CENTRO HISTORICO,2023-04-14,17,16,1,0.0588235294117647
CENTRO HISTORICO,2023-04-15,30,28,2,0.0666666666666667
CENTRO HISTORICO,2023-04-16,13,13,0,0
CENTRO HISTORICO,2023-04-17,20,19,1,0.05
CENTRO HISTORICO,2023-04-18,14,14,0,0
CENTRO HISTORICO,2023-04-19,17,15,2,0.117647058823529
CENTRO HISTORICO,2023-04-20,16,16,0,0
CENTRO HISTORICO,2023-04-21,24,22,2,0.0833333333333333
CENTRO HISTORICO,2023-04-22,21,20,1,0.0476190476190476
CENTRO HISTORICO,2023-04-23,29,28,1,0.0344827586206897
CENTRO HISTORICO,2023-04-24,21,21,0,0
CENTRO HISTORICO,2023-04-25,22,21,1,0.0454545454545455
CENTRO HISTORICO,2023-04-26,26,26,0,0
CENTRO HISTORICO,2023-04-27,29,24,5,0.172413793103448
CENTRO HISTORICO,2023-04-28,34,31,3,0.0882352941176471
CENTRO HISTORICO,2023-04-29,31,30,1,0.032258064516129
CENTRO HISTORICO,2023-04-30,28,25,3,0.107142857142857
CENTRO HISTORICO,2023-05-01,9,7,2,0.222222222222222
CENTRO HISTORICO,2023-05-02,33,32,1,0.0303030303030303
CENTRO HISTORICO,2023-05-03,25,23,2,0.08
CENTRO HISTORICO,2023-05-04,22,21,1,0.0454545454545455
CENTRO HISTORICO,2023-05-05,37,37,0,0
CENTRO HISTORICO,2023-05-06,35,34,1,0.0285714285714286
CENTRO HISTORICO,2023-05-07,23,23,0,0
CENTRO HISTORICO,2023-05-08,23,23,0,0
CHALCO IXTAPALUCA,2023-01-02,32,15,17,0.53125
CHALCO IXTAPALUCA,2023-01-03,41,28,13,0.317073170731707
CHALCO IXTAPALUCA,2023-01-04,43,26,17,0.395348837209302
CHALCO IXTAPALUCA,2023-01-05,42,25,17,0.404761904761905
CHALCO IXTAPALUCA,2023-01-06,39,29,10,0.256410256410256
CHALCO IXTAPALUCA,2023-01-07,49,32,17,0.346938775510204
CHALCO IXTAPALUCA,2023-01-08,47,32,15,0.319148936170213
CHALCO IXTAPALUCA,2023-01-09,43,30,13,0.302325581395349
CHALCO IXTAPALUCA,2023-01-10,54,33,21,0.388888888888889
CHALCO IXTAPALUCA,2023-01-11,54,31,23,0.425925925925926
CHALCO IXTAPALUCA,2023-01-12,54,39,15,0.277777777777778
CHALCO IXTAPALUCA,2023-01-13,39,30,9,0.230769230769231
CHALCO IXTAPALUCA,2023-01-14,45,30,15,0.333333333333333
CHALCO IXTAPALUCA,2023-01-15,51,37,14,0.274509803921569
CHALCO IXTAPALUCA,2023-01-16,46,27,19,0.41304347826087
CHALCO IXTAPALUCA,2023-01-17,41,19,22,0.536585365853659
CHALCO IXTAPALUCA,2023-01-18,57,18,39,0.684210526315789
CHALCO IXTAPALUCA,2023-01-19,48,10,38,0.791666666666667
CHALCO IXTAPALUCA,2023-01-20,38,14,24,0.631578947368421
CHALCO IXTAPALUCA,2023-01-21,58,26,32,0.551724137931034
CHALCO IXTAPALUCA,2023-01-22,43,22,21,0.488372093023256
CHALCO IXTAPALUCA,2023-01-23,43,14,29,0.674418604651163
CHALCO IXTAPALUCA,2023-01-24,52,23,29,0.557692307692308
CHALCO IXTAPALUCA,2023-01-25,49,23,26,0.530612244897959
CHALCO IXTAPALUCA,2023-01-26,66,25,41,0.621212121212121
CHALCO IXTAPALUCA,2023-01-27,53,13,40,0.754716981132076
CHALCO IXTAPALUCA,2023-01-28,63,14,49,0.777777777777778
CHALCO IXTAPALUCA,2023-01-29,50,20,30,0.6
CHALCO IXTAPALUCA,2023-01-30,58,24,34,0.586206896551724
CHALCO IXTAPALUCA,2023-01-31,52,23,29,0.557692307692308
CHALCO IXTAPALUCA,2023-02-01,47,26,21,0.446808510638298
CHALCO IXTAPALUCA,2023-02-02,58,23,35,0.603448275862069
CHALCO IXTAPALUCA,2023-02-03,41,16,25,0.609756097560976
CHALCO IXTAPALUCA,2023-02-04,75,37,38,0.506666666666667
CHALCO IXTAPALUCA,2023-02-05,55,20,35,0.636363636363636
CHALCO IXTAPALUCA,2023-02-06,67,30,37,0.552238805970149
CHALCO IXTAPALUCA,2023-02-07,58,12,46,0.793103448275862
CHALCO IXTAPALUCA,2023-02-08,32,7,25,0.78125
CHALCO IXTAPALUCA,2023-02-09,41,9,32,0.780487804878049
CHALCO IXTAPALUCA,2023-02-10,37,8,29,0.783783783783784
CHALCO IXTAPALUCA,2023-02-11,49,11,38,0.775510204081633
CHALCO IXTAPALUCA,2023-02-12,55,11,44,0.8
CHALCO IXTAPALUCA,2023-02-13,56,7,49,0.875
CHALCO IXTAPALUCA,2023-02-14,57,15,42,0.736842105263158
CHALCO IXTAPALUCA,2023-02-15,66,13,53,0.803030303030303
CHALCO IXTAPALUCA,2023-02-16,41,7,34,0.829268292682927
CHALCO IXTAPALUCA,2023-02-17,51,8,43,0.843137254901961
CHALCO IXTAPALUCA,2023-02-18,59,17,42,0.711864406779661
CHALCO IXTAPALUCA,2023-02-19,66,9,57,0.863636363636364
CHALCO IXTAPALUCA,2023-02-20,38,7,31,0.815789473684211
CHALCO IXTAPALUCA,2023-02-21,51,26,25,0.490196078431373
CHALCO IXTAPALUCA,2023-02-22,43,26,17,0.395348837209302
CHALCO IXTAPALUCA,2023-02-23,56,37,19,0.339285714285714
CHALCO IXTAPALUCA,2023-02-24,45,30,15,0.333333333333333
CHALCO IXTAPALUCA,2023-02-25,75,47,28,0.373333333333333
CHALCO IXTAPALUCA,2023-02-26,43,25,18,0.418604651162791
CHALCO IXTAPALUCA,2023-02-27,60,33,27,0.45
CHALCO IXTAPALUCA,2023-02-28,47,32,15,0.319148936170213
CHALCO IXTAPALUCA,2023-03-01,34,24,10,0.294117647058824
CHALCO IXTAPALUCA,2023-03-02,50,31,19,0.38
CHALCO IXTAPALUCA,2023-03-03,37,29,8,0.216216216216216
CHALCO IXTAPALUCA,2023-03-04,64,36,28,0.4375
CHALCO IXTAPALUCA,2023-03-05,64,35,29,0.453125
CHALCO IXTAPALUCA,2023-03-06,52,34,18,0.346153846153846
CHALCO IXTAPALUCA,2023-03-07,42,32,10,0.238095238095238
CHALCO IXTAPALUCA,2023-03-08,43,34,9,0.209302325581395
CHALCO IXTAPALUCA,2023-03-09,65,52,13,0.2
CHALCO IXTAPALUCA,2023-03-10,39,31,8,0.205128205128205
CHALCO IXTAPALUCA,2023-03-11,76,62,14,0.184210526315789
CHALCO IXTAPALUCA,2023-03-12,53,45,8,0.150943396226415
CHALCO IXTAPALUCA,2023-03-13,63,43,20,0.317460317460317
CHALCO IXTAPALUCA,2023-03-14,77,55,22,0.285714285714286
CHALCO IXTAPALUCA,2023-03-15,56,45,11,0.196428571428571
CHALCO IXTAPALUCA,2023-03-16,76,70,6,0.0789473684210526
CHALCO IXTAPALUCA,2023-03-17,64,62,2,0.03125
CHALCO IXTAPALUCA,2023-03-18,101,89,12,0.118811881188119
CHALCO IXTAPALUCA,2023-03-19,84,79,5,0.0595238095238095
CHALCO IXTAPALUCA,2023-03-20,103,97,6,0.058252427184466
CHALCO IXTAPALUCA,2023-03-21,83,82,1,0.0120481927710843
CHALCO IXTAPALUCA,2023-03-22,57,52,5,0.087719298245614
CHALCO IXTAPALUCA,2023-03-23,59,59,0,0
CHALCO IXTAPALUCA,2023-03-24,72,72,0,0
CHALCO IXTAPALUCA,2023-03-25,76,75,1,0.0131578947368421
CHALCO IXTAPALUCA,2023-03-26,69,68,1,0.0144927536231884
CHALCO IXTAPALUCA,2023-03-27,59,59,0,0
CHALCO IXTAPALUCA,2023-03-28,63,63,0,0
CHALCO IXTAPALUCA,2023-03-29,63,62,1,0.0158730158730159
CHALCO IXTAPALUCA,2023-03-30,88,86,2,0.0227272727272727
CHALCO IXTAPALUCA,2023-03-31,81,79,2,0.0246913580246914
CHALCO IXTAPALUCA,2023-04-01,86,85,1,0.0116279069767442
CHALCO IXTAPALUCA,2023-04-02,60,59,1,0.0166666666666667
CHALCO IXTAPALUCA,2023-04-03,76,72,4,0.0526315789473684
CHALCO IXTAPALUCA,2023-04-04,39,39,0,0
CHALCO IXTAPALUCA,2023-04-05,40,40,0,0
CHALCO IXTAPALUCA,2023-04-06,51,51,0,0
CHALCO IXTAPALUCA,2023-04-07,48,48,0,0
CHALCO IXTAPALUCA,2023-04-08,50,50,0,0
CHALCO IXTAPALUCA,2023-04-09,54,54,0,0
CHALCO IXTAPALUCA,2023-04-10,45,45,0,0
CHALCO IXTAPALUCA,2023-04-11,57,57,0,0
CHALCO IXTAPALUCA,2023-04-12,50,50,0,0
CHALCO IXTAPALUCA,2023-04-13,50,50,0,0
CHALCO IXTAPALUCA,2023-04-14,63,63,0,0
CHALCO IXTAPALUCA,2023-04-15,70,70,0,0
CHALCO IXTAPALUCA,2023-04-16,85,85,0,0
CHALCO IXTAPALUCA,2023-04-17,81,81,0,0
CHALCO IXTAPALUCA,2023-04-18,70,70,0,0
CHALCO IXTAPALUCA,2023-04-19,42,42,0,0
CHALCO IXTAPALUCA,2023-04-20,57,57,0,0
CHALCO IXTAPALUCA,2023-04-21,54,54,0,0
CHALCO IXTAPALUCA,2023-04-22,63,63,0,0
CHALCO IXTAPALUCA,2023-04-23,57,57,0,0
CHALCO IXTAPALUCA,2023-04-24,55,55,0,0
CHALCO IXTAPALUCA,2023-04-25,60,60,0,0
CHALCO IXTAPALUCA,2023-04-26,63,63,0,0
CHALCO IXTAPALUCA,2023-04-27,45,45,0,0
CHALCO IXTAPALUCA,2023-04-28,85,85,0,0
CHALCO IXTAPALUCA,2023-04-29,79,79,0,0
CHALCO IXTAPALUCA,2023-04-30,78,78,0,0
CHALCO IXTAPALUCA,2023-05-01,75,75,0,0
CHALCO IXTAPALUCA,2023-05-02,103,103,0,0
CHALCO IXTAPALUCA,2023-05-03,74,74,0,0
CHALCO IXTAPALUCA,2023-05-04,67,67,0,0
CHALCO IXTAPALUCA,2023-05-05,49,49,0,0
CHALCO IXTAPALUCA,2023-05-06,71,71,0,0
CHALCO IXTAPALUCA,2023-05-07,65,65,0,0
CHALCO IXTAPALUCA,2023-05-08,67,67,0,0
CHIHUAHUA CUMBRES,2023-01-02,11,10,1,0.0909090909090909
CHIHUAHUA CUMBRES,2023-01-03,29,23,6,0.206896551724138
CHIHUAHUA CUMBRES,2023-01-04,29,21,8,0.275862068965517
CHIHUAHUA CUMBRES,2023-01-05,32,27,5,0.15625
CHIHUAHUA CUMBRES,2023-01-06,22,16,6,0.272727272727273
CHIHUAHUA CUMBRES,2023-01-07,33,27,6,0.181818181818182
CHIHUAHUA CUMBRES,2023-01-08,10,8,2,0.2
CHIHUAHUA CUMBRES,2023-01-09,25,23,2,0.08
CHIHUAHUA CUMBRES,2023-01-10,34,27,7,0.205882352941176
CHIHUAHUA CUMBRES,2023-01-11,22,18,4,0.181818181818182
CHIHUAHUA CUMBRES,2023-01-12,31,23,8,0.258064516129032
CHIHUAHUA CUMBRES,2023-01-13,24,15,9,0.375
CHIHUAHUA CUMBRES,2023-01-14,40,20,20,0.5
CHIHUAHUA CUMBRES,2023-01-15,20,13,7,0.35
CHIHUAHUA CUMBRES,2023-01-16,34,14,20,0.588235294117647
CHIHUAHUA CUMBRES,2023-01-17,21,9,12,0.571428571428571
CHIHUAHUA CUMBRES,2023-01-18,30,21,9,0.3
CHIHUAHUA CUMBRES,2023-01-19,38,18,20,0.526315789473684
CHIHUAHUA CUMBRES,2023-01-20,27,17,10,0.37037037037037
CHIHUAHUA CUMBRES,2023-01-21,40,23,17,0.425
CHIHUAHUA CUMBRES,2023-01-22,13,8,5,0.384615384615385
CHIHUAHUA CUMBRES,2023-01-23,27,13,14,0.518518518518518
CHIHUAHUA CUMBRES,2023-01-24,34,22,12,0.352941176470588
CHIHUAHUA CUMBRES,2023-01-25,22,19,3,0.136363636363636
CHIHUAHUA CUMBRES,2023-01-26,20,14,6,0.3
CHIHUAHUA CUMBRES,2023-01-27,27,18,9,0.333333333333333
CHIHUAHUA CUMBRES,2023-01-28,24,14,10,0.416666666666667
CHIHUAHUA CUMBRES,2023-01-29,13,10,3,0.230769230769231
CHIHUAHUA CUMBRES,2023-01-30,25,16,9,0.36
CHIHUAHUA CUMBRES,2023-01-31,32,23,9,0.28125
CHIHUAHUA CUMBRES,2023-02-01,34,23,11,0.323529411764706
CHIHUAHUA CUMBRES,2023-02-02,20,12,8,0.4
CHIHUAHUA CUMBRES,2023-02-03,27,14,13,0.481481481481481
CHIHUAHUA CUMBRES,2023-02-04,39,26,13,0.333333333333333
CHIHUAHUA CUMBRES,2023-02-05,17,13,4,0.235294117647059
CHIHUAHUA CUMBRES,2023-02-06,19,13,6,0.315789473684211
CHIHUAHUA CUMBRES,2023-02-07,31,22,9,0.290322580645161
CHIHUAHUA CUMBRES,2023-02-08,28,21,7,0.25
CHIHUAHUA CUMBRES,2023-02-09,24,15,9,0.375
CHIHUAHUA CUMBRES,2023-02-10,25,19,6,0.24
CHIHUAHUA CUMBRES,2023-02-11,31,18,13,0.419354838709677
CHIHUAHUA CUMBRES,2023-02-12,20,13,7,0.35
CHIHUAHUA CUMBRES,2023-02-13,23,18,5,0.217391304347826
CHIHUAHUA CUMBRES,2023-02-14,23,19,4,0.173913043478261
CHIHUAHUA CUMBRES,2023-02-15,25,20,5,0.2
CHIHUAHUA CUMBRES,2023-02-16,23,21,2,0.0869565217391304
CHIHUAHUA CUMBRES,2023-02-17,26,16,10,0.384615384615385
CHIHUAHUA CUMBRES,2023-02-18,36,25,11,0.305555555555556
CHIHUAHUA CUMBRES,2023-02-19,15,9,6,0.4
CHIHUAHUA CUMBRES,2023-02-20,25,19,6,0.24
CHIHUAHUA CUMBRES,2023-02-21,29,24,5,0.172413793103448
CHIHUAHUA CUMBRES,2023-02-22,19,14,5,0.263157894736842
CHIHUAHUA CUMBRES,2023-02-23,20,13,7,0.35
CHIHUAHUA CUMBRES,2023-02-24,26,15,11,0.423076923076923
CHIHUAHUA CUMBRES,2023-02-25,35,22,13,0.371428571428571
CHIHUAHUA CUMBRES,2023-02-26,10,4,6,0.6
CHIHUAHUA CUMBRES,2023-02-27,21,13,8,0.380952380952381
CHIHUAHUA CUMBRES,2023-02-28,29,21,8,0.275862068965517
CHIHUAHUA CUMBRES,2023-03-01,31,21,10,0.32258064516129
CHIHUAHUA CUMBRES,2023-03-02,20,13,7,0.35
CHIHUAHUA CUMBRES,2023-03-03,29,18,11,0.379310344827586
CHIHUAHUA CUMBRES,2023-03-04,44,29,15,0.340909090909091
CHIHUAHUA CUMBRES,2023-03-05,20,8,12,0.6
CHIHUAHUA CUMBRES,2023-03-06,25,17,8,0.32
CHIHUAHUA CUMBRES,2023-03-07,21,12,9,0.428571428571429
CHIHUAHUA CUMBRES,2023-03-08,24,15,9,0.375
CHIHUAHUA CUMBRES,2023-03-09,30,28,2,0.0666666666666667
CHIHUAHUA CUMBRES,2023-03-10,27,25,2,0.0740740740740741
CHIHUAHUA CUMBRES,2023-03-11,32,24,8,0.25
CHIHUAHUA CUMBRES,2023-03-12,13,10,3,0.230769230769231
CHIHUAHUA CUMBRES,2023-03-13,25,22,3,0.12
CHIHUAHUA CUMBRES,2023-03-14,22,21,1,0.0454545454545455
CHIHUAHUA CUMBRES,2023-03-15,20,20,0,0
CHIHUAHUA CUMBRES,2023-03-16,29,29,0,0
CHIHUAHUA CUMBRES,2023-03-17,18,18,0,0
CHIHUAHUA CUMBRES,2023-03-18,32,32,0,0
CHIHUAHUA CUMBRES,2023-03-19,23,22,1,0.0434782608695652
CHIHUAHUA CUMBRES,2023-03-20,33,31,2,0.0606060606060606
CHIHUAHUA CUMBRES,2023-03-21,22,22,0,0
CHIHUAHUA CUMBRES,2023-03-22,22,22,0,0
CHIHUAHUA CUMBRES,2023-03-23,27,27,0,0
CHIHUAHUA CUMBRES,2023-03-24,29,29,0,0
CHIHUAHUA CUMBRES,2023-03-25,34,34,0,0
CHIHUAHUA CUMBRES,2023-03-26,20,17,3,0.15
CHIHUAHUA CUMBRES,2023-03-27,22,22,0,0
CHIHUAHUA CUMBRES,2023-03-28,29,29,0,0
CHIHUAHUA CUMBRES,2023-03-29,22,22,0,0
CHIHUAHUA CUMBRES,2023-03-30,37,35,2,0.0540540540540541
CHIHUAHUA CUMBRES,2023-03-31,38,37,1,0.0263157894736842
CHIHUAHUA CUMBRES,2023-04-01,46,40,6,0.130434782608696
CHIHUAHUA CUMBRES,2023-04-02,24,23,1,0.0416666666666667
CHIHUAHUA CUMBRES,2023-04-03,32,30,2,0.0625
CHIHUAHUA CUMBRES,2023-04-04,33,32,1,0.0303030303030303
CHIHUAHUA CUMBRES,2023-04-05,32,29,3,0.09375
CHIHUAHUA CUMBRES,2023-04-06,31,27,4,0.129032258064516
CHIHUAHUA CUMBRES,2023-04-07,26,26,0,0
CHIHUAHUA CUMBRES,2023-04-08,14,14,0,0
CHIHUAHUA CUMBRES,2023-04-09,6,6,0,0
CHIHUAHUA CUMBRES,2023-04-10,29,28,1,0.0344827586206897
CHIHUAHUA CUMBRES,2023-04-11,20,18,2,0.1
CHIHUAHUA CUMBRES,2023-04-12,21,21,0,0
CHIHUAHUA CUMBRES,2023-04-13,29,26,3,0.103448275862069
CHIHUAHUA CUMBRES,2023-04-14,32,30,2,0.0625
CHIHUAHUA CUMBRES,2023-04-15,48,47,1,0.0208333333333333
CHIHUAHUA CUMBRES,2023-04-16,22,21,1,0.0454545454545455
CHIHUAHUA CUMBRES,2023-04-17,39,33,6,0.153846153846154
CHIHUAHUA CUMBRES,2023-04-18,19,17,2,0.105263157894737
CHIHUAHUA CUMBRES,2023-04-19,26,25,1,0.0384615384615385
CHIHUAHUA CUMBRES,2023-04-20,23,22,1,0.0434782608695652
CHIHUAHUA CUMBRES,2023-04-21,32,25,7,0.21875
CHIHUAHUA CUMBRES,2023-04-22,38,35,3,0.0789473684210526
CHIHUAHUA CUMBRES,2023-04-23,15,11,4,0.266666666666667
CHIHUAHUA CUMBRES,2023-04-24,27,22,5,0.185185185185185
CHIHUAHUA CUMBRES,2023-04-25,30,24,6,0.2
CHIHUAHUA CUMBRES,2023-04-26,40,26,14,0.35
CHIHUAHUA CUMBRES,2023-04-27,31,23,8,0.258064516129032
CHIHUAHUA CUMBRES,2023-04-28,33,29,4,0.121212121212121
CHIHUAHUA CUMBRES,2023-04-29,55,45,10,0.181818181818182
CHIHUAHUA CUMBRES,2023-04-30,31,27,4,0.129032258064516
CHIHUAHUA CUMBRES,2023-05-01,20,20,0,0
CHIHUAHUA CUMBRES,2023-05-02,23,21,2,0.0869565217391304
CHIHUAHUA CUMBRES,2023-05-03,26,24,2,0.0769230769230769
CHIHUAHUA CUMBRES,2023-05-04,30,22,8,0.266666666666667
CHIHUAHUA CUMBRES,2023-05-05,23,18,5,0.217391304347826
CHIHUAHUA CUMBRES,2023-05-06,29,25,4,0.137931034482759
CHIHUAHUA CUMBRES,2023-05-07,15,15,0,0
CHIHUAHUA CUMBRES,2023-05-08,29,27,2,0.0689655172413793
CHIHUAHUA EL RELIZ,2023-01-02,23,10,13,0.565217391304348
CHIHUAHUA EL RELIZ,2023-01-03,28,14,14,0.5
CHIHUAHUA EL RELIZ,2023-01-04,42,24,18,0.428571428571429
CHIHUAHUA EL RELIZ,2023-01-05,29,13,16,0.551724137931034
CHIHUAHUA EL RELIZ,2023-01-06,26,10,16,0.615384615384615
CHIHUAHUA EL RELIZ,2023-01-07,28,14,14,0.5
CHIHUAHUA EL RELIZ,2023-01-08,14,5,9,0.642857142857143
CHIHUAHUA EL RELIZ,2023-01-09,26,17,9,0.346153846153846
CHIHUAHUA EL RELIZ,2023-01-10,32,12,20,0.625
CHIHUAHUA EL RELIZ,2023-01-11,26,10,16,0.615384615384615
CHIHUAHUA EL RELIZ,2023-01-12,26,14,12,0.461538461538462
CHIHUAHUA EL RELIZ,2023-01-13,32,19,13,0.40625
CHIHUAHUA EL RELIZ,2023-01-14,28,17,11,0.392857142857143
CHIHUAHUA EL RELIZ,2023-01-15,21,17,4,0.19047619047619
CHIHUAHUA EL RELIZ,2023-01-16,25,14,11,0.44
CHIHUAHUA EL RELIZ,2023-01-17,29,19,10,0.344827586206897
CHIHUAHUA EL RELIZ,2023-01-18,25,14,11,0.44
CHIHUAHUA EL RELIZ,2023-01-19,25,13,12,0.48
CHIHUAHUA EL RELIZ,2023-01-20,33,19,14,0.424242424242424
CHIHUAHUA EL RELIZ,2023-01-21,31,21,10,0.32258064516129
CHIHUAHUA EL RELIZ,2023-01-22,19,13,6,0.315789473684211
CHIHUAHUA EL RELIZ,2023-01-23,20,12,8,0.4
CHIHUAHUA EL RELIZ,2023-01-24,27,18,9,0.333333333333333
CHIHUAHUA EL RELIZ,2023-01-25,22,13,9,0.409090909090909
CHIHUAHUA EL RELIZ,2023-01-26,27,16,11,0.407407407407407
CHIHUAHUA EL RELIZ,2023-01-27,27,17,10,0.37037037037037
CHIHUAHUA EL RELIZ,2023-01-28,33,21,12,0.363636363636364
CHIHUAHUA EL RELIZ,2023-01-29,16,14,2,0.125
CHIHUAHUA EL RELIZ,2023-01-30,23,14,9,0.391304347826087
CHIHUAHUA EL RELIZ,2023-01-31,34,24,10,0.294117647058824
CHIHUAHUA EL RELIZ,2023-02-01,24,19,5,0.208333333333333
CHIHUAHUA EL RELIZ,2023-02-02,34,20,14,0.411764705882353
CHIHUAHUA EL RELIZ,2023-02-03,29,19,10,0.344827586206897
CHIHUAHUA EL RELIZ,2023-02-04,39,25,14,0.358974358974359
CHIHUAHUA EL RELIZ,2023-02-05,16,8,8,0.5
CHIHUAHUA EL RELIZ,2023-02-06,32,20,12,0.375
CHIHUAHUA EL RELIZ,2023-02-07,31,20,11,0.354838709677419
CHIHUAHUA EL RELIZ,2023-02-08,33,19,14,0.424242424242424
CHIHUAHUA EL RELIZ,2023-02-09,35,17,18,0.514285714285714
CHIHUAHUA EL RELIZ,2023-02-10,39,26,13,0.333333333333333
CHIHUAHUA EL RELIZ,2023-02-11,26,13,13,0.5
CHIHUAHUA EL RELIZ,2023-02-12,14,9,5,0.357142857142857
CHIHUAHUA EL RELIZ,2023-02-13,17,9,8,0.470588235294118
CHIHUAHUA EL RELIZ,2023-02-14,30,15,15,0.5
CHIHUAHUA EL RELIZ,2023-02-15,25,15,10,0.4
CHIHUAHUA EL RELIZ,2023-02-16,34,21,13,0.382352941176471
CHIHUAHUA EL RELIZ,2023-02-17,29,14,15,0.517241379310345
CHIHUAHUA EL RELIZ,2023-02-18,32,16,16,0.5
CHIHUAHUA EL RELIZ,2023-02-19,13,6,7,0.538461538461538
CHIHUAHUA EL RELIZ,2023-02-20,35,20,15,0.428571428571429
CHIHUAHUA EL RELIZ,2023-02-21,24,12,12,0.5
CHIHUAHUA EL RELIZ,2023-02-22,31,16,15,0.483870967741935
CHIHUAHUA EL RELIZ,2023-02-23,42,20,22,0.523809523809524
CHIHUAHUA EL RELIZ,2023-02-24,38,22,16,0.421052631578947
CHIHUAHUA EL RELIZ,2023-02-25,31,21,10,0.32258064516129
CHIHUAHUA EL RELIZ,2023-02-26,8,4,4,0.5
CHIHUAHUA EL RELIZ,2023-02-27,31,17,14,0.451612903225806
CHIHUAHUA EL RELIZ,2023-02-28,36,27,9,0.25
CHIHUAHUA EL RELIZ,2023-03-01,28,20,8,0.285714285714286
CHIHUAHUA EL RELIZ,2023-03-02,23,10,13,0.565217391304348
CHIHUAHUA EL RELIZ,2023-03-03,36,25,11,0.305555555555556
CHIHUAHUA EL RELIZ,2023-03-04,29,16,13,0.448275862068966
CHIHUAHUA EL RELIZ,2023-03-05,16,11,5,0.3125
CHIHUAHUA EL RELIZ,2023-03-06,33,20,13,0.393939393939394
CHIHUAHUA EL RELIZ,2023-03-07,28,25,3,0.107142857142857
CHIHUAHUA EL RELIZ,2023-03-08,34,23,11,0.323529411764706
CHIHUAHUA EL RELIZ,2023-03-09,27,23,4,0.148148148148148
CHIHUAHUA EL RELIZ,2023-03-10,20,17,3,0.15
CHIHUAHUA EL RELIZ,2023-03-11,40,35,5,0.125
CHIHUAHUA EL RELIZ,2023-03-12,19,19,0,0
CHIHUAHUA EL RELIZ,2023-03-13,19,17,2,0.105263157894737
CHIHUAHUA EL RELIZ,2023-03-14,29,27,2,0.0689655172413793
CHIHUAHUA EL RELIZ,2023-03-15,26,25,1,0.0384615384615385
CHIHUAHUA EL RELIZ,2023-03-16,42,41,1,0.0238095238095238
CHIHUAHUA EL RELIZ,2023-03-17,29,28,1,0.0344827586206897
CHIHUAHUA EL RELIZ,2023-03-18,34,31,3,0.0882352941176471
CHIHUAHUA EL RELIZ,2023-03-19,27,25,2,0.0740740740740741
CHIHUAHUA EL RELIZ,2023-03-20,34,31,3,0.0882352941176471
CHIHUAHUA EL RELIZ,2023-03-21,37,37,0,0
CHIHUAHUA EL RELIZ,2023-03-22,24,24,0,0
CHIHUAHUA EL RELIZ,2023-03-23,30,29,1,0.0333333333333333
CHIHUAHUA EL RELIZ,2023-03-24,37,35,2,0.0540540540540541
CHIHUAHUA EL RELIZ,2023-03-25,48,47,1,0.0208333333333333
CHIHUAHUA EL RELIZ,2023-03-26,24,24,0,0
CHIHUAHUA EL RELIZ,2023-03-27,12,12,0,0
CHIHUAHUA EL RELIZ,2023-03-28,22,21,1,0.0454545454545455
CHIHUAHUA EL RELIZ,2023-03-29,28,26,2,0.0714285714285714
CHIHUAHUA EL RELIZ,2023-03-30,29,29,0,0
CHIHUAHUA EL RELIZ,2023-03-31,42,42,0,0
CHIHUAHUA EL RELIZ,2023-04-01,48,48,0,0
CHIHUAHUA EL RELIZ,2023-04-02,10,10,0,0
CHIHUAHUA EL RELIZ,2023-04-03,27,27,0,0
CHIHUAHUA EL RELIZ,2023-04-04,29,29,0,0
CHIHUAHUA EL RELIZ,2023-04-05,26,26,0,0
CHIHUAHUA EL RELIZ,2023-04-06,44,44,0,0
CHIHUAHUA EL RELIZ,2023-04-07,32,32,0,0
CHIHUAHUA EL RELIZ,2023-04-08,20,20,0,0
CHIHUAHUA EL RELIZ,2023-04-09,12,12,0,0
CHIHUAHUA EL RELIZ,2023-04-10,35,34,1,0.0285714285714286
CHIHUAHUA EL RELIZ,2023-04-11,27,27,0,0
CHIHUAHUA EL RELIZ,2023-04-12,30,30,0,0
CHIHUAHUA EL RELIZ,2023-04-13,33,31,2,0.0606060606060606
CHIHUAHUA EL RELIZ,2023-04-14,31,28,3,0.0967741935483871
CHIHUAHUA EL RELIZ,2023-04-15,53,51,2,0.0377358490566038
CHIHUAHUA EL RELIZ,2023-04-16,29,29,0,0
CHIHUAHUA EL RELIZ,2023-04-17,29,29,0,0
CHIHUAHUA EL RELIZ,2023-04-18,17,17,0,0
CHIHUAHUA EL RELIZ,2023-04-19,32,29,3,0.09375
CHIHUAHUA EL RELIZ,2023-04-20,29,26,3,0.103448275862069
CHIHUAHUA EL RELIZ,2023-04-21,24,23,1,0.0416666666666667
CHIHUAHUA EL RELIZ,2023-04-22,42,36,6,0.142857142857143
CHIHUAHUA EL RELIZ,2023-04-23,18,17,1,0.0555555555555556
CHIHUAHUA EL RELIZ,2023-04-24,33,30,3,0.0909090909090909
CHIHUAHUA EL RELIZ,2023-04-25,45,27,18,0.4
CHIHUAHUA EL RELIZ,2023-04-26,46,37,9,0.195652173913043
CHIHUAHUA EL RELIZ,2023-04-27,26,24,2,0.0769230769230769
CHIHUAHUA EL RELIZ,2023-04-28,48,41,7,0.145833333333333
CHIHUAHUA EL RELIZ,2023-04-29,49,41,8,0.163265306122449
CHIHUAHUA EL RELIZ,2023-04-30,25,22,3,0.12
CHIHUAHUA EL RELIZ,2023-05-01,19,12,7,0.368421052631579
CHIHUAHUA EL RELIZ,2023-05-02,31,28,3,0.0967741935483871
CHIHUAHUA EL RELIZ,2023-05-03,36,34,2,0.0555555555555556
CHIHUAHUA EL RELIZ,2023-05-04,32,28,4,0.125
CHIHUAHUA EL RELIZ,2023-05-05,42,40,2,0.0476190476190476
CHIHUAHUA EL RELIZ,2023-05-06,24,21,3,0.125
CHIHUAHUA EL RELIZ,2023-05-07,15,14,1,0.0666666666666667
CHIHUAHUA EL RELIZ,2023-05-08,32,27,5,0.15625
CIUDAD OBREGON / NAVOJOA,2023-01-02,15,10,5,0.333333333333333
CIUDAD OBREGON / NAVOJOA,2023-01-03,21,11,10,0.476190476190476
CIUDAD OBREGON / NAVOJOA,2023-01-04,17,7,10,0.588235294117647
CIUDAD OBREGON / NAVOJOA,2023-01-05,25,10,15,0.6
CIUDAD OBREGON / NAVOJOA,2023-01-06,17,7,10,0.588235294117647
CIUDAD OBREGON / NAVOJOA,2023-01-07,28,16,12,0.428571428571429
CIUDAD OBREGON / NAVOJOA,2023-01-08,13,4,9,0.692307692307692
CIUDAD OBREGON / NAVOJOA,2023-01-09,25,14,11,0.44
CIUDAD OBREGON / NAVOJOA,2023-01-10,27,14,13,0.481481481481481
CIUDAD OBREGON / NAVOJOA,2023-01-11,24,9,15,0.625
CIUDAD OBREGON / NAVOJOA,2023-01-12,18,12,6,0.333333333333333
CIUDAD OBREGON / NAVOJOA,2023-01-13,21,12,9,0.428571428571429
CIUDAD OBREGON / NAVOJOA,2023-01-14,24,15,9,0.375
CIUDAD OBREGON / NAVOJOA,2023-01-15,18,12,6,0.333333333333333
CIUDAD OBREGON / NAVOJOA,2023-01-16,21,9,12,0.571428571428571
CIUDAD OBREGON / NAVOJOA,2023-01-17,23,10,13,0.565217391304348
CIUDAD OBREGON / NAVOJOA,2023-01-18,23,11,12,0.521739130434783
CIUDAD OBREGON / NAVOJOA,2023-01-19,22,7,15,0.681818181818182
CIUDAD OBREGON / NAVOJOA,2023-01-20,13,4,9,0.692307692307692
CIUDAD OBREGON / NAVOJOA,2023-01-21,24,12,12,0.5
CIUDAD OBREGON / NAVOJOA,2023-01-22,20,10,10,0.5
CIUDAD OBREGON / NAVOJOA,2023-01-23,20,14,6,0.3
CIUDAD OBREGON / NAVOJOA,2023-01-24,18,10,8,0.444444444444444
CIUDAD OBREGON / NAVOJOA,2023-01-25,23,9,14,0.608695652173913
CIUDAD OBREGON / NAVOJOA,2023-01-26,26,10,16,0.615384615384615
CIUDAD OBREGON / NAVOJOA,2023-01-27,26,15,11,0.423076923076923
CIUDAD OBREGON / NAVOJOA,2023-01-28,17,8,9,0.529411764705882
CIUDAD OBREGON / NAVOJOA,2023-01-29,21,17,4,0.19047619047619
CIUDAD OBREGON / NAVOJOA,2023-01-30,25,12,13,0.52
CIUDAD OBREGON / NAVOJOA,2023-01-31,31,18,13,0.419354838709677
CIUDAD OBREGON / NAVOJOA,2023-02-01,20,13,7,0.35
CIUDAD OBREGON / NAVOJOA,2023-02-02,19,13,6,0.315789473684211
CIUDAD OBREGON / NAVOJOA,2023-02-03,28,19,9,0.321428571428571
CIUDAD OBREGON / NAVOJOA,2023-02-04,23,14,9,0.391304347826087
CIUDAD OBREGON / NAVOJOA,2023-02-05,19,12,7,0.368421052631579
CIUDAD OBREGON / NAVOJOA,2023-02-06,20,15,5,0.25
CIUDAD OBREGON / NAVOJOA,2023-02-07,17,11,6,0.352941176470588
CIUDAD OBREGON / NAVOJOA,2023-02-08,20,13,7,0.35
CIUDAD OBREGON / NAVOJOA,2023-02-09,17,9,8,0.470588235294118
CIUDAD OBREGON / NAVOJOA,2023-02-10,22,12,10,0.454545454545455
CIUDAD OBREGON / NAVOJOA,2023-02-11,21,8,13,0.619047619047619
CIUDAD OBREGON / NAVOJOA,2023-02-12,7,3,4,0.571428571428571
CIUDAD OBREGON / NAVOJOA,2023-02-13,18,9,9,0.5
CIUDAD OBREGON / NAVOJOA,2023-02-14,18,9,9,0.5
CIUDAD OBREGON / NAVOJOA,2023-02-15,25,15,10,0.4
CIUDAD OBREGON / NAVOJOA,2023-02-16,22,11,11,0.5
CIUDAD OBREGON / NAVOJOA,2023-02-17,23,10,13,0.565217391304348
CIUDAD OBREGON / NAVOJOA,2023-02-18,20,11,9,0.45
CIUDAD OBREGON / NAVOJOA,2023-02-19,11,9,2,0.181818181818182
CIUDAD OBREGON / NAVOJOA,2023-02-20,25,10,15,0.6
CIUDAD OBREGON / NAVOJOA,2023-02-21,23,13,10,0.434782608695652
CIUDAD OBREGON / NAVOJOA,2023-02-22,16,9,7,0.4375
CIUDAD OBREGON / NAVOJOA,2023-02-23,22,18,4,0.181818181818182
CIUDAD OBREGON / NAVOJOA,2023-02-24,26,16,10,0.384615384615385
CIUDAD OBREGON / NAVOJOA,2023-02-25,20,10,10,0.5
CIUDAD OBREGON / NAVOJOA,2023-02-26,9,5,4,0.444444444444444
CIUDAD OBREGON / NAVOJOA,2023-02-27,23,12,11,0.478260869565217
CIUDAD OBREGON / NAVOJOA,2023-02-28,29,17,12,0.413793103448276
CIUDAD OBREGON / NAVOJOA,2023-03-01,20,13,7,0.35
CIUDAD OBREGON / NAVOJOA,2023-03-02,18,10,8,0.444444444444444
CIUDAD OBREGON / NAVOJOA,2023-03-03,27,17,10,0.37037037037037
CIUDAD OBREGON / NAVOJOA,2023-03-04,20,9,11,0.55
CIUDAD OBREGON / NAVOJOA,2023-03-05,16,8,8,0.5
CIUDAD OBREGON / NAVOJOA,2023-03-06,24,13,11,0.458333333333333
CIUDAD OBREGON / NAVOJOA,2023-03-07,31,14,17,0.548387096774194
CIUDAD OBREGON / NAVOJOA,2023-03-08,23,8,15,0.652173913043478
CIUDAD OBREGON / NAVOJOA,2023-03-09,24,14,10,0.416666666666667
CIUDAD OBREGON / NAVOJOA,2023-03-10,21,12,9,0.428571428571429
CIUDAD OBREGON / NAVOJOA,2023-03-11,28,13,15,0.535714285714286
CIUDAD OBREGON / NAVOJOA,2023-03-12,16,11,5,0.3125
CIUDAD OBREGON / NAVOJOA,2023-03-13,17,14,3,0.176470588235294
CIUDAD OBREGON / NAVOJOA,2023-03-14,17,16,1,0.0588235294117647
CIUDAD OBREGON / NAVOJOA,2023-03-15,8,8,0,0
CIUDAD OBREGON / NAVOJOA,2023-03-16,26,26,0,0
CIUDAD OBREGON / NAVOJOA,2023-03-17,26,26,0,0
CIUDAD OBREGON / NAVOJOA,2023-03-18,27,23,4,0.148148148148148
CIUDAD OBREGON / NAVOJOA,2023-03-19,17,17,0,0
CIUDAD OBREGON / NAVOJOA,2023-03-20,31,30,1,0.032258064516129
CIUDAD OBREGON / NAVOJOA,2023-03-21,22,21,1,0.0454545454545455
CIUDAD OBREGON / NAVOJOA,2023-03-22,26,24,2,0.0769230769230769
CIUDAD OBREGON / NAVOJOA,2023-03-23,18,15,3,0.166666666666667
CIUDAD OBREGON / NAVOJOA,2023-03-24,26,22,4,0.153846153846154
CIUDAD OBREGON / NAVOJOA,2023-03-25,35,35,0,0
CIUDAD OBREGON / NAVOJOA,2023-03-26,33,32,1,0.0303030303030303
CIUDAD OBREGON / NAVOJOA,2023-03-27,13,13,0,0
CIUDAD OBREGON / NAVOJOA,2023-03-28,19,18,1,0.0526315789473684
CIUDAD OBREGON / NAVOJOA,2023-03-29,31,31,0,0
CIUDAD OBREGON / NAVOJOA,2023-03-30,31,31,0,0
CIUDAD OBREGON / NAVOJOA,2023-03-31,36,35,1,0.0277777777777778
CIUDAD OBREGON / NAVOJOA,2023-04-01,20,20,0,0
CIUDAD OBREGON / NAVOJOA,2023-04-02,17,17,0,0
CIUDAD OBREGON / NAVOJOA,2023-04-03,27,25,2,0.0740740740740741
CIUDAD OBREGON / NAVOJOA,2023-04-04,33,32,1,0.0303030303030303
CIUDAD OBREGON / NAVOJOA,2023-04-05,15,15,0,0
CIUDAD OBREGON / NAVOJOA,2023-04-06,23,23,0,0
CIUDAD OBREGON / NAVOJOA,2023-04-07,11,11,0,0
CIUDAD OBREGON / NAVOJOA,2023-04-08,11,11,0,0
CIUDAD OBREGON / NAVOJOA,2023-04-09,9,9,0,0
CIUDAD OBREGON / NAVOJOA,2023-04-10,19,19,0,0
CIUDAD OBREGON / NAVOJOA,2023-04-11,19,19,0,0
CIUDAD OBREGON / NAVOJOA,2023-04-12,21,21,0,0
CIUDAD OBREGON / NAVOJOA,2023-04-13,21,21,0,0
CIUDAD OBREGON / NAVOJOA,2023-04-14,37,37,0,0
CIUDAD OBREGON / NAVOJOA,2023-04-15,51,50,1,0.0196078431372549
CIUDAD OBREGON / NAVOJOA,2023-04-16,40,40,0,0
CIUDAD OBREGON / NAVOJOA,2023-04-17,17,17,0,0
CIUDAD OBREGON / NAVOJOA,2023-04-18,21,21,0,0
CIUDAD OBREGON / NAVOJOA,2023-04-19,22,22,0,0
CIUDAD OBREGON / NAVOJOA,2023-04-20,15,15,0,0
CIUDAD OBREGON / NAVOJOA,2023-04-21,18,18,0,0
CIUDAD OBREGON / NAVOJOA,2023-04-22,19,19,0,0
CIUDAD OBREGON / NAVOJOA,2023-04-23,19,19,0,0
CIUDAD OBREGON / NAVOJOA,2023-04-24,27,27,0,0
CIUDAD OBREGON / NAVOJOA,2023-04-25,36,35,1,0.0277777777777778
CIUDAD OBREGON / NAVOJOA,2023-04-26,19,19,0,0
CIUDAD OBREGON / NAVOJOA,2023-04-27,20,20,0,0
CIUDAD OBREGON / NAVOJOA,2023-04-28,33,29,4,0.121212121212121
CIUDAD OBREGON / NAVOJOA,2023-04-29,42,39,3,0.0714285714285714
CIUDAD OBREGON / NAVOJOA,2023-04-30,31,27,4,0.129032258064516
CIUDAD OBREGON / NAVOJOA,2023-05-01,43,38,5,0.116279069767442
CIUDAD OBREGON / NAVOJOA,2023-05-02,30,28,2,0.0666666666666667
CIUDAD OBREGON / NAVOJOA,2023-05-03,30,28,2,0.0666666666666667
CIUDAD OBREGON / NAVOJOA,2023-05-04,22,21,1,0.0454545454545455
CIUDAD OBREGON / NAVOJOA,2023-05-05,23,17,6,0.260869565217391
CIUDAD OBREGON / NAVOJOA,2023-05-06,19,17,2,0.105263157894737
CIUDAD OBREGON / NAVOJOA,2023-05-07,17,13,4,0.235294117647059
CIUDAD OBREGON / NAVOJOA,2023-05-08,23,22,1,0.0434782608695652
CIUDAD VICTORIA,2023-01-02,21,21,0,0
CIUDAD VICTORIA,2023-01-03,27,27,0,0
CIUDAD VICTORIA,2023-01-04,29,29,0,0
CIUDAD VICTORIA,2023-01-05,23,23,0,0
CIUDAD VICTORIA,2023-01-06,17,17,0,0
CIUDAD VICTORIA,2023-01-07,22,22,0,0
CIUDAD VICTORIA,2023-01-08,16,16,0,0
CIUDAD VICTORIA,2023-01-09,24,24,0,0
CIUDAD VICTORIA,2023-01-10,32,32,0,0
CIUDAD VICTORIA,2023-01-11,25,25,0,0
CIUDAD VICTORIA,2023-01-12,25,25,0,0
CIUDAD VICTORIA,2023-01-13,25,25,0,0
CIUDAD VICTORIA,2023-01-14,29,29,0,0
CIUDAD VICTORIA,2023-01-15,17,17,0,0
CIUDAD VICTORIA,2023-01-16,25,23,2,0.08
CIUDAD VICTORIA,2023-01-17,27,27,0,0
CIUDAD VICTORIA,2023-01-18,25,23,2,0.08
CIUDAD VICTORIA,2023-01-19,23,23,0,0
CIUDAD VICTORIA,2023-01-20,28,26,2,0.0714285714285714
CIUDAD VICTORIA,2023-01-21,29,27,2,0.0689655172413793
CIUDAD VICTORIA,2023-01-22,15,15,0,0
CIUDAD VICTORIA,2023-01-23,11,10,1,0.0909090909090909
CIUDAD VICTORIA,2023-01-24,21,20,1,0.0476190476190476
CIUDAD VICTORIA,2023-01-25,17,17,0,0
CIUDAD VICTORIA,2023-01-26,22,21,1,0.0454545454545455
CIUDAD VICTORIA,2023-01-27,21,20,1,0.0476190476190476
CIUDAD VICTORIA,2023-01-28,33,29,4,0.121212121212121
CIUDAD VICTORIA,2023-01-29,15,15,0,0
CIUDAD VICTORIA,2023-01-30,16,16,0,0
CIUDAD VICTORIA,2023-01-31,22,20,2,0.0909090909090909
CIUDAD VICTORIA,2023-02-01,30,29,1,0.0333333333333333
CIUDAD VICTORIA,2023-02-02,21,21,0,0
CIUDAD VICTORIA,2023-02-03,16,16,0,0
CIUDAD VICTORIA,2023-02-04,27,26,1,0.037037037037037
CIUDAD VICTORIA,2023-02-05,19,19,0,0
CIUDAD VICTORIA,2023-02-06,16,15,1,0.0625
CIUDAD VICTORIA,2023-02-07,20,19,1,0.05
CIUDAD VICTORIA,2023-02-08,18,16,2,0.111111111111111
CIUDAD VICTORIA,2023-02-09,20,19,1,0.05
CIUDAD VICTORIA,2023-02-10,22,21,1,0.0454545454545455
CIUDAD VICTORIA,2023-02-11,25,24,1,0.04
CIUDAD VICTORIA,2023-02-12,15,13,2,0.133333333333333
CIUDAD VICTORIA,2023-02-13,14,13,1,0.0714285714285714
CIUDAD VICTORIA,2023-02-14,19,17,2,0.105263157894737
CIUDAD VICTORIA,2023-02-15,25,25,0,0
CIUDAD VICTORIA,2023-02-16,22,18,4,0.181818181818182
CIUDAD VICTORIA,2023-02-17,16,15,1,0.0625
CIUDAD VICTORIA,2023-02-18,24,23,1,0.0416666666666667
CIUDAD VICTORIA,2023-02-19,9,9,0,0
CIUDAD VICTORIA,2023-02-20,19,18,1,0.0526315789473684
CIUDAD VICTORIA,2023-02-21,20,19,1,0.05
CIUDAD VICTORIA,2023-02-22,22,22,0,0
CIUDAD VICTORIA,2023-02-23,17,16,1,0.0588235294117647
CIUDAD VICTORIA,2023-02-24,17,16,1,0.0588235294117647
CIUDAD VICTORIA,2023-02-25,19,19,0,0
CIUDAD VICTORIA,2023-02-26,11,11,0,0
CIUDAD VICTORIA,2023-02-27,17,17,0,0
CIUDAD VICTORIA,2023-02-28,29,26,3,0.103448275862069
CIUDAD VICTORIA,2023-03-01,23,21,2,0.0869565217391304
CIUDAD VICTORIA,2023-03-02,37,36,1,0.027027027027027
CIUDAD VICTORIA,2023-03-03,21,19,2,0.0952380952380952
CIUDAD VICTORIA,2023-03-04,30,28,2,0.0666666666666667
CIUDAD VICTORIA,2023-03-05,16,16,0,0
CIUDAD VICTORIA,2023-03-06,14,14,0,0
CIUDAD VICTORIA,2023-03-07,23,21,2,0.0869565217391304
CIUDAD VICTORIA,2023-03-08,13,12,1,0.0769230769230769
CIUDAD VICTORIA,2023-03-09,23,23,0,0
CIUDAD VICTORIA,2023-03-10,15,15,0,0
CIUDAD VICTORIA,2023-03-11,27,25,2,0.0740740740740741
CIUDAD VICTORIA,2023-03-12,15,15,0,0
CIUDAD VICTORIA,2023-03-13,22,22,0,0
CIUDAD VICTORIA,2023-03-14,29,27,2,0.0689655172413793
CIUDAD VICTORIA,2023-03-15,32,32,0,0
CIUDAD VICTORIA,2023-03-16,27,27,0,0
CIUDAD VICTORIA,2023-03-17,29,29,0,0
CIUDAD VICTORIA,2023-03-18,44,44,0,0
CIUDAD VICTORIA,2023-03-19,29,29,0,0
CIUDAD VICTORIA,2023-03-20,29,29,0,0
CIUDAD VICTORIA,2023-03-21,31,31,0,0
CIUDAD VICTORIA,2023-03-22,25,25,0,0
CIUDAD VICTORIA,2023-03-23,21,21,0,0
CIUDAD VICTORIA,2023-03-24,19,19,0,0
CIUDAD VICTORIA,2023-03-25,25,25,0,0
CIUDAD VICTORIA,2023-03-26,19,17,2,0.105263157894737
CIUDAD VICTORIA,2023-03-27,13,13,0,0
CIUDAD VICTORIA,2023-03-28,14,14,0,0
CIUDAD VICTORIA,2023-03-29,18,18,0,0
CIUDAD VICTORIA,2023-03-30,18,17,1,0.0555555555555556
CIUDAD VICTORIA,2023-03-31,41,41,0,0
CIUDAD VICTORIA,2023-04-01,39,39,0,0
CIUDAD VICTORIA,2023-04-02,18,17,1,0.0555555555555556
CIUDAD VICTORIA,2023-04-03,31,31,0,0
CIUDAD VICTORIA,2023-04-04,28,26,2,0.0714285714285714
CIUDAD VICTORIA,2023-04-05,17,17,0,0
CIUDAD VICTORIA,2023-04-06,19,18,1,0.0526315789473684
CIUDAD VICTORIA,2023-04-07,10,10,0,0
CIUDAD VICTORIA,2023-04-08,16,16,0,0
CIUDAD VICTORIA,2023-04-09,7,7,0,0
CIUDAD VICTORIA,2023-04-10,13,13,0,0
CIUDAD VICTORIA,2023-04-11,16,16,0,0
CIUDAD VICTORIA,2023-04-12,13,12,1,0.0769230769230769
CIUDAD VICTORIA,2023-04-13,23,23,0,0
CIUDAD VICTORIA,2023-04-14,20,20,0,0
CIUDAD VICTORIA,2023-04-15,34,33,1,0.0294117647058824
CIUDAD VICTORIA,2023-04-16,18,18,0,0
CIUDAD VICTORIA,2023-04-17,28,27,1,0.0357142857142857
CIUDAD VICTORIA,2023-04-18,29,27,2,0.0689655172413793
CIUDAD VICTORIA,2023-04-19,18,17,1,0.0555555555555556
CIUDAD VICTORIA,2023-04-20,22,19,3,0.136363636363636
CIUDAD VICTORIA,2023-04-21,26,25,1,0.0384615384615385
CIUDAD VICTORIA,2023-04-22,26,24,2,0.0769230769230769
CIUDAD VICTORIA,2023-04-23,21,20,1,0.0476190476190476
CIUDAD VICTORIA,2023-04-24,20,18,2,0.1
CIUDAD VICTORIA,2023-04-25,25,23,2,0.08
CIUDAD VICTORIA,2023-04-26,25,24,1,0.04
CIUDAD VICTORIA,2023-04-27,17,14,3,0.176470588235294
CIUDAD VICTORIA,2023-04-28,31,30,1,0.032258064516129
CIUDAD VICTORIA,2023-04-29,30,27,3,0.1
CIUDAD VICTORIA,2023-04-30,24,23,1,0.0416666666666667
CIUDAD VICTORIA,2023-05-01,18,16,2,0.111111111111111
CIUDAD VICTORIA,2023-05-02,18,18,0,0
CIUDAD VICTORIA,2023-05-03,28,27,1,0.0357142857142857
CIUDAD VICTORIA,2023-05-04,18,17,1,0.0555555555555556
CIUDAD VICTORIA,2023-05-05,24,23,1,0.0416666666666667
CIUDAD VICTORIA,2023-05-06,29,27,2,0.0689655172413793
CIUDAD VICTORIA,2023-05-07,20,19,1,0.05
CIUDAD VICTORIA,2023-05-08,19,18,1,0.0526315789473684
COACALCO,2023-01-02,29,15,14,0.482758620689655
COACALCO,2023-01-03,38,16,22,0.578947368421053
COACALCO,2023-01-04,33,14,19,0.575757575757576
COACALCO,2023-01-05,40,16,24,0.6
COACALCO,2023-01-06,28,17,11,0.392857142857143
COACALCO,2023-01-07,39,17,22,0.564102564102564
COACALCO,2023-01-08,39,17,22,0.564102564102564
COACALCO,2023-01-09,50,24,26,0.52
COACALCO,2023-01-10,40,24,16,0.4
COACALCO,2023-01-11,36,17,19,0.527777777777778
COACALCO,2023-01-12,50,27,23,0.46
COACALCO,2023-01-13,51,22,29,0.568627450980392
COACALCO,2023-01-14,56,26,30,0.535714285714286
COACALCO,2023-01-15,47,15,32,0.680851063829787
COACALCO,2023-01-16,32,18,14,0.4375
COACALCO,2023-01-17,48,24,24,0.5
COACALCO,2023-01-18,50,14,36,0.72
COACALCO,2023-01-19,39,16,23,0.58974358974359
COACALCO,2023-01-20,29,9,20,0.689655172413793
COACALCO,2023-01-21,47,23,24,0.51063829787234
COACALCO,2023-01-22,29,7,22,0.758620689655172
COACALCO,2023-01-23,41,15,26,0.634146341463415
COACALCO,2023-01-24,27,11,16,0.592592592592593
COACALCO,2023-01-25,39,15,24,0.615384615384615
COACALCO,2023-01-26,26,4,22,0.846153846153846
COACALCO,2023-01-27,39,14,25,0.641025641025641
COACALCO,2023-01-28,43,18,25,0.581395348837209
COACALCO,2023-01-29,49,22,27,0.551020408163265
COACALCO,2023-01-30,29,12,17,0.586206896551724
COACALCO,2023-01-31,45,11,34,0.755555555555556
COACALCO,2023-02-01,25,10,15,0.6
COACALCO,2023-02-02,49,26,23,0.469387755102041
COACALCO,2023-02-03,33,17,16,0.484848484848485
COACALCO,2023-02-04,35,7,28,0.8
COACALCO,2023-02-05,43,22,21,0.488372093023256
COACALCO,2023-02-06,44,15,29,0.659090909090909
COACALCO,2023-02-07,42,9,33,0.785714285714286
COACALCO,2023-02-08,31,10,21,0.67741935483871
COACALCO,2023-02-09,42,12,30,0.714285714285714
COACALCO,2023-02-10,30,6,24,0.8
COACALCO,2023-02-11,33,7,26,0.787878787878788
COACALCO,2023-02-12,42,12,30,0.714285714285714
COACALCO,2023-02-13,32,7,25,0.78125
COACALCO,2023-02-14,34,9,25,0.735294117647059
COACALCO,2023-02-15,29,5,24,0.827586206896552
COACALCO,2023-02-16,31,11,20,0.645161290322581
COACALCO,2023-02-17,46,8,38,0.826086956521739
COACALCO,2023-02-18,48,10,38,0.791666666666667
COACALCO,2023-02-19,51,16,35,0.686274509803922
COACALCO,2023-02-20,40,12,28,0.7
COACALCO,2023-02-21,30,8,22,0.733333333333333
COACALCO,2023-02-22,40,13,27,0.675
COACALCO,2023-02-23,30,15,15,0.5
COACALCO,2023-02-24,34,21,13,0.382352941176471
COACALCO,2023-02-25,46,26,20,0.434782608695652
COACALCO,2023-02-26,41,16,25,0.609756097560976
COACALCO,2023-02-27,36,18,18,0.5
COACALCO,2023-02-28,42,26,16,0.380952380952381
COACALCO,2023-03-01,35,19,16,0.457142857142857
COACALCO,2023-03-02,29,11,18,0.620689655172414
COACALCO,2023-03-03,43,21,22,0.511627906976744
COACALCO,2023-03-04,36,23,13,0.361111111111111
COACALCO,2023-03-05,37,18,19,0.513513513513513
COACALCO,2023-03-06,39,20,19,0.487179487179487
COACALCO,2023-03-07,25,14,11,0.44
COACALCO,2023-03-08,39,26,13,0.333333333333333
COACALCO,2023-03-09,49,28,21,0.428571428571429
COACALCO,2023-03-10,32,18,14,0.4375
COACALCO,2023-03-11,46,32,14,0.304347826086957
COACALCO,2023-03-12,29,17,12,0.413793103448276
COACALCO,2023-03-13,34,21,13,0.382352941176471
COACALCO,2023-03-14,37,24,13,0.351351351351351
COACALCO,2023-03-15,46,44,2,0.0434782608695652
COACALCO,2023-03-16,45,45,0,0
COACALCO,2023-03-17,75,75,0,0
COACALCO,2023-03-18,62,60,2,0.032258064516129
COACALCO,2023-03-19,69,65,4,0.0579710144927536
COACALCO,2023-03-20,88,86,2,0.0227272727272727
COACALCO,2023-03-21,51,51,0,0
COACALCO,2023-03-22,60,59,1,0.0166666666666667
COACALCO,2023-03-23,38,37,1,0.0263157894736842
COACALCO,2023-03-24,35,35,0,0
COACALCO,2023-03-25,48,48,0,0
COACALCO,2023-03-26,47,47,0,0
COACALCO,2023-03-27,32,32,0,0
COACALCO,2023-03-28,30,30,0,0
COACALCO,2023-03-29,42,42,0,0
COACALCO,2023-03-30,36,36,0,0
COACALCO,2023-03-31,54,54,0,0
COACALCO,2023-04-01,55,55,0,0
COACALCO,2023-04-02,55,55,0,0
COACALCO,2023-04-03,52,52,0,0
COACALCO,2023-04-04,22,22,0,0
COACALCO,2023-04-05,37,37,0,0
COACALCO,2023-04-06,50,50,0,0
COACALCO,2023-04-07,48,48,0,0
COACALCO,2023-04-08,46,46,0,0
COACALCO,2023-04-09,21,21,0,0
COACALCO,2023-04-10,39,39,0,0
COACALCO,2023-04-11,32,32,0,0
COACALCO,2023-04-12,33,33,0,0
COACALCO,2023-04-13,33,33,0,0
COACALCO,2023-04-14,49,49,0,0
COACALCO,2023-04-15,72,72,0,0
COACALCO,2023-04-16,40,40,0,0
COACALCO,2023-04-17,62,62,0,0
COACALCO,2023-04-18,58,58,0,0
COACALCO,2023-04-19,37,37,0,0
COACALCO,2023-04-20,38,38,0,0
COACALCO,2023-04-21,32,32,0,0
COACALCO,2023-04-22,40,40,0,0
COACALCO,2023-04-23,33,33,0,0
COACALCO,2023-04-24,52,52,0,0
COACALCO,2023-04-25,43,43,0,0
COACALCO,2023-04-26,54,54,0,0
COACALCO,2023-04-27,41,41,0,0
COACALCO,2023-04-28,31,31,0,0
COACALCO,2023-04-29,67,67,0,0
COACALCO,2023-04-30,63,63,0,0
COACALCO,2023-05-01,44,44,0,0
COACALCO,2023-05-02,49,49,0,0
COACALCO,2023-05-03,32,32,0,0
COACALCO,2023-05-04,34,34,0,0
COACALCO,2023-05-05,39,39,0,0
COACALCO,2023-05-06,36,36,0,0
COACALCO,2023-05-07,28,28,0,0
COACALCO,2023-05-08,36,36,0,0
COATZA / MINA,2023-01-02,9,9,0,0
COATZA / MINA,2023-01-03,8,7,1,0.125
COATZA / MINA,2023-01-04,15,12,3,0.2
COATZA / MINA,2023-01-05,10,9,1,0.1
COATZA / MINA,2023-01-06,17,13,4,0.235294117647059
COATZA / MINA,2023-01-07,16,15,1,0.0625
COATZA / MINA,2023-01-08,16,11,5,0.3125
COATZA / MINA,2023-01-09,25,21,4,0.16
COATZA / MINA,2023-01-10,17,13,4,0.235294117647059
COATZA / MINA,2023-01-11,18,17,1,0.0555555555555556
COATZA / MINA,2023-01-12,17,14,3,0.176470588235294
COATZA / MINA,2023-01-13,13,12,1,0.0769230769230769
COATZA / MINA,2023-01-14,12,9,3,0.25
COATZA / MINA,2023-01-15,12,9,3,0.25
COATZA / MINA,2023-01-16,12,11,1,0.0833333333333333
COATZA / MINA,2023-01-17,16,13,3,0.1875
COATZA / MINA,2023-01-18,19,13,6,0.315789473684211
COATZA / MINA,2023-01-19,16,14,2,0.125
COATZA / MINA,2023-01-20,17,15,2,0.117647058823529
COATZA / MINA,2023-01-21,13,9,4,0.307692307692308
COATZA / MINA,2023-01-22,12,10,2,0.166666666666667
COATZA / MINA,2023-01-23,13,9,4,0.307692307692308
COATZA / MINA,2023-01-24,9,8,1,0.111111111111111
COATZA / MINA,2023-01-25,20,16,4,0.2
COATZA / MINA,2023-01-26,13,7,6,0.461538461538462
COATZA / MINA,2023-01-27,8,8,0,0
COATZA / MINA,2023-01-28,14,10,4,0.285714285714286
COATZA / MINA,2023-01-29,19,17,2,0.105263157894737
COATZA / MINA,2023-01-30,13,9,4,0.307692307692308
COATZA / MINA,2023-01-31,11,6,5,0.454545454545455
COATZA / MINA,2023-02-01,24,16,8,0.333333333333333
COATZA / MINA,2023-02-02,22,13,9,0.409090909090909
COATZA / MINA,2023-02-03,13,6,7,0.538461538461538
COATZA / MINA,2023-02-04,17,4,13,0.764705882352941
COATZA / MINA,2023-02-05,19,10,9,0.473684210526316
COATZA / MINA,2023-02-06,28,10,18,0.642857142857143
COATZA / MINA,2023-02-07,16,8,8,0.5
COATZA / MINA,2023-02-08,15,13,2,0.133333333333333
COATZA / MINA,2023-02-09,10,6,4,0.4
COATZA / MINA,2023-02-10,15,8,7,0.466666666666667
COATZA / MINA,2023-02-11,13,8,5,0.384615384615385
COATZA / MINA,2023-02-12,20,14,6,0.3
COATZA / MINA,2023-02-13,4,3,1,0.25
COATZA / MINA,2023-02-14,15,8,7,0.466666666666667
COATZA / MINA,2023-02-15,16,9,7,0.4375
COATZA / MINA,2023-02-16,13,4,9,0.692307692307692
COATZA / MINA,2023-02-17,12,6,6,0.5
COATZA / MINA,2023-02-18,19,5,14,0.736842105263158
COATZA / MINA,2023-02-19,15,8,7,0.466666666666667
COATZA / MINA,2023-02-20,15,7,8,0.533333333333333
COATZA / MINA,2023-02-21,15,9,6,0.4
COATZA / MINA,2023-02-22,14,10,4,0.285714285714286
COATZA / MINA,2023-02-23,15,8,7,0.466666666666667
COATZA / MINA,2023-02-24,15,11,4,0.266666666666667
COATZA / MINA,2023-02-25,14,10,4,0.285714285714286
COATZA / MINA,2023-02-26,21,16,5,0.238095238095238
COATZA / MINA,2023-02-27,11,9,2,0.181818181818182
COATZA / MINA,2023-02-28,16,9,7,0.4375
COATZA / MINA,2023-03-01,12,9,3,0.25
COATZA / MINA,2023-03-02,16,5,11,0.6875
COATZA / MINA,2023-03-03,18,11,7,0.388888888888889
COATZA / MINA,2023-03-04,29,16,13,0.448275862068966
COATZA / MINA,2023-03-05,15,7,8,0.533333333333333
COATZA / MINA,2023-03-06,18,13,5,0.277777777777778
COATZA / MINA,2023-03-07,16,9,7,0.4375
COATZA / MINA,2023-03-08,13,11,2,0.153846153846154
COATZA / MINA,2023-03-09,12,9,3,0.25
COATZA / MINA,2023-03-10,26,24,2,0.0769230769230769
COATZA / MINA,2023-03-11,20,18,2,0.1
COATZA / MINA,2023-03-12,11,11,0,0
COATZA / MINA,2023-03-13,23,23,0,0
COATZA / MINA,2023-03-14,29,27,2,0.0689655172413793
COATZA / MINA,2023-03-15,10,9,1,0.1
COATZA / MINA,2023-03-16,29,27,2,0.0689655172413793
COATZA / MINA,2023-03-17,28,27,1,0.0357142857142857
COATZA / MINA,2023-03-18,31,30,1,0.032258064516129
COATZA / MINA,2023-03-19,20,20,0,0
COATZA / MINA,2023-03-20,25,25,0,0
COATZA / MINA,2023-03-21,16,15,1,0.0625
COATZA / MINA,2023-03-22,14,14,0,0
COATZA / MINA,2023-03-23,15,15,0,0
COATZA / MINA,2023-03-24,29,29,0,0
COATZA / MINA,2023-03-25,19,19,0,0
COATZA / MINA,2023-03-26,19,18,1,0.0526315789473684
COATZA / MINA,2023-03-27,14,14,0,0
COATZA / MINA,2023-03-28,15,15,0,0
COATZA / MINA,2023-03-29,12,12,0,0
COATZA / MINA,2023-03-30,22,22,0,0
COATZA / MINA,2023-03-31,24,24,0,0
COATZA / MINA,2023-04-01,22,22,0,0
COATZA / MINA,2023-04-02,16,16,0,0
COATZA / MINA,2023-04-03,13,13,0,0
COATZA / MINA,2023-04-04,16,16,0,0
COATZA / MINA,2023-04-05,15,13,2,0.133333333333333
COATZA / MINA,2023-04-06,11,10,1,0.0909090909090909
COATZA / MINA,2023-04-07,10,10,0,0
COATZA / MINA,2023-04-08,10,10,0,0
COATZA / MINA,2023-04-09,5,4,1,0.2
COATZA / MINA,2023-04-10,13,11,2,0.153846153846154
COATZA / MINA,2023-04-11,12,12,0,0
COATZA / MINA,2023-04-12,23,22,1,0.0434782608695652
COATZA / MINA,2023-04-13,11,11,0,0
COATZA / MINA,2023-04-14,20,19,1,0.05
COATZA / MINA,2023-04-15,26,24,2,0.0769230769230769
COATZA / MINA,2023-04-16,25,25,0,0
COATZA / MINA,2023-04-17,18,17,1,0.0555555555555556
COATZA / MINA,2023-04-18,14,13,1,0.0714285714285714
COATZA / MINA,2023-04-19,17,17,0,0
COATZA / MINA,2023-04-20,15,14,1,0.0666666666666667
COATZA / MINA,2023-04-21,20,18,2,0.1
COATZA / MINA,2023-04-22,14,13,1,0.0714285714285714
COATZA / MINA,2023-04-23,19,19,0,0
COATZA / MINA,2023-04-24,20,19,1,0.05
COATZA / MINA,2023-04-25,30,29,1,0.0333333333333333
COATZA / MINA,2023-04-26,27,26,1,0.037037037037037
COATZA / MINA,2023-04-27,23,23,0,0
COATZA / MINA,2023-04-28,13,12,1,0.0769230769230769
COATZA / MINA,2023-04-29,34,33,1,0.0294117647058824
COATZA / MINA,2023-04-30,20,20,0,0
COATZA / MINA,2023-05-01,25,24,1,0.04
COATZA / MINA,2023-05-02,14,14,0,0
COATZA / MINA,2023-05-03,13,13,0,0
COATZA / MINA,2023-05-04,18,16,2,0.111111111111111
COATZA / MINA,2023-05-05,16,16,0,0
COATZA / MINA,2023-05-06,14,14,0,0
COATZA / MINA,2023-05-07,16,15,1,0.0625
COATZA / MINA,2023-05-08,17,16,1,0.0588235294117647
COLIMA / MANZANILLO,2023-01-02,19,8,11,0.578947368421053
COLIMA / MANZANILLO,2023-01-03,32,15,17,0.53125
COLIMA / MANZANILLO,2023-01-04,29,12,17,0.586206896551724
COLIMA / MANZANILLO,2023-01-05,24,10,14,0.583333333333333
COLIMA / MANZANILLO,2023-01-06,25,12,13,0.52
COLIMA / MANZANILLO,2023-01-07,25,14,11,0.44
COLIMA / MANZANILLO,2023-01-08,12,5,7,0.583333333333333
COLIMA / MANZANILLO,2023-01-09,24,14,10,0.416666666666667
COLIMA / MANZANILLO,2023-01-10,24,12,12,0.5
COLIMA / MANZANILLO,2023-01-11,14,8,6,0.428571428571429
COLIMA / MANZANILLO,2023-01-12,19,11,8,0.421052631578947
COLIMA / MANZANILLO,2023-01-13,15,6,9,0.6
COLIMA / MANZANILLO,2023-01-14,20,10,10,0.5
COLIMA / MANZANILLO,2023-01-15,12,8,4,0.333333333333333
COLIMA / MANZANILLO,2023-01-16,23,12,11,0.478260869565217
COLIMA / MANZANILLO,2023-01-17,20,14,6,0.3
COLIMA / MANZANILLO,2023-01-18,25,21,4,0.16
COLIMA / MANZANILLO,2023-01-19,33,26,7,0.212121212121212
COLIMA / MANZANILLO,2023-01-20,25,11,14,0.56
COLIMA / MANZANILLO,2023-01-21,22,2,20,0.909090909090909
COLIMA / MANZANILLO,2023-01-22,12,3,9,0.75
COLIMA / MANZANILLO,2023-01-23,17,1,16,0.941176470588235
COLIMA / MANZANILLO,2023-01-24,19,3,16,0.842105263157895
COLIMA / MANZANILLO,2023-01-25,22,3,19,0.863636363636364
COLIMA / MANZANILLO,2023-01-26,23,4,19,0.826086956521739
COLIMA / MANZANILLO,2023-01-27,14,2,12,0.857142857142857
COLIMA / MANZANILLO,2023-01-28,17,4,13,0.764705882352941
COLIMA / MANZANILLO,2023-01-29,20,3,17,0.85
COLIMA / MANZANILLO,2023-01-30,19,1,18,0.947368421052632
COLIMA / MANZANILLO,2023-01-31,27,4,23,0.851851851851852
COLIMA / MANZANILLO,2023-02-01,28,5,23,0.821428571428571
COLIMA / MANZANILLO,2023-02-02,29,6,23,0.793103448275862
COLIMA / MANZANILLO,2023-02-03,18,4,14,0.777777777777778
COLIMA / MANZANILLO,2023-02-04,25,6,19,0.76
COLIMA / MANZANILLO,2023-02-05,20,9,11,0.55
COLIMA / MANZANILLO,2023-02-06,23,6,17,0.739130434782609
COLIMA / MANZANILLO,2023-02-07,26,9,17,0.653846153846154
COLIMA / MANZANILLO,2023-02-08,23,5,18,0.782608695652174
COLIMA / MANZANILLO,2023-02-09,21,9,12,0.571428571428571
COLIMA / MANZANILLO,2023-02-10,18,6,12,0.666666666666667
COLIMA / MANZANILLO,2023-02-11,17,7,10,0.588235294117647
COLIMA / MANZANILLO,2023-02-12,15,4,11,0.733333333333333
COLIMA / MANZANILLO,2023-02-13,19,8,11,0.578947368421053
COLIMA / MANZANILLO,2023-02-14,18,6,12,0.666666666666667
COLIMA / MANZANILLO,2023-02-15,21,4,17,0.80952380952381
COLIMA / MANZANILLO,2023-02-16,25,2,23,0.92
COLIMA / MANZANILLO,2023-02-17,17,7,10,0.588235294117647
COLIMA / MANZANILLO,2023-02-18,22,11,11,0.5
COLIMA / MANZANILLO,2023-02-19,22,6,16,0.727272727272727
COLIMA / MANZANILLO,2023-02-20,18,3,15,0.833333333333333
COLIMA / MANZANILLO,2023-02-21,20,7,13,0.65
COLIMA / MANZANILLO,2023-02-22,19,7,12,0.631578947368421
COLIMA / MANZANILLO,2023-02-23,17,6,11,0.647058823529412
COLIMA / MANZANILLO,2023-02-24,24,12,12,0.5
COLIMA / MANZANILLO,2023-02-25,23,7,16,0.695652173913043
COLIMA / MANZANILLO,2023-02-26,11,3,8,0.727272727272727
COLIMA / MANZANILLO,2023-02-27,18,6,12,0.666666666666667
COLIMA / MANZANILLO,2023-02-28,18,7,11,0.611111111111111
COLIMA / MANZANILLO,2023-03-01,17,6,11,0.647058823529412
COLIMA / MANZANILLO,2023-03-02,23,12,11,0.478260869565217
COLIMA / MANZANILLO,2023-03-03,21,13,8,0.380952380952381
COLIMA / MANZANILLO,2023-03-04,17,4,13,0.764705882352941
COLIMA / MANZANILLO,2023-03-05,22,10,12,0.545454545454545
COLIMA / MANZANILLO,2023-03-06,17,13,4,0.235294117647059
COLIMA / MANZANILLO,2023-03-07,15,9,6,0.4
COLIMA / MANZANILLO,2023-03-08,20,12,8,0.4
COLIMA / MANZANILLO,2023-03-09,23,22,1,0.0434782608695652
COLIMA / MANZANILLO,2023-03-10,19,18,1,0.0526315789473684
COLIMA / MANZANILLO,2023-03-11,26,24,2,0.0769230769230769
COLIMA / MANZANILLO,2023-03-12,27,26,1,0.037037037037037
COLIMA / MANZANILLO,2023-03-13,18,18,0,0
COLIMA / MANZANILLO,2023-03-14,17,17,0,0
COLIMA / MANZANILLO,2023-03-15,18,17,1,0.0555555555555556
COLIMA / MANZANILLO,2023-03-16,26,25,1,0.0384615384615385
COLIMA / MANZANILLO,2023-03-17,32,31,1,0.03125
COLIMA / MANZANILLO,2023-03-18,28,26,2,0.0714285714285714
COLIMA / MANZANILLO,2023-03-19,24,23,1,0.0416666666666667
COLIMA / MANZANILLO,2023-03-20,33,30,3,0.0909090909090909
COLIMA / MANZANILLO,2023-03-21,26,26,0,0
COLIMA / MANZANILLO,2023-03-22,9,9,0,0
COLIMA / MANZANILLO,2023-03-23,21,21,0,0
COLIMA / MANZANILLO,2023-03-24,23,23,0,0
COLIMA / MANZANILLO,2023-03-25,17,16,1,0.0588235294117647
COLIMA / MANZANILLO,2023-03-26,27,27,0,0
COLIMA / MANZANILLO,2023-03-27,15,15,0,0
COLIMA / MANZANILLO,2023-03-28,20,20,0,0
COLIMA / MANZANILLO,2023-03-29,17,17,0,0
COLIMA / MANZANILLO,2023-03-30,21,21,0,0
COLIMA / MANZANILLO,2023-03-31,25,24,1,0.04
COLIMA / MANZANILLO,2023-04-01,30,30,0,0
COLIMA / MANZANILLO,2023-04-02,19,19,0,0
COLIMA / MANZANILLO,2023-04-03,20,20,0,0
COLIMA / MANZANILLO,2023-04-04,30,30,0,0
COLIMA / MANZANILLO,2023-04-05,21,20,1,0.0476190476190476
COLIMA / MANZANILLO,2023-04-06,20,20,0,0
COLIMA / MANZANILLO,2023-04-07,17,17,0,0
COLIMA / MANZANILLO,2023-04-08,9,9,0,0
COLIMA / MANZANILLO,2023-04-09,7,7,0,0
COLIMA / MANZANILLO,2023-04-10,17,16,1,0.0588235294117647
COLIMA / MANZANILLO,2023-04-11,21,19,2,0.0952380952380952
COLIMA / MANZANILLO,2023-04-12,24,24,0,0
COLIMA / MANZANILLO,2023-04-13,16,15,1,0.0625
COLIMA / MANZANILLO,2023-04-14,23,23,0,0
COLIMA / MANZANILLO,2023-04-15,32,29,3,0.09375
COLIMA / MANZANILLO,2023-04-16,16,15,1,0.0625
COLIMA / MANZANILLO,2023-04-17,16,16,0,0
COLIMA / MANZANILLO,2023-04-18,27,27,0,0
COLIMA / MANZANILLO,2023-04-19,21,20,1,0.0476190476190476
COLIMA / MANZANILLO,2023-04-20,16,16,0,0
COLIMA / MANZANILLO,2023-04-21,24,23,1,0.0416666666666667
COLIMA / MANZANILLO,2023-04-22,20,20,0,0
COLIMA / MANZANILLO,2023-04-23,13,12,1,0.0769230769230769
COLIMA / MANZANILLO,2023-04-24,19,18,1,0.0526315789473684
COLIMA / MANZANILLO,2023-04-25,20,19,1,0.05
COLIMA / MANZANILLO,2023-04-26,21,19,2,0.0952380952380952
COLIMA / MANZANILLO,2023-04-27,22,22,0,0
COLIMA / MANZANILLO,2023-04-28,25,24,1,0.04
COLIMA / MANZANILLO,2023-04-29,28,25,3,0.107142857142857
COLIMA / MANZANILLO,2023-04-30,25,24,1,0.04
COLIMA / MANZANILLO,2023-05-01,18,18,0,0
COLIMA / MANZANILLO,2023-05-02,29,26,3,0.103448275862069
COLIMA / MANZANILLO,2023-05-03,19,19,0,0
COLIMA / MANZANILLO,2023-05-04,24,20,4,0.166666666666667
COLIMA / MANZANILLO,2023-05-05,17,17,0,0
COLIMA / MANZANILLO,2023-05-06,19,19,0,0
COLIMA / MANZANILLO,2023-05-07,19,18,1,0.0526315789473684
COLIMA / MANZANILLO,2023-05-08,15,14,1,0.0666666666666667
CONDESA,2023-01-02,39,24,15,0.384615384615385
CONDESA,2023-01-03,43,28,15,0.348837209302326
CONDESA,2023-01-04,38,24,14,0.368421052631579
CONDESA,2023-01-05,38,24,14,0.368421052631579
CONDESA,2023-01-06,25,16,9,0.36
CONDESA,2023-01-07,52,34,18,0.346153846153846
CONDESA,2023-01-08,28,22,6,0.214285714285714
CONDESA,2023-01-09,51,35,16,0.313725490196078
CONDESA,2023-01-10,36,26,10,0.277777777777778
CONDESA,2023-01-11,41,28,13,0.317073170731707
CONDESA,2023-01-12,50,36,14,0.28
CONDESA,2023-01-13,44,35,9,0.204545454545455
CONDESA,2023-01-14,39,25,14,0.358974358974359
CONDESA,2023-01-15,24,14,10,0.416666666666667
CONDESA,2023-01-16,40,25,15,0.375
CONDESA,2023-01-17,34,18,16,0.470588235294118
CONDESA,2023-01-18,56,21,35,0.625
CONDESA,2023-01-19,47,31,16,0.340425531914894
CONDESA,2023-01-20,57,40,17,0.298245614035088
CONDESA,2023-01-21,31,22,9,0.290322580645161
CONDESA,2023-01-22,18,13,5,0.277777777777778
CONDESA,2023-01-23,42,26,16,0.380952380952381
CONDESA,2023-01-24,41,28,13,0.317073170731707
CONDESA,2023-01-25,39,19,20,0.512820512820513
CONDESA,2023-01-26,38,24,14,0.368421052631579
CONDESA,2023-01-27,38,24,14,0.368421052631579
CONDESA,2023-01-28,38,21,17,0.447368421052632
CONDESA,2023-01-29,30,21,9,0.3
CONDESA,2023-01-30,52,38,14,0.269230769230769
CONDESA,2023-01-31,48,30,18,0.375
CONDESA,2023-02-01,47,27,20,0.425531914893617
CONDESA,2023-02-02,55,38,17,0.309090909090909
CONDESA,2023-02-03,56,30,26,0.464285714285714
CONDESA,2023-02-04,59,40,19,0.322033898305085
CONDESA,2023-02-05,31,19,12,0.387096774193548
CONDESA,2023-02-06,28,15,13,0.464285714285714
CONDESA,2023-02-07,53,35,18,0.339622641509434
CONDESA,2023-02-08,49,31,18,0.36734693877551
CONDESA,2023-02-09,44,28,16,0.363636363636364
CONDESA,2023-02-10,54,30,24,0.444444444444444
CONDESA,2023-02-11,51,32,19,0.372549019607843
CONDESA,2023-02-12,21,11,10,0.476190476190476
CONDESA,2023-02-13,44,25,19,0.431818181818182
CONDESA,2023-02-14,46,30,16,0.347826086956522
CONDESA,2023-02-15,41,21,20,0.48780487804878
CONDESA,2023-02-16,34,17,17,0.5
CONDESA,2023-02-17,40,27,13,0.325
CONDESA,2023-02-18,48,24,24,0.5
CONDESA,2023-02-19,34,26,8,0.235294117647059
CONDESA,2023-02-20,55,31,24,0.436363636363636
CONDESA,2023-02-21,39,21,18,0.461538461538462
CONDESA,2023-02-22,40,28,12,0.3
CONDESA,2023-02-23,43,32,11,0.255813953488372
CONDESA,2023-02-24,29,21,8,0.275862068965517
CONDESA,2023-02-25,41,33,8,0.195121951219512
CONDESA,2023-02-26,25,19,6,0.24
CONDESA,2023-02-27,50,28,22,0.44
CONDESA,2023-02-28,41,28,13,0.317073170731707
CONDESA,2023-03-01,40,31,9,0.225
CONDESA,2023-03-02,60,40,20,0.333333333333333
CONDESA,2023-03-03,47,33,14,0.297872340425532
CONDESA,2023-03-04,56,36,20,0.357142857142857
CONDESA,2023-03-05,40,25,15,0.375
CONDESA,2023-03-06,45,23,22,0.488888888888889
CONDESA,2023-03-07,61,40,21,0.344262295081967
CONDESA,2023-03-08,60,44,16,0.266666666666667
CONDESA,2023-03-09,54,38,16,0.296296296296296
CONDESA,2023-03-10,56,44,12,0.214285714285714
CONDESA,2023-03-11,44,31,13,0.295454545454545
CONDESA,2023-03-12,24,20,4,0.166666666666667
CONDESA,2023-03-13,30,20,10,0.333333333333333
CONDESA,2023-03-14,42,27,15,0.357142857142857
CONDESA,2023-03-15,44,37,7,0.159090909090909
CONDESA,2023-03-16,48,45,3,0.0625
CONDESA,2023-03-17,57,54,3,0.0526315789473684
CONDESA,2023-03-18,50,49,1,0.02
CONDESA,2023-03-19,20,18,2,0.1
CONDESA,2023-03-20,30,30,0,0
CONDESA,2023-03-21,44,44,0,0
CONDESA,2023-03-22,55,54,1,0.0181818181818182
CONDESA,2023-03-23,46,46,0,0
CONDESA,2023-03-24,40,37,3,0.075
CONDESA,2023-03-25,44,43,1,0.0227272727272727
CONDESA,2023-03-26,30,30,0,0
CONDESA,2023-03-27,38,38,0,0
CONDESA,2023-03-28,43,43,0,0
CONDESA,2023-03-29,39,39,0,0
CONDESA,2023-03-30,55,54,1,0.0181818181818182
CONDESA,2023-03-31,65,62,3,0.0461538461538462
CONDESA,2023-04-01,54,54,0,0
CONDESA,2023-04-02,31,31,0,0
CONDESA,2023-04-03,42,41,1,0.0238095238095238
CONDESA,2023-04-04,45,44,1,0.0222222222222222
CONDESA,2023-04-05,45,44,1,0.0222222222222222
CONDESA,2023-04-06,48,48,0,0
CONDESA,2023-04-07,32,32,0,0
CONDESA,2023-04-08,23,23,0,0
CONDESA,2023-04-09,15,15,0,0
CONDESA,2023-04-10,44,43,1,0.0227272727272727
CONDESA,2023-04-11,33,32,1,0.0303030303030303
CONDESA,2023-04-12,42,42,0,0
CONDESA,2023-04-13,34,34,0,0
CONDESA,2023-04-14,50,50,0,0
CONDESA,2023-04-15,51,50,1,0.0196078431372549
CONDESA,2023-04-16,36,35,1,0.0277777777777778
CONDESA,2023-04-17,41,40,1,0.024390243902439
CONDESA,2023-04-18,33,32,1,0.0303030303030303
CONDESA,2023-04-19,46,46,0,0
CONDESA,2023-04-20,41,40,1,0.024390243902439
CONDESA,2023-04-21,56,55,1,0.0178571428571429
CONDESA,2023-04-22,43,42,1,0.0232558139534884
CONDESA,2023-04-23,38,36,2,0.0526315789473684
CONDESA,2023-04-24,39,38,1,0.0256410256410256
CONDESA,2023-04-25,62,62,0,0
CONDESA,2023-04-26,51,48,3,0.0588235294117647
CONDESA,2023-04-27,44,44,0,0
CONDESA,2023-04-28,39,39,0,0
CONDESA,2023-04-29,59,58,1,0.0169491525423729
CONDESA,2023-04-30,41,41,0,0
CONDESA,2023-05-01,35,34,1,0.0285714285714286
CONDESA,2023-05-02,56,53,3,0.0535714285714286
CONDESA,2023-05-03,39,39,0,0
CONDESA,2023-05-04,48,46,2,0.0416666666666667
CONDESA,2023-05-05,54,53,1,0.0185185185185185
CONDESA,2023-05-06,47,45,2,0.0425531914893617
CONDESA,2023-05-07,33,33,0,0
CONDESA,2023-05-08,58,57,1,0.0172413793103448
CONSTITUCION,2023-01-02,22,15,7,0.318181818181818
CONSTITUCION,2023-01-03,28,17,11,0.392857142857143
CONSTITUCION,2023-01-04,31,24,7,0.225806451612903
CONSTITUCION,2023-01-05,18,12,6,0.333333333333333
CONSTITUCION,2023-01-06,29,21,8,0.275862068965517
CONSTITUCION,2023-01-07,33,21,12,0.363636363636364
CONSTITUCION,2023-01-08,35,24,11,0.314285714285714
CONSTITUCION,2023-01-09,29,17,12,0.413793103448276
CONSTITUCION,2023-01-10,33,21,12,0.363636363636364
CONSTITUCION,2023-01-11,27,15,12,0.444444444444444
CONSTITUCION,2023-01-12,33,14,19,0.575757575757576
CONSTITUCION,2023-01-13,33,21,12,0.363636363636364
CONSTITUCION,2023-01-14,44,18,26,0.590909090909091
CONSTITUCION,2023-01-15,38,18,20,0.526315789473684
CONSTITUCION,2023-01-16,31,11,20,0.645161290322581
CONSTITUCION,2023-01-17,22,10,12,0.545454545454545
CONSTITUCION,2023-01-18,48,25,23,0.479166666666667
CONSTITUCION,2023-01-19,38,19,19,0.5
CONSTITUCION,2023-01-20,35,19,16,0.457142857142857
CONSTITUCION,2023-01-21,34,21,13,0.382352941176471
CONSTITUCION,2023-01-22,34,17,17,0.5
CONSTITUCION,2023-01-23,33,17,16,0.484848484848485
CONSTITUCION,2023-01-24,31,14,17,0.548387096774194
CONSTITUCION,2023-01-25,31,20,11,0.354838709677419
CONSTITUCION,2023-01-26,37,15,22,0.594594594594595
CONSTITUCION,2023-01-27,28,18,10,0.357142857142857
CONSTITUCION,2023-01-28,44,25,19,0.431818181818182
CONSTITUCION,2023-01-29,47,27,20,0.425531914893617
CONSTITUCION,2023-01-30,35,19,16,0.457142857142857
CONSTITUCION,2023-01-31,40,22,18,0.45
CONSTITUCION,2023-02-01,32,18,14,0.4375
CONSTITUCION,2023-02-02,45,33,12,0.266666666666667
CONSTITUCION,2023-02-03,30,17,13,0.433333333333333
CONSTITUCION,2023-02-04,46,23,23,0.5
CONSTITUCION,2023-02-05,27,13,14,0.518518518518518
CONSTITUCION,2023-02-06,29,18,11,0.379310344827586
CONSTITUCION,2023-02-07,32,5,27,0.84375
CONSTITUCION,2023-02-08,28,6,22,0.785714285714286
CONSTITUCION,2023-02-09,25,5,20,0.8
CONSTITUCION,2023-02-10,31,9,22,0.709677419354839
CONSTITUCION,2023-02-11,34,9,25,0.735294117647059
CONSTITUCION,2023-02-12,31,7,24,0.774193548387097
CONSTITUCION,2023-02-13,31,6,25,0.806451612903226
CONSTITUCION,2023-02-14,32,13,19,0.59375
CONSTITUCION,2023-02-15,37,11,26,0.702702702702703
CONSTITUCION,2023-02-16,46,13,33,0.717391304347826
CONSTITUCION,2023-02-17,40,13,27,0.675
CONSTITUCION,2023-02-18,46,17,29,0.630434782608696
CONSTITUCION,2023-02-19,33,12,21,0.636363636363636
CONSTITUCION,2023-02-20,33,9,24,0.727272727272727
CONSTITUCION,2023-02-21,35,17,18,0.514285714285714
CONSTITUCION,2023-02-22,31,23,8,0.258064516129032
CONSTITUCION,2023-02-23,33,32,1,0.0303030303030303
CONSTITUCION,2023-02-24,26,23,3,0.115384615384615
CONSTITUCION,2023-02-25,37,37,0,0
CONSTITUCION,2023-02-26,34,30,4,0.117647058823529
CONSTITUCION,2023-02-27,34,32,2,0.0588235294117647
CONSTITUCION,2023-02-28,46,43,3,0.0652173913043478
CONSTITUCION,2023-03-01,10,9,1,0.1
CONSTITUCION,2023-03-02,38,34,4,0.105263157894737
CONSTITUCION,2023-03-03,43,41,2,0.0465116279069767
CONSTITUCION,2023-03-04,48,45,3,0.0625
CONSTITUCION,2023-03-05,25,19,6,0.24
CONSTITUCION,2023-03-06,30,30,0,0
CONSTITUCION,2023-03-07,44,39,5,0.113636363636364
CONSTITUCION,2023-03-08,44,41,3,0.0681818181818182
CONSTITUCION,2023-03-09,34,34,0,0
CONSTITUCION,2023-03-10,35,35,0,0
CONSTITUCION,2023-03-11,37,37,0,0
CONSTITUCION,2023-03-12,32,29,3,0.09375
CONSTITUCION,2023-03-13,37,36,1,0.027027027027027
CONSTITUCION,2023-03-14,40,40,0,0
CONSTITUCION,2023-03-15,32,32,0,0
CONSTITUCION,2023-03-16,31,29,2,0.0645161290322581
CONSTITUCION,2023-03-17,51,47,4,0.0784313725490196
CONSTITUCION,2023-03-18,65,64,1,0.0153846153846154
CONSTITUCION,2023-03-19,57,55,2,0.0350877192982456
CONSTITUCION,2023-03-20,54,54,0,0
CONSTITUCION,2023-03-21,47,45,2,0.0425531914893617
CONSTITUCION,2023-03-22,47,46,1,0.0212765957446809
CONSTITUCION,2023-03-23,34,34,0,0
CONSTITUCION,2023-03-24,52,51,1,0.0192307692307692
CONSTITUCION,2023-03-25,49,49,0,0
CONSTITUCION,2023-03-26,48,48,0,0
CONSTITUCION,2023-03-27,49,49,0,0
CONSTITUCION,2023-03-28,25,24,1,0.04
CONSTITUCION,2023-03-29,44,43,1,0.0227272727272727
CONSTITUCION,2023-03-30,54,54,0,0
CONSTITUCION,2023-03-31,62,62,0,0
CONSTITUCION,2023-04-01,50,50,0,0
CONSTITUCION,2023-04-02,56,56,0,0
CONSTITUCION,2023-04-03,51,50,1,0.0196078431372549
CONSTITUCION,2023-04-04,39,39,0,0
CONSTITUCION,2023-04-05,43,43,0,0
CONSTITUCION,2023-04-06,33,33,0,0
CONSTITUCION,2023-04-07,22,22,0,0
CONSTITUCION,2023-04-08,34,34,0,0
CONSTITUCION,2023-04-09,29,29,0,0
CONSTITUCION,2023-04-10,29,29,0,0
CONSTITUCION,2023-04-11,30,30,0,0
CONSTITUCION,2023-04-12,29,29,0,0
CONSTITUCION,2023-04-13,26,26,0,0
CONSTITUCION,2023-04-14,37,37,0,0
CONSTITUCION,2023-04-15,43,43,0,0
CONSTITUCION,2023-04-16,50,50,0,0
CONSTITUCION,2023-04-17,48,48,0,0
CONSTITUCION,2023-04-18,28,28,0,0
CONSTITUCION,2023-04-19,45,45,0,0
CONSTITUCION,2023-04-20,31,31,0,0
CONSTITUCION,2023-04-21,42,42,0,0
CONSTITUCION,2023-04-22,39,39,0,0
CONSTITUCION,2023-04-23,36,36,0,0
CONSTITUCION,2023-04-24,36,36,0,0
CONSTITUCION,2023-04-25,52,52,0,0
CONSTITUCION,2023-04-26,46,46,0,0
CONSTITUCION,2023-04-27,37,37,0,0
CONSTITUCION,2023-04-28,39,39,0,0
CONSTITUCION,2023-04-29,55,55,0,0
CONSTITUCION,2023-04-30,43,43,0,0
CONSTITUCION,2023-05-01,36,36,0,0
CONSTITUCION,2023-05-02,39,39,0,0
CONSTITUCION,2023-05-03,28,28,0,0
CONSTITUCION,2023-05-04,36,36,0,0
CONSTITUCION,2023-05-05,48,48,0,0
CONSTITUCION,2023-05-06,39,39,0,0
CONSTITUCION,2023-05-07,22,22,0,0
CONSTITUCION,2023-05-08,30,30,0,0
CORDOBA / ORIZABA,2023-01-02,16,11,5,0.3125
CORDOBA / ORIZABA,2023-01-03,28,21,7,0.25
CORDOBA / ORIZABA,2023-01-04,34,23,11,0.323529411764706
CORDOBA / ORIZABA,2023-01-05,29,22,7,0.241379310344828
CORDOBA / ORIZABA,2023-01-06,24,19,5,0.208333333333333
CORDOBA / ORIZABA,2023-01-07,27,19,8,0.296296296296296
CORDOBA / ORIZABA,2023-01-08,24,22,2,0.0833333333333333
CORDOBA / ORIZABA,2023-01-09,17,16,1,0.0588235294117647
CORDOBA / ORIZABA,2023-01-10,26,12,14,0.538461538461538
CORDOBA / ORIZABA,2023-01-11,24,14,10,0.416666666666667
CORDOBA / ORIZABA,2023-01-12,27,15,12,0.444444444444444
CORDOBA / ORIZABA,2023-01-13,23,17,6,0.260869565217391
CORDOBA / ORIZABA,2023-01-14,24,11,13,0.541666666666667
CORDOBA / ORIZABA,2023-01-15,24,13,11,0.458333333333333
CORDOBA / ORIZABA,2023-01-16,38,10,28,0.736842105263158
CORDOBA / ORIZABA,2023-01-17,27,14,13,0.481481481481481
CORDOBA / ORIZABA,2023-01-18,19,12,7,0.368421052631579
CORDOBA / ORIZABA,2023-01-19,34,23,11,0.323529411764706
CORDOBA / ORIZABA,2023-01-20,29,22,7,0.241379310344828
CORDOBA / ORIZABA,2023-01-21,20,15,5,0.25
CORDOBA / ORIZABA,2023-01-22,16,11,5,0.3125
CORDOBA / ORIZABA,2023-01-23,14,9,5,0.357142857142857
CORDOBA / ORIZABA,2023-01-24,21,10,11,0.523809523809524
CORDOBA / ORIZABA,2023-01-25,33,21,12,0.363636363636364
CORDOBA / ORIZABA,2023-01-26,29,18,11,0.379310344827586
CORDOBA / ORIZABA,2023-01-27,23,15,8,0.347826086956522
CORDOBA / ORIZABA,2023-01-28,34,23,11,0.323529411764706
CORDOBA / ORIZABA,2023-01-29,23,8,15,0.652173913043478
CORDOBA / ORIZABA,2023-01-30,21,14,7,0.333333333333333
CORDOBA / ORIZABA,2023-01-31,30,17,13,0.433333333333333
CORDOBA / ORIZABA,2023-02-01,23,13,10,0.434782608695652
CORDOBA / ORIZABA,2023-02-02,28,18,10,0.357142857142857
CORDOBA / ORIZABA,2023-02-03,22,14,8,0.363636363636364
CORDOBA / ORIZABA,2023-02-04,30,19,11,0.366666666666667
CORDOBA / ORIZABA,2023-02-05,10,3,7,0.7
CORDOBA / ORIZABA,2023-02-06,25,11,14,0.56
CORDOBA / ORIZABA,2023-02-07,26,18,8,0.307692307692308
CORDOBA / ORIZABA,2023-02-08,35,20,15,0.428571428571429
CORDOBA / ORIZABA,2023-02-09,23,10,13,0.565217391304348
CORDOBA / ORIZABA,2023-02-10,23,15,8,0.347826086956522
CORDOBA / ORIZABA,2023-02-11,23,11,12,0.521739130434783
CORDOBA / ORIZABA,2023-02-12,17,9,8,0.470588235294118
CORDOBA / ORIZABA,2023-02-13,33,17,16,0.484848484848485
CORDOBA / ORIZABA,2023-02-14,17,9,8,0.470588235294118
CORDOBA / ORIZABA,2023-02-15,24,14,10,0.416666666666667
CORDOBA / ORIZABA,2023-02-16,25,12,13,0.52
CORDOBA / ORIZABA,2023-02-17,25,12,13,0.52
CORDOBA / ORIZABA,2023-02-18,27,15,12,0.444444444444444
CORDOBA / ORIZABA,2023-02-19,24,12,12,0.5
CORDOBA / ORIZABA,2023-02-20,29,14,15,0.517241379310345
CORDOBA / ORIZABA,2023-02-21,24,13,11,0.458333333333333
CORDOBA / ORIZABA,2023-02-22,30,21,9,0.3
CORDOBA / ORIZABA,2023-02-23,23,8,15,0.652173913043478
CORDOBA / ORIZABA,2023-02-24,31,18,13,0.419354838709677
CORDOBA / ORIZABA,2023-02-25,24,12,12,0.5
CORDOBA / ORIZABA,2023-02-26,21,14,7,0.333333333333333
CORDOBA / ORIZABA,2023-02-27,35,18,17,0.485714285714286
CORDOBA / ORIZABA,2023-02-28,34,14,20,0.588235294117647
CORDOBA / ORIZABA,2023-03-01,42,21,21,0.5
CORDOBA / ORIZABA,2023-03-02,24,17,7,0.291666666666667
CORDOBA / ORIZABA,2023-03-03,23,13,10,0.434782608695652
CORDOBA / ORIZABA,2023-03-04,26,9,17,0.653846153846154
CORDOBA / ORIZABA,2023-03-05,12,4,8,0.666666666666667
CORDOBA / ORIZABA,2023-03-06,27,15,12,0.444444444444444
CORDOBA / ORIZABA,2023-03-07,29,16,13,0.448275862068966
CORDOBA / ORIZABA,2023-03-08,36,27,9,0.25
CORDOBA / ORIZABA,2023-03-09,29,24,5,0.172413793103448
CORDOBA / ORIZABA,2023-03-10,34,25,9,0.264705882352941
CORDOBA / ORIZABA,2023-03-11,30,19,11,0.366666666666667
CORDOBA / ORIZABA,2023-03-12,22,17,5,0.227272727272727
CORDOBA / ORIZABA,2023-03-13,31,25,6,0.193548387096774
CORDOBA / ORIZABA,2023-03-14,29,25,4,0.137931034482759
CORDOBA / ORIZABA,2023-03-15,24,18,6,0.25
CORDOBA / ORIZABA,2023-03-16,38,36,2,0.0526315789473684
CORDOBA / ORIZABA,2023-03-17,41,37,4,0.0975609756097561
CORDOBA / ORIZABA,2023-03-18,50,45,5,0.1
CORDOBA / ORIZABA,2023-03-19,22,22,0,0
CORDOBA / ORIZABA,2023-03-20,43,40,3,0.0697674418604651
CORDOBA / ORIZABA,2023-03-21,42,39,3,0.0714285714285714
CORDOBA / ORIZABA,2023-03-22,33,32,1,0.0303030303030303
CORDOBA / ORIZABA,2023-03-23,28,27,1,0.0357142857142857
CORDOBA / ORIZABA,2023-03-24,40,40,0,0
CORDOBA / ORIZABA,2023-03-25,36,35,1,0.0277777777777778
CORDOBA / ORIZABA,2023-03-26,29,28,1,0.0344827586206897
CORDOBA / ORIZABA,2023-03-27,31,29,2,0.0645161290322581
CORDOBA / ORIZABA,2023-03-28,14,12,2,0.142857142857143
CORDOBA / ORIZABA,2023-03-29,32,32,0,0
CORDOBA / ORIZABA,2023-03-30,36,34,2,0.0555555555555556
CORDOBA / ORIZABA,2023-03-31,45,41,4,0.0888888888888889
CORDOBA / ORIZABA,2023-04-01,38,37,1,0.0263157894736842
CORDOBA / ORIZABA,2023-04-02,23,21,2,0.0869565217391304
CORDOBA / ORIZABA,2023-04-03,41,37,4,0.0975609756097561
CORDOBA / ORIZABA,2023-04-04,28,25,3,0.107142857142857
CORDOBA / ORIZABA,2023-04-05,19,16,3,0.157894736842105
CORDOBA / ORIZABA,2023-04-06,22,20,2,0.0909090909090909
CORDOBA / ORIZABA,2023-04-07,18,18,0,0
CORDOBA / ORIZABA,2023-04-08,26,25,1,0.0384615384615385
CORDOBA / ORIZABA,2023-04-09,19,16,3,0.157894736842105
CORDOBA / ORIZABA,2023-04-10,24,19,5,0.208333333333333
CORDOBA / ORIZABA,2023-04-11,15,13,2,0.133333333333333
CORDOBA / ORIZABA,2023-04-12,30,26,4,0.133333333333333
CORDOBA / ORIZABA,2023-04-13,21,17,4,0.19047619047619
CORDOBA / ORIZABA,2023-04-14,30,26,4,0.133333333333333
CORDOBA / ORIZABA,2023-04-15,53,49,4,0.0754716981132075
CORDOBA / ORIZABA,2023-04-16,32,28,4,0.125
CORDOBA / ORIZABA,2023-04-17,27,25,2,0.0740740740740741
CORDOBA / ORIZABA,2023-04-18,26,24,2,0.0769230769230769
CORDOBA / ORIZABA,2023-04-19,18,18,0,0
CORDOBA / ORIZABA,2023-04-20,35,28,7,0.2
CORDOBA / ORIZABA,2023-04-21,27,26,1,0.037037037037037
CORDOBA / ORIZABA,2023-04-22,46,37,9,0.195652173913043
CORDOBA / ORIZABA,2023-04-23,31,22,9,0.290322580645161
CORDOBA / ORIZABA,2023-04-24,32,30,2,0.0625
CORDOBA / ORIZABA,2023-04-25,52,42,10,0.192307692307692
CORDOBA / ORIZABA,2023-04-26,35,32,3,0.0857142857142857
CORDOBA / ORIZABA,2023-04-27,25,22,3,0.12
CORDOBA / ORIZABA,2023-04-28,38,35,3,0.0789473684210526
CORDOBA / ORIZABA,2023-04-29,51,48,3,0.0588235294117647
CORDOBA / ORIZABA,2023-04-30,44,40,4,0.0909090909090909
CORDOBA / ORIZABA,2023-05-01,31,29,2,0.0645161290322581
CORDOBA / ORIZABA,2023-05-02,29,26,3,0.103448275862069
CORDOBA / ORIZABA,2023-05-03,34,31,3,0.0882352941176471
CORDOBA / ORIZABA,2023-05-04,25,20,5,0.2
CORDOBA / ORIZABA,2023-05-05,32,30,2,0.0625
CORDOBA / ORIZABA,2023-05-06,34,33,1,0.0294117647058824
CORDOBA / ORIZABA,2023-05-07,19,16,3,0.157894736842105
CORDOBA / ORIZABA,2023-05-08,18,17,1,0.0555555555555556
CUERNAVACA BUGAMBILIAS,2023-01-02,17,13,4,0.235294117647059
CUERNAVACA BUGAMBILIAS,2023-01-03,29,13,16,0.551724137931034
CUERNAVACA BUGAMBILIAS,2023-01-04,36,19,17,0.472222222222222
CUERNAVACA BUGAMBILIAS,2023-01-05,24,12,12,0.5
CUERNAVACA BUGAMBILIAS,2023-01-06,24,12,12,0.5
CUERNAVACA BUGAMBILIAS,2023-01-07,17,13,4,0.235294117647059
CUERNAVACA BUGAMBILIAS,2023-01-08,22,12,10,0.454545454545455
CUERNAVACA BUGAMBILIAS,2023-01-09,15,7,8,0.533333333333333
CUERNAVACA BUGAMBILIAS,2023-01-10,27,18,9,0.333333333333333
CUERNAVACA BUGAMBILIAS,2023-01-11,26,18,8,0.307692307692308
CUERNAVACA BUGAMBILIAS,2023-01-12,25,17,8,0.32
CUERNAVACA BUGAMBILIAS,2023-01-13,18,14,4,0.222222222222222
CUERNAVACA BUGAMBILIAS,2023-01-14,27,17,10,0.37037037037037
CUERNAVACA BUGAMBILIAS,2023-01-15,15,11,4,0.266666666666667
CUERNAVACA BUGAMBILIAS,2023-01-16,21,13,8,0.380952380952381
CUERNAVACA BUGAMBILIAS,2023-01-17,28,19,9,0.321428571428571
CUERNAVACA BUGAMBILIAS,2023-01-18,28,22,6,0.214285714285714
CUERNAVACA BUGAMBILIAS,2023-01-19,23,16,7,0.304347826086957
CUERNAVACA BUGAMBILIAS,2023-01-20,13,8,5,0.384615384615385
CUERNAVACA BUGAMBILIAS,2023-01-21,22,11,11,0.5
CUERNAVACA BUGAMBILIAS,2023-01-22,22,10,12,0.545454545454545
CUERNAVACA BUGAMBILIAS,2023-01-23,17,15,2,0.117647058823529
CUERNAVACA BUGAMBILIAS,2023-01-24,20,12,8,0.4
CUERNAVACA BUGAMBILIAS,2023-01-25,20,12,8,0.4
CUERNAVACA BUGAMBILIAS,2023-01-26,22,14,8,0.363636363636364
CUERNAVACA BUGAMBILIAS,2023-01-27,23,11,12,0.521739130434783
CUERNAVACA BUGAMBILIAS,2023-01-28,29,20,9,0.310344827586207
CUERNAVACA BUGAMBILIAS,2023-01-29,24,13,11,0.458333333333333
CUERNAVACA BUGAMBILIAS,2023-01-30,17,13,4,0.235294117647059
CUERNAVACA BUGAMBILIAS,2023-01-31,22,14,8,0.363636363636364
CUERNAVACA BUGAMBILIAS,2023-02-01,21,12,9,0.428571428571429
CUERNAVACA BUGAMBILIAS,2023-02-02,17,10,7,0.411764705882353
CUERNAVACA BUGAMBILIAS,2023-02-03,23,15,8,0.347826086956522
CUERNAVACA BUGAMBILIAS,2023-02-04,28,20,8,0.285714285714286
CUERNAVACA BUGAMBILIAS,2023-02-05,24,9,15,0.625
CUERNAVACA BUGAMBILIAS,2023-02-06,24,14,10,0.416666666666667
CUERNAVACA BUGAMBILIAS,2023-02-07,18,12,6,0.333333333333333
CUERNAVACA BUGAMBILIAS,2023-02-08,21,16,5,0.238095238095238
CUERNAVACA BUGAMBILIAS,2023-02-09,24,14,10,0.416666666666667
CUERNAVACA BUGAMBILIAS,2023-02-10,26,14,12,0.461538461538462
CUERNAVACA BUGAMBILIAS,2023-02-11,31,19,12,0.387096774193548
CUERNAVACA BUGAMBILIAS,2023-02-12,13,7,6,0.461538461538462
CUERNAVACA BUGAMBILIAS,2023-02-13,19,9,10,0.526315789473684
CUERNAVACA BUGAMBILIAS,2023-02-14,12,8,4,0.333333333333333
CUERNAVACA BUGAMBILIAS,2023-02-15,27,14,13,0.481481481481481
CUERNAVACA BUGAMBILIAS,2023-02-16,28,17,11,0.392857142857143
CUERNAVACA BUGAMBILIAS,2023-02-17,27,15,12,0.444444444444444
CUERNAVACA BUGAMBILIAS,2023-02-18,36,21,15,0.416666666666667
CUERNAVACA BUGAMBILIAS,2023-02-19,38,22,16,0.421052631578947
CUERNAVACA BUGAMBILIAS,2023-02-20,25,16,9,0.36
CUERNAVACA BUGAMBILIAS,2023-02-21,22,12,10,0.454545454545455
CUERNAVACA BUGAMBILIAS,2023-02-22,20,10,10,0.5
CUERNAVACA BUGAMBILIAS,2023-02-23,22,15,7,0.318181818181818
CUERNAVACA BUGAMBILIAS,2023-02-24,31,18,13,0.419354838709677
CUERNAVACA BUGAMBILIAS,2023-02-25,36,23,13,0.361111111111111
CUERNAVACA BUGAMBILIAS,2023-02-26,20,15,5,0.25
CUERNAVACA BUGAMBILIAS,2023-02-27,31,17,14,0.451612903225806
CUERNAVACA BUGAMBILIAS,2023-02-28,30,24,6,0.2
CUERNAVACA BUGAMBILIAS,2023-03-01,33,17,16,0.484848484848485
CUERNAVACA BUGAMBILIAS,2023-03-02,15,9,6,0.4
CUERNAVACA BUGAMBILIAS,2023-03-03,18,17,1,0.0555555555555556
CUERNAVACA BUGAMBILIAS,2023-03-04,27,14,13,0.481481481481481
CUERNAVACA BUGAMBILIAS,2023-03-05,13,11,2,0.153846153846154
CUERNAVACA BUGAMBILIAS,2023-03-06,10,10,0,0
CUERNAVACA BUGAMBILIAS,2023-03-07,20,14,6,0.3
CUERNAVACA BUGAMBILIAS,2023-03-08,22,17,5,0.227272727272727
CUERNAVACA BUGAMBILIAS,2023-03-09,13,11,2,0.153846153846154
CUERNAVACA BUGAMBILIAS,2023-03-10,27,27,0,0
CUERNAVACA BUGAMBILIAS,2023-03-11,21,21,0,0
CUERNAVACA BUGAMBILIAS,2023-03-12,22,14,8,0.363636363636364
CUERNAVACA BUGAMBILIAS,2023-03-13,18,16,2,0.111111111111111
CUERNAVACA BUGAMBILIAS,2023-03-14,24,24,0,0
CUERNAVACA BUGAMBILIAS,2023-03-15,30,29,1,0.0333333333333333
CUERNAVACA BUGAMBILIAS,2023-03-16,33,33,0,0
CUERNAVACA BUGAMBILIAS,2023-03-17,37,37,0,0
CUERNAVACA BUGAMBILIAS,2023-03-18,52,50,2,0.0384615384615385
CUERNAVACA BUGAMBILIAS,2023-03-19,41,41,0,0
CUERNAVACA BUGAMBILIAS,2023-03-20,48,47,1,0.0208333333333333
CUERNAVACA BUGAMBILIAS,2023-03-21,37,37,0,0
CUERNAVACA BUGAMBILIAS,2023-03-22,30,29,1,0.0333333333333333
CUERNAVACA BUGAMBILIAS,2023-03-23,30,30,0,0
CUERNAVACA BUGAMBILIAS,2023-03-24,32,32,0,0
CUERNAVACA BUGAMBILIAS,2023-03-25,38,38,0,0
CUERNAVACA BUGAMBILIAS,2023-03-26,31,31,0,0
CUERNAVACA BUGAMBILIAS,2023-03-27,23,23,0,0
CUERNAVACA BUGAMBILIAS,2023-03-28,23,23,0,0
CUERNAVACA BUGAMBILIAS,2023-03-29,28,28,0,0
CUERNAVACA BUGAMBILIAS,2023-03-30,27,27,0,0
CUERNAVACA BUGAMBILIAS,2023-03-31,34,34,0,0
CUERNAVACA BUGAMBILIAS,2023-04-01,39,39,0,0
CUERNAVACA BUGAMBILIAS,2023-04-02,28,28,0,0
CUERNAVACA BUGAMBILIAS,2023-04-03,46,46,0,0
CUERNAVACA BUGAMBILIAS,2023-04-04,35,35,0,0
CUERNAVACA BUGAMBILIAS,2023-04-05,41,40,1,0.024390243902439
CUERNAVACA BUGAMBILIAS,2023-04-06,38,38,0,0
CUERNAVACA BUGAMBILIAS,2023-04-07,30,30,0,0
CUERNAVACA BUGAMBILIAS,2023-04-08,28,28,0,0
CUERNAVACA BUGAMBILIAS,2023-04-09,18,18,0,0
CUERNAVACA BUGAMBILIAS,2023-04-10,28,26,2,0.0714285714285714
CUERNAVACA BUGAMBILIAS,2023-04-11,28,28,0,0
CUERNAVACA BUGAMBILIAS,2023-04-12,20,20,0,0
CUERNAVACA BUGAMBILIAS,2023-04-13,23,23,0,0
CUERNAVACA BUGAMBILIAS,2023-04-14,23,23,0,0
CUERNAVACA BUGAMBILIAS,2023-04-15,39,37,2,0.0512820512820513
CUERNAVACA BUGAMBILIAS,2023-04-16,29,29,0,0
CUERNAVACA BUGAMBILIAS,2023-04-17,18,17,1,0.0555555555555556
CUERNAVACA BUGAMBILIAS,2023-04-18,16,14,2,0.125
CUERNAVACA BUGAMBILIAS,2023-04-19,18,17,1,0.0555555555555556
CUERNAVACA BUGAMBILIAS,2023-04-20,21,20,1,0.0476190476190476
CUERNAVACA BUGAMBILIAS,2023-04-21,26,25,1,0.0384615384615385
CUERNAVACA BUGAMBILIAS,2023-04-22,29,27,2,0.0689655172413793
CUERNAVACA BUGAMBILIAS,2023-04-23,21,21,0,0
CUERNAVACA BUGAMBILIAS,2023-04-24,29,27,2,0.0689655172413793
CUERNAVACA BUGAMBILIAS,2023-04-25,39,38,1,0.0256410256410256
CUERNAVACA BUGAMBILIAS,2023-04-26,24,21,3,0.125
CUERNAVACA BUGAMBILIAS,2023-04-27,20,18,2,0.1
CUERNAVACA BUGAMBILIAS,2023-04-28,28,28,0,0
CUERNAVACA BUGAMBILIAS,2023-04-29,35,33,2,0.0571428571428571
CUERNAVACA BUGAMBILIAS,2023-04-30,29,28,1,0.0344827586206897
CUERNAVACA BUGAMBILIAS,2023-05-01,24,22,2,0.0833333333333333
CUERNAVACA BUGAMBILIAS,2023-05-02,22,21,1,0.0454545454545455
CUERNAVACA BUGAMBILIAS,2023-05-03,25,23,2,0.08
CUERNAVACA BUGAMBILIAS,2023-05-04,18,17,1,0.0555555555555556
CUERNAVACA BUGAMBILIAS,2023-05-05,20,20,0,0
CUERNAVACA BUGAMBILIAS,2023-05-06,36,36,0,0
CUERNAVACA BUGAMBILIAS,2023-05-07,18,18,0,0
CUERNAVACA BUGAMBILIAS,2023-05-08,12,11,1,0.0833333333333333
CUERNAVACA DE CORTEZ,2023-01-02,14,9,5,0.357142857142857
CUERNAVACA DE CORTEZ,2023-01-03,27,14,13,0.481481481481481
CUERNAVACA DE CORTEZ,2023-01-04,13,10,3,0.230769230769231
CUERNAVACA DE CORTEZ,2023-01-05,29,17,12,0.413793103448276
CUERNAVACA DE CORTEZ,2023-01-06,18,12,6,0.333333333333333
CUERNAVACA DE CORTEZ,2023-01-07,14,8,6,0.428571428571429
CUERNAVACA DE CORTEZ,2023-01-08,12,9,3,0.25
CUERNAVACA DE CORTEZ,2023-01-09,29,22,7,0.241379310344828
CUERNAVACA DE CORTEZ,2023-01-10,25,17,8,0.32
CUERNAVACA DE CORTEZ,2023-01-11,23,18,5,0.217391304347826
CUERNAVACA DE CORTEZ,2023-01-12,17,13,4,0.235294117647059
CUERNAVACA DE CORTEZ,2023-01-13,23,17,6,0.260869565217391
CUERNAVACA DE CORTEZ,2023-01-14,30,17,13,0.433333333333333
CUERNAVACA DE CORTEZ,2023-01-15,20,13,7,0.35
CUERNAVACA DE CORTEZ,2023-01-16,26,15,11,0.423076923076923
CUERNAVACA DE CORTEZ,2023-01-17,30,16,14,0.466666666666667
CUERNAVACA DE CORTEZ,2023-01-18,23,8,15,0.652173913043478
CUERNAVACA DE CORTEZ,2023-01-19,22,16,6,0.272727272727273
CUERNAVACA DE CORTEZ,2023-01-20,21,8,13,0.619047619047619
CUERNAVACA DE CORTEZ,2023-01-21,25,12,13,0.52
CUERNAVACA DE CORTEZ,2023-01-22,19,12,7,0.368421052631579
CUERNAVACA DE CORTEZ,2023-01-23,23,14,9,0.391304347826087
CUERNAVACA DE CORTEZ,2023-01-24,17,11,6,0.352941176470588
CUERNAVACA DE CORTEZ,2023-01-25,21,13,8,0.380952380952381
CUERNAVACA DE CORTEZ,2023-01-26,20,8,12,0.6
CUERNAVACA DE CORTEZ,2023-01-27,17,11,6,0.352941176470588
CUERNAVACA DE CORTEZ,2023-01-28,30,19,11,0.366666666666667
CUERNAVACA DE CORTEZ,2023-01-29,25,8,17,0.68
CUERNAVACA DE CORTEZ,2023-01-30,15,6,9,0.6
CUERNAVACA DE CORTEZ,2023-01-31,38,14,24,0.631578947368421
CUERNAVACA DE CORTEZ,2023-02-01,30,18,12,0.4
CUERNAVACA DE CORTEZ,2023-02-02,34,19,15,0.441176470588235
CUERNAVACA DE CORTEZ,2023-02-03,33,13,20,0.606060606060606
CUERNAVACA DE CORTEZ,2023-02-04,25,15,10,0.4
CUERNAVACA DE CORTEZ,2023-02-05,19,10,9,0.473684210526316
CUERNAVACA DE CORTEZ,2023-02-06,32,15,17,0.53125
CUERNAVACA DE CORTEZ,2023-02-07,18,9,9,0.5
CUERNAVACA DE CORTEZ,2023-02-08,25,14,11,0.44
CUERNAVACA DE CORTEZ,2023-02-09,26,13,13,0.5
CUERNAVACA DE CORTEZ,2023-02-10,25,18,7,0.28
CUERNAVACA DE CORTEZ,2023-02-11,27,16,11,0.407407407407407
CUERNAVACA DE CORTEZ,2023-02-12,15,7,8,0.533333333333333
CUERNAVACA DE CORTEZ,2023-02-13,19,12,7,0.368421052631579
CUERNAVACA DE CORTEZ,2023-02-14,19,8,11,0.578947368421053
CUERNAVACA DE CORTEZ,2023-02-15,20,11,9,0.45
CUERNAVACA DE CORTEZ,2023-02-16,17,9,8,0.470588235294118
CUERNAVACA DE CORTEZ,2023-02-17,24,14,10,0.416666666666667
CUERNAVACA DE CORTEZ,2023-02-18,23,13,10,0.434782608695652
CUERNAVACA DE CORTEZ,2023-02-19,14,9,5,0.357142857142857
CUERNAVACA DE CORTEZ,2023-02-20,15,12,3,0.2
CUERNAVACA DE CORTEZ,2023-02-21,27,18,9,0.333333333333333
CUERNAVACA DE CORTEZ,2023-02-22,26,20,6,0.230769230769231
CUERNAVACA DE CORTEZ,2023-02-23,14,11,3,0.214285714285714
CUERNAVACA DE CORTEZ,2023-02-24,32,21,11,0.34375
CUERNAVACA DE CORTEZ,2023-02-25,18,14,4,0.222222222222222
CUERNAVACA DE CORTEZ,2023-02-26,18,14,4,0.222222222222222
CUERNAVACA DE CORTEZ,2023-02-27,26,23,3,0.115384615384615
CUERNAVACA DE CORTEZ,2023-02-28,19,15,4,0.210526315789474
CUERNAVACA DE CORTEZ,2023-03-01,32,24,8,0.25
CUERNAVACA DE CORTEZ,2023-03-02,24,20,4,0.166666666666667
CUERNAVACA DE CORTEZ,2023-03-03,21,18,3,0.142857142857143
CUERNAVACA DE CORTEZ,2023-03-04,22,17,5,0.227272727272727
CUERNAVACA DE CORTEZ,2023-03-05,16,13,3,0.1875
CUERNAVACA DE CORTEZ,2023-03-06,18,15,3,0.166666666666667
CUERNAVACA DE CORTEZ,2023-03-07,20,16,4,0.2
CUERNAVACA DE CORTEZ,2023-03-08,31,30,1,0.032258064516129
CUERNAVACA DE CORTEZ,2023-03-09,19,17,2,0.105263157894737
CUERNAVACA DE CORTEZ,2023-03-10,19,19,0,0
CUERNAVACA DE CORTEZ,2023-03-11,22,21,1,0.0454545454545455
CUERNAVACA DE CORTEZ,2023-03-12,16,14,2,0.125
CUERNAVACA DE CORTEZ,2023-03-13,18,17,1,0.0555555555555556
CUERNAVACA DE CORTEZ,2023-03-14,28,28,0,0
CUERNAVACA DE CORTEZ,2023-03-15,23,23,0,0
CUERNAVACA DE CORTEZ,2023-03-16,32,32,0,0
CUERNAVACA DE CORTEZ,2023-03-17,27,26,1,0.037037037037037
CUERNAVACA DE CORTEZ,2023-03-18,36,36,0,0
CUERNAVACA DE CORTEZ,2023-03-19,15,15,0,0
CUERNAVACA DE CORTEZ,2023-03-20,27,27,0,0
CUERNAVACA DE CORTEZ,2023-03-21,34,33,1,0.0294117647058824
CUERNAVACA DE CORTEZ,2023-03-22,14,14,0,0
CUERNAVACA DE CORTEZ,2023-03-23,25,25,0,0
CUERNAVACA DE CORTEZ,2023-03-24,20,20,0,0
CUERNAVACA DE CORTEZ,2023-03-25,31,30,1,0.032258064516129
CUERNAVACA DE CORTEZ,2023-03-26,17,17,0,0
CUERNAVACA DE CORTEZ,2023-03-27,20,19,1,0.05
CUERNAVACA DE CORTEZ,2023-03-28,24,23,1,0.0416666666666667
CUERNAVACA DE CORTEZ,2023-03-29,32,30,2,0.0625
CUERNAVACA DE CORTEZ,2023-03-30,21,21,0,0
CUERNAVACA DE CORTEZ,2023-03-31,34,33,1,0.0294117647058824
CUERNAVACA DE CORTEZ,2023-04-01,22,21,1,0.0454545454545455
CUERNAVACA DE CORTEZ,2023-04-02,19,18,1,0.0526315789473684
CUERNAVACA DE CORTEZ,2023-04-03,22,22,0,0
CUERNAVACA DE CORTEZ,2023-04-04,28,26,2,0.0714285714285714
CUERNAVACA DE CORTEZ,2023-04-05,32,30,2,0.0625
CUERNAVACA DE CORTEZ,2023-04-06,28,27,1,0.0357142857142857
CUERNAVACA DE CORTEZ,2023-04-07,19,18,1,0.0526315789473684
CUERNAVACA DE CORTEZ,2023-04-08,19,19,0,0
CUERNAVACA DE CORTEZ,2023-04-09,13,12,1,0.0769230769230769
CUERNAVACA DE CORTEZ,2023-04-10,17,16,1,0.0588235294117647
CUERNAVACA DE CORTEZ,2023-04-11,26,23,3,0.115384615384615
CUERNAVACA DE CORTEZ,2023-04-12,24,21,3,0.125
CUERNAVACA DE CORTEZ,2023-04-13,21,21,0,0
CUERNAVACA DE CORTEZ,2023-04-14,29,26,3,0.103448275862069
CUERNAVACA DE CORTEZ,2023-04-15,29,27,2,0.0689655172413793
CUERNAVACA DE CORTEZ,2023-04-16,30,28,2,0.0666666666666667
CUERNAVACA DE CORTEZ,2023-04-17,32,31,1,0.03125
CUERNAVACA DE CORTEZ,2023-04-18,16,15,1,0.0625
CUERNAVACA DE CORTEZ,2023-04-19,20,18,2,0.1
CUERNAVACA DE CORTEZ,2023-04-20,15,15,0,0
CUERNAVACA DE CORTEZ,2023-04-21,23,22,1,0.0434782608695652
CUERNAVACA DE CORTEZ,2023-04-22,30,29,1,0.0333333333333333
CUERNAVACA DE CORTEZ,2023-04-23,14,13,1,0.0714285714285714
CUERNAVACA DE CORTEZ,2023-04-24,18,17,1,0.0555555555555556
CUERNAVACA DE CORTEZ,2023-04-25,27,25,2,0.0740740740740741
CUERNAVACA DE CORTEZ,2023-04-26,34,32,2,0.0588235294117647
CUERNAVACA DE CORTEZ,2023-04-27,27,27,0,0
CUERNAVACA DE CORTEZ,2023-04-28,23,22,1,0.0434782608695652
CUERNAVACA DE CORTEZ,2023-04-29,28,27,1,0.0357142857142857
CUERNAVACA DE CORTEZ,2023-04-30,37,35,2,0.0540540540540541
CUERNAVACA DE CORTEZ,2023-05-01,19,19,0,0
CUERNAVACA DE CORTEZ,2023-05-02,29,28,1,0.0344827586206897
CUERNAVACA DE CORTEZ,2023-05-03,19,19,0,0
CUERNAVACA DE CORTEZ,2023-05-04,28,28,0,0
CUERNAVACA DE CORTEZ,2023-05-05,24,22,2,0.0833333333333333
CUERNAVACA DE CORTEZ,2023-05-06,28,27,1,0.0357142857142857
CUERNAVACA DE CORTEZ,2023-05-07,15,15,0,0
CUERNAVACA DE CORTEZ,2023-05-08,20,20,0,0
CULIACAN,2023-01-02,24,16,8,0.333333333333333
CULIACAN,2023-01-03,41,32,9,0.219512195121951
CULIACAN,2023-01-04,38,26,12,0.315789473684211
CULIACAN,2023-01-06,1,1,0,0
CULIACAN,2023-01-07,50,37,13,0.26
CULIACAN,2023-01-08,42,30,12,0.285714285714286
CULIACAN,2023-01-09,35,29,6,0.171428571428571
CULIACAN,2023-01-10,37,31,6,0.162162162162162
CULIACAN,2023-01-11,43,34,9,0.209302325581395
CULIACAN,2023-01-12,37,29,8,0.216216216216216
CULIACAN,2023-01-13,24,19,5,0.208333333333333
CULIACAN,2023-01-14,35,29,6,0.171428571428571
CULIACAN,2023-01-15,24,17,7,0.291666666666667
CULIACAN,2023-01-16,30,25,5,0.166666666666667
CULIACAN,2023-01-17,28,23,5,0.178571428571429
CULIACAN,2023-01-18,33,25,8,0.242424242424242
CULIACAN,2023-01-19,38,27,11,0.289473684210526
CULIACAN,2023-01-20,29,21,8,0.275862068965517
CULIACAN,2023-01-21,36,27,9,0.25
CULIACAN,2023-01-22,33,27,6,0.181818181818182
CULIACAN,2023-01-23,31,23,8,0.258064516129032
CULIACAN,2023-01-24,40,31,9,0.225
CULIACAN,2023-01-25,34,27,7,0.205882352941176
CULIACAN,2023-01-26,26,17,9,0.346153846153846
CULIACAN,2023-01-27,29,18,11,0.379310344827586
CULIACAN,2023-01-28,28,22,6,0.214285714285714
CULIACAN,2023-01-29,34,22,12,0.352941176470588
CULIACAN,2023-01-30,39,21,18,0.461538461538462
CULIACAN,2023-01-31,38,22,16,0.421052631578947
CULIACAN,2023-02-01,38,26,12,0.315789473684211
CULIACAN,2023-02-02,33,25,8,0.242424242424242
CULIACAN,2023-02-03,30,19,11,0.366666666666667
CULIACAN,2023-02-04,37,24,13,0.351351351351351
CULIACAN,2023-02-05,21,14,7,0.333333333333333
CULIACAN,2023-02-06,31,17,14,0.451612903225806
CULIACAN,2023-02-07,43,30,13,0.302325581395349
CULIACAN,2023-02-08,31,22,9,0.290322580645161
CULIACAN,2023-02-09,35,20,15,0.428571428571429
CULIACAN,2023-02-10,37,27,10,0.27027027027027
CULIACAN,2023-02-11,39,21,18,0.461538461538462
CULIACAN,2023-02-12,28,15,13,0.464285714285714
CULIACAN,2023-02-13,31,23,8,0.258064516129032
CULIACAN,2023-02-14,25,19,6,0.24
CULIACAN,2023-02-15,30,17,13,0.433333333333333
CULIACAN,2023-02-16,32,24,8,0.25
CULIACAN,2023-02-17,39,17,22,0.564102564102564
CULIACAN,2023-02-18,34,23,11,0.323529411764706
CULIACAN,2023-02-19,22,17,5,0.227272727272727
CULIACAN,2023-02-20,30,19,11,0.366666666666667
CULIACAN,2023-02-21,33,25,8,0.242424242424242
CULIACAN,2023-02-22,36,22,14,0.388888888888889
CULIACAN,2023-02-23,38,27,11,0.289473684210526
CULIACAN,2023-02-24,32,25,7,0.21875
CULIACAN,2023-02-25,41,33,8,0.195121951219512
CULIACAN,2023-02-26,25,21,4,0.16
CULIACAN,2023-02-27,34,22,12,0.352941176470588
CULIACAN,2023-02-28,33,25,8,0.242424242424242
CULIACAN,2023-03-01,29,20,9,0.310344827586207
CULIACAN,2023-03-02,37,26,11,0.297297297297297
CULIACAN,2023-03-03,37,25,12,0.324324324324324
CULIACAN,2023-03-04,46,35,11,0.239130434782609
CULIACAN,2023-03-05,28,19,9,0.321428571428571
CULIACAN,2023-03-06,36,29,7,0.194444444444444
CULIACAN,2023-03-07,38,24,14,0.368421052631579
CULIACAN,2023-03-08,35,27,8,0.228571428571429
CULIACAN,2023-03-09,24,20,4,0.166666666666667
CULIACAN,2023-03-10,30,24,6,0.2
CULIACAN,2023-03-11,35,23,12,0.342857142857143
CULIACAN,2023-03-12,19,14,5,0.263157894736842
CULIACAN,2023-03-13,27,15,12,0.444444444444444
CULIACAN,2023-03-14,31,22,9,0.290322580645161
CULIACAN,2023-03-15,34,28,6,0.176470588235294
CULIACAN,2023-03-16,29,25,4,0.137931034482759
CULIACAN,2023-03-17,48,43,5,0.104166666666667
CULIACAN,2023-03-18,61,48,13,0.213114754098361
CULIACAN,2023-03-19,43,36,7,0.162790697674419
CULIACAN,2023-03-20,39,27,12,0.307692307692308
CULIACAN,2023-03-21,39,30,9,0.230769230769231
CULIACAN,2023-03-22,34,29,5,0.147058823529412
CULIACAN,2023-03-23,31,31,0,0
CULIACAN,2023-03-24,41,39,2,0.0487804878048781
CULIACAN,2023-03-25,47,44,3,0.0638297872340425
CULIACAN,2023-03-26,43,40,3,0.0697674418604651
CULIACAN,2023-03-27,23,22,1,0.0434782608695652
CULIACAN,2023-03-28,28,25,3,0.107142857142857
CULIACAN,2023-03-29,39,35,4,0.102564102564103
CULIACAN,2023-03-30,38,36,2,0.0526315789473684
CULIACAN,2023-03-31,51,47,4,0.0784313725490196
CULIACAN,2023-04-01,30,30,0,0
CULIACAN,2023-04-02,25,24,1,0.04
CULIACAN,2023-04-03,32,31,1,0.03125
CULIACAN,2023-04-04,45,43,2,0.0444444444444444
CULIACAN,2023-04-05,29,24,5,0.172413793103448
CULIACAN,2023-04-06,26,26,0,0
CULIACAN,2023-04-07,18,18,0,0
CULIACAN,2023-04-08,19,19,0,0
CULIACAN,2023-04-09,14,14,0,0
CULIACAN,2023-04-10,36,30,6,0.166666666666667
CULIACAN,2023-04-11,37,29,8,0.216216216216216
CULIACAN,2023-04-12,33,31,2,0.0606060606060606
CULIACAN,2023-04-13,28,26,2,0.0714285714285714
CULIACAN,2023-04-14,39,37,2,0.0512820512820513
CULIACAN,2023-04-15,55,48,7,0.127272727272727
CULIACAN,2023-04-16,50,47,3,0.06
CULIACAN,2023-04-17,30,28,2,0.0666666666666667
CULIACAN,2023-04-18,37,37,0,0
CULIACAN,2023-04-19,35,35,0,0
CULIACAN,2023-04-20,41,41,0,0
CULIACAN,2023-04-21,31,31,0,0
CULIACAN,2023-04-22,38,38,0,0
CULIACAN,2023-04-23,30,30,0,0
CULIACAN,2023-04-24,40,40,0,0
CULIACAN,2023-04-25,44,44,0,0
CULIACAN,2023-04-26,49,49,0,0
CULIACAN,2023-04-27,35,35,0,0
CULIACAN,2023-04-28,46,46,0,0
CULIACAN,2023-04-29,53,53,0,0
CULIACAN,2023-04-30,27,27,0,0
CULIACAN,2023-05-01,20,20,0,0
CULIACAN,2023-05-02,30,30,0,0
CULIACAN,2023-05-03,31,31,0,0
CULIACAN,2023-05-04,42,42,0,0
CULIACAN,2023-05-05,29,29,0,0
CULIACAN,2023-05-06,45,45,0,0
CULIACAN,2023-05-07,32,32,0,0
CULIACAN,2023-05-08,32,32,0,0
ECATEPEC,2023-01-02,17,15,2,0.117647058823529
ECATEPEC,2023-01-03,26,24,2,0.0769230769230769
ECATEPEC,2023-01-04,23,19,4,0.173913043478261
ECATEPEC,2023-01-05,34,33,1,0.0294117647058824
ECATEPEC,2023-01-06,29,25,4,0.137931034482759
ECATEPEC,2023-01-07,41,38,3,0.0731707317073171
ECATEPEC,2023-01-08,27,27,0,0
ECATEPEC,2023-01-09,28,25,3,0.107142857142857
ECATEPEC,2023-01-10,34,34,0,0
ECATEPEC,2023-01-11,33,32,1,0.0303030303030303
ECATEPEC,2023-01-12,31,27,4,0.129032258064516
ECATEPEC,2023-01-13,34,32,2,0.0588235294117647
ECATEPEC,2023-01-14,43,39,4,0.0930232558139535
ECATEPEC,2023-01-15,37,33,4,0.108108108108108
ECATEPEC,2023-01-16,32,28,4,0.125
ECATEPEC,2023-01-17,37,30,7,0.189189189189189
ECATEPEC,2023-01-18,23,20,3,0.130434782608696
ECATEPEC,2023-01-19,16,15,1,0.0625
ECATEPEC,2023-01-20,30,29,1,0.0333333333333333
ECATEPEC,2023-01-21,34,26,8,0.235294117647059
ECATEPEC,2023-01-22,42,28,14,0.333333333333333
ECATEPEC,2023-01-23,32,29,3,0.09375
ECATEPEC,2023-01-24,40,37,3,0.075
ECATEPEC,2023-01-25,30,29,1,0.0333333333333333
ECATEPEC,2023-01-26,37,31,6,0.162162162162162
ECATEPEC,2023-01-27,36,30,6,0.166666666666667
ECATEPEC,2023-01-28,35,32,3,0.0857142857142857
ECATEPEC,2023-01-29,40,35,5,0.125
ECATEPEC,2023-01-30,36,32,4,0.111111111111111
ECATEPEC,2023-01-31,40,36,4,0.1
ECATEPEC,2023-02-01,26,25,1,0.0384615384615385
ECATEPEC,2023-02-02,35,32,3,0.0857142857142857
ECATEPEC,2023-02-03,30,25,5,0.166666666666667
ECATEPEC,2023-02-04,35,26,9,0.257142857142857
ECATEPEC,2023-02-05,35,33,2,0.0571428571428571
ECATEPEC,2023-02-06,40,39,1,0.025
ECATEPEC,2023-02-07,38,34,4,0.105263157894737
ECATEPEC,2023-02-08,26,20,6,0.230769230769231
ECATEPEC,2023-02-09,34,33,1,0.0294117647058824
ECATEPEC,2023-02-10,32,30,2,0.0625
ECATEPEC,2023-02-11,35,31,4,0.114285714285714
ECATEPEC,2023-02-12,36,34,2,0.0555555555555556
ECATEPEC,2023-02-13,30,28,2,0.0666666666666667
ECATEPEC,2023-02-14,30,24,6,0.2
ECATEPEC,2023-02-15,33,28,5,0.151515151515152
ECATEPEC,2023-02-16,25,23,2,0.08
ECATEPEC,2023-02-17,27,24,3,0.111111111111111
ECATEPEC,2023-02-18,29,24,5,0.172413793103448
ECATEPEC,2023-02-19,30,28,2,0.0666666666666667
ECATEPEC,2023-02-20,28,25,3,0.107142857142857
ECATEPEC,2023-02-21,38,36,2,0.0526315789473684
ECATEPEC,2023-02-22,24,24,0,0
ECATEPEC,2023-02-23,28,28,0,0
ECATEPEC,2023-02-24,35,35,0,0
ECATEPEC,2023-02-25,34,34,0,0
ECATEPEC,2023-02-26,38,37,1,0.0263157894736842
ECATEPEC,2023-02-27,39,36,3,0.0769230769230769
ECATEPEC,2023-02-28,33,32,1,0.0303030303030303
ECATEPEC,2023-03-01,31,30,1,0.032258064516129
ECATEPEC,2023-03-02,28,27,1,0.0357142857142857
ECATEPEC,2023-03-03,35,35,0,0
ECATEPEC,2023-03-04,35,33,2,0.0571428571428571
ECATEPEC,2023-03-05,34,32,2,0.0588235294117647
ECATEPEC,2023-03-06,30,29,1,0.0333333333333333
ECATEPEC,2023-03-07,25,24,1,0.04
ECATEPEC,2023-03-08,29,29,0,0
ECATEPEC,2023-03-09,30,30,0,0
ECATEPEC,2023-03-10,34,34,0,0
ECATEPEC,2023-03-11,39,39,0,0
ECATEPEC,2023-03-12,36,35,1,0.0277777777777778
ECATEPEC,2023-03-13,17,17,0,0
ECATEPEC,2023-03-14,26,26,0,0
ECATEPEC,2023-03-15,45,45,0,0
ECATEPEC,2023-03-16,46,45,1,0.0217391304347826
ECATEPEC,2023-03-17,62,62,0,0
ECATEPEC,2023-03-18,73,73,0,0
ECATEPEC,2023-03-19,52,52,0,0
ECATEPEC,2023-03-20,59,59,0,0
ECATEPEC,2023-03-21,57,57,0,0
ECATEPEC,2023-03-22,39,39,0,0
ECATEPEC,2023-03-23,34,34,0,0
ECATEPEC,2023-03-24,38,38,0,0
ECATEPEC,2023-03-25,46,46,0,0
ECATEPEC,2023-03-26,52,52,0,0
ECATEPEC,2023-03-27,33,33,0,0
ECATEPEC,2023-03-28,30,30,0,0
ECATEPEC,2023-03-29,26,26,0,0
ECATEPEC,2023-03-30,39,39,0,0
ECATEPEC,2023-03-31,57,57,0,0
ECATEPEC,2023-04-01,46,46,0,0
ECATEPEC,2023-04-02,41,40,1,0.024390243902439
ECATEPEC,2023-04-03,46,46,0,0
ECATEPEC,2023-04-04,33,33,0,0
ECATEPEC,2023-04-05,34,34,0,0
ECATEPEC,2023-04-06,37,37,0,0
ECATEPEC,2023-04-07,23,23,0,0
ECATEPEC,2023-04-08,23,23,0,0
ECATEPEC,2023-04-09,30,30,0,0
ECATEPEC,2023-04-10,27,27,0,0
ECATEPEC,2023-04-11,27,27,0,0
ECATEPEC,2023-04-12,25,25,0,0
ECATEPEC,2023-04-13,36,36,0,0
ECATEPEC,2023-04-14,35,35,0,0
ECATEPEC,2023-04-15,58,58,0,0
ECATEPEC,2023-04-16,59,59,0,0
ECATEPEC,2023-04-17,40,40,0,0
ECATEPEC,2023-04-18,31,31,0,0
ECATEPEC,2023-04-19,26,26,0,0
ECATEPEC,2023-04-20,18,18,0,0
ECATEPEC,2023-04-21,42,42,0,0
ECATEPEC,2023-04-22,46,46,0,0
ECATEPEC,2023-04-23,46,46,0,0
ECATEPEC,2023-04-24,38,38,0,0
ECATEPEC,2023-04-25,50,50,0,0
ECATEPEC,2023-04-26,36,36,0,0
ECATEPEC,2023-04-27,21,21,0,0
ECATEPEC,2023-04-28,26,26,0,0
ECATEPEC,2023-04-29,28,28,0,0
ECATEPEC,2023-04-30,45,45,0,0
ECATEPEC,2023-05-01,41,41,0,0
ECATEPEC,2023-05-02,35,35,0,0
ECATEPEC,2023-05-03,27,27,0,0
ECATEPEC,2023-05-04,25,25,0,0
ECATEPEC,2023-05-05,41,41,0,0
ECATEPEC,2023-05-06,40,40,0,0
ECATEPEC,2023-05-07,36,36,0,0
ECATEPEC,2023-05-08,28,28,0,0
GDL BARRANCA,2023-01-02,14,10,4,0.285714285714286
GDL BARRANCA,2023-01-03,17,10,7,0.411764705882353
GDL BARRANCA,2023-01-04,15,11,4,0.266666666666667
GDL BARRANCA,2023-01-05,16,11,5,0.3125
GDL BARRANCA,2023-01-06,15,8,7,0.466666666666667
GDL BARRANCA,2023-01-07,20,13,7,0.35
GDL BARRANCA,2023-01-08,19,14,5,0.263157894736842
GDL BARRANCA,2023-01-09,16,11,5,0.3125
GDL BARRANCA,2023-01-10,29,18,11,0.379310344827586
GDL BARRANCA,2023-01-11,21,13,8,0.380952380952381
GDL BARRANCA,2023-01-12,17,11,6,0.352941176470588
GDL BARRANCA,2023-01-13,26,15,11,0.423076923076923
GDL BARRANCA,2023-01-14,21,14,7,0.333333333333333
GDL BARRANCA,2023-01-15,16,11,5,0.3125
GDL BARRANCA,2023-01-16,19,11,8,0.421052631578947
GDL BARRANCA,2023-01-17,18,13,5,0.277777777777778
GDL BARRANCA,2023-01-18,16,8,8,0.5
GDL BARRANCA,2023-01-19,21,16,5,0.238095238095238
GDL BARRANCA,2023-01-20,20,14,6,0.3
GDL BARRANCA,2023-01-21,19,3,16,0.842105263157895
GDL BARRANCA,2023-01-22,20,2,18,0.9
GDL BARRANCA,2023-01-23,16,5,11,0.6875
GDL BARRANCA,2023-01-24,17,1,16,0.941176470588235
GDL BARRANCA,2023-01-25,25,3,22,0.88
GDL BARRANCA,2023-01-26,26,2,24,0.923076923076923
GDL BARRANCA,2023-01-27,14,4,10,0.714285714285714
GDL BARRANCA,2023-01-28,25,3,22,0.88
GDL BARRANCA,2023-01-29,18,2,16,0.888888888888889
GDL BARRANCA,2023-01-30,20,5,15,0.75
GDL BARRANCA,2023-01-31,26,2,24,0.923076923076923
GDL BARRANCA,2023-02-01,18,7,11,0.611111111111111
GDL BARRANCA,2023-02-02,13,1,12,0.923076923076923
GDL BARRANCA,2023-02-03,23,3,20,0.869565217391304
GDL BARRANCA,2023-02-04,25,8,17,0.68
GDL BARRANCA,2023-02-05,20,6,14,0.7
GDL BARRANCA,2023-02-06,17,4,13,0.764705882352941
GDL BARRANCA,2023-02-07,25,5,20,0.8
GDL BARRANCA,2023-02-08,21,3,18,0.857142857142857
GDL BARRANCA,2023-02-09,13,5,8,0.615384615384615
GDL BARRANCA,2023-02-10,14,5,9,0.642857142857143
GDL BARRANCA,2023-02-11,26,5,21,0.807692307692308
GDL BARRANCA,2023-02-12,12,2,10,0.833333333333333
GDL BARRANCA,2023-02-13,14,2,12,0.857142857142857
GDL BARRANCA,2023-02-14,20,10,10,0.5
GDL BARRANCA,2023-02-15,15,5,10,0.666666666666667
GDL BARRANCA,2023-02-16,20,3,17,0.85
GDL BARRANCA,2023-02-17,20,10,10,0.5
GDL BARRANCA,2023-02-18,25,9,16,0.64
GDL BARRANCA,2023-02-19,16,9,7,0.4375
GDL BARRANCA,2023-02-20,23,10,13,0.565217391304348
GDL BARRANCA,2023-02-21,11,3,8,0.727272727272727
GDL BARRANCA,2023-02-22,14,7,7,0.5
GDL BARRANCA,2023-02-23,14,9,5,0.357142857142857
GDL BARRANCA,2023-02-24,13,10,3,0.230769230769231
GDL BARRANCA,2023-02-25,20,16,4,0.2
GDL BARRANCA,2023-02-26,10,9,1,0.1
GDL BARRANCA,2023-02-27,19,16,3,0.157894736842105
GDL BARRANCA,2023-02-28,21,16,5,0.238095238095238
GDL BARRANCA,2023-03-01,19,16,3,0.157894736842105
GDL BARRANCA,2023-03-02,18,12,6,0.333333333333333
GDL BARRANCA,2023-03-03,7,6,1,0.142857142857143
GDL BARRANCA,2023-03-04,20,19,1,0.05
GDL BARRANCA,2023-03-05,10,7,3,0.3
GDL BARRANCA,2023-03-06,14,12,2,0.142857142857143
GDL BARRANCA,2023-03-07,22,21,1,0.0454545454545455
GDL BARRANCA,2023-03-08,17,14,3,0.176470588235294
GDL BARRANCA,2023-03-09,15,14,1,0.0666666666666667
GDL BARRANCA,2023-03-10,11,11,0,0
GDL BARRANCA,2023-03-11,20,20,0,0
GDL BARRANCA,2023-03-12,13,12,1,0.0769230769230769
GDL BARRANCA,2023-03-13,13,12,1,0.0769230769230769
GDL BARRANCA,2023-03-14,21,21,0,0
GDL BARRANCA,2023-03-15,16,16,0,0
GDL BARRANCA,2023-03-16,22,22,0,0
GDL BARRANCA,2023-03-17,21,21,0,0
GDL BARRANCA,2023-03-18,29,29,0,0
GDL BARRANCA,2023-03-19,28,28,0,0
GDL BARRANCA,2023-03-20,18,16,2,0.111111111111111
GDL BARRANCA,2023-03-21,26,25,1,0.0384615384615385
GDL BARRANCA,2023-03-22,26,25,1,0.0384615384615385
GDL BARRANCA,2023-03-23,17,17,0,0
GDL BARRANCA,2023-03-24,27,26,1,0.037037037037037
GDL BARRANCA,2023-03-25,23,22,1,0.0434782608695652
GDL BARRANCA,2023-03-26,28,28,0,0
GDL BARRANCA,2023-03-27,23,23,0,0
GDL BARRANCA,2023-03-28,15,15,0,0
GDL BARRANCA,2023-03-29,17,17,0,0
GDL BARRANCA,2023-03-30,29,29,0,0
GDL BARRANCA,2023-03-31,42,42,0,0
GDL BARRANCA,2023-04-01,31,31,0,0
GDL BARRANCA,2023-04-02,10,10,0,0
GDL BARRANCA,2023-04-03,18,18,0,0
GDL BARRANCA,2023-04-04,25,25,0,0
GDL BARRANCA,2023-04-05,11,9,2,0.181818181818182
GDL BARRANCA,2023-04-06,14,14,0,0
GDL BARRANCA,2023-04-07,16,16,0,0
GDL BARRANCA,2023-04-08,12,12,0,0
GDL BARRANCA,2023-04-09,7,7,0,0
GDL BARRANCA,2023-04-10,13,12,1,0.0769230769230769
GDL BARRANCA,2023-04-11,19,19,0,0
GDL BARRANCA,2023-04-12,21,20,1,0.0476190476190476
GDL BARRANCA,2023-04-13,11,11,0,0
GDL BARRANCA,2023-04-14,14,14,0,0
GDL BARRANCA,2023-04-15,24,24,0,0
GDL BARRANCA,2023-04-16,22,22,0,0
GDL BARRANCA,2023-04-17,19,19,0,0
GDL BARRANCA,2023-04-18,16,16,0,0
GDL BARRANCA,2023-04-19,25,23,2,0.08
GDL BARRANCA,2023-04-20,20,20,0,0
GDL BARRANCA,2023-04-21,16,16,0,0
GDL BARRANCA,2023-04-22,22,22,0,0
GDL BARRANCA,2023-04-23,15,14,1,0.0666666666666667
GDL BARRANCA,2023-04-24,18,18,0,0
GDL BARRANCA,2023-04-25,24,23,1,0.0416666666666667
GDL BARRANCA,2023-04-26,16,15,1,0.0625
GDL BARRANCA,2023-04-27,15,15,0,0
GDL BARRANCA,2023-04-28,18,18,0,0
GDL BARRANCA,2023-04-29,18,17,1,0.0555555555555556
GDL BARRANCA,2023-04-30,9,9,0,0
GDL BARRANCA,2023-05-01,14,12,2,0.142857142857143
GDL BARRANCA,2023-05-02,10,10,0,0
GDL BARRANCA,2023-05-03,17,17,0,0
GDL BARRANCA,2023-05-04,14,14,0,0
GDL BARRANCA,2023-05-05,9,9,0,0
GDL BARRANCA,2023-05-06,31,28,3,0.0967741935483871
GDL BARRANCA,2023-05-07,13,13,0,0
GDL BARRANCA,2023-05-08,11,11,0,0
GDL CHAPULTEPEC,2023-01-02,18,14,4,0.222222222222222
GDL CHAPULTEPEC,2023-01-03,28,23,5,0.178571428571429
GDL CHAPULTEPEC,2023-01-04,19,15,4,0.210526315789474
GDL CHAPULTEPEC,2023-01-05,30,26,4,0.133333333333333
GDL CHAPULTEPEC,2023-01-06,16,12,4,0.25
GDL CHAPULTEPEC,2023-01-07,17,16,1,0.0588235294117647
GDL CHAPULTEPEC,2023-01-08,5,4,1,0.2
GDL CHAPULTEPEC,2023-01-09,21,18,3,0.142857142857143
GDL CHAPULTEPEC,2023-01-10,32,27,5,0.15625
GDL CHAPULTEPEC,2023-01-11,24,20,4,0.166666666666667
GDL CHAPULTEPEC,2023-01-12,26,24,2,0.0769230769230769
GDL CHAPULTEPEC,2023-01-13,20,14,6,0.3
GDL CHAPULTEPEC,2023-01-14,19,17,2,0.105263157894737
GDL CHAPULTEPEC,2023-01-15,7,5,2,0.285714285714286
GDL CHAPULTEPEC,2023-01-16,20,18,2,0.1
GDL CHAPULTEPEC,2023-01-17,21,20,1,0.0476190476190476
GDL CHAPULTEPEC,2023-01-18,23,22,1,0.0434782608695652
GDL CHAPULTEPEC,2023-01-19,18,17,1,0.0555555555555556
GDL CHAPULTEPEC,2023-01-20,10,9,1,0.1
GDL CHAPULTEPEC,2023-01-21,24,10,14,0.583333333333333
GDL CHAPULTEPEC,2023-01-22,9,8,1,0.111111111111111
GDL CHAPULTEPEC,2023-01-23,20,12,8,0.4
GDL CHAPULTEPEC,2023-01-24,30,13,17,0.566666666666667
GDL CHAPULTEPEC,2023-01-25,8,5,3,0.375
GDL CHAPULTEPEC,2023-01-26,28,15,13,0.464285714285714
GDL CHAPULTEPEC,2023-01-27,22,9,13,0.590909090909091
GDL CHAPULTEPEC,2023-01-28,21,10,11,0.523809523809524
GDL CHAPULTEPEC,2023-01-29,14,9,5,0.357142857142857
GDL CHAPULTEPEC,2023-01-30,23,9,14,0.608695652173913
GDL CHAPULTEPEC,2023-01-31,31,15,16,0.516129032258065
GDL CHAPULTEPEC,2023-02-01,23,14,9,0.391304347826087
GDL CHAPULTEPEC,2023-02-02,23,12,11,0.478260869565217
GDL CHAPULTEPEC,2023-02-03,22,12,10,0.454545454545455
GDL CHAPULTEPEC,2023-02-04,19,3,16,0.842105263157895
GDL CHAPULTEPEC,2023-02-05,18,9,9,0.5
GDL CHAPULTEPEC,2023-02-06,9,3,6,0.666666666666667
GDL CHAPULTEPEC,2023-02-07,26,13,13,0.5
GDL CHAPULTEPEC,2023-02-08,25,12,13,0.52
GDL CHAPULTEPEC,2023-02-09,33,15,18,0.545454545454545
GDL CHAPULTEPEC,2023-02-10,27,16,11,0.407407407407407
GDL CHAPULTEPEC,2023-02-11,17,8,9,0.529411764705882
GDL CHAPULTEPEC,2023-02-12,9,5,4,0.444444444444444
GDL CHAPULTEPEC,2023-02-13,18,6,12,0.666666666666667
GDL CHAPULTEPEC,2023-02-14,21,9,12,0.571428571428571
GDL CHAPULTEPEC,2023-02-15,20,11,9,0.45
GDL CHAPULTEPEC,2023-02-16,21,9,12,0.571428571428571
GDL CHAPULTEPEC,2023-02-17,18,11,7,0.388888888888889
GDL CHAPULTEPEC,2023-02-18,32,16,16,0.5
GDL CHAPULTEPEC,2023-02-19,10,7,3,0.3
GDL CHAPULTEPEC,2023-02-20,23,12,11,0.478260869565217
GDL CHAPULTEPEC,2023-02-21,30,13,17,0.566666666666667
GDL CHAPULTEPEC,2023-02-22,14,10,4,0.285714285714286
GDL CHAPULTEPEC,2023-02-23,22,18,4,0.181818181818182
GDL CHAPULTEPEC,2023-02-24,13,10,3,0.230769230769231
GDL CHAPULTEPEC,2023-02-25,20,16,4,0.2
GDL CHAPULTEPEC,2023-02-26,13,10,3,0.230769230769231
GDL CHAPULTEPEC,2023-02-27,26,20,6,0.230769230769231
GDL CHAPULTEPEC,2023-02-28,29,24,5,0.172413793103448
GDL CHAPULTEPEC,2023-03-01,28,23,5,0.178571428571429
GDL CHAPULTEPEC,2023-03-02,17,16,1,0.0588235294117647
GDL CHAPULTEPEC,2023-03-03,28,23,5,0.178571428571429
GDL CHAPULTEPEC,2023-03-04,25,21,4,0.16
GDL CHAPULTEPEC,2023-03-05,14,11,3,0.214285714285714
GDL CHAPULTEPEC,2023-03-06,18,14,4,0.222222222222222
GDL CHAPULTEPEC,2023-03-07,19,14,5,0.263157894736842
GDL CHAPULTEPEC,2023-03-08,26,21,5,0.192307692307692
GDL CHAPULTEPEC,2023-03-09,23,22,1,0.0434782608695652
GDL CHAPULTEPEC,2023-03-10,18,18,0,0
GDL CHAPULTEPEC,2023-03-11,22,22,0,0
GDL CHAPULTEPEC,2023-03-12,14,14,0,0
GDL CHAPULTEPEC,2023-03-13,25,25,0,0
GDL CHAPULTEPEC,2023-03-14,19,17,2,0.105263157894737
GDL CHAPULTEPEC,2023-03-15,26,26,0,0
GDL CHAPULTEPEC,2023-03-16,19,19,0,0
GDL CHAPULTEPEC,2023-03-17,19,19,0,0
GDL CHAPULTEPEC,2023-03-18,25,25,0,0
GDL CHAPULTEPEC,2023-03-19,14,14,0,0
GDL CHAPULTEPEC,2023-03-20,20,20,0,0
GDL CHAPULTEPEC,2023-03-21,26,26,0,0
GDL CHAPULTEPEC,2023-03-22,23,23,0,0
GDL CHAPULTEPEC,2023-03-23,24,24,0,0
GDL CHAPULTEPEC,2023-03-24,19,18,1,0.0526315789473684
GDL CHAPULTEPEC,2023-03-25,23,23,0,0
GDL CHAPULTEPEC,2023-03-26,10,10,0,0
GDL CHAPULTEPEC,2023-03-27,19,19,0,0
GDL CHAPULTEPEC,2023-03-28,25,24,1,0.04
GDL CHAPULTEPEC,2023-03-29,17,16,1,0.0588235294117647
GDL CHAPULTEPEC,2023-03-30,26,26,0,0
GDL CHAPULTEPEC,2023-03-31,29,29,0,0
GDL CHAPULTEPEC,2023-04-01,22,22,0,0
GDL CHAPULTEPEC,2023-04-02,8,8,0,0
GDL CHAPULTEPEC,2023-04-03,25,25,0,0
GDL CHAPULTEPEC,2023-04-04,29,28,1,0.0344827586206897
GDL CHAPULTEPEC,2023-04-05,23,23,0,0
GDL CHAPULTEPEC,2023-04-06,19,19,0,0
GDL CHAPULTEPEC,2023-04-07,12,12,0,0
GDL CHAPULTEPEC,2023-04-08,8,8,0,0
GDL CHAPULTEPEC,2023-04-09,5,5,0,0
GDL CHAPULTEPEC,2023-04-10,16,16,0,0
GDL CHAPULTEPEC,2023-04-11,21,18,3,0.142857142857143
GDL CHAPULTEPEC,2023-04-12,17,16,1,0.0588235294117647
GDL CHAPULTEPEC,2023-04-13,11,10,1,0.0909090909090909
GDL CHAPULTEPEC,2023-04-14,17,17,0,0
GDL CHAPULTEPEC,2023-04-15,18,17,1,0.0555555555555556
GDL CHAPULTEPEC,2023-04-16,13,13,0,0
GDL CHAPULTEPEC,2023-04-17,22,21,1,0.0454545454545455
GDL CHAPULTEPEC,2023-04-18,17,14,3,0.176470588235294
GDL CHAPULTEPEC,2023-04-19,26,25,1,0.0384615384615385
GDL CHAPULTEPEC,2023-04-20,22,21,1,0.0454545454545455
GDL CHAPULTEPEC,2023-04-21,28,28,0,0
GDL CHAPULTEPEC,2023-04-22,24,23,1,0.0416666666666667
GDL CHAPULTEPEC,2023-04-23,3,3,0,0
GDL CHAPULTEPEC,2023-04-24,21,19,2,0.0952380952380952
GDL CHAPULTEPEC,2023-04-25,23,20,3,0.130434782608696
GDL CHAPULTEPEC,2023-04-26,19,18,1,0.0526315789473684
GDL CHAPULTEPEC,2023-04-27,23,23,0,0
GDL CHAPULTEPEC,2023-04-28,28,26,2,0.0714285714285714
GDL CHAPULTEPEC,2023-04-29,33,32,1,0.0303030303030303
GDL CHAPULTEPEC,2023-04-30,15,14,1,0.0666666666666667
GDL CHAPULTEPEC,2023-05-01,11,10,1,0.0909090909090909
GDL CHAPULTEPEC,2023-05-02,26,24,2,0.0769230769230769
GDL CHAPULTEPEC,2023-05-03,28,28,0,0
GDL CHAPULTEPEC,2023-05-04,22,20,2,0.0909090909090909
GDL CHAPULTEPEC,2023-05-05,21,20,1,0.0476190476190476
GDL CHAPULTEPEC,2023-05-06,15,15,0,0
GDL CHAPULTEPEC,2023-05-07,11,10,1,0.0909090909090909
GDL CHAPULTEPEC,2023-05-08,21,19,2,0.0952380952380952
GDL COLOMOS,2023-01-02,36,26,10,0.277777777777778
GDL COLOMOS,2023-01-03,49,27,22,0.448979591836735
GDL COLOMOS,2023-01-04,49,25,24,0.489795918367347
GDL COLOMOS,2023-01-05,67,37,30,0.447761194029851
GDL COLOMOS,2023-01-06,62,43,19,0.306451612903226
GDL COLOMOS,2023-01-07,54,39,15,0.277777777777778
GDL COLOMOS,2023-01-08,31,22,9,0.290322580645161
GDL COLOMOS,2023-01-09,51,24,27,0.529411764705882
GDL COLOMOS,2023-01-10,43,25,18,0.418604651162791
GDL COLOMOS,2023-01-11,64,37,27,0.421875
GDL COLOMOS,2023-01-12,44,29,15,0.340909090909091
GDL COLOMOS,2023-01-13,46,27,19,0.41304347826087
GDL COLOMOS,2023-01-14,67,45,22,0.328358208955224
GDL COLOMOS,2023-01-15,32,22,10,0.3125
GDL COLOMOS,2023-01-16,57,33,24,0.421052631578947
GDL COLOMOS,2023-01-17,62,37,25,0.403225806451613
GDL COLOMOS,2023-01-18,55,31,24,0.436363636363636
GDL COLOMOS,2023-01-19,35,17,18,0.514285714285714
GDL COLOMOS,2023-01-20,60,28,32,0.533333333333333
GDL COLOMOS,2023-01-21,52,11,41,0.788461538461538
GDL COLOMOS,2023-01-22,30,16,14,0.466666666666667
GDL COLOMOS,2023-01-23,51,15,36,0.705882352941177
GDL COLOMOS,2023-01-24,51,20,31,0.607843137254902
GDL COLOMOS,2023-01-25,48,29,19,0.395833333333333
GDL COLOMOS,2023-01-26,52,17,35,0.673076923076923
GDL COLOMOS,2023-01-27,43,18,25,0.581395348837209
GDL COLOMOS,2023-01-28,50,18,32,0.64
GDL COLOMOS,2023-01-29,27,17,10,0.37037037037037
GDL COLOMOS,2023-01-30,50,20,30,0.6
GDL COLOMOS,2023-01-31,61,31,30,0.491803278688525
GDL COLOMOS,2023-02-01,42,22,20,0.476190476190476
GDL COLOMOS,2023-02-02,56,20,36,0.642857142857143
GDL COLOMOS,2023-02-03,51,22,29,0.568627450980392
GDL COLOMOS,2023-02-04,64,24,40,0.625
GDL COLOMOS,2023-02-05,24,14,10,0.416666666666667
GDL COLOMOS,2023-02-06,51,20,31,0.607843137254902
GDL COLOMOS,2023-02-07,70,35,35,0.5
GDL COLOMOS,2023-02-08,52,18,34,0.653846153846154
GDL COLOMOS,2023-02-09,53,20,33,0.622641509433962
GDL COLOMOS,2023-02-10,47,18,29,0.617021276595745
GDL COLOMOS,2023-02-11,63,27,36,0.571428571428571
GDL COLOMOS,2023-02-12,31,17,14,0.451612903225806
GDL COLOMOS,2023-02-13,45,22,23,0.511111111111111
GDL COLOMOS,2023-02-14,48,18,30,0.625
GDL COLOMOS,2023-02-15,46,21,25,0.543478260869565
GDL COLOMOS,2023-02-16,61,27,34,0.557377049180328
GDL COLOMOS,2023-02-17,69,20,49,0.710144927536232
GDL COLOMOS,2023-02-18,89,29,60,0.674157303370786
GDL COLOMOS,2023-02-19,47,18,29,0.617021276595745
GDL COLOMOS,2023-02-20,36,11,25,0.694444444444444
GDL COLOMOS,2023-02-21,60,20,40,0.666666666666667
GDL COLOMOS,2023-02-22,65,23,42,0.646153846153846
GDL COLOMOS,2023-02-23,49,27,22,0.448979591836735
GDL COLOMOS,2023-02-24,65,42,23,0.353846153846154
GDL COLOMOS,2023-02-25,62,38,24,0.387096774193548
GDL COLOMOS,2023-02-26,8,3,5,0.625
GDL COLOMOS,2023-02-27,39,22,17,0.435897435897436
GDL COLOMOS,2023-02-28,51,27,24,0.470588235294118
GDL COLOMOS,2023-03-01,54,35,19,0.351851851851852
GDL COLOMOS,2023-03-02,58,33,25,0.431034482758621
GDL COLOMOS,2023-03-03,55,34,21,0.381818181818182
GDL COLOMOS,2023-03-04,68,40,28,0.411764705882353
GDL COLOMOS,2023-03-05,32,19,13,0.40625
GDL COLOMOS,2023-03-06,55,32,23,0.418181818181818
GDL COLOMOS,2023-03-07,47,29,18,0.382978723404255
GDL COLOMOS,2023-03-08,50,35,15,0.3
GDL COLOMOS,2023-03-09,35,30,5,0.142857142857143
GDL COLOMOS,2023-03-10,42,39,3,0.0714285714285714
GDL COLOMOS,2023-03-11,60,42,18,0.3
GDL COLOMOS,2023-03-12,24,19,5,0.208333333333333
GDL COLOMOS,2023-03-13,41,40,1,0.024390243902439
GDL COLOMOS,2023-03-14,55,49,6,0.109090909090909
GDL COLOMOS,2023-03-15,53,48,5,0.0943396226415094
GDL COLOMOS,2023-03-16,50,42,8,0.16
GDL COLOMOS,2023-03-17,48,45,3,0.0625
GDL COLOMOS,2023-03-18,60,53,7,0.116666666666667
GDL COLOMOS,2023-03-19,35,31,4,0.114285714285714
GDL COLOMOS,2023-03-20,55,46,9,0.163636363636364
GDL COLOMOS,2023-03-21,59,50,9,0.152542372881356
GDL COLOMOS,2023-03-22,53,47,6,0.113207547169811
GDL COLOMOS,2023-03-23,45,42,3,0.0666666666666667
GDL COLOMOS,2023-03-24,55,52,3,0.0545454545454545
GDL COLOMOS,2023-03-25,62,59,3,0.0483870967741935
GDL COLOMOS,2023-03-26,39,34,5,0.128205128205128
GDL COLOMOS,2023-03-27,44,40,4,0.0909090909090909
GDL COLOMOS,2023-03-28,39,37,2,0.0512820512820513
GDL COLOMOS,2023-03-29,56,53,3,0.0535714285714286
GDL COLOMOS,2023-03-30,41,39,2,0.0487804878048781
GDL COLOMOS,2023-03-31,49,44,5,0.102040816326531
GDL COLOMOS,2023-04-01,63,60,3,0.0476190476190476
GDL COLOMOS,2023-04-02,28,27,1,0.0357142857142857
GDL COLOMOS,2023-04-03,59,56,3,0.0508474576271186
GDL COLOMOS,2023-04-04,59,54,5,0.0847457627118644
GDL COLOMOS,2023-04-05,56,51,5,0.0892857142857143
GDL COLOMOS,2023-04-06,47,41,6,0.127659574468085
GDL COLOMOS,2023-04-07,43,40,3,0.0697674418604651
GDL COLOMOS,2023-04-08,24,23,1,0.0416666666666667
GDL COLOMOS,2023-04-09,22,21,1,0.0454545454545455
GDL COLOMOS,2023-04-10,39,37,2,0.0512820512820513
GDL COLOMOS,2023-04-11,48,43,5,0.104166666666667
GDL COLOMOS,2023-04-12,49,44,5,0.102040816326531
GDL COLOMOS,2023-04-13,32,30,2,0.0625
GDL COLOMOS,2023-04-14,43,39,4,0.0930232558139535
GDL COLOMOS,2023-04-15,62,53,9,0.145161290322581
GDL COLOMOS,2023-04-16,35,33,2,0.0571428571428571
GDL COLOMOS,2023-04-17,44,42,2,0.0454545454545455
GDL COLOMOS,2023-04-18,46,35,11,0.239130434782609
GDL COLOMOS,2023-04-19,46,43,3,0.0652173913043478
GDL COLOMOS,2023-04-20,50,43,7,0.14
GDL COLOMOS,2023-04-21,38,31,7,0.184210526315789
GDL COLOMOS,2023-04-22,64,53,11,0.171875
GDL COLOMOS,2023-04-23,30,26,4,0.133333333333333
GDL COLOMOS,2023-04-24,52,47,5,0.0961538461538462
GDL COLOMOS,2023-04-25,67,60,7,0.104477611940299
GDL COLOMOS,2023-04-26,50,42,8,0.16
GDL COLOMOS,2023-04-27,39,36,3,0.0769230769230769
GDL COLOMOS,2023-04-28,56,50,6,0.107142857142857
GDL COLOMOS,2023-04-29,79,62,17,0.215189873417722
GDL COLOMOS,2023-04-30,55,49,6,0.109090909090909
GDL COLOMOS,2023-05-01,34,28,6,0.176470588235294
GDL COLOMOS,2023-05-02,36,32,4,0.111111111111111
GDL COLOMOS,2023-05-03,47,36,11,0.234042553191489
GDL COLOMOS,2023-05-04,62,53,9,0.145161290322581
GDL COLOMOS,2023-05-05,66,55,11,0.166666666666667
GDL COLOMOS,2023-05-06,63,52,11,0.174603174603175
GDL COLOMOS,2023-05-07,30,28,2,0.0666666666666667
GDL COLOMOS,2023-05-08,33,29,4,0.121212121212121
GDL EL SALTO,2023-01-02,18,12,6,0.333333333333333
GDL EL SALTO,2023-01-03,23,18,5,0.217391304347826
GDL EL SALTO,2023-01-04,29,25,4,0.137931034482759
GDL EL SALTO,2023-01-05,16,12,4,0.25
GDL EL SALTO,2023-01-06,25,22,3,0.12
GDL EL SALTO,2023-01-07,36,30,6,0.166666666666667
GDL EL SALTO,2023-01-08,24,23,1,0.0416666666666667
GDL EL SALTO,2023-01-09,23,21,2,0.0869565217391304
GDL EL SALTO,2023-01-10,28,25,3,0.107142857142857
GDL EL SALTO,2023-01-11,19,15,4,0.210526315789474
GDL EL SALTO,2023-01-12,19,18,1,0.0526315789473684
GDL EL SALTO,2023-01-13,25,22,3,0.12
GDL EL SALTO,2023-01-14,29,26,3,0.103448275862069
GDL EL SALTO,2023-01-15,12,8,4,0.333333333333333
GDL EL SALTO,2023-01-16,19,19,0,0
GDL EL SALTO,2023-01-17,26,25,1,0.0384615384615385
GDL EL SALTO,2023-01-18,20,13,7,0.35
GDL EL SALTO,2023-01-19,12,8,4,0.333333333333333
GDL EL SALTO,2023-01-20,23,20,3,0.130434782608696
GDL EL SALTO,2023-01-21,23,10,13,0.565217391304348
GDL EL SALTO,2023-01-22,26,10,16,0.615384615384615
GDL EL SALTO,2023-01-23,13,3,10,0.769230769230769
GDL EL SALTO,2023-01-24,15,12,3,0.2
GDL EL SALTO,2023-01-25,20,11,9,0.45
GDL EL SALTO,2023-01-26,15,9,6,0.4
GDL EL SALTO,2023-01-27,20,10,10,0.5
GDL EL SALTO,2023-01-28,31,17,14,0.451612903225806
GDL EL SALTO,2023-01-29,19,12,7,0.368421052631579
GDL EL SALTO,2023-01-30,24,14,10,0.416666666666667
GDL EL SALTO,2023-01-31,19,14,5,0.263157894736842
GDL EL SALTO,2023-02-01,11,2,9,0.818181818181818
GDL EL SALTO,2023-02-02,20,13,7,0.35
GDL EL SALTO,2023-02-03,25,12,13,0.52
GDL EL SALTO,2023-02-04,29,15,14,0.482758620689655
GDL EL SALTO,2023-02-05,20,8,12,0.6
GDL EL SALTO,2023-02-06,22,11,11,0.5
GDL EL SALTO,2023-02-07,25,11,14,0.56
GDL EL SALTO,2023-02-08,28,13,15,0.535714285714286
GDL EL SALTO,2023-02-09,19,9,10,0.526315789473684
GDL EL SALTO,2023-02-10,29,18,11,0.379310344827586
GDL EL SALTO,2023-02-11,30,15,15,0.5
GDL EL SALTO,2023-02-12,20,9,11,0.55
GDL EL SALTO,2023-02-13,19,10,9,0.473684210526316
GDL EL SALTO,2023-02-14,14,7,7,0.5
GDL EL SALTO,2023-02-15,24,10,14,0.583333333333333
GDL EL SALTO,2023-02-16,24,14,10,0.416666666666667
GDL EL SALTO,2023-02-17,18,7,11,0.611111111111111
GDL EL SALTO,2023-02-18,20,12,8,0.4
GDL EL SALTO,2023-02-19,16,7,9,0.5625
GDL EL SALTO,2023-02-20,10,7,3,0.3
GDL EL SALTO,2023-02-21,18,14,4,0.222222222222222
GDL EL SALTO,2023-02-22,13,11,2,0.153846153846154
GDL EL SALTO,2023-02-23,12,11,1,0.0833333333333333
GDL EL SALTO,2023-02-24,16,9,7,0.4375
GDL EL SALTO,2023-02-25,25,19,6,0.24
GDL EL SALTO,2023-02-26,26,21,5,0.192307692307692
GDL EL SALTO,2023-02-27,18,15,3,0.166666666666667
GDL EL SALTO,2023-02-28,24,18,6,0.25
GDL EL SALTO,2023-03-01,23,12,11,0.478260869565217
GDL EL SALTO,2023-03-02,17,15,2,0.117647058823529
GDL EL SALTO,2023-03-03,20,17,3,0.15
GDL EL SALTO,2023-03-04,28,25,3,0.107142857142857
GDL EL SALTO,2023-03-05,16,11,5,0.3125
GDL EL SALTO,2023-03-06,23,17,6,0.260869565217391
GDL EL SALTO,2023-03-07,25,17,8,0.32
GDL EL SALTO,2023-03-08,19,18,1,0.0526315789473684
GDL EL SALTO,2023-03-09,22,17,5,0.227272727272727
GDL EL SALTO,2023-03-10,17,15,2,0.117647058823529
GDL EL SALTO,2023-03-11,26,23,3,0.115384615384615
GDL EL SALTO,2023-03-12,14,12,2,0.142857142857143
GDL EL SALTO,2023-03-13,16,12,4,0.25
GDL EL SALTO,2023-03-14,22,21,1,0.0454545454545455
GDL EL SALTO,2023-03-15,15,12,3,0.2
GDL EL SALTO,2023-03-16,27,23,4,0.148148148148148
GDL EL SALTO,2023-03-17,23,21,2,0.0869565217391304
GDL EL SALTO,2023-03-18,26,21,5,0.192307692307692
GDL EL SALTO,2023-03-19,34,27,7,0.205882352941176
GDL EL SALTO,2023-03-20,36,28,8,0.222222222222222
GDL EL SALTO,2023-03-21,33,26,7,0.212121212121212
GDL EL SALTO,2023-03-22,31,26,5,0.161290322580645
GDL EL SALTO,2023-03-23,20,18,2,0.1
GDL EL SALTO,2023-03-24,17,13,4,0.235294117647059
GDL EL SALTO,2023-03-25,30,27,3,0.1
GDL EL SALTO,2023-03-26,22,18,4,0.181818181818182
GDL EL SALTO,2023-03-27,14,12,2,0.142857142857143
GDL EL SALTO,2023-03-28,21,19,2,0.0952380952380952
GDL EL SALTO,2023-03-29,24,23,1,0.0416666666666667
GDL EL SALTO,2023-03-30,27,26,1,0.037037037037037
GDL EL SALTO,2023-03-31,42,38,4,0.0952380952380952
GDL EL SALTO,2023-04-01,19,15,4,0.210526315789474
GDL EL SALTO,2023-04-02,17,12,5,0.294117647058824
GDL EL SALTO,2023-04-03,19,17,2,0.105263157894737
GDL EL SALTO,2023-04-04,26,23,3,0.115384615384615
GDL EL SALTO,2023-04-05,14,14,0,0
GDL EL SALTO,2023-04-06,31,25,6,0.193548387096774
GDL EL SALTO,2023-04-07,31,26,5,0.161290322580645
GDL EL SALTO,2023-04-08,21,16,5,0.238095238095238
GDL EL SALTO,2023-04-09,15,13,2,0.133333333333333
GDL EL SALTO,2023-04-10,22,18,4,0.181818181818182
GDL EL SALTO,2023-04-11,23,16,7,0.304347826086957
GDL EL SALTO,2023-04-12,29,26,3,0.103448275862069
GDL EL SALTO,2023-04-13,24,21,3,0.125
GDL EL SALTO,2023-04-14,39,32,7,0.179487179487179
GDL EL SALTO,2023-04-15,30,23,7,0.233333333333333
GDL EL SALTO,2023-04-16,18,16,2,0.111111111111111
GDL EL SALTO,2023-04-17,28,24,4,0.142857142857143
GDL EL SALTO,2023-04-18,27,19,8,0.296296296296296
GDL EL SALTO,2023-04-19,19,17,2,0.105263157894737
GDL EL SALTO,2023-04-20,22,18,4,0.181818181818182
GDL EL SALTO,2023-04-21,24,20,4,0.166666666666667
GDL EL SALTO,2023-04-22,32,25,7,0.21875
GDL EL SALTO,2023-04-23,24,19,5,0.208333333333333
GDL EL SALTO,2023-04-24,20,18,2,0.1
GDL EL SALTO,2023-04-25,26,22,4,0.153846153846154
GDL EL SALTO,2023-04-26,31,24,7,0.225806451612903
GDL EL SALTO,2023-04-27,25,21,4,0.16
GDL EL SALTO,2023-04-28,28,18,10,0.357142857142857
GDL EL SALTO,2023-04-29,39,33,6,0.153846153846154
GDL EL SALTO,2023-04-30,21,15,6,0.285714285714286
GDL EL SALTO,2023-05-01,23,16,7,0.304347826086957
GDL EL SALTO,2023-05-02,24,18,6,0.25
GDL EL SALTO,2023-05-03,15,11,4,0.266666666666667
GDL EL SALTO,2023-05-04,27,18,9,0.333333333333333
GDL EL SALTO,2023-05-05,30,25,5,0.166666666666667
GDL EL SALTO,2023-05-06,27,20,7,0.259259259259259
GDL EL SALTO,2023-05-07,20,17,3,0.15
GDL EL SALTO,2023-05-08,22,17,5,0.227272727272727
GDL EL TAPATIO,2023-01-02,21,9,12,0.571428571428571
GDL EL TAPATIO,2023-01-03,31,16,15,0.483870967741935
GDL EL TAPATIO,2023-01-04,29,13,16,0.551724137931034
GDL EL TAPATIO,2023-01-05,35,24,11,0.314285714285714
GDL EL TAPATIO,2023-01-06,32,20,12,0.375
GDL EL TAPATIO,2023-01-07,41,23,18,0.439024390243902
GDL EL TAPATIO,2023-01-08,29,16,13,0.448275862068966
GDL EL TAPATIO,2023-01-09,22,11,11,0.5
GDL EL TAPATIO,2023-01-10,24,9,15,0.625
GDL EL TAPATIO,2023-01-11,39,19,20,0.512820512820513
GDL EL TAPATIO,2023-01-12,25,17,8,0.32
GDL EL TAPATIO,2023-01-13,28,13,15,0.535714285714286
GDL EL TAPATIO,2023-01-14,32,14,18,0.5625
GDL EL TAPATIO,2023-01-15,29,19,10,0.344827586206897
GDL EL TAPATIO,2023-01-16,33,21,12,0.363636363636364
GDL EL TAPATIO,2023-01-17,20,13,7,0.35
GDL EL TAPATIO,2023-01-18,23,6,17,0.739130434782609
GDL EL TAPATIO,2023-01-19,28,17,11,0.392857142857143
GDL EL TAPATIO,2023-01-20,38,19,19,0.5
GDL EL TAPATIO,2023-01-21,38,4,34,0.894736842105263
GDL EL TAPATIO,2023-01-22,24,8,16,0.666666666666667
GDL EL TAPATIO,2023-01-23,29,7,22,0.758620689655172
GDL EL TAPATIO,2023-01-24,22,6,16,0.727272727272727
GDL EL TAPATIO,2023-01-25,22,4,18,0.818181818181818
GDL EL TAPATIO,2023-01-26,26,3,23,0.884615384615385
GDL EL TAPATIO,2023-01-27,22,3,19,0.863636363636364
GDL EL TAPATIO,2023-01-28,37,7,30,0.810810810810811
GDL EL TAPATIO,2023-01-29,26,10,16,0.615384615384615
GDL EL TAPATIO,2023-01-30,31,11,20,0.645161290322581
GDL EL TAPATIO,2023-01-31,29,8,21,0.724137931034483
GDL EL TAPATIO,2023-02-01,24,7,17,0.708333333333333
GDL EL TAPATIO,2023-02-02,35,6,29,0.828571428571429
GDL EL TAPATIO,2023-02-03,27,6,21,0.777777777777778
GDL EL TAPATIO,2023-02-04,35,3,32,0.914285714285714
GDL EL TAPATIO,2023-02-05,17,2,15,0.882352941176471
GDL EL TAPATIO,2023-02-06,21,5,16,0.761904761904762
GDL EL TAPATIO,2023-02-07,35,7,28,0.8
GDL EL TAPATIO,2023-02-08,24,5,19,0.791666666666667
GDL EL TAPATIO,2023-02-09,23,3,20,0.869565217391304
GDL EL TAPATIO,2023-02-10,24,6,18,0.75
GDL EL TAPATIO,2023-02-11,27,5,22,0.814814814814815
GDL EL TAPATIO,2023-02-12,23,2,21,0.91304347826087
GDL EL TAPATIO,2023-02-13,23,1,22,0.956521739130435
GDL EL TAPATIO,2023-02-14,29,5,24,0.827586206896552
GDL EL TAPATIO,2023-02-15,16,2,14,0.875
GDL EL TAPATIO,2023-02-16,25,2,23,0.92
GDL EL TAPATIO,2023-02-17,27,1,26,0.962962962962963
GDL EL TAPATIO,2023-02-18,44,5,39,0.886363636363636
GDL EL TAPATIO,2023-02-19,23,2,21,0.91304347826087
GDL EL TAPATIO,2023-02-20,18,1,17,0.944444444444444
GDL EL TAPATIO,2023-02-21,38,8,30,0.789473684210526
GDL EL TAPATIO,2023-02-22,26,3,23,0.884615384615385
GDL EL TAPATIO,2023-02-23,18,3,15,0.833333333333333
GDL EL TAPATIO,2023-02-24,26,0,26,1
GDL EL TAPATIO,2023-02-25,27,6,21,0.777777777777778
GDL EL TAPATIO,2023-02-26,27,6,21,0.777777777777778
GDL EL TAPATIO,2023-02-27,18,2,16,0.888888888888889
GDL EL TAPATIO,2023-02-28,21,3,18,0.857142857142857
GDL EL TAPATIO,2023-03-01,18,2,16,0.888888888888889
GDL EL TAPATIO,2023-03-02,29,5,24,0.827586206896552
GDL EL TAPATIO,2023-03-03,17,7,10,0.588235294117647
GDL EL TAPATIO,2023-03-04,36,14,22,0.611111111111111
GDL EL TAPATIO,2023-03-05,23,7,16,0.695652173913043
GDL EL TAPATIO,2023-03-06,25,10,15,0.6
GDL EL TAPATIO,2023-03-07,28,7,21,0.75
GDL EL TAPATIO,2023-03-08,27,8,19,0.703703703703704
GDL EL TAPATIO,2023-03-09,19,15,4,0.210526315789474
GDL EL TAPATIO,2023-03-10,18,12,6,0.333333333333333
GDL EL TAPATIO,2023-03-11,30,23,7,0.233333333333333
GDL EL TAPATIO,2023-03-12,21,18,3,0.142857142857143
GDL EL TAPATIO,2023-03-13,18,12,6,0.333333333333333
GDL EL TAPATIO,2023-03-14,18,10,8,0.444444444444444
GDL EL TAPATIO,2023-03-15,37,30,7,0.189189189189189
GDL EL TAPATIO,2023-03-16,22,19,3,0.136363636363636
GDL EL TAPATIO,2023-03-17,38,35,3,0.0789473684210526
GDL EL TAPATIO,2023-03-18,54,40,14,0.259259259259259
GDL EL TAPATIO,2023-03-19,31,24,7,0.225806451612903
GDL EL TAPATIO,2023-03-20,38,34,4,0.105263157894737
GDL EL TAPATIO,2023-03-21,24,20,4,0.166666666666667
GDL EL TAPATIO,2023-03-22,24,23,1,0.0416666666666667
GDL EL TAPATIO,2023-03-23,34,31,3,0.0882352941176471
GDL EL TAPATIO,2023-03-24,24,23,1,0.0416666666666667
GDL EL TAPATIO,2023-03-25,39,38,1,0.0256410256410256
GDL EL TAPATIO,2023-03-26,24,24,0,0
GDL EL TAPATIO,2023-03-27,27,22,5,0.185185185185185
GDL EL TAPATIO,2023-03-28,22,22,0,0
GDL EL TAPATIO,2023-03-29,18,18,0,0
GDL EL TAPATIO,2023-03-30,29,28,1,0.0344827586206897
GDL EL TAPATIO,2023-03-31,38,38,0,0
GDL EL TAPATIO,2023-04-01,32,29,3,0.09375
GDL EL TAPATIO,2023-04-02,14,13,1,0.0714285714285714
GDL EL TAPATIO,2023-04-03,18,17,1,0.0555555555555556
GDL EL TAPATIO,2023-04-04,14,12,2,0.142857142857143
GDL EL TAPATIO,2023-04-05,19,17,2,0.105263157894737
GDL EL TAPATIO,2023-04-06,33,31,2,0.0606060606060606
GDL EL TAPATIO,2023-04-07,18,17,1,0.0555555555555556
GDL EL TAPATIO,2023-04-08,15,14,1,0.0666666666666667
GDL EL TAPATIO,2023-04-09,18,18,0,0
GDL EL TAPATIO,2023-04-10,21,16,5,0.238095238095238
GDL EL TAPATIO,2023-04-11,23,20,3,0.130434782608696
GDL EL TAPATIO,2023-04-12,21,19,2,0.0952380952380952
GDL EL TAPATIO,2023-04-13,20,17,3,0.15
GDL EL TAPATIO,2023-04-14,31,25,6,0.193548387096774
GDL EL TAPATIO,2023-04-15,33,30,3,0.0909090909090909
GDL EL TAPATIO,2023-04-16,18,14,4,0.222222222222222
GDL EL TAPATIO,2023-04-17,19,16,3,0.157894736842105
GDL EL TAPATIO,2023-04-18,17,15,2,0.117647058823529
GDL EL TAPATIO,2023-04-19,26,22,4,0.153846153846154
GDL EL TAPATIO,2023-04-20,22,21,1,0.0454545454545455
GDL EL TAPATIO,2023-04-21,23,17,6,0.260869565217391
GDL EL TAPATIO,2023-04-22,36,32,4,0.111111111111111
GDL EL TAPATIO,2023-04-23,19,18,1,0.0526315789473684
GDL EL TAPATIO,2023-04-24,29,29,0,0
GDL EL TAPATIO,2023-04-25,29,26,3,0.103448275862069
GDL EL TAPATIO,2023-04-26,24,22,2,0.0833333333333333
GDL EL TAPATIO,2023-04-27,23,21,2,0.0869565217391304
GDL EL TAPATIO,2023-04-28,21,19,2,0.0952380952380952
GDL EL TAPATIO,2023-04-29,30,28,2,0.0666666666666667
GDL EL TAPATIO,2023-04-30,16,15,1,0.0625
GDL EL TAPATIO,2023-05-01,18,17,1,0.0555555555555556
GDL EL TAPATIO,2023-05-02,18,18,0,0
GDL EL TAPATIO,2023-05-03,12,11,1,0.0833333333333333
GDL EL TAPATIO,2023-05-04,27,22,5,0.185185185185185
GDL EL TAPATIO,2023-05-05,18,15,3,0.166666666666667
GDL EL TAPATIO,2023-05-06,27,23,4,0.148148148148148
GDL EL TAPATIO,2023-05-07,20,20,0,0
GDL EL TAPATIO,2023-05-08,24,20,4,0.166666666666667
GDL ESTADIO,2023-01-02,13,8,5,0.384615384615385
GDL ESTADIO,2023-01-03,30,22,8,0.266666666666667
GDL ESTADIO,2023-01-04,15,12,3,0.2
GDL ESTADIO,2023-01-05,23,16,7,0.304347826086957
GDL ESTADIO,2023-01-06,23,15,8,0.347826086956522
GDL ESTADIO,2023-01-07,34,20,14,0.411764705882353
GDL ESTADIO,2023-01-08,19,12,7,0.368421052631579
GDL ESTADIO,2023-01-09,39,26,13,0.333333333333333
GDL ESTADIO,2023-01-10,36,25,11,0.305555555555556
GDL ESTADIO,2023-01-11,26,11,15,0.576923076923077
GDL ESTADIO,2023-01-12,32,18,14,0.4375
GDL ESTADIO,2023-01-13,30,18,12,0.4
GDL ESTADIO,2023-01-14,40,29,11,0.275
GDL ESTADIO,2023-01-15,31,21,10,0.32258064516129
GDL ESTADIO,2023-01-16,31,23,8,0.258064516129032
GDL ESTADIO,2023-01-17,27,19,8,0.296296296296296
GDL ESTADIO,2023-01-18,26,17,9,0.346153846153846
GDL ESTADIO,2023-01-19,26,21,5,0.192307692307692
GDL ESTADIO,2023-01-20,26,17,9,0.346153846153846
GDL ESTADIO,2023-01-21,36,13,23,0.638888888888889
GDL ESTADIO,2023-01-22,24,4,20,0.833333333333333
GDL ESTADIO,2023-01-23,26,7,19,0.730769230769231
GDL ESTADIO,2023-01-24,28,11,17,0.607142857142857
GDL ESTADIO,2023-01-25,31,11,20,0.645161290322581
GDL ESTADIO,2023-01-26,26,5,21,0.807692307692308
GDL ESTADIO,2023-01-27,28,8,20,0.714285714285714
GDL ESTADIO,2023-01-28,28,7,21,0.75
GDL ESTADIO,2023-01-29,24,9,15,0.625
GDL ESTADIO,2023-01-30,32,5,27,0.84375
GDL ESTADIO,2023-01-31,33,14,19,0.575757575757576
GDL ESTADIO,2023-02-01,41,13,28,0.682926829268293
GDL ESTADIO,2023-02-02,35,15,20,0.571428571428571
GDL ESTADIO,2023-02-03,21,6,15,0.714285714285714
GDL ESTADIO,2023-02-04,38,19,19,0.5
GDL ESTADIO,2023-02-05,24,10,14,0.583333333333333
GDL ESTADIO,2023-02-06,32,12,20,0.625
GDL ESTADIO,2023-02-07,31,13,18,0.580645161290323
GDL ESTADIO,2023-02-08,23,5,18,0.782608695652174
GDL ESTADIO,2023-02-09,20,7,13,0.65
GDL ESTADIO,2023-02-10,30,12,18,0.6
GDL ESTADIO,2023-02-11,28,15,13,0.464285714285714
GDL ESTADIO,2023-02-12,15,7,8,0.533333333333333
GDL ESTADIO,2023-02-13,25,8,17,0.68
GDL ESTADIO,2023-02-14,27,9,18,0.666666666666667
GDL ESTADIO,2023-02-15,17,9,8,0.470588235294118
GDL ESTADIO,2023-02-16,18,3,15,0.833333333333333
GDL ESTADIO,2023-02-17,24,7,17,0.708333333333333
GDL ESTADIO,2023-02-18,41,23,18,0.439024390243902
GDL ESTADIO,2023-02-19,28,12,16,0.571428571428571
GDL ESTADIO,2023-02-20,21,11,10,0.476190476190476
GDL ESTADIO,2023-02-21,23,11,12,0.521739130434783
GDL ESTADIO,2023-02-22,22,15,7,0.318181818181818
GDL ESTADIO,2023-02-23,26,17,9,0.346153846153846
GDL ESTADIO,2023-02-24,26,16,10,0.384615384615385
GDL ESTADIO,2023-02-25,40,23,17,0.425
GDL ESTADIO,2023-02-26,18,10,8,0.444444444444444
GDL ESTADIO,2023-02-27,23,18,5,0.217391304347826
GDL ESTADIO,2023-02-28,38,28,10,0.263157894736842
GDL ESTADIO,2023-03-01,22,18,4,0.181818181818182
GDL ESTADIO,2023-03-02,24,20,4,0.166666666666667
GDL ESTADIO,2023-03-03,24,21,3,0.125
GDL ESTADIO,2023-03-04,30,23,7,0.233333333333333
GDL ESTADIO,2023-03-05,19,13,6,0.315789473684211
GDL ESTADIO,2023-03-06,27,15,12,0.444444444444444
GDL ESTADIO,2023-03-07,29,16,13,0.448275862068966
GDL ESTADIO,2023-03-08,29,20,9,0.310344827586207
GDL ESTADIO,2023-03-09,18,16,2,0.111111111111111
GDL ESTADIO,2023-03-10,28,24,4,0.142857142857143
GDL ESTADIO,2023-03-11,23,22,1,0.0434782608695652
GDL ESTADIO,2023-03-12,24,20,4,0.166666666666667
GDL ESTADIO,2023-03-13,15,11,4,0.266666666666667
GDL ESTADIO,2023-03-14,31,24,7,0.225806451612903
GDL ESTADIO,2023-03-15,27,25,2,0.0740740740740741
GDL ESTADIO,2023-03-16,38,35,3,0.0789473684210526
GDL ESTADIO,2023-03-17,34,31,3,0.0882352941176471
GDL ESTADIO,2023-03-18,34,29,5,0.147058823529412
GDL ESTADIO,2023-03-19,33,30,3,0.0909090909090909
GDL ESTADIO,2023-03-20,41,37,4,0.0975609756097561
GDL ESTADIO,2023-03-21,33,31,2,0.0606060606060606
GDL ESTADIO,2023-03-22,27,26,1,0.037037037037037
GDL ESTADIO,2023-03-23,19,15,4,0.210526315789474
GDL ESTADIO,2023-03-24,27,27,0,0
GDL ESTADIO,2023-03-25,38,33,5,0.131578947368421
GDL ESTADIO,2023-03-26,27,25,2,0.0740740740740741
GDL ESTADIO,2023-03-27,17,17,0,0
GDL ESTADIO,2023-03-28,27,26,1,0.037037037037037
GDL ESTADIO,2023-03-29,27,25,2,0.0740740740740741
GDL ESTADIO,2023-03-30,33,29,4,0.121212121212121
GDL ESTADIO,2023-03-31,37,33,4,0.108108108108108
GDL ESTADIO,2023-04-01,34,33,1,0.0294117647058824
GDL ESTADIO,2023-04-02,14,13,1,0.0714285714285714
GDL ESTADIO,2023-04-03,27,24,3,0.111111111111111
GDL ESTADIO,2023-04-04,32,32,0,0
GDL ESTADIO,2023-04-05,23,22,1,0.0434782608695652
GDL ESTADIO,2023-04-06,15,13,2,0.133333333333333
GDL ESTADIO,2023-04-07,11,10,1,0.0909090909090909
GDL ESTADIO,2023-04-08,19,17,2,0.105263157894737
GDL ESTADIO,2023-04-09,9,9,0,0
GDL ESTADIO,2023-04-10,17,16,1,0.0588235294117647
GDL ESTADIO,2023-04-11,17,17,0,0
GDL ESTADIO,2023-04-12,16,12,4,0.25
GDL ESTADIO,2023-04-13,32,30,2,0.0625
GDL ESTADIO,2023-04-14,23,21,2,0.0869565217391304
GDL ESTADIO,2023-04-15,43,35,8,0.186046511627907
GDL ESTADIO,2023-04-16,29,25,4,0.137931034482759
GDL ESTADIO,2023-04-17,20,20,0,0
GDL ESTADIO,2023-04-18,26,23,3,0.115384615384615
GDL ESTADIO,2023-04-19,25,20,5,0.2
GDL ESTADIO,2023-04-20,24,23,1,0.0416666666666667
GDL ESTADIO,2023-04-21,16,15,1,0.0625
GDL ESTADIO,2023-04-22,30,29,1,0.0333333333333333
GDL ESTADIO,2023-04-23,29,27,2,0.0689655172413793
GDL ESTADIO,2023-04-24,22,21,1,0.0454545454545455
GDL ESTADIO,2023-04-25,30,27,3,0.1
GDL ESTADIO,2023-04-26,25,23,2,0.08
GDL ESTADIO,2023-04-27,17,15,2,0.117647058823529
GDL ESTADIO,2023-04-28,19,19,0,0
GDL ESTADIO,2023-04-29,33,29,4,0.121212121212121
GDL ESTADIO,2023-04-30,21,20,1,0.0476190476190476
GDL ESTADIO,2023-05-01,20,19,1,0.05
GDL ESTADIO,2023-05-02,27,25,2,0.0740740740740741
GDL ESTADIO,2023-05-03,20,20,0,0
GDL ESTADIO,2023-05-04,17,16,1,0.0588235294117647
GDL ESTADIO,2023-05-05,23,18,5,0.217391304347826
GDL ESTADIO,2023-05-06,18,16,2,0.111111111111111
GDL ESTADIO,2023-05-07,19,19,0,0
GDL ESTADIO,2023-05-08,22,20,2,0.0909090909090909
GDL LA PRIMAVERA,2023-01-02,29,10,19,0.655172413793103
GDL LA PRIMAVERA,2023-01-03,24,6,18,0.75
GDL LA PRIMAVERA,2023-01-04,31,14,17,0.548387096774194
GDL LA PRIMAVERA,2023-01-05,25,9,16,0.64
GDL LA PRIMAVERA,2023-01-06,28,15,13,0.464285714285714
GDL LA PRIMAVERA,2023-01-07,34,16,18,0.529411764705882
GDL LA PRIMAVERA,2023-01-08,8,2,6,0.75
GDL LA PRIMAVERA,2023-01-09,33,15,18,0.545454545454545
GDL LA PRIMAVERA,2023-01-10,34,18,16,0.470588235294118
GDL LA PRIMAVERA,2023-01-11,32,17,15,0.46875
GDL LA PRIMAVERA,2023-01-12,28,18,10,0.357142857142857
GDL LA PRIMAVERA,2023-01-13,34,15,19,0.558823529411765
GDL LA PRIMAVERA,2023-01-14,31,19,12,0.387096774193548
GDL LA PRIMAVERA,2023-01-15,21,12,9,0.428571428571429
GDL LA PRIMAVERA,2023-01-16,33,14,19,0.575757575757576
GDL LA PRIMAVERA,2023-01-17,48,31,17,0.354166666666667
GDL LA PRIMAVERA,2023-01-18,31,21,10,0.32258064516129
GDL LA PRIMAVERA,2023-01-19,45,28,17,0.377777777777778
GDL LA PRIMAVERA,2023-01-20,25,8,17,0.68
GDL LA PRIMAVERA,2023-01-21,35,8,27,0.771428571428571
GDL LA PRIMAVERA,2023-01-22,13,1,12,0.923076923076923
GDL LA PRIMAVERA,2023-01-23,18,4,14,0.777777777777778
GDL LA PRIMAVERA,2023-01-24,28,2,26,0.928571428571429
GDL LA PRIMAVERA,2023-01-25,31,7,24,0.774193548387097
GDL LA PRIMAVERA,2023-01-26,37,6,31,0.837837837837838
GDL LA PRIMAVERA,2023-01-27,24,4,20,0.833333333333333
GDL LA PRIMAVERA,2023-01-28,30,4,26,0.866666666666667
GDL LA PRIMAVERA,2023-01-29,26,2,24,0.923076923076923
GDL LA PRIMAVERA,2023-01-30,28,5,23,0.821428571428571
GDL LA PRIMAVERA,2023-01-31,36,14,22,0.611111111111111
GDL LA PRIMAVERA,2023-02-01,29,9,20,0.689655172413793
GDL LA PRIMAVERA,2023-02-02,37,5,32,0.864864864864865
GDL LA PRIMAVERA,2023-02-03,29,6,23,0.793103448275862
GDL LA PRIMAVERA,2023-02-04,40,8,32,0.8
GDL LA PRIMAVERA,2023-02-05,19,4,15,0.789473684210526
GDL LA PRIMAVERA,2023-02-06,26,7,19,0.730769230769231
GDL LA PRIMAVERA,2023-02-07,30,4,26,0.866666666666667
GDL LA PRIMAVERA,2023-02-08,20,4,16,0.8
GDL LA PRIMAVERA,2023-02-09,23,11,12,0.521739130434783
GDL LA PRIMAVERA,2023-02-10,22,5,17,0.772727272727273
GDL LA PRIMAVERA,2023-02-11,31,7,24,0.774193548387097
GDL LA PRIMAVERA,2023-02-12,13,3,10,0.769230769230769
GDL LA PRIMAVERA,2023-02-13,28,5,23,0.821428571428571
GDL LA PRIMAVERA,2023-02-14,26,6,20,0.769230769230769
GDL LA PRIMAVERA,2023-02-15,26,8,18,0.692307692307692
GDL LA PRIMAVERA,2023-02-16,36,11,25,0.694444444444444
GDL LA PRIMAVERA,2023-02-17,28,5,23,0.821428571428571
GDL LA PRIMAVERA,2023-02-18,21,9,12,0.571428571428571
GDL LA PRIMAVERA,2023-02-19,16,5,11,0.6875
GDL LA PRIMAVERA,2023-02-20,23,10,13,0.565217391304348
GDL LA PRIMAVERA,2023-02-21,31,14,17,0.548387096774194
GDL LA PRIMAVERA,2023-02-22,40,26,14,0.35
GDL LA PRIMAVERA,2023-02-23,23,11,12,0.521739130434783
GDL LA PRIMAVERA,2023-02-24,20,14,6,0.3
GDL LA PRIMAVERA,2023-02-25,24,16,8,0.333333333333333
GDL LA PRIMAVERA,2023-02-26,18,9,9,0.5
GDL LA PRIMAVERA,2023-02-27,19,13,6,0.315789473684211
GDL LA PRIMAVERA,2023-02-28,15,9,6,0.4
GDL LA PRIMAVERA,2023-03-01,31,22,9,0.290322580645161
GDL LA PRIMAVERA,2023-03-02,38,22,16,0.421052631578947
GDL LA PRIMAVERA,2023-03-03,23,8,15,0.652173913043478
GDL LA PRIMAVERA,2023-03-04,44,22,22,0.5
GDL LA PRIMAVERA,2023-03-05,15,9,6,0.4
GDL LA PRIMAVERA,2023-03-06,29,16,13,0.448275862068966
GDL LA PRIMAVERA,2023-03-07,34,20,14,0.411764705882353
GDL LA PRIMAVERA,2023-03-08,23,15,8,0.347826086956522
GDL LA PRIMAVERA,2023-03-09,20,16,4,0.2
GDL LA PRIMAVERA,2023-03-10,27,19,8,0.296296296296296
GDL LA PRIMAVERA,2023-03-11,30,23,7,0.233333333333333
GDL LA PRIMAVERA,2023-03-12,13,11,2,0.153846153846154
GDL LA PRIMAVERA,2023-03-13,21,16,5,0.238095238095238
GDL LA PRIMAVERA,2023-03-14,33,15,18,0.545454545454545
GDL LA PRIMAVERA,2023-03-15,33,24,9,0.272727272727273
GDL LA PRIMAVERA,2023-03-16,30,25,5,0.166666666666667
GDL LA PRIMAVERA,2023-03-17,31,23,8,0.258064516129032
GDL LA PRIMAVERA,2023-03-18,37,22,15,0.405405405405405
GDL LA PRIMAVERA,2023-03-19,17,16,1,0.0588235294117647
GDL LA PRIMAVERA,2023-03-20,21,19,2,0.0952380952380952
GDL LA PRIMAVERA,2023-03-21,22,20,2,0.0909090909090909
GDL LA PRIMAVERA,2023-03-22,39,31,8,0.205128205128205
GDL LA PRIMAVERA,2023-03-23,26,19,7,0.269230769230769
GDL LA PRIMAVERA,2023-03-24,23,17,6,0.260869565217391
GDL LA PRIMAVERA,2023-03-25,31,27,4,0.129032258064516
GDL LA PRIMAVERA,2023-03-26,15,14,1,0.0666666666666667
GDL LA PRIMAVERA,2023-03-27,17,13,4,0.235294117647059
GDL LA PRIMAVERA,2023-03-28,18,13,5,0.277777777777778
GDL LA PRIMAVERA,2023-03-29,27,24,3,0.111111111111111
GDL LA PRIMAVERA,2023-03-30,25,17,8,0.32
GDL LA PRIMAVERA,2023-03-31,33,25,8,0.242424242424242
GDL LA PRIMAVERA,2023-04-01,40,37,3,0.075
GDL LA PRIMAVERA,2023-04-02,17,14,3,0.176470588235294
GDL LA PRIMAVERA,2023-04-03,31,31,0,0
GDL LA PRIMAVERA,2023-04-04,23,19,4,0.173913043478261
GDL LA PRIMAVERA,2023-04-05,18,16,2,0.111111111111111
GDL LA PRIMAVERA,2023-04-06,20,20,0,0
GDL LA PRIMAVERA,2023-04-07,25,20,5,0.2
GDL LA PRIMAVERA,2023-04-08,14,14,0,0
GDL LA PRIMAVERA,2023-04-09,10,8,2,0.2
GDL LA PRIMAVERA,2023-04-10,19,18,1,0.0526315789473684
GDL LA PRIMAVERA,2023-04-11,27,23,4,0.148148148148148
GDL LA PRIMAVERA,2023-04-12,26,18,8,0.307692307692308
GDL LA PRIMAVERA,2023-04-13,25,20,5,0.2
GDL LA PRIMAVERA,2023-04-14,22,21,1,0.0454545454545455
GDL LA PRIMAVERA,2023-04-15,29,28,1,0.0344827586206897
GDL LA PRIMAVERA,2023-04-16,11,11,0,0
GDL LA PRIMAVERA,2023-04-17,29,24,5,0.172413793103448
GDL LA PRIMAVERA,2023-04-18,27,23,4,0.148148148148148
GDL LA PRIMAVERA,2023-04-19,27,17,10,0.37037037037037
GDL LA PRIMAVERA,2023-04-20,25,23,2,0.08
GDL LA PRIMAVERA,2023-04-21,31,24,7,0.225806451612903
GDL LA PRIMAVERA,2023-04-22,22,15,7,0.318181818181818
GDL LA PRIMAVERA,2023-04-23,11,10,1,0.0909090909090909
GDL LA PRIMAVERA,2023-04-24,22,18,4,0.181818181818182
GDL LA PRIMAVERA,2023-04-25,28,26,2,0.0714285714285714
GDL LA PRIMAVERA,2023-04-26,34,33,1,0.0294117647058824
GDL LA PRIMAVERA,2023-04-27,17,15,2,0.117647058823529
GDL LA PRIMAVERA,2023-04-28,24,21,3,0.125
GDL LA PRIMAVERA,2023-04-29,22,22,0,0
GDL LA PRIMAVERA,2023-04-30,18,17,1,0.0555555555555556
GDL LA PRIMAVERA,2023-05-01,20,20,0,0
GDL LA PRIMAVERA,2023-05-02,32,29,3,0.09375
GDL LA PRIMAVERA,2023-05-03,26,23,3,0.115384615384615
GDL LA PRIMAVERA,2023-05-04,21,20,1,0.0476190476190476
GDL LA PRIMAVERA,2023-05-05,27,27,0,0
GDL LA PRIMAVERA,2023-05-06,23,21,2,0.0869565217391304
GDL LA PRIMAVERA,2023-05-07,8,7,1,0.125
GDL LA PRIMAVERA,2023-05-08,22,18,4,0.181818181818182
GDL LAZARO CARDENAS,2023-01-02,25,16,9,0.36
GDL LAZARO CARDENAS,2023-01-03,31,15,16,0.516129032258065
GDL LAZARO CARDENAS,2023-01-04,28,19,9,0.321428571428571
GDL LAZARO CARDENAS,2023-01-05,29,13,16,0.551724137931034
GDL LAZARO CARDENAS,2023-01-06,27,20,7,0.259259259259259
GDL LAZARO CARDENAS,2023-01-07,27,14,13,0.481481481481481
GDL LAZARO CARDENAS,2023-01-08,21,13,8,0.380952380952381
GDL LAZARO CARDENAS,2023-01-09,23,11,12,0.521739130434783
GDL LAZARO CARDENAS,2023-01-10,34,23,11,0.323529411764706
GDL LAZARO CARDENAS,2023-01-11,34,16,18,0.529411764705882
GDL LAZARO CARDENAS,2023-01-12,21,11,10,0.476190476190476
GDL LAZARO CARDENAS,2023-01-13,30,16,14,0.466666666666667
GDL LAZARO CARDENAS,2023-01-14,38,17,21,0.552631578947368
GDL LAZARO CARDENAS,2023-01-15,20,12,8,0.4
GDL LAZARO CARDENAS,2023-01-16,28,17,11,0.392857142857143
GDL LAZARO CARDENAS,2023-01-17,30,20,10,0.333333333333333
GDL LAZARO CARDENAS,2023-01-18,28,14,14,0.5
GDL LAZARO CARDENAS,2023-01-19,26,12,14,0.538461538461538
GDL LAZARO CARDENAS,2023-01-20,28,16,12,0.428571428571429
GDL LAZARO CARDENAS,2023-01-21,21,5,16,0.761904761904762
GDL LAZARO CARDENAS,2023-01-22,12,6,6,0.5
GDL LAZARO CARDENAS,2023-01-23,22,7,15,0.681818181818182
GDL LAZARO CARDENAS,2023-01-24,27,9,18,0.666666666666667
GDL LAZARO CARDENAS,2023-01-25,22,6,16,0.727272727272727
GDL LAZARO CARDENAS,2023-01-26,24,9,15,0.625
GDL LAZARO CARDENAS,2023-01-27,27,10,17,0.62962962962963
GDL LAZARO CARDENAS,2023-01-28,37,14,23,0.621621621621622
GDL LAZARO CARDENAS,2023-01-29,17,8,9,0.529411764705882
GDL LAZARO CARDENAS,2023-01-30,26,9,17,0.653846153846154
GDL LAZARO CARDENAS,2023-01-31,33,11,22,0.666666666666667
GDL LAZARO CARDENAS,2023-02-01,30,10,20,0.666666666666667
GDL LAZARO CARDENAS,2023-02-02,38,10,28,0.736842105263158
GDL LAZARO CARDENAS,2023-02-03,20,4,16,0.8
GDL LAZARO CARDENAS,2023-02-04,16,7,9,0.5625
GDL LAZARO CARDENAS,2023-02-05,15,6,9,0.6
GDL LAZARO CARDENAS,2023-02-06,32,14,18,0.5625
GDL LAZARO CARDENAS,2023-02-07,32,14,18,0.5625
GDL LAZARO CARDENAS,2023-02-08,38,11,27,0.710526315789474
GDL LAZARO CARDENAS,2023-02-09,29,12,17,0.586206896551724
GDL LAZARO CARDENAS,2023-02-10,25,15,10,0.4
GDL LAZARO CARDENAS,2023-02-11,28,8,20,0.714285714285714
GDL LAZARO CARDENAS,2023-02-12,18,9,9,0.5
GDL LAZARO CARDENAS,2023-02-13,21,11,10,0.476190476190476
GDL LAZARO CARDENAS,2023-02-14,23,10,13,0.565217391304348
GDL LAZARO CARDENAS,2023-02-15,24,11,13,0.541666666666667
GDL LAZARO CARDENAS,2023-02-16,23,13,10,0.434782608695652
GDL LAZARO CARDENAS,2023-02-17,27,11,16,0.592592592592593
GDL LAZARO CARDENAS,2023-02-18,36,20,16,0.444444444444444
GDL LAZARO CARDENAS,2023-02-19,15,6,9,0.6
GDL LAZARO CARDENAS,2023-02-20,27,13,14,0.518518518518518
GDL LAZARO CARDENAS,2023-02-21,39,16,23,0.58974358974359
GDL LAZARO CARDENAS,2023-02-22,29,13,16,0.551724137931034
GDL LAZARO CARDENAS,2023-02-23,24,15,9,0.375
GDL LAZARO CARDENAS,2023-02-24,26,18,8,0.307692307692308
GDL LAZARO CARDENAS,2023-02-25,31,23,8,0.258064516129032
GDL LAZARO CARDENAS,2023-02-26,14,5,9,0.642857142857143
GDL LAZARO CARDENAS,2023-02-27,15,9,6,0.4
GDL LAZARO CARDENAS,2023-02-28,41,32,9,0.219512195121951
GDL LAZARO CARDENAS,2023-03-01,27,18,9,0.333333333333333
GDL LAZARO CARDENAS,2023-03-02,31,18,13,0.419354838709677
GDL LAZARO CARDENAS,2023-03-03,29,15,14,0.482758620689655
GDL LAZARO CARDENAS,2023-03-04,28,15,13,0.464285714285714
GDL LAZARO CARDENAS,2023-03-05,12,8,4,0.333333333333333
GDL LAZARO CARDENAS,2023-03-06,19,12,7,0.368421052631579
GDL LAZARO CARDENAS,2023-03-07,26,20,6,0.230769230769231
GDL LAZARO CARDENAS,2023-03-08,23,15,8,0.347826086956522
GDL LAZARO CARDENAS,2023-03-09,13,13,0,0
GDL LAZARO CARDENAS,2023-03-10,22,16,6,0.272727272727273
GDL LAZARO CARDENAS,2023-03-11,34,27,7,0.205882352941176
GDL LAZARO CARDENAS,2023-03-12,20,17,3,0.15
GDL LAZARO CARDENAS,2023-03-13,28,19,9,0.321428571428571
GDL LAZARO CARDENAS,2023-03-14,38,31,7,0.184210526315789
GDL LAZARO CARDENAS,2023-03-15,26,23,3,0.115384615384615
GDL LAZARO CARDENAS,2023-03-16,30,30,0,0
GDL LAZARO CARDENAS,2023-03-17,32,30,2,0.0625
GDL LAZARO CARDENAS,2023-03-18,41,39,2,0.0487804878048781
GDL LAZARO CARDENAS,2023-03-19,35,34,1,0.0285714285714286
GDL LAZARO CARDENAS,2023-03-20,33,33,0,0
GDL LAZARO CARDENAS,2023-03-21,23,22,1,0.0434782608695652
GDL LAZARO CARDENAS,2023-03-22,25,25,0,0
GDL LAZARO CARDENAS,2023-03-23,22,22,0,0
GDL LAZARO CARDENAS,2023-03-24,17,14,3,0.176470588235294
GDL LAZARO CARDENAS,2023-03-25,40,38,2,0.05
GDL LAZARO CARDENAS,2023-03-26,24,23,1,0.0416666666666667
GDL LAZARO CARDENAS,2023-03-27,20,19,1,0.05
GDL LAZARO CARDENAS,2023-03-28,28,28,0,0
GDL LAZARO CARDENAS,2023-03-29,29,29,0,0
GDL LAZARO CARDENAS,2023-03-30,27,27,0,0
GDL LAZARO CARDENAS,2023-03-31,43,41,2,0.0465116279069767
GDL LAZARO CARDENAS,2023-04-01,42,42,0,0
GDL LAZARO CARDENAS,2023-04-02,16,16,0,0
GDL LAZARO CARDENAS,2023-04-03,30,29,1,0.0333333333333333
GDL LAZARO CARDENAS,2023-04-04,46,45,1,0.0217391304347826
GDL LAZARO CARDENAS,2023-04-05,21,20,1,0.0476190476190476
GDL LAZARO CARDENAS,2023-04-06,25,25,0,0
GDL LAZARO CARDENAS,2023-04-07,21,21,0,0
GDL LAZARO CARDENAS,2023-04-08,18,18,0,0
GDL LAZARO CARDENAS,2023-04-09,10,10,0,0
GDL LAZARO CARDENAS,2023-04-10,19,17,2,0.105263157894737
GDL LAZARO CARDENAS,2023-04-11,30,29,1,0.0333333333333333
GDL LAZARO CARDENAS,2023-04-12,26,25,1,0.0384615384615385
GDL LAZARO CARDENAS,2023-04-13,21,21,0,0
GDL LAZARO CARDENAS,2023-04-14,47,45,2,0.0425531914893617
GDL LAZARO CARDENAS,2023-04-15,39,38,1,0.0256410256410256
GDL LAZARO CARDENAS,2023-04-16,22,22,0,0
GDL LAZARO CARDENAS,2023-04-17,24,23,1,0.0416666666666667
GDL LAZARO CARDENAS,2023-04-18,33,31,2,0.0606060606060606
GDL LAZARO CARDENAS,2023-04-19,29,26,3,0.103448275862069
GDL LAZARO CARDENAS,2023-04-20,27,27,0,0
GDL LAZARO CARDENAS,2023-04-21,21,21,0,0
GDL LAZARO CARDENAS,2023-04-22,29,29,0,0
GDL LAZARO CARDENAS,2023-04-23,16,15,1,0.0625
GDL LAZARO CARDENAS,2023-04-24,33,31,2,0.0606060606060606
GDL LAZARO CARDENAS,2023-04-25,33,32,1,0.0303030303030303
GDL LAZARO CARDENAS,2023-04-26,28,28,0,0
GDL LAZARO CARDENAS,2023-04-27,24,24,0,0
GDL LAZARO CARDENAS,2023-04-28,36,35,1,0.0277777777777778
GDL LAZARO CARDENAS,2023-04-29,34,33,1,0.0294117647058824
GDL LAZARO CARDENAS,2023-04-30,23,21,2,0.0869565217391304
GDL LAZARO CARDENAS,2023-05-01,23,22,1,0.0434782608695652
GDL LAZARO CARDENAS,2023-05-02,18,18,0,0
GDL LAZARO CARDENAS,2023-05-03,20,18,2,0.1
GDL LAZARO CARDENAS,2023-05-04,20,20,0,0
GDL LAZARO CARDENAS,2023-05-05,28,27,1,0.0357142857142857
GDL LAZARO CARDENAS,2023-05-06,26,22,4,0.153846153846154
GDL LAZARO CARDENAS,2023-05-07,14,14,0,0
GDL LAZARO CARDENAS,2023-05-08,21,17,4,0.19047619047619
GDL LOPEZ MATEOS,2023-01-02,6,2,4,0.666666666666667
GDL LOPEZ MATEOS,2023-01-03,35,29,6,0.171428571428571
GDL LOPEZ MATEOS,2023-01-04,23,11,12,0.521739130434783
GDL LOPEZ MATEOS,2023-01-05,23,16,7,0.304347826086957
GDL LOPEZ MATEOS,2023-01-06,20,14,6,0.3
GDL LOPEZ MATEOS,2023-01-07,28,15,13,0.464285714285714
GDL LOPEZ MATEOS,2023-01-08,22,19,3,0.136363636363636
GDL LOPEZ MATEOS,2023-01-09,26,20,6,0.230769230769231
GDL LOPEZ MATEOS,2023-01-10,31,23,8,0.258064516129032
GDL LOPEZ MATEOS,2023-01-11,33,24,9,0.272727272727273
GDL LOPEZ MATEOS,2023-01-12,31,25,6,0.193548387096774
GDL LOPEZ MATEOS,2023-01-13,33,22,11,0.333333333333333
GDL LOPEZ MATEOS,2023-01-14,35,29,6,0.171428571428571
GDL LOPEZ MATEOS,2023-01-15,14,12,2,0.142857142857143
GDL LOPEZ MATEOS,2023-01-16,34,23,11,0.323529411764706
GDL LOPEZ MATEOS,2023-01-17,24,17,7,0.291666666666667
GDL LOPEZ MATEOS,2023-01-18,22,16,6,0.272727272727273
GDL LOPEZ MATEOS,2023-01-19,27,14,13,0.481481481481481
GDL LOPEZ MATEOS,2023-01-20,24,18,6,0.25
GDL LOPEZ MATEOS,2023-01-21,30,13,17,0.566666666666667
GDL LOPEZ MATEOS,2023-01-22,25,10,15,0.6
GDL LOPEZ MATEOS,2023-01-23,23,5,18,0.782608695652174
GDL LOPEZ MATEOS,2023-01-24,29,6,23,0.793103448275862
GDL LOPEZ MATEOS,2023-01-25,17,7,10,0.588235294117647
GDL LOPEZ MATEOS,2023-01-26,32,11,21,0.65625
GDL LOPEZ MATEOS,2023-01-27,24,10,14,0.583333333333333
GDL LOPEZ MATEOS,2023-01-28,18,9,9,0.5
GDL LOPEZ MATEOS,2023-01-29,16,4,12,0.75
GDL LOPEZ MATEOS,2023-01-30,27,13,14,0.518518518518518
GDL LOPEZ MATEOS,2023-01-31,45,24,21,0.466666666666667
GDL LOPEZ MATEOS,2023-02-01,36,14,22,0.611111111111111
GDL LOPEZ MATEOS,2023-02-02,24,8,16,0.666666666666667
GDL LOPEZ MATEOS,2023-02-03,25,11,14,0.56
GDL LOPEZ MATEOS,2023-02-04,28,14,14,0.5
GDL LOPEZ MATEOS,2023-02-05,11,3,8,0.727272727272727
GDL LOPEZ MATEOS,2023-02-06,24,6,18,0.75
GDL LOPEZ MATEOS,2023-02-07,24,12,12,0.5
GDL LOPEZ MATEOS,2023-02-08,22,8,14,0.636363636363636
GDL LOPEZ MATEOS,2023-02-09,16,8,8,0.5
GDL LOPEZ MATEOS,2023-02-10,26,13,13,0.5
GDL LOPEZ MATEOS,2023-02-11,28,20,8,0.285714285714286
GDL LOPEZ MATEOS,2023-02-12,23,16,7,0.304347826086957
GDL LOPEZ MATEOS,2023-02-13,18,7,11,0.611111111111111
GDL LOPEZ MATEOS,2023-02-14,27,12,15,0.555555555555556
GDL LOPEZ MATEOS,2023-02-15,29,18,11,0.379310344827586
GDL LOPEZ MATEOS,2023-02-16,30,19,11,0.366666666666667
GDL LOPEZ MATEOS,2023-02-17,22,8,14,0.636363636363636
GDL LOPEZ MATEOS,2023-02-18,23,14,9,0.391304347826087
GDL LOPEZ MATEOS,2023-02-19,19,13,6,0.315789473684211
GDL LOPEZ MATEOS,2023-02-20,21,16,5,0.238095238095238
GDL LOPEZ MATEOS,2023-02-21,29,17,12,0.413793103448276
GDL LOPEZ MATEOS,2023-02-22,18,12,6,0.333333333333333
GDL LOPEZ MATEOS,2023-02-23,28,20,8,0.285714285714286
GDL LOPEZ MATEOS,2023-02-24,18,11,7,0.388888888888889
GDL LOPEZ MATEOS,2023-02-25,33,22,11,0.333333333333333
GDL LOPEZ MATEOS,2023-02-26,18,12,6,0.333333333333333
GDL LOPEZ MATEOS,2023-02-27,18,10,8,0.444444444444444
GDL LOPEZ MATEOS,2023-02-28,32,21,11,0.34375
GDL LOPEZ MATEOS,2023-03-01,35,21,14,0.4
GDL LOPEZ MATEOS,2023-03-02,19,17,2,0.105263157894737
GDL LOPEZ MATEOS,2023-03-03,27,21,6,0.222222222222222
GDL LOPEZ MATEOS,2023-03-04,26,14,12,0.461538461538462
GDL LOPEZ MATEOS,2023-03-05,11,9,2,0.181818181818182
GDL LOPEZ MATEOS,2023-03-06,22,16,6,0.272727272727273
GDL LOPEZ MATEOS,2023-03-07,26,19,7,0.269230769230769
GDL LOPEZ MATEOS,2023-03-08,26,21,5,0.192307692307692
GDL LOPEZ MATEOS,2023-03-09,34,32,2,0.0588235294117647
GDL LOPEZ MATEOS,2023-03-10,20,20,0,0
GDL LOPEZ MATEOS,2023-03-11,30,27,3,0.1
GDL LOPEZ MATEOS,2023-03-12,19,19,0,0
GDL LOPEZ MATEOS,2023-03-13,23,21,2,0.0869565217391304
GDL LOPEZ MATEOS,2023-03-14,24,20,4,0.166666666666667
GDL LOPEZ MATEOS,2023-03-15,25,25,0,0
GDL LOPEZ MATEOS,2023-03-16,33,33,0,0
GDL LOPEZ MATEOS,2023-03-17,38,33,5,0.131578947368421
GDL LOPEZ MATEOS,2023-03-18,36,34,2,0.0555555555555556
GDL LOPEZ MATEOS,2023-03-19,32,30,2,0.0625
GDL LOPEZ MATEOS,2023-03-20,28,27,1,0.0357142857142857
GDL LOPEZ MATEOS,2023-03-21,29,26,3,0.103448275862069
GDL LOPEZ MATEOS,2023-03-22,15,13,2,0.133333333333333
GDL LOPEZ MATEOS,2023-03-23,22,21,1,0.0454545454545455
GDL LOPEZ MATEOS,2023-03-24,32,31,1,0.03125
GDL LOPEZ MATEOS,2023-03-25,40,39,1,0.025
GDL LOPEZ MATEOS,2023-03-26,24,23,1,0.0416666666666667
GDL LOPEZ MATEOS,2023-03-27,19,18,1,0.0526315789473684
GDL LOPEZ MATEOS,2023-03-28,14,13,1,0.0714285714285714
GDL LOPEZ MATEOS,2023-03-29,34,25,9,0.264705882352941
GDL LOPEZ MATEOS,2023-03-30,34,26,8,0.235294117647059
GDL LOPEZ MATEOS,2023-03-31,41,36,5,0.121951219512195
GDL LOPEZ MATEOS,2023-04-01,37,33,4,0.108108108108108
GDL LOPEZ MATEOS,2023-04-02,19,19,0,0
GDL LOPEZ MATEOS,2023-04-03,33,31,2,0.0606060606060606
GDL LOPEZ MATEOS,2023-04-04,41,35,6,0.146341463414634
GDL LOPEZ MATEOS,2023-04-05,38,37,1,0.0263157894736842
GDL LOPEZ MATEOS,2023-04-06,24,22,2,0.0833333333333333
GDL LOPEZ MATEOS,2023-04-07,13,13,0,0
GDL LOPEZ MATEOS,2023-04-08,20,18,2,0.1
GDL LOPEZ MATEOS,2023-04-09,7,7,0,0
GDL LOPEZ MATEOS,2023-04-10,26,22,4,0.153846153846154
GDL LOPEZ MATEOS,2023-04-11,35,31,4,0.114285714285714
GDL LOPEZ MATEOS,2023-04-12,26,20,6,0.230769230769231
GDL LOPEZ MATEOS,2023-04-13,22,19,3,0.136363636363636
GDL LOPEZ MATEOS,2023-04-14,29,22,7,0.241379310344828
GDL LOPEZ MATEOS,2023-04-15,28,28,0,0
GDL LOPEZ MATEOS,2023-04-16,20,19,1,0.05
GDL LOPEZ MATEOS,2023-04-17,30,27,3,0.1
GDL LOPEZ MATEOS,2023-04-18,26,19,7,0.269230769230769
GDL LOPEZ MATEOS,2023-04-19,22,20,2,0.0909090909090909
GDL LOPEZ MATEOS,2023-04-20,30,28,2,0.0666666666666667
GDL LOPEZ MATEOS,2023-04-21,23,18,5,0.217391304347826
GDL LOPEZ MATEOS,2023-04-22,25,22,3,0.12
GDL LOPEZ MATEOS,2023-04-23,17,14,3,0.176470588235294
GDL LOPEZ MATEOS,2023-04-24,38,32,6,0.157894736842105
GDL LOPEZ MATEOS,2023-04-25,46,35,11,0.239130434782609
GDL LOPEZ MATEOS,2023-04-26,36,30,6,0.166666666666667
GDL LOPEZ MATEOS,2023-04-27,30,25,5,0.166666666666667
GDL LOPEZ MATEOS,2023-04-28,41,31,10,0.24390243902439
GDL LOPEZ MATEOS,2023-04-29,31,27,4,0.129032258064516
GDL LOPEZ MATEOS,2023-04-30,19,15,4,0.210526315789474
GDL LOPEZ MATEOS,2023-05-01,27,24,3,0.111111111111111
GDL LOPEZ MATEOS,2023-05-02,34,28,6,0.176470588235294
GDL LOPEZ MATEOS,2023-05-03,41,36,5,0.121951219512195
GDL LOPEZ MATEOS,2023-05-04,19,15,4,0.210526315789474
GDL LOPEZ MATEOS,2023-05-05,29,27,2,0.0689655172413793
GDL LOPEZ MATEOS,2023-05-06,25,25,0,0
GDL LOPEZ MATEOS,2023-05-07,15,14,1,0.0666666666666667
GDL LOPEZ MATEOS,2023-05-08,27,25,2,0.0740740740740741
GUADALUPE TEPEYAC,2023-01-02,18,15,3,0.166666666666667
GUADALUPE TEPEYAC,2023-01-03,15,12,3,0.2
GUADALUPE TEPEYAC,2023-01-04,30,26,4,0.133333333333333
GUADALUPE TEPEYAC,2023-01-05,23,18,5,0.217391304347826
GUADALUPE TEPEYAC,2023-01-06,25,21,4,0.16
GUADALUPE TEPEYAC,2023-01-07,27,22,5,0.185185185185185
GUADALUPE TEPEYAC,2023-01-08,31,26,5,0.161290322580645
GUADALUPE TEPEYAC,2023-01-09,30,20,10,0.333333333333333
GUADALUPE TEPEYAC,2023-01-10,41,32,9,0.219512195121951
GUADALUPE TEPEYAC,2023-01-11,35,21,14,0.4
GUADALUPE TEPEYAC,2023-01-12,32,23,9,0.28125
GUADALUPE TEPEYAC,2023-01-13,39,27,12,0.307692307692308
GUADALUPE TEPEYAC,2023-01-14,35,24,11,0.314285714285714
GUADALUPE TEPEYAC,2023-01-15,48,29,19,0.395833333333333
GUADALUPE TEPEYAC,2023-01-16,40,13,27,0.675
GUADALUPE TEPEYAC,2023-01-17,27,13,14,0.518518518518518
GUADALUPE TEPEYAC,2023-01-18,32,14,18,0.5625
GUADALUPE TEPEYAC,2023-01-19,23,16,7,0.304347826086957
GUADALUPE TEPEYAC,2023-01-20,30,17,13,0.433333333333333
GUADALUPE TEPEYAC,2023-01-21,44,27,17,0.386363636363636
GUADALUPE TEPEYAC,2023-01-22,35,15,20,0.571428571428571
GUADALUPE TEPEYAC,2023-01-23,29,13,16,0.551724137931034
GUADALUPE TEPEYAC,2023-01-24,34,19,15,0.441176470588235
GUADALUPE TEPEYAC,2023-01-25,24,20,4,0.166666666666667
GUADALUPE TEPEYAC,2023-01-26,34,18,16,0.470588235294118
GUADALUPE TEPEYAC,2023-01-27,30,18,12,0.4
GUADALUPE TEPEYAC,2023-01-28,34,20,14,0.411764705882353
GUADALUPE TEPEYAC,2023-01-29,24,17,7,0.291666666666667
GUADALUPE TEPEYAC,2023-01-30,39,22,17,0.435897435897436
GUADALUPE TEPEYAC,2023-01-31,43,26,17,0.395348837209302
GUADALUPE TEPEYAC,2023-02-01,33,23,10,0.303030303030303
GUADALUPE TEPEYAC,2023-02-02,19,10,9,0.473684210526316
GUADALUPE TEPEYAC,2023-02-03,35,26,9,0.257142857142857
GUADALUPE TEPEYAC,2023-02-04,51,35,16,0.313725490196078
GUADALUPE TEPEYAC,2023-02-05,28,14,14,0.5
GUADALUPE TEPEYAC,2023-02-06,31,20,11,0.354838709677419
GUADALUPE TEPEYAC,2023-02-07,27,13,14,0.518518518518518
GUADALUPE TEPEYAC,2023-02-08,32,16,16,0.5
GUADALUPE TEPEYAC,2023-02-09,33,23,10,0.303030303030303
GUADALUPE TEPEYAC,2023-02-10,33,20,13,0.393939393939394
GUADALUPE TEPEYAC,2023-02-11,33,25,8,0.242424242424242
GUADALUPE TEPEYAC,2023-02-12,18,12,6,0.333333333333333
GUADALUPE TEPEYAC,2023-02-13,23,17,6,0.260869565217391
GUADALUPE TEPEYAC,2023-02-14,26,15,11,0.423076923076923
GUADALUPE TEPEYAC,2023-02-15,27,19,8,0.296296296296296
GUADALUPE TEPEYAC,2023-02-16,36,22,14,0.388888888888889
GUADALUPE TEPEYAC,2023-02-17,36,24,12,0.333333333333333
GUADALUPE TEPEYAC,2023-02-18,46,36,10,0.217391304347826
GUADALUPE TEPEYAC,2023-02-19,41,32,9,0.219512195121951
GUADALUPE TEPEYAC,2023-02-20,24,17,7,0.291666666666667
GUADALUPE TEPEYAC,2023-02-21,37,25,12,0.324324324324324
GUADALUPE TEPEYAC,2023-02-22,22,14,8,0.363636363636364
GUADALUPE TEPEYAC,2023-02-23,28,24,4,0.142857142857143
GUADALUPE TEPEYAC,2023-02-24,26,12,14,0.538461538461538
GUADALUPE TEPEYAC,2023-02-25,37,30,7,0.189189189189189
GUADALUPE TEPEYAC,2023-02-26,25,20,5,0.2
GUADALUPE TEPEYAC,2023-02-27,38,31,7,0.184210526315789
GUADALUPE TEPEYAC,2023-02-28,35,29,6,0.171428571428571
GUADALUPE TEPEYAC,2023-03-01,23,16,7,0.304347826086957
GUADALUPE TEPEYAC,2023-03-02,25,19,6,0.24
GUADALUPE TEPEYAC,2023-03-03,32,25,7,0.21875
GUADALUPE TEPEYAC,2023-03-04,41,34,7,0.170731707317073
GUADALUPE TEPEYAC,2023-03-05,37,29,8,0.216216216216216
GUADALUPE TEPEYAC,2023-03-06,38,26,12,0.315789473684211
GUADALUPE TEPEYAC,2023-03-07,34,30,4,0.117647058823529
GUADALUPE TEPEYAC,2023-03-08,25,23,2,0.08
GUADALUPE TEPEYAC,2023-03-09,24,18,6,0.25
GUADALUPE TEPEYAC,2023-03-10,21,18,3,0.142857142857143
GUADALUPE TEPEYAC,2023-03-11,32,29,3,0.09375
GUADALUPE TEPEYAC,2023-03-12,44,36,8,0.181818181818182
GUADALUPE TEPEYAC,2023-03-13,31,26,5,0.161290322580645
GUADALUPE TEPEYAC,2023-03-14,39,31,8,0.205128205128205
GUADALUPE TEPEYAC,2023-03-15,41,34,7,0.170731707317073
GUADALUPE TEPEYAC,2023-03-16,38,33,5,0.131578947368421
GUADALUPE TEPEYAC,2023-03-17,37,34,3,0.0810810810810811
GUADALUPE TEPEYAC,2023-03-18,55,51,4,0.0727272727272727
GUADALUPE TEPEYAC,2023-03-19,33,30,3,0.0909090909090909
GUADALUPE TEPEYAC,2023-03-20,45,40,5,0.111111111111111
GUADALUPE TEPEYAC,2023-03-21,42,40,2,0.0476190476190476
GUADALUPE TEPEYAC,2023-03-22,30,30,0,0
GUADALUPE TEPEYAC,2023-03-23,41,41,0,0
GUADALUPE TEPEYAC,2023-03-24,27,27,0,0
GUADALUPE TEPEYAC,2023-03-25,25,25,0,0
GUADALUPE TEPEYAC,2023-03-26,34,34,0,0
GUADALUPE TEPEYAC,2023-03-27,38,38,0,0
GUADALUPE TEPEYAC,2023-03-28,31,31,0,0
GUADALUPE TEPEYAC,2023-03-29,30,30,0,0
GUADALUPE TEPEYAC,2023-03-30,40,40,0,0
GUADALUPE TEPEYAC,2023-03-31,51,49,2,0.0392156862745098
GUADALUPE TEPEYAC,2023-04-01,33,33,0,0
GUADALUPE TEPEYAC,2023-04-02,31,31,0,0
GUADALUPE TEPEYAC,2023-04-03,39,39,0,0
GUADALUPE TEPEYAC,2023-04-04,36,36,0,0
GUADALUPE TEPEYAC,2023-04-05,20,20,0,0
GUADALUPE TEPEYAC,2023-04-06,31,31,0,0
GUADALUPE TEPEYAC,2023-04-07,18,17,1,0.0555555555555556
GUADALUPE TEPEYAC,2023-04-08,19,19,0,0
GUADALUPE TEPEYAC,2023-04-09,13,13,0,0
GUADALUPE TEPEYAC,2023-04-10,17,17,0,0
GUADALUPE TEPEYAC,2023-04-11,26,26,0,0
GUADALUPE TEPEYAC,2023-04-12,27,27,0,0
GUADALUPE TEPEYAC,2023-04-13,26,25,1,0.0384615384615385
GUADALUPE TEPEYAC,2023-04-14,40,40,0,0
GUADALUPE TEPEYAC,2023-04-15,41,39,2,0.0487804878048781
GUADALUPE TEPEYAC,2023-04-16,29,29,0,0
GUADALUPE TEPEYAC,2023-04-17,30,30,0,0
GUADALUPE TEPEYAC,2023-04-18,44,44,0,0
GUADALUPE TEPEYAC,2023-04-19,24,23,1,0.0416666666666667
GUADALUPE TEPEYAC,2023-04-20,25,25,0,0
GUADALUPE TEPEYAC,2023-04-21,29,29,0,0
GUADALUPE TEPEYAC,2023-04-22,49,46,3,0.0612244897959184
GUADALUPE TEPEYAC,2023-04-23,37,36,1,0.027027027027027
GUADALUPE TEPEYAC,2023-04-24,34,33,1,0.0294117647058824
GUADALUPE TEPEYAC,2023-04-25,39,39,0,0
GUADALUPE TEPEYAC,2023-04-26,29,26,3,0.103448275862069
GUADALUPE TEPEYAC,2023-04-27,27,24,3,0.111111111111111
GUADALUPE TEPEYAC,2023-04-28,33,32,1,0.0303030303030303
GUADALUPE TEPEYAC,2023-04-29,57,54,3,0.0526315789473684
GUADALUPE TEPEYAC,2023-04-30,51,51,0,0
GUADALUPE TEPEYAC,2023-05-01,25,25,0,0
GUADALUPE TEPEYAC,2023-05-02,32,30,2,0.0625
GUADALUPE TEPEYAC,2023-05-03,29,29,0,0
GUADALUPE TEPEYAC,2023-05-04,35,34,1,0.0285714285714286
GUADALUPE TEPEYAC,2023-05-05,37,36,1,0.027027027027027
GUADALUPE TEPEYAC,2023-05-06,35,34,1,0.0285714285714286
GUADALUPE TEPEYAC,2023-05-07,27,25,2,0.0740740740740741
GUADALUPE TEPEYAC,2023-05-08,43,41,2,0.0465116279069767
GUANAJUATO,2023-01-02,24,16,8,0.333333333333333
GUANAJUATO,2023-01-03,22,14,8,0.363636363636364
GUANAJUATO,2023-01-04,19,17,2,0.105263157894737
GUANAJUATO,2023-01-05,17,12,5,0.294117647058824
GUANAJUATO,2023-01-06,20,13,7,0.35
GUANAJUATO,2023-01-07,18,9,9,0.5
GUANAJUATO,2023-01-08,15,10,5,0.333333333333333
GUANAJUATO,2023-01-09,20,14,6,0.3
GUANAJUATO,2023-01-10,27,19,8,0.296296296296296
GUANAJUATO,2023-01-11,28,14,14,0.5
GUANAJUATO,2023-01-12,25,20,5,0.2
GUANAJUATO,2023-01-13,18,14,4,0.222222222222222
GUANAJUATO,2023-01-14,24,18,6,0.25
GUANAJUATO,2023-01-15,14,12,2,0.142857142857143
GUANAJUATO,2023-01-16,8,5,3,0.375
GUANAJUATO,2023-01-17,21,13,8,0.380952380952381
GUANAJUATO,2023-01-18,13,9,4,0.307692307692308
GUANAJUATO,2023-01-19,16,6,10,0.625
GUANAJUATO,2023-01-20,23,16,7,0.304347826086957
GUANAJUATO,2023-01-21,17,10,7,0.411764705882353
GUANAJUATO,2023-01-22,20,15,5,0.25
GUANAJUATO,2023-01-23,24,15,9,0.375
GUANAJUATO,2023-01-24,25,20,5,0.2
GUANAJUATO,2023-01-25,20,14,6,0.3
GUANAJUATO,2023-01-26,23,16,7,0.304347826086957
GUANAJUATO,2023-01-27,24,15,9,0.375
GUANAJUATO,2023-01-28,27,21,6,0.222222222222222
GUANAJUATO,2023-01-29,14,10,4,0.285714285714286
GUANAJUATO,2023-01-30,31,25,6,0.193548387096774
GUANAJUATO,2023-01-31,35,27,8,0.228571428571429
GUANAJUATO,2023-02-01,20,18,2,0.1
GUANAJUATO,2023-02-02,20,12,8,0.4
GUANAJUATO,2023-02-03,26,20,6,0.230769230769231
GUANAJUATO,2023-02-04,23,20,3,0.130434782608696
GUANAJUATO,2023-02-05,9,7,2,0.222222222222222
GUANAJUATO,2023-02-06,26,20,6,0.230769230769231
GUANAJUATO,2023-02-07,21,17,4,0.19047619047619
GUANAJUATO,2023-02-08,17,12,5,0.294117647058824
GUANAJUATO,2023-02-09,18,16,2,0.111111111111111
GUANAJUATO,2023-02-10,21,12,9,0.428571428571429
GUANAJUATO,2023-02-11,24,17,7,0.291666666666667
GUANAJUATO,2023-02-12,14,9,5,0.357142857142857
GUANAJUATO,2023-02-13,21,14,7,0.333333333333333
GUANAJUATO,2023-02-14,7,3,4,0.571428571428571
GUANAJUATO,2023-02-15,24,7,17,0.708333333333333
GUANAJUATO,2023-02-16,19,9,10,0.526315789473684
GUANAJUATO,2023-02-17,25,9,16,0.64
GUANAJUATO,2023-02-18,25,12,13,0.52
GUANAJUATO,2023-02-19,9,4,5,0.555555555555556
GUANAJUATO,2023-02-20,24,16,8,0.333333333333333
GUANAJUATO,2023-02-21,30,16,14,0.466666666666667
GUANAJUATO,2023-02-22,26,16,10,0.384615384615385
GUANAJUATO,2023-02-23,23,12,11,0.478260869565217
GUANAJUATO,2023-02-24,26,15,11,0.423076923076923
GUANAJUATO,2023-02-25,24,13,11,0.458333333333333
GUANAJUATO,2023-02-26,16,10,6,0.375
GUANAJUATO,2023-02-27,29,17,12,0.413793103448276
GUANAJUATO,2023-02-28,35,24,11,0.314285714285714
GUANAJUATO,2023-03-01,25,13,12,0.48
GUANAJUATO,2023-03-02,26,13,13,0.5
GUANAJUATO,2023-03-03,21,5,16,0.761904761904762
GUANAJUATO,2023-03-04,23,9,14,0.608695652173913
GUANAJUATO,2023-03-05,6,6,0,0
GUANAJUATO,2023-03-06,21,12,9,0.428571428571429
GUANAJUATO,2023-03-07,19,15,4,0.210526315789474
GUANAJUATO,2023-03-08,15,11,4,0.266666666666667
GUANAJUATO,2023-03-09,20,16,4,0.2
GUANAJUATO,2023-03-10,17,13,4,0.235294117647059
GUANAJUATO,2023-03-11,22,17,5,0.227272727272727
GUANAJUATO,2023-03-12,13,13,0,0
GUANAJUATO,2023-03-13,20,17,3,0.15
GUANAJUATO,2023-03-14,19,15,4,0.210526315789474
GUANAJUATO,2023-03-15,20,20,0,0
GUANAJUATO,2023-03-16,25,23,2,0.08
GUANAJUATO,2023-03-17,40,35,5,0.125
GUANAJUATO,2023-03-18,32,26,6,0.1875
GUANAJUATO,2023-03-19,16,16,0,0
GUANAJUATO,2023-03-20,26,23,3,0.115384615384615
GUANAJUATO,2023-03-21,24,23,1,0.0416666666666667
GUANAJUATO,2023-03-22,29,29,0,0
GUANAJUATO,2023-03-23,14,13,1,0.0714285714285714
GUANAJUATO,2023-03-24,21,19,2,0.0952380952380952
GUANAJUATO,2023-03-25,28,27,1,0.0357142857142857
GUANAJUATO,2023-03-26,17,17,0,0
GUANAJUATO,2023-03-27,22,19,3,0.136363636363636
GUANAJUATO,2023-03-28,22,21,1,0.0454545454545455
GUANAJUATO,2023-03-29,32,30,2,0.0625
GUANAJUATO,2023-03-30,22,19,3,0.136363636363636
GUANAJUATO,2023-03-31,38,31,7,0.184210526315789
GUANAJUATO,2023-04-01,24,22,2,0.0833333333333333
GUANAJUATO,2023-04-02,14,14,0,0
GUANAJUATO,2023-04-03,19,19,0,0
GUANAJUATO,2023-04-04,25,22,3,0.12
GUANAJUATO,2023-04-05,22,17,5,0.227272727272727
GUANAJUATO,2023-04-06,32,23,9,0.28125
GUANAJUATO,2023-04-07,20,18,2,0.1
GUANAJUATO,2023-04-08,19,19,0,0
GUANAJUATO,2023-04-09,18,16,2,0.111111111111111
GUANAJUATO,2023-04-10,22,22,0,0
GUANAJUATO,2023-04-11,24,21,3,0.125
GUANAJUATO,2023-04-12,23,20,3,0.130434782608696
GUANAJUATO,2023-04-13,28,25,3,0.107142857142857
GUANAJUATO,2023-04-14,17,17,0,0
GUANAJUATO,2023-04-15,42,37,5,0.119047619047619
GUANAJUATO,2023-04-16,20,19,1,0.05
GUANAJUATO,2023-04-17,22,19,3,0.136363636363636
GUANAJUATO,2023-04-18,36,31,5,0.138888888888889
GUANAJUATO,2023-04-19,20,16,4,0.2
GUANAJUATO,2023-04-20,18,14,4,0.222222222222222
GUANAJUATO,2023-04-21,22,19,3,0.136363636363636
GUANAJUATO,2023-04-22,23,20,3,0.130434782608696
GUANAJUATO,2023-04-23,16,13,3,0.1875
GUANAJUATO,2023-04-24,23,18,5,0.217391304347826
GUANAJUATO,2023-04-25,26,21,5,0.192307692307692
GUANAJUATO,2023-04-26,17,13,4,0.235294117647059
GUANAJUATO,2023-04-27,32,28,4,0.125
GUANAJUATO,2023-04-28,32,27,5,0.15625
GUANAJUATO,2023-04-29,45,36,9,0.2
GUANAJUATO,2023-04-30,16,14,2,0.125
GUANAJUATO,2023-05-01,29,24,5,0.172413793103448
GUANAJUATO,2023-05-02,15,14,1,0.0666666666666667
GUANAJUATO,2023-05-03,18,14,4,0.222222222222222
GUANAJUATO,2023-05-04,25,19,6,0.24
GUANAJUATO,2023-05-05,27,24,3,0.111111111111111
GUANAJUATO,2023-05-06,34,29,5,0.147058823529412
GUANAJUATO,2023-05-07,14,11,3,0.214285714285714
GUANAJUATO,2023-05-08,20,18,2,0.1
HERMOSILLO,2023-01-02,20,15,5,0.25
HERMOSILLO,2023-01-03,17,14,3,0.176470588235294
HERMOSILLO,2023-01-04,32,24,8,0.25
HERMOSILLO,2023-01-05,27,25,2,0.0740740740740741
HERMOSILLO,2023-01-06,24,20,4,0.166666666666667
HERMOSILLO,2023-01-07,25,21,4,0.16
HERMOSILLO,2023-01-08,28,21,7,0.25
HERMOSILLO,2023-01-09,20,18,2,0.1
HERMOSILLO,2023-01-10,25,22,3,0.12
HERMOSILLO,2023-01-11,23,15,8,0.347826086956522
HERMOSILLO,2023-01-12,26,17,9,0.346153846153846
HERMOSILLO,2023-01-13,27,23,4,0.148148148148148
HERMOSILLO,2023-01-14,29,24,5,0.172413793103448
HERMOSILLO,2023-01-15,36,27,9,0.25
HERMOSILLO,2023-01-16,23,20,3,0.130434782608696
HERMOSILLO,2023-01-17,14,13,1,0.0714285714285714
HERMOSILLO,2023-01-18,22,5,17,0.772727272727273
HERMOSILLO,2023-01-19,26,9,17,0.653846153846154
HERMOSILLO,2023-01-20,23,9,14,0.608695652173913
HERMOSILLO,2023-01-21,30,3,27,0.9
HERMOSILLO,2023-01-22,29,3,26,0.896551724137931
HERMOSILLO,2023-01-23,24,5,19,0.791666666666667
HERMOSILLO,2023-01-24,30,9,21,0.7
HERMOSILLO,2023-01-25,28,4,24,0.857142857142857
HERMOSILLO,2023-01-26,12,2,10,0.833333333333333
HERMOSILLO,2023-01-27,36,6,30,0.833333333333333
HERMOSILLO,2023-01-28,26,0,26,1
HERMOSILLO,2023-01-29,29,7,22,0.758620689655172
HERMOSILLO,2023-01-30,32,7,25,0.78125
HERMOSILLO,2023-01-31,33,6,27,0.818181818181818
HERMOSILLO,2023-02-01,30,11,19,0.633333333333333
HERMOSILLO,2023-02-02,27,7,20,0.740740740740741
HERMOSILLO,2023-02-03,32,9,23,0.71875
HERMOSILLO,2023-02-04,36,7,29,0.805555555555556
HERMOSILLO,2023-02-05,24,7,17,0.708333333333333
HERMOSILLO,2023-02-06,32,4,28,0.875
HERMOSILLO,2023-02-07,30,7,23,0.766666666666667
HERMOSILLO,2023-02-08,25,7,18,0.72
HERMOSILLO,2023-02-09,35,4,31,0.885714285714286
HERMOSILLO,2023-02-10,26,3,23,0.884615384615385
HERMOSILLO,2023-02-11,38,12,26,0.684210526315789
HERMOSILLO,2023-02-12,13,1,12,0.923076923076923
HERMOSILLO,2023-02-13,16,4,12,0.75
HERMOSILLO,2023-02-14,25,2,23,0.92
HERMOSILLO,2023-02-15,27,7,20,0.740740740740741
HERMOSILLO,2023-02-16,27,6,21,0.777777777777778
HERMOSILLO,2023-02-17,33,7,26,0.787878787878788
HERMOSILLO,2023-02-18,33,3,30,0.909090909090909
HERMOSILLO,2023-02-19,16,0,16,1
HERMOSILLO,2023-02-20,17,2,15,0.882352941176471
HERMOSILLO,2023-02-21,20,4,16,0.8
HERMOSILLO,2023-02-22,31,10,21,0.67741935483871
HERMOSILLO,2023-02-23,25,3,22,0.88
HERMOSILLO,2023-02-24,33,8,25,0.757575757575758
HERMOSILLO,2023-02-25,29,8,21,0.724137931034483
HERMOSILLO,2023-02-26,23,7,16,0.695652173913043
HERMOSILLO,2023-02-27,24,7,17,0.708333333333333
HERMOSILLO,2023-02-28,32,9,23,0.71875
HERMOSILLO,2023-03-01,30,9,21,0.7
HERMOSILLO,2023-03-02,32,15,17,0.53125
HERMOSILLO,2023-03-03,23,9,14,0.608695652173913
HERMOSILLO,2023-03-04,32,10,22,0.6875
HERMOSILLO,2023-03-05,20,7,13,0.65
HERMOSILLO,2023-03-06,25,5,20,0.8
HERMOSILLO,2023-03-07,34,13,21,0.617647058823529
HERMOSILLO,2023-03-08,39,14,25,0.641025641025641
HERMOSILLO,2023-03-09,32,16,16,0.5
HERMOSILLO,2023-03-10,28,13,15,0.535714285714286
HERMOSILLO,2023-03-11,37,18,19,0.513513513513513
HERMOSILLO,2023-03-12,15,4,11,0.733333333333333
HERMOSILLO,2023-03-13,22,17,5,0.227272727272727
HERMOSILLO,2023-03-14,29,23,6,0.206896551724138
HERMOSILLO,2023-03-15,22,21,1,0.0454545454545455
HERMOSILLO,2023-03-16,31,25,6,0.193548387096774
HERMOSILLO,2023-03-17,32,30,2,0.0625
HERMOSILLO,2023-03-18,44,42,2,0.0454545454545455
HERMOSILLO,2023-03-19,24,24,0,0
HERMOSILLO,2023-03-20,27,26,1,0.037037037037037
HERMOSILLO,2023-03-21,29,26,3,0.103448275862069
HERMOSILLO,2023-03-22,32,30,2,0.0625
HERMOSILLO,2023-03-23,40,37,3,0.075
HERMOSILLO,2023-03-24,30,29,1,0.0333333333333333
HERMOSILLO,2023-03-25,38,38,0,0
HERMOSILLO,2023-03-26,27,24,3,0.111111111111111
HERMOSILLO,2023-03-27,21,19,2,0.0952380952380952
HERMOSILLO,2023-03-28,25,24,1,0.04
HERMOSILLO,2023-03-29,22,21,1,0.0454545454545455
HERMOSILLO,2023-03-30,45,42,3,0.0666666666666667
HERMOSILLO,2023-03-31,39,39,0,0
HERMOSILLO,2023-04-01,28,25,3,0.107142857142857
HERMOSILLO,2023-04-02,25,23,2,0.08
HERMOSILLO,2023-04-03,39,35,4,0.102564102564103
HERMOSILLO,2023-04-04,34,31,3,0.0882352941176471
HERMOSILLO,2023-04-05,20,19,1,0.05
HERMOSILLO,2023-04-06,25,22,3,0.12
HERMOSILLO,2023-04-07,14,12,2,0.142857142857143
HERMOSILLO,2023-04-08,5,5,0,0
HERMOSILLO,2023-04-09,10,9,1,0.1
HERMOSILLO,2023-04-10,17,15,2,0.117647058823529
HERMOSILLO,2023-04-11,21,16,5,0.238095238095238
HERMOSILLO,2023-04-12,21,17,4,0.19047619047619
HERMOSILLO,2023-04-13,30,26,4,0.133333333333333
HERMOSILLO,2023-04-14,32,25,7,0.21875
HERMOSILLO,2023-04-15,57,49,8,0.140350877192982
HERMOSILLO,2023-04-16,48,44,4,0.0833333333333333
HERMOSILLO,2023-04-17,34,32,2,0.0588235294117647
HERMOSILLO,2023-04-18,33,32,1,0.0303030303030303
HERMOSILLO,2023-04-19,27,24,3,0.111111111111111
HERMOSILLO,2023-04-20,18,15,3,0.166666666666667
HERMOSILLO,2023-04-21,28,26,2,0.0714285714285714
HERMOSILLO,2023-04-22,27,23,4,0.148148148148148
HERMOSILLO,2023-04-23,19,19,0,0
HERMOSILLO,2023-04-24,21,21,0,0
HERMOSILLO,2023-04-25,37,37,0,0
HERMOSILLO,2023-04-26,32,28,4,0.125
HERMOSILLO,2023-04-27,23,22,1,0.0434782608695652
HERMOSILLO,2023-04-28,32,28,4,0.125
HERMOSILLO,2023-04-29,41,37,4,0.0975609756097561
HERMOSILLO,2023-04-30,33,31,2,0.0606060606060606
HERMOSILLO,2023-05-01,22,20,2,0.0909090909090909
HERMOSILLO,2023-05-02,29,27,2,0.0689655172413793
HERMOSILLO,2023-05-03,33,31,2,0.0606060606060606
HERMOSILLO,2023-05-04,30,29,1,0.0333333333333333
HERMOSILLO,2023-05-05,34,32,2,0.0588235294117647
HERMOSILLO,2023-05-06,26,26,0,0
HERMOSILLO,2023-05-07,21,16,5,0.238095238095238
HERMOSILLO,2023-05-08,28,25,3,0.107142857142857
HUEHUETOCA,2023-01-02,45,33,12,0.266666666666667
HUEHUETOCA,2023-01-03,54,38,16,0.296296296296296
HUEHUETOCA,2023-01-04,51,37,14,0.274509803921569
HUEHUETOCA,2023-01-05,70,48,22,0.314285714285714
HUEHUETOCA,2023-01-06,49,34,15,0.306122448979592
HUEHUETOCA,2023-01-07,74,47,27,0.364864864864865
HUEHUETOCA,2023-01-08,68,46,22,0.323529411764706
HUEHUETOCA,2023-01-09,41,29,12,0.292682926829268
HUEHUETOCA,2023-01-10,41,24,17,0.414634146341463
HUEHUETOCA,2023-01-11,53,30,23,0.433962264150943
HUEHUETOCA,2023-01-12,47,32,15,0.319148936170213
HUEHUETOCA,2023-01-13,39,19,20,0.512820512820513
HUEHUETOCA,2023-01-14,43,28,15,0.348837209302326
HUEHUETOCA,2023-01-15,42,28,14,0.333333333333333
HUEHUETOCA,2023-01-16,54,31,23,0.425925925925926
HUEHUETOCA,2023-01-17,41,22,19,0.463414634146341
HUEHUETOCA,2023-01-18,41,26,15,0.365853658536585
HUEHUETOCA,2023-01-19,28,13,15,0.535714285714286
HUEHUETOCA,2023-01-20,47,22,25,0.531914893617021
HUEHUETOCA,2023-01-21,50,22,28,0.56
HUEHUETOCA,2023-01-22,46,25,21,0.456521739130435
HUEHUETOCA,2023-01-23,54,31,23,0.425925925925926
HUEHUETOCA,2023-01-24,45,24,21,0.466666666666667
HUEHUETOCA,2023-01-25,50,20,30,0.6
HUEHUETOCA,2023-01-26,42,21,21,0.5
HUEHUETOCA,2023-01-27,47,23,24,0.51063829787234
HUEHUETOCA,2023-01-28,61,31,30,0.491803278688525
HUEHUETOCA,2023-01-29,48,25,23,0.479166666666667
HUEHUETOCA,2023-01-30,40,16,24,0.6
HUEHUETOCA,2023-01-31,42,19,23,0.547619047619048
HUEHUETOCA,2023-02-01,46,22,24,0.521739130434783
HUEHUETOCA,2023-02-02,44,20,24,0.545454545454545
HUEHUETOCA,2023-02-03,47,19,28,0.595744680851064
HUEHUETOCA,2023-02-04,61,27,34,0.557377049180328
HUEHUETOCA,2023-02-05,42,19,23,0.547619047619048
HUEHUETOCA,2023-02-06,50,19,31,0.62
HUEHUETOCA,2023-02-07,69,21,48,0.695652173913043
HUEHUETOCA,2023-02-08,49,16,33,0.673469387755102
HUEHUETOCA,2023-02-09,42,9,33,0.785714285714286
HUEHUETOCA,2023-02-10,51,16,35,0.686274509803922
HUEHUETOCA,2023-02-11,55,20,35,0.636363636363636
HUEHUETOCA,2023-02-12,40,7,33,0.825
HUEHUETOCA,2023-02-13,50,10,40,0.8
HUEHUETOCA,2023-02-14,42,7,35,0.833333333333333
HUEHUETOCA,2023-02-15,37,6,31,0.837837837837838
HUEHUETOCA,2023-02-16,40,3,37,0.925
HUEHUETOCA,2023-02-17,35,7,28,0.8
HUEHUETOCA,2023-02-18,61,10,51,0.836065573770492
HUEHUETOCA,2023-02-19,38,8,30,0.789473684210526
HUEHUETOCA,2023-02-20,54,13,41,0.759259259259259
HUEHUETOCA,2023-02-21,45,40,5,0.111111111111111
HUEHUETOCA,2023-02-22,27,22,5,0.185185185185185
HUEHUETOCA,2023-02-23,38,33,5,0.131578947368421
HUEHUETOCA,2023-02-24,43,38,5,0.116279069767442
HUEHUETOCA,2023-02-25,47,40,7,0.148936170212766
HUEHUETOCA,2023-02-26,45,18,27,0.6
HUEHUETOCA,2023-02-27,42,39,3,0.0714285714285714
HUEHUETOCA,2023-02-28,58,33,25,0.431034482758621
HUEHUETOCA,2023-03-01,43,39,4,0.0930232558139535
HUEHUETOCA,2023-03-02,35,30,5,0.142857142857143
HUEHUETOCA,2023-03-03,50,43,7,0.14
HUEHUETOCA,2023-03-04,60,42,18,0.3
HUEHUETOCA,2023-03-05,37,20,17,0.459459459459459
HUEHUETOCA,2023-03-06,45,43,2,0.0444444444444444
HUEHUETOCA,2023-03-07,37,35,2,0.0540540540540541
HUEHUETOCA,2023-03-08,48,45,3,0.0625
HUEHUETOCA,2023-03-09,45,45,0,0
HUEHUETOCA,2023-03-10,51,50,1,0.0196078431372549
HUEHUETOCA,2023-03-11,57,56,1,0.0175438596491228
HUEHUETOCA,2023-03-12,34,28,6,0.176470588235294
HUEHUETOCA,2023-03-13,47,46,1,0.0212765957446809
HUEHUETOCA,2023-03-14,48,48,0,0
HUEHUETOCA,2023-03-15,33,33,0,0
HUEHUETOCA,2023-03-16,51,51,0,0
HUEHUETOCA,2023-03-17,72,71,1,0.0138888888888889
HUEHUETOCA,2023-03-18,84,81,3,0.0357142857142857
HUEHUETOCA,2023-03-19,78,78,0,0
HUEHUETOCA,2023-03-20,57,55,2,0.0350877192982456
HUEHUETOCA,2023-03-21,52,52,0,0
HUEHUETOCA,2023-03-22,58,58,0,0
HUEHUETOCA,2023-03-23,42,42,0,0
HUEHUETOCA,2023-03-24,53,53,0,0
HUEHUETOCA,2023-03-25,72,72,0,0
HUEHUETOCA,2023-03-26,54,54,0,0
HUEHUETOCA,2023-03-27,54,54,0,0
HUEHUETOCA,2023-03-28,43,43,0,0
HUEHUETOCA,2023-03-29,50,50,0,0
HUEHUETOCA,2023-03-30,66,66,0,0
HUEHUETOCA,2023-03-31,50,50,0,0
HUEHUETOCA,2023-04-01,71,71,0,0
HUEHUETOCA,2023-04-02,44,44,0,0
HUEHUETOCA,2023-04-03,57,56,1,0.0175438596491228
HUEHUETOCA,2023-04-04,39,39,0,0
HUEHUETOCA,2023-04-05,39,39,0,0
HUEHUETOCA,2023-04-06,48,48,0,0
HUEHUETOCA,2023-04-07,43,43,0,0
HUEHUETOCA,2023-04-08,27,27,0,0
HUEHUETOCA,2023-04-09,28,28,0,0
HUEHUETOCA,2023-04-10,34,34,0,0
HUEHUETOCA,2023-04-11,31,31,0,0
HUEHUETOCA,2023-04-12,69,69,0,0
HUEHUETOCA,2023-04-13,56,56,0,0
HUEHUETOCA,2023-04-14,45,45,0,0
HUEHUETOCA,2023-04-15,55,55,0,0
HUEHUETOCA,2023-04-16,53,53,0,0
HUEHUETOCA,2023-04-17,57,57,0,0
HUEHUETOCA,2023-04-18,48,48,0,0
HUEHUETOCA,2023-04-19,49,49,0,0
HUEHUETOCA,2023-04-20,44,44,0,0
HUEHUETOCA,2023-04-21,43,43,0,0
HUEHUETOCA,2023-04-22,66,66,0,0
HUEHUETOCA,2023-04-23,49,49,0,0
HUEHUETOCA,2023-04-24,70,70,0,0
HUEHUETOCA,2023-04-25,60,60,0,0
HUEHUETOCA,2023-04-26,59,59,0,0
HUEHUETOCA,2023-04-27,41,41,0,0
HUEHUETOCA,2023-04-28,52,52,0,0
HUEHUETOCA,2023-04-29,60,60,0,0
HUEHUETOCA,2023-04-30,53,53,0,0
HUEHUETOCA,2023-05-01,45,45,0,0
HUEHUETOCA,2023-05-02,47,47,0,0
HUEHUETOCA,2023-05-03,40,40,0,0
HUEHUETOCA,2023-05-04,29,29,0,0
HUEHUETOCA,2023-05-05,49,49,0,0
HUEHUETOCA,2023-05-06,30,30,0,0
HUEHUETOCA,2023-05-07,48,48,0,0
HUEHUETOCA,2023-05-08,33,33,0,0
IRAPUATO,2023-01-02,25,17,8,0.32
IRAPUATO,2023-01-03,25,23,2,0.08
IRAPUATO,2023-01-04,21,16,5,0.238095238095238
IRAPUATO,2023-01-05,25,21,4,0.16
IRAPUATO,2023-01-06,30,27,3,0.1
IRAPUATO,2023-01-07,30,26,4,0.133333333333333
IRAPUATO,2023-01-08,13,9,4,0.307692307692308
IRAPUATO,2023-01-09,32,25,7,0.21875
IRAPUATO,2023-01-10,31,21,10,0.32258064516129
IRAPUATO,2023-01-11,33,26,7,0.212121212121212
IRAPUATO,2023-01-12,30,20,10,0.333333333333333
IRAPUATO,2023-01-13,25,19,6,0.24
IRAPUATO,2023-01-14,28,20,8,0.285714285714286
IRAPUATO,2023-01-15,30,26,4,0.133333333333333
IRAPUATO,2023-01-16,18,17,1,0.0555555555555556
IRAPUATO,2023-01-17,33,27,6,0.181818181818182
IRAPUATO,2023-01-18,34,28,6,0.176470588235294
IRAPUATO,2023-01-19,30,28,2,0.0666666666666667
IRAPUATO,2023-01-20,29,21,8,0.275862068965517
IRAPUATO,2023-01-21,26,22,4,0.153846153846154
IRAPUATO,2023-01-22,22,17,5,0.227272727272727
IRAPUATO,2023-01-23,22,20,2,0.0909090909090909
IRAPUATO,2023-01-24,27,21,6,0.222222222222222
IRAPUATO,2023-01-25,27,26,1,0.037037037037037
IRAPUATO,2023-01-26,27,20,7,0.259259259259259
IRAPUATO,2023-01-27,38,31,7,0.184210526315789
IRAPUATO,2023-01-28,45,39,6,0.133333333333333
IRAPUATO,2023-01-29,21,16,5,0.238095238095238
IRAPUATO,2023-01-30,41,31,10,0.24390243902439
IRAPUATO,2023-01-31,32,26,6,0.1875
IRAPUATO,2023-02-01,17,12,5,0.294117647058824
IRAPUATO,2023-02-02,27,18,9,0.333333333333333
IRAPUATO,2023-02-03,32,24,8,0.25
IRAPUATO,2023-02-04,44,38,6,0.136363636363636
IRAPUATO,2023-02-05,10,10,0,0
IRAPUATO,2023-02-06,31,29,2,0.0645161290322581
IRAPUATO,2023-02-07,28,24,4,0.142857142857143
IRAPUATO,2023-02-08,31,27,4,0.129032258064516
IRAPUATO,2023-02-09,25,22,3,0.12
IRAPUATO,2023-02-10,31,27,4,0.129032258064516
IRAPUATO,2023-02-11,31,27,4,0.129032258064516
IRAPUATO,2023-02-12,13,10,3,0.230769230769231
IRAPUATO,2023-02-13,23,19,4,0.173913043478261
IRAPUATO,2023-02-14,20,13,7,0.35
IRAPUATO,2023-02-15,32,22,10,0.3125
IRAPUATO,2023-02-16,27,20,7,0.259259259259259
IRAPUATO,2023-02-17,19,10,9,0.473684210526316
IRAPUATO,2023-02-18,29,22,7,0.241379310344828
IRAPUATO,2023-02-19,17,9,8,0.470588235294118
IRAPUATO,2023-02-20,24,16,8,0.333333333333333
IRAPUATO,2023-02-21,26,18,8,0.307692307692308
IRAPUATO,2023-02-22,19,16,3,0.157894736842105
IRAPUATO,2023-02-23,24,17,7,0.291666666666667
IRAPUATO,2023-02-24,25,17,8,0.32
IRAPUATO,2023-02-25,43,32,11,0.255813953488372
IRAPUATO,2023-02-26,12,5,7,0.583333333333333
IRAPUATO,2023-02-27,31,20,11,0.354838709677419
IRAPUATO,2023-02-28,30,20,10,0.333333333333333
IRAPUATO,2023-03-01,19,13,6,0.315789473684211
IRAPUATO,2023-03-02,30,18,12,0.4
IRAPUATO,2023-03-03,28,17,11,0.392857142857143
IRAPUATO,2023-03-04,33,22,11,0.333333333333333
IRAPUATO,2023-03-05,19,16,3,0.157894736842105
IRAPUATO,2023-03-06,20,14,6,0.3
IRAPUATO,2023-03-07,36,27,9,0.25
IRAPUATO,2023-03-08,31,28,3,0.0967741935483871
IRAPUATO,2023-03-09,28,26,2,0.0714285714285714
IRAPUATO,2023-03-10,28,28,0,0
IRAPUATO,2023-03-11,33,31,2,0.0606060606060606
IRAPUATO,2023-03-12,22,21,1,0.0454545454545455
IRAPUATO,2023-03-13,25,25,0,0
IRAPUATO,2023-03-14,18,18,0,0
IRAPUATO,2023-03-15,24,24,0,0
IRAPUATO,2023-03-16,25,25,0,0
IRAPUATO,2023-03-17,41,40,1,0.024390243902439
IRAPUATO,2023-03-18,55,55,0,0
IRAPUATO,2023-03-19,19,18,1,0.0526315789473684
IRAPUATO,2023-03-20,33,32,1,0.0303030303030303
IRAPUATO,2023-03-21,45,44,1,0.0222222222222222
IRAPUATO,2023-03-22,33,32,1,0.0303030303030303
IRAPUATO,2023-03-23,35,35,0,0
IRAPUATO,2023-03-24,32,31,1,0.03125
IRAPUATO,2023-03-25,40,40,0,0
IRAPUATO,2023-03-26,19,19,0,0
IRAPUATO,2023-03-27,21,21,0,0
IRAPUATO,2023-03-28,25,25,0,0
IRAPUATO,2023-03-29,32,32,0,0
IRAPUATO,2023-03-30,33,32,1,0.0303030303030303
IRAPUATO,2023-03-31,50,50,0,0
IRAPUATO,2023-04-01,38,38,0,0
IRAPUATO,2023-04-02,26,26,0,0
IRAPUATO,2023-04-03,30,29,1,0.0333333333333333
IRAPUATO,2023-04-04,28,27,1,0.0357142857142857
IRAPUATO,2023-04-05,23,20,3,0.130434782608696
IRAPUATO,2023-04-06,26,26,0,0
IRAPUATO,2023-04-07,23,23,0,0
IRAPUATO,2023-04-08,23,23,0,0
IRAPUATO,2023-04-09,10,10,0,0
IRAPUATO,2023-04-10,25,25,0,0
IRAPUATO,2023-04-11,26,25,1,0.0384615384615385
IRAPUATO,2023-04-12,23,23,0,0
IRAPUATO,2023-04-13,22,22,0,0
IRAPUATO,2023-04-14,23,22,1,0.0434782608695652
IRAPUATO,2023-04-15,53,47,6,0.113207547169811
IRAPUATO,2023-04-16,35,35,0,0
IRAPUATO,2023-04-17,42,41,1,0.0238095238095238
IRAPUATO,2023-04-18,26,25,1,0.0384615384615385
IRAPUATO,2023-04-19,25,24,1,0.04
IRAPUATO,2023-04-20,37,35,2,0.0540540540540541
IRAPUATO,2023-04-21,28,27,1,0.0357142857142857
IRAPUATO,2023-04-22,33,33,0,0
IRAPUATO,2023-04-23,31,30,1,0.032258064516129
IRAPUATO,2023-04-24,33,33,0,0
IRAPUATO,2023-04-25,46,45,1,0.0217391304347826
IRAPUATO,2023-04-26,31,31,0,0
IRAPUATO,2023-04-27,31,31,0,0
IRAPUATO,2023-04-28,33,32,1,0.0303030303030303
IRAPUATO,2023-04-29,56,55,1,0.0178571428571429
IRAPUATO,2023-04-30,22,20,2,0.0909090909090909
IRAPUATO,2023-05-01,28,28,0,0
IRAPUATO,2023-05-02,30,30,0,0
IRAPUATO,2023-05-03,30,30,0,0
IRAPUATO,2023-05-04,21,20,1,0.0476190476190476
IRAPUATO,2023-05-05,33,29,4,0.121212121212121
IRAPUATO,2023-05-06,30,30,0,0
IRAPUATO,2023-05-07,24,20,4,0.166666666666667
IRAPUATO,2023-05-08,33,32,1,0.0303030303030303
IZTAPALAPA,2023-01-02,26,22,4,0.153846153846154
IZTAPALAPA,2023-01-03,33,29,4,0.121212121212121
IZTAPALAPA,2023-01-04,37,31,6,0.162162162162162
IZTAPALAPA,2023-01-05,33,29,4,0.121212121212121
IZTAPALAPA,2023-01-06,29,25,4,0.137931034482759
IZTAPALAPA,2023-01-07,35,30,5,0.142857142857143
IZTAPALAPA,2023-01-08,32,27,5,0.15625
IZTAPALAPA,2023-01-09,28,27,1,0.0357142857142857
IZTAPALAPA,2023-01-10,33,29,4,0.121212121212121
IZTAPALAPA,2023-01-11,35,26,9,0.257142857142857
IZTAPALAPA,2023-01-12,28,24,4,0.142857142857143
IZTAPALAPA,2023-01-13,38,29,9,0.236842105263158
IZTAPALAPA,2023-01-14,41,32,9,0.219512195121951
IZTAPALAPA,2023-01-15,38,32,6,0.157894736842105
IZTAPALAPA,2023-01-16,30,26,4,0.133333333333333
IZTAPALAPA,2023-01-17,34,24,10,0.294117647058824
IZTAPALAPA,2023-01-18,36,31,5,0.138888888888889
IZTAPALAPA,2023-01-19,37,32,5,0.135135135135135
IZTAPALAPA,2023-01-20,29,18,11,0.379310344827586
IZTAPALAPA,2023-01-21,42,29,13,0.30952380952381
IZTAPALAPA,2023-01-22,38,26,12,0.315789473684211
IZTAPALAPA,2023-01-23,33,26,7,0.212121212121212
IZTAPALAPA,2023-01-24,32,24,8,0.25
IZTAPALAPA,2023-01-25,24,18,6,0.25
IZTAPALAPA,2023-01-26,40,28,12,0.3
IZTAPALAPA,2023-01-27,41,28,13,0.317073170731707
IZTAPALAPA,2023-01-28,45,36,9,0.2
IZTAPALAPA,2023-01-29,47,38,9,0.191489361702128
IZTAPALAPA,2023-01-30,35,25,10,0.285714285714286
IZTAPALAPA,2023-01-31,43,34,9,0.209302325581395
IZTAPALAPA,2023-02-01,31,25,6,0.193548387096774
IZTAPALAPA,2023-02-02,37,26,11,0.297297297297297
IZTAPALAPA,2023-02-03,38,29,9,0.236842105263158
IZTAPALAPA,2023-02-04,40,32,8,0.2
IZTAPALAPA,2023-02-05,30,23,7,0.233333333333333
IZTAPALAPA,2023-02-06,27,22,5,0.185185185185185
IZTAPALAPA,2023-02-07,22,21,1,0.0454545454545455
IZTAPALAPA,2023-02-08,26,24,2,0.0769230769230769
IZTAPALAPA,2023-02-09,34,23,11,0.323529411764706
IZTAPALAPA,2023-02-10,34,25,9,0.264705882352941
IZTAPALAPA,2023-02-11,44,26,18,0.409090909090909
IZTAPALAPA,2023-02-12,42,32,10,0.238095238095238
IZTAPALAPA,2023-02-13,30,22,8,0.266666666666667
IZTAPALAPA,2023-02-14,21,13,8,0.380952380952381
IZTAPALAPA,2023-02-15,36,26,10,0.277777777777778
IZTAPALAPA,2023-02-16,21,16,5,0.238095238095238
IZTAPALAPA,2023-02-17,21,17,4,0.19047619047619
IZTAPALAPA,2023-02-18,38,30,8,0.210526315789474
IZTAPALAPA,2023-02-19,54,38,16,0.296296296296296
IZTAPALAPA,2023-02-20,50,37,13,0.26
IZTAPALAPA,2023-02-21,28,15,13,0.464285714285714
IZTAPALAPA,2023-02-22,33,25,8,0.242424242424242
IZTAPALAPA,2023-02-23,24,21,3,0.125
IZTAPALAPA,2023-02-24,31,28,3,0.0967741935483871
IZTAPALAPA,2023-02-25,42,31,11,0.261904761904762
IZTAPALAPA,2023-02-26,41,36,5,0.121951219512195
IZTAPALAPA,2023-02-27,40,31,9,0.225
IZTAPALAPA,2023-02-28,36,26,10,0.277777777777778
IZTAPALAPA,2023-03-01,30,25,5,0.166666666666667
IZTAPALAPA,2023-03-02,30,29,1,0.0333333333333333
IZTAPALAPA,2023-03-03,43,40,3,0.0697674418604651
IZTAPALAPA,2023-03-04,38,36,2,0.0526315789473684
IZTAPALAPA,2023-03-05,40,34,6,0.15
IZTAPALAPA,2023-03-06,37,31,6,0.162162162162162
IZTAPALAPA,2023-03-07,38,32,6,0.157894736842105
IZTAPALAPA,2023-03-08,31,29,2,0.0645161290322581
IZTAPALAPA,2023-03-09,36,35,1,0.0277777777777778
IZTAPALAPA,2023-03-10,31,30,1,0.032258064516129
IZTAPALAPA,2023-03-11,39,38,1,0.0256410256410256
IZTAPALAPA,2023-03-12,40,36,4,0.1
IZTAPALAPA,2023-03-13,27,25,2,0.0740740740740741
IZTAPALAPA,2023-03-14,39,35,4,0.102564102564103
IZTAPALAPA,2023-03-15,38,38,0,0
IZTAPALAPA,2023-03-16,39,39,0,0
IZTAPALAPA,2023-03-17,43,40,3,0.0697674418604651
IZTAPALAPA,2023-03-18,61,59,2,0.0327868852459016
IZTAPALAPA,2023-03-19,56,51,5,0.0892857142857143
IZTAPALAPA,2023-03-20,72,72,0,0
IZTAPALAPA,2023-03-21,40,39,1,0.025
IZTAPALAPA,2023-03-22,41,38,3,0.0731707317073171
IZTAPALAPA,2023-03-23,41,39,2,0.0487804878048781
IZTAPALAPA,2023-03-24,31,31,0,0
IZTAPALAPA,2023-03-25,52,52,0,0
IZTAPALAPA,2023-03-26,39,39,0,0
IZTAPALAPA,2023-03-27,31,31,0,0
IZTAPALAPA,2023-03-28,27,27,0,0
IZTAPALAPA,2023-03-29,30,29,1,0.0333333333333333
IZTAPALAPA,2023-03-30,49,48,1,0.0204081632653061
IZTAPALAPA,2023-03-31,59,55,4,0.0677966101694915
IZTAPALAPA,2023-04-01,45,42,3,0.0666666666666667
IZTAPALAPA,2023-04-02,39,38,1,0.0256410256410256
IZTAPALAPA,2023-04-03,44,44,0,0
IZTAPALAPA,2023-04-04,14,14,0,0
IZTAPALAPA,2023-04-05,25,25,0,0
IZTAPALAPA,2023-04-06,23,23,0,0
IZTAPALAPA,2023-04-07,37,37,0,0
IZTAPALAPA,2023-04-08,32,32,0,0
IZTAPALAPA,2023-04-09,27,27,0,0
IZTAPALAPA,2023-04-10,25,25,0,0
IZTAPALAPA,2023-04-11,30,30,0,0
IZTAPALAPA,2023-04-12,29,29,0,0
IZTAPALAPA,2023-04-13,38,38,0,0
IZTAPALAPA,2023-04-14,36,36,0,0
IZTAPALAPA,2023-04-15,29,29,0,0
IZTAPALAPA,2023-04-16,52,52,0,0
IZTAPALAPA,2023-04-17,54,54,0,0
IZTAPALAPA,2023-04-18,40,40,0,0
IZTAPALAPA,2023-04-19,31,31,0,0
IZTAPALAPA,2023-04-20,35,35,0,0
IZTAPALAPA,2023-04-21,44,44,0,0
IZTAPALAPA,2023-04-22,47,47,0,0
IZTAPALAPA,2023-04-23,42,42,0,0
IZTAPALAPA,2023-04-24,38,38,0,0
IZTAPALAPA,2023-04-25,53,53,0,0
IZTAPALAPA,2023-04-26,47,47,0,0
IZTAPALAPA,2023-04-27,41,41,0,0
IZTAPALAPA,2023-04-28,45,45,0,0
IZTAPALAPA,2023-04-29,52,52,0,0
IZTAPALAPA,2023-04-30,45,45,0,0
IZTAPALAPA,2023-05-01,41,41,0,0
IZTAPALAPA,2023-05-02,48,48,0,0
IZTAPALAPA,2023-05-03,29,29,0,0
IZTAPALAPA,2023-05-04,12,12,0,0
IZTAPALAPA,2023-05-05,39,39,0,0
IZTAPALAPA,2023-05-06,46,46,0,0
IZTAPALAPA,2023-05-07,30,30,0,0
IZTAPALAPA,2023-05-08,27,27,0,0
JUAREZ NORTE,2023-01-02,16,12,4,0.25
JUAREZ NORTE,2023-01-03,42,18,24,0.571428571428571
JUAREZ NORTE,2023-01-04,31,11,20,0.645161290322581
JUAREZ NORTE,2023-01-05,33,14,19,0.575757575757576
JUAREZ NORTE,2023-01-06,41,21,20,0.48780487804878
JUAREZ NORTE,2023-01-07,45,20,25,0.555555555555556
JUAREZ NORTE,2023-01-08,41,24,17,0.414634146341463
JUAREZ NORTE,2023-01-09,41,22,19,0.463414634146341
JUAREZ NORTE,2023-01-10,39,19,20,0.512820512820513
JUAREZ NORTE,2023-01-11,42,23,19,0.452380952380952
JUAREZ NORTE,2023-01-12,52,31,21,0.403846153846154
JUAREZ NORTE,2023-01-13,60,37,23,0.383333333333333
JUAREZ NORTE,2023-01-14,59,40,19,0.322033898305085
JUAREZ NORTE,2023-01-15,28,18,10,0.357142857142857
JUAREZ NORTE,2023-01-16,41,22,19,0.463414634146341
JUAREZ NORTE,2023-01-17,33,18,15,0.454545454545455
JUAREZ NORTE,2023-01-18,38,24,14,0.368421052631579
JUAREZ NORTE,2023-01-19,52,24,28,0.538461538461538
JUAREZ NORTE,2023-01-20,41,25,16,0.390243902439024
JUAREZ NORTE,2023-01-21,49,10,39,0.795918367346939
JUAREZ NORTE,2023-01-22,30,3,27,0.9
JUAREZ NORTE,2023-01-23,37,5,32,0.864864864864865
JUAREZ NORTE,2023-01-24,40,2,38,0.95
JUAREZ NORTE,2023-01-25,43,4,39,0.906976744186046
JUAREZ NORTE,2023-01-26,49,5,44,0.897959183673469
JUAREZ NORTE,2023-01-27,43,3,40,0.930232558139535
JUAREZ NORTE,2023-01-28,52,2,50,0.961538461538462
JUAREZ NORTE,2023-01-29,30,0,30,1
JUAREZ NORTE,2023-01-30,36,2,34,0.944444444444444
JUAREZ NORTE,2023-01-31,40,1,39,0.975
JUAREZ NORTE,2023-02-01,38,1,37,0.973684210526316
JUAREZ NORTE,2023-02-02,43,6,37,0.86046511627907
JUAREZ NORTE,2023-02-03,34,5,29,0.852941176470588
JUAREZ NORTE,2023-02-04,49,1,48,0.979591836734694
JUAREZ NORTE,2023-02-05,38,3,35,0.921052631578947
JUAREZ NORTE,2023-02-06,48,5,43,0.895833333333333
JUAREZ NORTE,2023-02-07,29,2,27,0.931034482758621
JUAREZ NORTE,2023-02-08,46,4,42,0.91304347826087
JUAREZ NORTE,2023-02-09,37,4,33,0.891891891891892
JUAREZ NORTE,2023-02-10,53,4,49,0.924528301886792
JUAREZ NORTE,2023-02-11,40,0,40,1
JUAREZ NORTE,2023-02-12,42,3,39,0.928571428571429
JUAREZ NORTE,2023-02-13,25,0,25,1
JUAREZ NORTE,2023-02-14,36,0,36,1
JUAREZ NORTE,2023-02-15,38,4,34,0.894736842105263
JUAREZ NORTE,2023-02-16,44,2,42,0.954545454545455
JUAREZ NORTE,2023-02-17,35,3,32,0.914285714285714
JUAREZ NORTE,2023-02-18,47,4,43,0.914893617021277
JUAREZ NORTE,2023-02-19,18,0,18,1
JUAREZ NORTE,2023-02-20,33,4,29,0.878787878787879
JUAREZ NORTE,2023-02-21,54,7,47,0.87037037037037
JUAREZ NORTE,2023-02-22,30,2,28,0.933333333333333
JUAREZ NORTE,2023-02-23,36,2,34,0.944444444444444
JUAREZ NORTE,2023-02-24,51,8,43,0.843137254901961
JUAREZ NORTE,2023-02-25,40,6,34,0.85
JUAREZ NORTE,2023-02-26,20,0,20,1
JUAREZ NORTE,2023-02-27,34,5,29,0.852941176470588
JUAREZ NORTE,2023-02-28,39,0,39,1
JUAREZ NORTE,2023-03-01,31,0,31,1
JUAREZ NORTE,2023-03-02,44,9,35,0.795454545454545
JUAREZ NORTE,2023-03-03,59,9,50,0.847457627118644
JUAREZ NORTE,2023-03-04,64,2,62,0.96875
JUAREZ NORTE,2023-03-05,44,5,39,0.886363636363636
JUAREZ NORTE,2023-03-06,30,0,30,1
JUAREZ NORTE,2023-03-07,55,6,49,0.890909090909091
JUAREZ NORTE,2023-03-08,41,4,37,0.902439024390244
JUAREZ NORTE,2023-03-09,41,27,14,0.341463414634146
JUAREZ NORTE,2023-03-10,26,26,0,0
JUAREZ NORTE,2023-03-11,56,54,2,0.0357142857142857
JUAREZ NORTE,2023-03-12,40,38,2,0.05
JUAREZ NORTE,2023-03-13,40,39,1,0.025
JUAREZ NORTE,2023-03-14,38,37,1,0.0263157894736842
JUAREZ NORTE,2023-03-15,54,53,1,0.0185185185185185
JUAREZ NORTE,2023-03-16,44,44,0,0
JUAREZ NORTE,2023-03-17,43,42,1,0.0232558139534884
JUAREZ NORTE,2023-03-18,51,51,0,0
JUAREZ NORTE,2023-03-19,44,44,0,0
JUAREZ NORTE,2023-03-20,41,40,1,0.024390243902439
JUAREZ NORTE,2023-03-21,38,38,0,0
JUAREZ NORTE,2023-03-22,50,50,0,0
JUAREZ NORTE,2023-03-23,50,50,0,0
JUAREZ NORTE,2023-03-24,44,44,0,0
JUAREZ NORTE,2023-03-25,53,52,1,0.0188679245283019
JUAREZ NORTE,2023-03-26,40,40,0,0
JUAREZ NORTE,2023-03-27,45,45,0,0
JUAREZ NORTE,2023-03-28,28,28,0,0
JUAREZ NORTE,2023-03-29,35,35,0,0
JUAREZ NORTE,2023-03-30,28,28,0,0
JUAREZ NORTE,2023-03-31,39,39,0,0
JUAREZ NORTE,2023-04-01,48,47,1,0.0208333333333333
JUAREZ NORTE,2023-04-02,31,31,0,0
JUAREZ NORTE,2023-04-03,37,37,0,0
JUAREZ NORTE,2023-04-04,37,37,0,0
JUAREZ NORTE,2023-04-05,48,48,0,0
JUAREZ NORTE,2023-04-06,43,43,0,0
JUAREZ NORTE,2023-04-07,51,51,0,0
JUAREZ NORTE,2023-04-08,34,34,0,0
JUAREZ NORTE,2023-04-09,13,13,0,0
JUAREZ NORTE,2023-04-10,29,29,0,0
JUAREZ NORTE,2023-04-11,33,33,0,0
JUAREZ NORTE,2023-04-12,46,46,0,0
JUAREZ NORTE,2023-04-13,41,41,0,0
JUAREZ NORTE,2023-04-14,39,39,0,0
JUAREZ NORTE,2023-04-15,48,48,0,0
JUAREZ NORTE,2023-04-16,38,38,0,0
JUAREZ NORTE,2023-04-17,46,46,0,0
JUAREZ NORTE,2023-04-18,39,39,0,0
JUAREZ NORTE,2023-04-19,34,34,0,0
JUAREZ NORTE,2023-04-20,58,58,0,0
JUAREZ NORTE,2023-04-21,36,36,0,0
JUAREZ NORTE,2023-04-22,52,52,0,0
JUAREZ NORTE,2023-04-23,35,35,0,0
JUAREZ NORTE,2023-04-24,40,40,0,0
JUAREZ NORTE,2023-04-25,43,43,0,0
JUAREZ NORTE,2023-04-26,45,44,1,0.0222222222222222
JUAREZ NORTE,2023-04-27,37,37,0,0
JUAREZ NORTE,2023-04-28,49,49,0,0
JUAREZ NORTE,2023-04-29,67,66,1,0.0149253731343284
JUAREZ NORTE,2023-04-30,32,32,0,0
JUAREZ NORTE,2023-05-01,34,34,0,0
JUAREZ NORTE,2023-05-02,46,46,0,0
JUAREZ NORTE,2023-05-03,38,38,0,0
JUAREZ NORTE,2023-05-04,41,41,0,0
JUAREZ NORTE,2023-05-05,44,43,1,0.0227272727272727
JUAREZ NORTE,2023-05-06,40,40,0,0
JUAREZ NORTE,2023-05-07,37,36,1,0.027027027027027
JUAREZ NORTE,2023-05-08,26,26,0,0
JUAREZ SUR,2023-01-02,43,32,11,0.255813953488372
JUAREZ SUR,2023-01-03,47,33,14,0.297872340425532
JUAREZ SUR,2023-01-04,46,35,11,0.239130434782609
JUAREZ SUR,2023-01-05,57,42,15,0.263157894736842
JUAREZ SUR,2023-01-06,52,36,16,0.307692307692308
JUAREZ SUR,2023-01-07,74,55,19,0.256756756756757
JUAREZ SUR,2023-01-08,57,43,14,0.245614035087719
JUAREZ SUR,2023-01-09,53,41,12,0.226415094339623
JUAREZ SUR,2023-01-10,65,48,17,0.261538461538462
JUAREZ SUR,2023-01-11,51,45,6,0.117647058823529
JUAREZ SUR,2023-01-12,49,38,11,0.224489795918367
JUAREZ SUR,2023-01-13,52,36,16,0.307692307692308
JUAREZ SUR,2023-01-14,87,63,24,0.275862068965517
JUAREZ SUR,2023-01-15,39,31,8,0.205128205128205
JUAREZ SUR,2023-01-16,45,33,12,0.266666666666667
JUAREZ SUR,2023-01-17,58,48,10,0.172413793103448
JUAREZ SUR,2023-01-18,50,37,13,0.26
JUAREZ SUR,2023-01-19,52,36,16,0.307692307692308
JUAREZ SUR,2023-01-20,51,32,19,0.372549019607843
JUAREZ SUR,2023-01-21,56,2,54,0.964285714285714
JUAREZ SUR,2023-01-22,52,2,50,0.961538461538462
JUAREZ SUR,2023-01-23,51,1,50,0.980392156862745
JUAREZ SUR,2023-01-24,57,1,56,0.982456140350877
JUAREZ SUR,2023-01-25,46,0,48,1
JUAREZ SUR,2023-01-26,46,2,44,0.956521739130435
JUAREZ SUR,2023-01-27,43,1,42,0.976744186046512
JUAREZ SUR,2023-01-28,62,2,60,0.967741935483871
JUAREZ SUR,2023-01-29,33,0,34,1
JUAREZ SUR,2023-01-30,40,0,40,1
JUAREZ SUR,2023-01-31,46,1,45,0.978260869565217
JUAREZ SUR,2023-02-01,31,0,34,1
JUAREZ SUR,2023-02-02,52,1,51,0.980769230769231
JUAREZ SUR,2023-02-03,55,3,52,0.945454545454545
JUAREZ SUR,2023-02-04,71,1,70,0.985915492957746
JUAREZ SUR,2023-02-05,48,0,48,1
JUAREZ SUR,2023-02-06,52,4,48,0.923076923076923
JUAREZ SUR,2023-02-07,54,0,54,1
JUAREZ SUR,2023-02-08,45,0,46,1
JUAREZ SUR,2023-02-09,48,0,48,1
JUAREZ SUR,2023-02-10,54,1,53,0.981481481481482
JUAREZ SUR,2023-02-11,57,0,59,1
JUAREZ SUR,2023-02-12,37,2,35,0.945945945945946
JUAREZ SUR,2023-02-13,42,1,41,0.976190476190476
JUAREZ SUR,2023-02-14,29,3,26,0.896551724137931
JUAREZ SUR,2023-02-15,42,2,40,0.952380952380952
JUAREZ SUR,2023-02-16,45,1,44,0.977777777777778
JUAREZ SUR,2023-02-17,50,2,48,0.96
JUAREZ SUR,2023-02-18,70,1,69,0.985714285714286
JUAREZ SUR,2023-02-19,22,0,22,1
JUAREZ SUR,2023-02-20,53,1,52,0.981132075471698
JUAREZ SUR,2023-02-21,61,3,58,0.950819672131147
JUAREZ SUR,2023-02-22,40,3,37,0.925
JUAREZ SUR,2023-02-23,44,1,43,0.977272727272727
JUAREZ SUR,2023-02-24,48,16,32,0.666666666666667
JUAREZ SUR,2023-02-25,76,6,70,0.921052631578947
JUAREZ SUR,2023-02-26,18,0,18,1
JUAREZ SUR,2023-02-27,42,3,39,0.928571428571429
JUAREZ SUR,2023-02-28,32,4,28,0.875
JUAREZ SUR,2023-03-01,30,5,25,0.833333333333333
JUAREZ SUR,2023-03-02,78,6,72,0.923076923076923
JUAREZ SUR,2023-03-03,53,1,52,0.981132075471698
JUAREZ SUR,2023-03-04,88,5,83,0.943181818181818
JUAREZ SUR,2023-03-05,43,2,41,0.953488372093023
JUAREZ SUR,2023-03-06,46,2,44,0.956521739130435
JUAREZ SUR,2023-03-07,57,7,50,0.87719298245614
JUAREZ SUR,2023-03-08,45,6,39,0.866666666666667
JUAREZ SUR,2023-03-09,48,18,30,0.625
JUAREZ SUR,2023-03-10,44,25,19,0.431818181818182
JUAREZ SUR,2023-03-11,58,23,35,0.603448275862069
JUAREZ SUR,2023-03-12,45,17,28,0.622222222222222
JUAREZ SUR,2023-03-13,56,26,30,0.535714285714286
JUAREZ SUR,2023-03-14,60,17,43,0.716666666666667
JUAREZ SUR,2023-03-15,46,26,20,0.434782608695652
JUAREZ SUR,2023-03-16,34,25,9,0.264705882352941
JUAREZ SUR,2023-03-17,61,49,12,0.19672131147541
JUAREZ SUR,2023-03-18,69,52,17,0.246376811594203
JUAREZ SUR,2023-03-19,38,21,17,0.447368421052632
JUAREZ SUR,2023-03-20,61,44,17,0.278688524590164
JUAREZ SUR,2023-03-21,50,35,15,0.3
JUAREZ SUR,2023-03-22,50,36,14,0.28
JUAREZ SUR,2023-03-23,52,40,12,0.230769230769231
JUAREZ SUR,2023-03-24,46,39,7,0.152173913043478
JUAREZ SUR,2023-03-25,91,64,27,0.296703296703297
JUAREZ SUR,2023-03-26,59,54,5,0.0847457627118644
JUAREZ SUR,2023-03-27,48,38,10,0.208333333333333
JUAREZ SUR,2023-03-28,41,37,4,0.0975609756097561
JUAREZ SUR,2023-03-29,56,51,5,0.0892857142857143
JUAREZ SUR,2023-03-30,54,49,5,0.0925925925925926
JUAREZ SUR,2023-03-31,71,69,2,0.028169014084507
JUAREZ SUR,2023-04-01,74,67,7,0.0945945945945946
JUAREZ SUR,2023-04-02,42,36,6,0.142857142857143
JUAREZ SUR,2023-04-03,68,61,7,0.102941176470588
JUAREZ SUR,2023-04-04,41,38,3,0.0731707317073171
JUAREZ SUR,2023-04-05,39,36,3,0.0769230769230769
JUAREZ SUR,2023-04-06,51,50,1,0.0196078431372549
JUAREZ SUR,2023-04-07,59,56,3,0.0508474576271186
JUAREZ SUR,2023-04-08,67,64,3,0.0447761194029851
JUAREZ SUR,2023-04-09,27,26,1,0.037037037037037
JUAREZ SUR,2023-04-10,36,35,1,0.0277777777777778
JUAREZ SUR,2023-04-11,45,45,0,0
JUAREZ SUR,2023-04-12,52,50,2,0.0384615384615385
JUAREZ SUR,2023-04-13,46,44,2,0.0434782608695652
JUAREZ SUR,2023-04-14,46,42,4,0.0869565217391304
JUAREZ SUR,2023-04-15,98,97,1,0.0102040816326531
JUAREZ SUR,2023-04-16,58,57,1,0.0172413793103448
JUAREZ SUR,2023-04-17,43,42,1,0.0232558139534884
JUAREZ SUR,2023-04-18,65,64,1,0.0153846153846154
JUAREZ SUR,2023-04-19,41,38,3,0.0731707317073171
JUAREZ SUR,2023-04-20,42,39,3,0.0714285714285714
JUAREZ SUR,2023-04-21,61,60,1,0.0163934426229508
JUAREZ SUR,2023-04-22,67,64,3,0.0447761194029851
JUAREZ SUR,2023-04-23,40,40,0,0
JUAREZ SUR,2023-04-24,42,42,0,0
JUAREZ SUR,2023-04-25,57,56,1,0.0175438596491228
JUAREZ SUR,2023-04-26,37,35,2,0.0540540540540541
JUAREZ SUR,2023-04-27,47,44,3,0.0638297872340425
JUAREZ SUR,2023-04-28,60,58,2,0.0333333333333333
JUAREZ SUR,2023-04-29,74,72,2,0.027027027027027
JUAREZ SUR,2023-04-30,38,38,0,0
JUAREZ SUR,2023-05-01,47,44,3,0.0638297872340425
JUAREZ SUR,2023-05-02,48,43,5,0.104166666666667
JUAREZ SUR,2023-05-03,37,34,3,0.0810810810810811
JUAREZ SUR,2023-05-04,46,45,1,0.0217391304347826
JUAREZ SUR,2023-05-05,54,51,3,0.0555555555555556
JUAREZ SUR,2023-05-06,56,54,2,0.0357142857142857
JUAREZ SUR,2023-05-07,33,32,1,0.0303030303030303
JUAREZ SUR,2023-05-08,60,58,2,0.0333333333333333
LA LAGUNA GOMEZ,2023-01-02,22,20,2,0.0909090909090909
LA LAGUNA GOMEZ,2023-01-03,26,22,4,0.153846153846154
LA LAGUNA GOMEZ,2023-01-04,30,20,10,0.333333333333333
LA LAGUNA GOMEZ,2023-01-05,26,22,4,0.153846153846154
LA LAGUNA GOMEZ,2023-01-06,31,30,1,0.032258064516129
LA LAGUNA GOMEZ,2023-01-07,33,21,12,0.363636363636364
LA LAGUNA GOMEZ,2023-01-08,19,14,5,0.263157894736842
LA LAGUNA GOMEZ,2023-01-09,34,29,5,0.147058823529412
LA LAGUNA GOMEZ,2023-01-10,27,23,4,0.148148148148148
LA LAGUNA GOMEZ,2023-01-11,38,31,7,0.184210526315789
LA LAGUNA GOMEZ,2023-01-12,26,19,7,0.269230769230769
LA LAGUNA GOMEZ,2023-01-13,15,13,2,0.133333333333333
LA LAGUNA GOMEZ,2023-01-14,35,25,10,0.285714285714286
LA LAGUNA GOMEZ,2023-01-15,15,12,3,0.2
LA LAGUNA GOMEZ,2023-01-16,21,18,3,0.142857142857143
LA LAGUNA GOMEZ,2023-01-17,26,20,6,0.230769230769231
LA LAGUNA GOMEZ,2023-01-18,19,17,2,0.105263157894737
LA LAGUNA GOMEZ,2023-01-19,19,13,6,0.315789473684211
LA LAGUNA GOMEZ,2023-01-20,16,13,3,0.1875
LA LAGUNA GOMEZ,2023-01-21,33,26,7,0.212121212121212
LA LAGUNA GOMEZ,2023-01-22,14,11,3,0.214285714285714
LA LAGUNA GOMEZ,2023-01-23,14,12,2,0.142857142857143
LA LAGUNA GOMEZ,2023-01-24,23,20,3,0.130434782608696
LA LAGUNA GOMEZ,2023-01-25,19,15,4,0.210526315789474
LA LAGUNA GOMEZ,2023-01-26,12,9,3,0.25
LA LAGUNA GOMEZ,2023-01-27,25,18,7,0.28
LA LAGUNA GOMEZ,2023-01-28,22,16,6,0.272727272727273
LA LAGUNA GOMEZ,2023-01-29,15,12,3,0.2
LA LAGUNA GOMEZ,2023-01-30,21,16,5,0.238095238095238
LA LAGUNA GOMEZ,2023-01-31,15,12,3,0.2
LA LAGUNA GOMEZ,2023-02-01,26,23,3,0.115384615384615
LA LAGUNA GOMEZ,2023-02-02,29,24,5,0.172413793103448
LA LAGUNA GOMEZ,2023-02-03,16,11,5,0.3125
LA LAGUNA GOMEZ,2023-02-04,28,18,10,0.357142857142857
LA LAGUNA GOMEZ,2023-02-05,22,16,6,0.272727272727273
LA LAGUNA GOMEZ,2023-02-06,25,21,4,0.16
LA LAGUNA GOMEZ,2023-02-07,26,23,3,0.115384615384615
LA LAGUNA GOMEZ,2023-02-08,16,12,4,0.25
LA LAGUNA GOMEZ,2023-02-09,21,16,5,0.238095238095238
LA LAGUNA GOMEZ,2023-02-10,29,26,3,0.103448275862069
LA LAGUNA GOMEZ,2023-02-11,36,29,7,0.194444444444444
LA LAGUNA GOMEZ,2023-02-12,20,19,1,0.05
LA LAGUNA GOMEZ,2023-02-13,22,19,3,0.136363636363636
LA LAGUNA GOMEZ,2023-02-14,21,18,3,0.142857142857143
LA LAGUNA GOMEZ,2023-02-15,25,23,2,0.08
LA LAGUNA GOMEZ,2023-02-16,22,19,3,0.136363636363636
LA LAGUNA GOMEZ,2023-02-17,19,18,1,0.0526315789473684
LA LAGUNA GOMEZ,2023-02-18,25,23,2,0.08
LA LAGUNA GOMEZ,2023-02-19,17,16,1,0.0588235294117647
LA LAGUNA GOMEZ,2023-02-20,21,21,0,0
LA LAGUNA GOMEZ,2023-02-21,23,18,5,0.217391304347826
LA LAGUNA GOMEZ,2023-02-22,18,13,5,0.277777777777778
LA LAGUNA GOMEZ,2023-02-23,21,11,10,0.476190476190476
LA LAGUNA GOMEZ,2023-02-24,19,9,10,0.526315789473684
LA LAGUNA GOMEZ,2023-02-25,32,18,14,0.4375
LA LAGUNA GOMEZ,2023-02-26,12,8,4,0.333333333333333
LA LAGUNA GOMEZ,2023-02-27,23,14,9,0.391304347826087
LA LAGUNA GOMEZ,2023-02-28,32,19,13,0.40625
LA LAGUNA GOMEZ,2023-03-01,26,11,15,0.576923076923077
LA LAGUNA GOMEZ,2023-03-02,25,12,13,0.52
LA LAGUNA GOMEZ,2023-03-03,23,8,15,0.652173913043478
LA LAGUNA GOMEZ,2023-03-04,27,10,17,0.62962962962963
LA LAGUNA GOMEZ,2023-03-05,17,9,8,0.470588235294118
LA LAGUNA GOMEZ,2023-03-06,20,13,7,0.35
LA LAGUNA GOMEZ,2023-03-07,27,16,11,0.407407407407407
LA LAGUNA GOMEZ,2023-03-08,40,20,20,0.5
LA LAGUNA GOMEZ,2023-03-09,28,17,11,0.392857142857143
LA LAGUNA GOMEZ,2023-03-10,32,24,8,0.25
LA LAGUNA GOMEZ,2023-03-11,38,23,15,0.394736842105263
LA LAGUNA GOMEZ,2023-03-12,5,4,1,0.2
LA LAGUNA GOMEZ,2023-03-13,25,19,6,0.24
LA LAGUNA GOMEZ,2023-03-14,30,22,8,0.266666666666667
LA LAGUNA GOMEZ,2023-03-15,31,27,4,0.129032258064516
LA LAGUNA GOMEZ,2023-03-16,30,28,2,0.0666666666666667
LA LAGUNA GOMEZ,2023-03-17,34,32,2,0.0588235294117647
LA LAGUNA GOMEZ,2023-03-18,52,51,1,0.0192307692307692
LA LAGUNA GOMEZ,2023-03-19,28,24,4,0.142857142857143
LA LAGUNA GOMEZ,2023-03-20,26,24,2,0.0769230769230769
LA LAGUNA GOMEZ,2023-03-21,42,40,2,0.0476190476190476
LA LAGUNA GOMEZ,2023-03-22,32,32,0,0
LA LAGUNA GOMEZ,2023-03-23,37,37,0,0
LA LAGUNA GOMEZ,2023-03-24,32,31,1,0.03125
LA LAGUNA GOMEZ,2023-03-25,39,38,1,0.0256410256410256
LA LAGUNA GOMEZ,2023-03-26,27,27,0,0
LA LAGUNA GOMEZ,2023-03-27,15,15,0,0
LA LAGUNA GOMEZ,2023-03-28,16,16,0,0
LA LAGUNA GOMEZ,2023-03-29,27,26,1,0.037037037037037
LA LAGUNA GOMEZ,2023-03-30,40,38,2,0.05
LA LAGUNA GOMEZ,2023-03-31,40,40,0,0
LA LAGUNA GOMEZ,2023-04-01,36,34,2,0.0555555555555556
LA LAGUNA GOMEZ,2023-04-02,20,20,0,0
LA LAGUNA GOMEZ,2023-04-03,31,31,0,0
LA LAGUNA GOMEZ,2023-04-04,35,35,0,0
LA LAGUNA GOMEZ,2023-04-05,29,28,1,0.0344827586206897
LA LAGUNA GOMEZ,2023-04-06,28,28,0,0
LA LAGUNA GOMEZ,2023-04-07,15,15,0,0
LA LAGUNA GOMEZ,2023-04-08,18,18,0,0
LA LAGUNA GOMEZ,2023-04-09,10,10,0,0
LA LAGUNA GOMEZ,2023-04-10,20,18,2,0.1
LA LAGUNA GOMEZ,2023-04-11,30,28,2,0.0666666666666667
LA LAGUNA GOMEZ,2023-04-12,23,22,1,0.0434782608695652
LA LAGUNA GOMEZ,2023-04-13,22,22,0,0
LA LAGUNA GOMEZ,2023-04-14,42,41,1,0.0238095238095238
LA LAGUNA GOMEZ,2023-04-15,58,54,4,0.0689655172413793
LA LAGUNA GOMEZ,2023-04-16,43,41,2,0.0465116279069767
LA LAGUNA GOMEZ,2023-04-17,33,31,2,0.0606060606060606
LA LAGUNA GOMEZ,2023-04-18,25,24,1,0.04
LA LAGUNA GOMEZ,2023-04-19,21,19,2,0.0952380952380952
LA LAGUNA GOMEZ,2023-04-20,38,36,2,0.0526315789473684
LA LAGUNA GOMEZ,2023-04-21,19,19,0,0
LA LAGUNA GOMEZ,2023-04-22,34,31,3,0.0882352941176471
LA LAGUNA GOMEZ,2023-04-23,16,16,0,0
LA LAGUNA GOMEZ,2023-04-24,39,38,1,0.0256410256410256
LA LAGUNA GOMEZ,2023-04-25,48,41,7,0.145833333333333
LA LAGUNA GOMEZ,2023-04-26,39,38,1,0.0256410256410256
LA LAGUNA GOMEZ,2023-04-27,28,25,3,0.107142857142857
LA LAGUNA GOMEZ,2023-04-28,47,41,6,0.127659574468085
LA LAGUNA GOMEZ,2023-04-29,51,46,5,0.0980392156862745
LA LAGUNA GOMEZ,2023-04-30,32,29,3,0.09375
LA LAGUNA GOMEZ,2023-05-01,37,32,5,0.135135135135135
LA LAGUNA GOMEZ,2023-05-02,44,43,1,0.0227272727272727
LA LAGUNA GOMEZ,2023-05-03,32,32,0,0
LA LAGUNA GOMEZ,2023-05-04,28,25,3,0.107142857142857
LA LAGUNA GOMEZ,2023-05-05,30,28,2,0.0666666666666667
LA LAGUNA GOMEZ,2023-05-06,33,32,1,0.0303030303030303
LA LAGUNA GOMEZ,2023-05-07,21,21,0,0
LA LAGUNA GOMEZ,2023-05-08,30,29,1,0.0333333333333333
LA LAGUNA TORREON,2023-01-02,28,19,9,0.321428571428571
LA LAGUNA TORREON,2023-01-03,31,22,9,0.290322580645161
LA LAGUNA TORREON,2023-01-04,24,15,9,0.375
LA LAGUNA TORREON,2023-01-05,24,18,6,0.25
LA LAGUNA TORREON,2023-01-06,34,23,11,0.323529411764706
LA LAGUNA TORREON,2023-01-07,40,24,16,0.4
LA LAGUNA TORREON,2023-01-08,25,11,14,0.56
LA LAGUNA TORREON,2023-01-09,24,11,13,0.541666666666667
LA LAGUNA TORREON,2023-01-10,32,21,11,0.34375
LA LAGUNA TORREON,2023-01-11,34,20,14,0.411764705882353
LA LAGUNA TORREON,2023-01-12,38,24,14,0.368421052631579
LA LAGUNA TORREON,2023-01-13,25,18,7,0.28
LA LAGUNA TORREON,2023-01-14,41,32,9,0.219512195121951
LA LAGUNA TORREON,2023-01-15,27,20,7,0.259259259259259
LA LAGUNA TORREON,2023-01-16,31,21,10,0.32258064516129
LA LAGUNA TORREON,2023-01-17,24,15,9,0.375
LA LAGUNA TORREON,2023-01-18,19,8,11,0.578947368421053
LA LAGUNA TORREON,2023-01-19,29,20,9,0.310344827586207
LA LAGUNA TORREON,2023-01-20,27,19,8,0.296296296296296
LA LAGUNA TORREON,2023-01-21,41,27,14,0.341463414634146
LA LAGUNA TORREON,2023-01-22,22,11,11,0.5
LA LAGUNA TORREON,2023-01-23,19,12,7,0.368421052631579
LA LAGUNA TORREON,2023-01-24,28,19,9,0.321428571428571
LA LAGUNA TORREON,2023-01-25,23,14,9,0.391304347826087
LA LAGUNA TORREON,2023-01-26,25,18,7,0.28
LA LAGUNA TORREON,2023-01-27,22,16,6,0.272727272727273
LA LAGUNA TORREON,2023-01-28,37,27,10,0.27027027027027
LA LAGUNA TORREON,2023-01-29,26,16,10,0.384615384615385
LA LAGUNA TORREON,2023-01-30,18,11,7,0.388888888888889
LA LAGUNA TORREON,2023-01-31,27,15,12,0.444444444444444
LA LAGUNA TORREON,2023-02-01,26,15,11,0.423076923076923
LA LAGUNA TORREON,2023-02-02,26,13,13,0.5
LA LAGUNA TORREON,2023-02-03,21,12,9,0.428571428571429
LA LAGUNA TORREON,2023-02-04,24,16,8,0.333333333333333
LA LAGUNA TORREON,2023-02-05,23,12,11,0.478260869565217
LA LAGUNA TORREON,2023-02-06,28,18,10,0.357142857142857
LA LAGUNA TORREON,2023-02-07,20,12,8,0.4
LA LAGUNA TORREON,2023-02-08,21,15,6,0.285714285714286
LA LAGUNA TORREON,2023-02-09,24,15,9,0.375
LA LAGUNA TORREON,2023-02-10,26,16,10,0.384615384615385
LA LAGUNA TORREON,2023-02-11,43,28,15,0.348837209302326
LA LAGUNA TORREON,2023-02-12,21,11,10,0.476190476190476
LA LAGUNA TORREON,2023-02-13,33,21,12,0.363636363636364
LA LAGUNA TORREON,2023-02-14,13,10,3,0.230769230769231
LA LAGUNA TORREON,2023-02-15,21,12,9,0.428571428571429
LA LAGUNA TORREON,2023-02-16,35,22,13,0.371428571428571
LA LAGUNA TORREON,2023-02-17,29,19,10,0.344827586206897
LA LAGUNA TORREON,2023-02-18,35,20,15,0.428571428571429
LA LAGUNA TORREON,2023-02-19,20,14,6,0.3
LA LAGUNA TORREON,2023-02-20,25,17,8,0.32
LA LAGUNA TORREON,2023-02-21,24,14,10,0.416666666666667
LA LAGUNA TORREON,2023-02-22,25,19,6,0.24
LA LAGUNA TORREON,2023-02-23,17,5,12,0.705882352941177
LA LAGUNA TORREON,2023-02-24,26,10,16,0.615384615384615
LA LAGUNA TORREON,2023-02-25,35,14,21,0.6
LA LAGUNA TORREON,2023-02-26,22,12,10,0.454545454545455
LA LAGUNA TORREON,2023-02-27,26,13,13,0.5
LA LAGUNA TORREON,2023-02-28,28,11,17,0.607142857142857
LA LAGUNA TORREON,2023-03-01,33,16,17,0.515151515151515
LA LAGUNA TORREON,2023-03-02,31,12,19,0.612903225806452
LA LAGUNA TORREON,2023-03-03,36,20,16,0.444444444444444
LA LAGUNA TORREON,2023-03-04,40,18,22,0.55
LA LAGUNA TORREON,2023-03-05,17,4,13,0.764705882352941
LA LAGUNA TORREON,2023-03-06,28,17,11,0.392857142857143
LA LAGUNA TORREON,2023-03-07,40,18,22,0.55
LA LAGUNA TORREON,2023-03-08,35,18,17,0.485714285714286
LA LAGUNA TORREON,2023-03-09,32,14,18,0.5625
LA LAGUNA TORREON,2023-03-10,20,9,11,0.55
LA LAGUNA TORREON,2023-03-11,35,22,13,0.371428571428571
LA LAGUNA TORREON,2023-03-12,23,11,12,0.521739130434783
LA LAGUNA TORREON,2023-03-13,22,13,9,0.409090909090909
LA LAGUNA TORREON,2023-03-14,30,15,15,0.5
LA LAGUNA TORREON,2023-03-15,24,15,9,0.375
LA LAGUNA TORREON,2023-03-16,39,29,10,0.256410256410256
LA LAGUNA TORREON,2023-03-17,43,25,18,0.418604651162791
LA LAGUNA TORREON,2023-03-18,49,33,16,0.326530612244898
LA LAGUNA TORREON,2023-03-19,29,19,10,0.344827586206897
LA LAGUNA TORREON,2023-03-20,31,20,11,0.354838709677419
LA LAGUNA TORREON,2023-03-21,32,29,3,0.09375
LA LAGUNA TORREON,2023-03-22,25,24,1,0.04
LA LAGUNA TORREON,2023-03-23,36,33,3,0.0833333333333333
LA LAGUNA TORREON,2023-03-24,36,33,3,0.0833333333333333
LA LAGUNA TORREON,2023-03-25,48,44,4,0.0833333333333333
LA LAGUNA TORREON,2023-03-26,31,28,3,0.0967741935483871
LA LAGUNA TORREON,2023-03-27,30,28,2,0.0666666666666667
LA LAGUNA TORREON,2023-03-28,23,21,2,0.0869565217391304
LA LAGUNA TORREON,2023-03-29,24,24,0,0
LA LAGUNA TORREON,2023-03-30,21,18,3,0.142857142857143
LA LAGUNA TORREON,2023-03-31,40,38,2,0.05
LA LAGUNA TORREON,2023-04-01,57,57,0,0
LA LAGUNA TORREON,2023-04-02,27,25,2,0.0740740740740741
LA LAGUNA TORREON,2023-04-03,36,35,1,0.0277777777777778
LA LAGUNA TORREON,2023-04-04,36,32,4,0.111111111111111
LA LAGUNA TORREON,2023-04-05,32,23,9,0.28125
LA LAGUNA TORREON,2023-04-06,31,30,1,0.032258064516129
LA LAGUNA TORREON,2023-04-07,18,18,0,0
LA LAGUNA TORREON,2023-04-08,23,22,1,0.0434782608695652
LA LAGUNA TORREON,2023-04-09,15,15,0,0
LA LAGUNA TORREON,2023-04-10,37,35,2,0.0540540540540541
LA LAGUNA TORREON,2023-04-11,34,30,4,0.117647058823529
LA LAGUNA TORREON,2023-04-12,30,28,2,0.0666666666666667
LA LAGUNA TORREON,2023-04-13,26,24,2,0.0769230769230769
LA LAGUNA TORREON,2023-04-14,35,29,6,0.171428571428571
LA LAGUNA TORREON,2023-04-15,63,56,7,0.111111111111111
LA LAGUNA TORREON,2023-04-16,39,33,6,0.153846153846154
LA LAGUNA TORREON,2023-04-17,32,25,7,0.21875
LA LAGUNA TORREON,2023-04-18,35,29,6,0.171428571428571
LA LAGUNA TORREON,2023-04-19,31,26,5,0.161290322580645
LA LAGUNA TORREON,2023-04-20,25,19,6,0.24
LA LAGUNA TORREON,2023-04-21,42,34,8,0.19047619047619
LA LAGUNA TORREON,2023-04-22,47,35,12,0.25531914893617
LA LAGUNA TORREON,2023-04-23,29,25,4,0.137931034482759
LA LAGUNA TORREON,2023-04-24,41,37,4,0.0975609756097561
LA LAGUNA TORREON,2023-04-25,38,37,1,0.0263157894736842
LA LAGUNA TORREON,2023-04-26,28,24,4,0.142857142857143
LA LAGUNA TORREON,2023-04-27,44,38,6,0.136363636363636
LA LAGUNA TORREON,2023-04-28,48,46,2,0.0416666666666667
LA LAGUNA TORREON,2023-04-29,50,41,9,0.18
LA LAGUNA TORREON,2023-04-30,50,38,12,0.24
LA LAGUNA TORREON,2023-05-01,45,42,3,0.0666666666666667
LA LAGUNA TORREON,2023-05-02,43,37,6,0.13953488372093
LA LAGUNA TORREON,2023-05-03,26,22,4,0.153846153846154
LA LAGUNA TORREON,2023-05-04,28,24,4,0.142857142857143
LA LAGUNA TORREON,2023-05-05,43,36,7,0.162790697674419
LA LAGUNA TORREON,2023-05-06,45,40,5,0.111111111111111
LA LAGUNA TORREON,2023-05-07,26,20,6,0.230769230769231
LA LAGUNA TORREON,2023-05-08,34,28,6,0.176470588235294
LAS AGUILAS,2023-01-02,15,7,8,0.533333333333333
LAS AGUILAS,2023-01-03,24,16,8,0.333333333333333
LAS AGUILAS,2023-01-04,22,16,6,0.272727272727273
LAS AGUILAS,2023-01-05,25,19,6,0.24
LAS AGUILAS,2023-01-06,13,7,6,0.461538461538462
LAS AGUILAS,2023-01-07,14,9,5,0.357142857142857
LAS AGUILAS,2023-01-08,12,9,3,0.25
LAS AGUILAS,2023-01-09,27,10,17,0.62962962962963
LAS AGUILAS,2023-01-10,19,8,11,0.578947368421053
LAS AGUILAS,2023-01-11,19,4,15,0.789473684210526
LAS AGUILAS,2023-01-12,22,11,11,0.5
LAS AGUILAS,2023-01-13,23,11,12,0.521739130434783
LAS AGUILAS,2023-01-14,31,15,16,0.516129032258065
LAS AGUILAS,2023-01-15,34,16,18,0.529411764705882
LAS AGUILAS,2023-01-16,26,6,20,0.769230769230769
LAS AGUILAS,2023-01-17,16,2,14,0.875
LAS AGUILAS,2023-01-18,22,8,14,0.636363636363636
LAS AGUILAS,2023-01-19,21,6,15,0.714285714285714
LAS AGUILAS,2023-01-20,31,13,18,0.580645161290323
LAS AGUILAS,2023-01-21,23,10,13,0.565217391304348
LAS AGUILAS,2023-01-22,20,6,14,0.7
LAS AGUILAS,2023-01-23,14,8,6,0.428571428571429
LAS AGUILAS,2023-01-24,19,7,12,0.631578947368421
LAS AGUILAS,2023-01-25,22,7,15,0.681818181818182
LAS AGUILAS,2023-01-26,18,3,15,0.833333333333333
LAS AGUILAS,2023-01-27,19,6,13,0.684210526315789
LAS AGUILAS,2023-01-28,38,14,24,0.631578947368421
LAS AGUILAS,2023-01-29,31,12,19,0.612903225806452
LAS AGUILAS,2023-01-30,25,4,21,0.84
LAS AGUILAS,2023-01-31,32,10,22,0.6875
LAS AGUILAS,2023-02-01,26,8,18,0.692307692307692
LAS AGUILAS,2023-02-02,18,3,15,0.833333333333333
LAS AGUILAS,2023-02-03,24,7,17,0.708333333333333
LAS AGUILAS,2023-02-04,29,7,22,0.758620689655172
LAS AGUILAS,2023-02-05,25,7,18,0.72
LAS AGUILAS,2023-02-06,23,7,16,0.695652173913043
LAS AGUILAS,2023-02-07,21,6,15,0.714285714285714
LAS AGUILAS,2023-02-08,22,6,16,0.727272727272727
LAS AGUILAS,2023-02-09,22,7,15,0.681818181818182
LAS AGUILAS,2023-02-10,18,3,15,0.833333333333333
LAS AGUILAS,2023-02-11,31,10,21,0.67741935483871
LAS AGUILAS,2023-02-12,23,3,20,0.869565217391304
LAS AGUILAS,2023-02-13,19,2,17,0.894736842105263
LAS AGUILAS,2023-02-14,14,2,12,0.857142857142857
LAS AGUILAS,2023-02-15,12,2,10,0.833333333333333
LAS AGUILAS,2023-02-16,25,2,23,0.92
LAS AGUILAS,2023-02-17,22,5,17,0.772727272727273
LAS AGUILAS,2023-02-18,33,11,22,0.666666666666667
LAS AGUILAS,2023-02-19,17,7,10,0.588235294117647
LAS AGUILAS,2023-02-20,21,5,16,0.761904761904762
LAS AGUILAS,2023-02-21,21,9,12,0.571428571428571
LAS AGUILAS,2023-02-22,11,2,9,0.818181818181818
LAS AGUILAS,2023-02-23,14,7,7,0.5
LAS AGUILAS,2023-02-24,19,13,6,0.315789473684211
LAS AGUILAS,2023-02-25,24,5,19,0.791666666666667
LAS AGUILAS,2023-02-26,19,8,11,0.578947368421053
LAS AGUILAS,2023-02-27,19,5,14,0.736842105263158
LAS AGUILAS,2023-02-28,29,13,16,0.551724137931034
LAS AGUILAS,2023-03-01,34,10,24,0.705882352941177
LAS AGUILAS,2023-03-02,25,8,17,0.68
LAS AGUILAS,2023-03-03,19,7,12,0.631578947368421
LAS AGUILAS,2023-03-04,29,14,15,0.517241379310345
LAS AGUILAS,2023-03-05,34,14,20,0.588235294117647
LAS AGUILAS,2023-03-06,21,13,8,0.380952380952381
LAS AGUILAS,2023-03-07,21,9,12,0.571428571428571
LAS AGUILAS,2023-03-08,20,10,10,0.5
LAS AGUILAS,2023-03-09,22,11,11,0.5
LAS AGUILAS,2023-03-10,19,14,5,0.263157894736842
LAS AGUILAS,2023-03-11,28,16,12,0.428571428571429
LAS AGUILAS,2023-03-12,21,12,9,0.428571428571429
LAS AGUILAS,2023-03-13,26,17,9,0.346153846153846
LAS AGUILAS,2023-03-14,19,8,11,0.578947368421053
LAS AGUILAS,2023-03-15,26,18,8,0.307692307692308
LAS AGUILAS,2023-03-16,29,18,11,0.379310344827586
LAS AGUILAS,2023-03-17,41,21,20,0.48780487804878
LAS AGUILAS,2023-03-18,48,32,16,0.333333333333333
LAS AGUILAS,2023-03-19,34,21,13,0.382352941176471
LAS AGUILAS,2023-03-20,46,26,20,0.434782608695652
LAS AGUILAS,2023-03-21,31,19,12,0.387096774193548
LAS AGUILAS,2023-03-22,19,14,5,0.263157894736842
LAS AGUILAS,2023-03-23,19,12,7,0.368421052631579
LAS AGUILAS,2023-03-24,23,21,2,0.0869565217391304
LAS AGUILAS,2023-03-25,28,22,6,0.214285714285714
LAS AGUILAS,2023-03-26,37,34,3,0.0810810810810811
LAS AGUILAS,2023-03-27,21,19,2,0.0952380952380952
LAS AGUILAS,2023-03-28,14,14,0,0
LAS AGUILAS,2023-03-29,19,18,1,0.0526315789473684
LAS AGUILAS,2023-03-30,27,26,1,0.037037037037037
LAS AGUILAS,2023-03-31,40,39,1,0.025
LAS AGUILAS,2023-04-01,37,37,0,0
LAS AGUILAS,2023-04-02,20,20,0,0
LAS AGUILAS,2023-04-03,20,20,0,0
LAS AGUILAS,2023-04-04,30,30,0,0
LAS AGUILAS,2023-04-05,23,22,1,0.0434782608695652
LAS AGUILAS,2023-04-06,19,18,1,0.0526315789473684
LAS AGUILAS,2023-04-07,18,18,0,0
LAS AGUILAS,2023-04-08,16,16,0,0
LAS AGUILAS,2023-04-09,18,18,0,0
LAS AGUILAS,2023-04-10,22,22,0,0
LAS AGUILAS,2023-04-11,12,12,0,0
LAS AGUILAS,2023-04-12,16,14,2,0.125
LAS AGUILAS,2023-04-13,26,26,0,0
LAS AGUILAS,2023-04-14,25,25,0,0
LAS AGUILAS,2023-04-15,41,40,1,0.024390243902439
LAS AGUILAS,2023-04-16,28,27,1,0.0357142857142857
LAS AGUILAS,2023-04-17,30,30,0,0
LAS AGUILAS,2023-04-18,23,22,1,0.0434782608695652
LAS AGUILAS,2023-04-19,26,26,0,0
LAS AGUILAS,2023-04-20,15,14,1,0.0666666666666667
LAS AGUILAS,2023-04-21,26,26,0,0
LAS AGUILAS,2023-04-22,25,25,0,0
LAS AGUILAS,2023-04-23,30,28,2,0.0666666666666667
LAS AGUILAS,2023-04-24,28,27,1,0.0357142857142857
LAS AGUILAS,2023-04-25,30,28,2,0.0666666666666667
LAS AGUILAS,2023-04-26,18,17,1,0.0555555555555556
LAS AGUILAS,2023-04-27,18,16,2,0.111111111111111
LAS AGUILAS,2023-04-28,32,30,2,0.0625
LAS AGUILAS,2023-04-29,38,36,2,0.0526315789473684
LAS AGUILAS,2023-04-30,22,20,2,0.0909090909090909
LAS AGUILAS,2023-05-01,23,20,3,0.130434782608696
LAS AGUILAS,2023-05-02,27,25,2,0.0740740740740741
LAS AGUILAS,2023-05-03,23,21,2,0.0869565217391304
LAS AGUILAS,2023-05-04,27,26,1,0.037037037037037
LAS AGUILAS,2023-05-05,28,27,1,0.0357142857142857
LAS AGUILAS,2023-05-06,24,22,2,0.0833333333333333
LAS AGUILAS,2023-05-07,22,21,1,0.0454545454545455
LAS AGUILAS,2023-05-08,18,16,2,0.111111111111111
LEON CERRO GORDO,2023-01-02,29,15,14,0.482758620689655
LEON CERRO GORDO,2023-01-03,40,20,20,0.5
LEON CERRO GORDO,2023-01-04,45,20,25,0.555555555555556
LEON CERRO GORDO,2023-01-05,37,21,16,0.432432432432432
LEON CERRO GORDO,2023-01-06,39,24,15,0.384615384615385
LEON CERRO GORDO,2023-01-07,58,33,25,0.431034482758621
LEON CERRO GORDO,2023-01-08,17,9,8,0.470588235294118
LEON CERRO GORDO,2023-01-09,38,23,15,0.394736842105263
LEON CERRO GORDO,2023-01-10,43,25,18,0.418604651162791
LEON CERRO GORDO,2023-01-11,38,26,12,0.315789473684211
LEON CERRO GORDO,2023-01-12,34,15,19,0.558823529411765
LEON CERRO GORDO,2023-01-13,55,28,27,0.490909090909091
LEON CERRO GORDO,2023-01-14,43,17,26,0.604651162790698
LEON CERRO GORDO,2023-01-15,35,17,18,0.514285714285714
LEON CERRO GORDO,2023-01-16,39,22,17,0.435897435897436
LEON CERRO GORDO,2023-01-17,49,27,22,0.448979591836735
LEON CERRO GORDO,2023-01-18,35,24,11,0.314285714285714
LEON CERRO GORDO,2023-01-19,39,21,18,0.461538461538462
LEON CERRO GORDO,2023-01-20,37,21,16,0.432432432432432
LEON CERRO GORDO,2023-01-21,47,19,28,0.595744680851064
LEON CERRO GORDO,2023-01-22,32,19,13,0.40625
LEON CERRO GORDO,2023-01-23,53,28,25,0.471698113207547
LEON CERRO GORDO,2023-01-24,46,21,25,0.543478260869565
LEON CERRO GORDO,2023-01-25,51,22,29,0.568627450980392
LEON CERRO GORDO,2023-01-26,60,28,32,0.533333333333333
LEON CERRO GORDO,2023-01-27,53,28,25,0.471698113207547
LEON CERRO GORDO,2023-01-28,59,25,34,0.576271186440678
LEON CERRO GORDO,2023-01-29,22,11,11,0.5
LEON CERRO GORDO,2023-01-30,28,10,18,0.642857142857143
LEON CERRO GORDO,2023-01-31,54,23,31,0.574074074074074
LEON CERRO GORDO,2023-02-01,42,20,22,0.523809523809524
LEON CERRO GORDO,2023-02-02,38,16,22,0.578947368421053
LEON CERRO GORDO,2023-02-03,51,24,27,0.529411764705882
LEON CERRO GORDO,2023-02-04,43,16,27,0.627906976744186
LEON CERRO GORDO,2023-02-05,40,14,26,0.65
LEON CERRO GORDO,2023-02-06,44,17,27,0.613636363636364
LEON CERRO GORDO,2023-02-07,49,24,25,0.510204081632653
LEON CERRO GORDO,2023-02-08,52,25,27,0.519230769230769
LEON CERRO GORDO,2023-02-09,46,22,24,0.521739130434783
LEON CERRO GORDO,2023-02-10,46,16,30,0.652173913043478
LEON CERRO GORDO,2023-02-11,57,31,26,0.456140350877193
LEON CERRO GORDO,2023-02-12,23,13,10,0.434782608695652
LEON CERRO GORDO,2023-02-13,34,25,9,0.264705882352941
LEON CERRO GORDO,2023-02-14,35,10,25,0.714285714285714
LEON CERRO GORDO,2023-02-15,35,13,22,0.628571428571429
LEON CERRO GORDO,2023-02-16,43,21,22,0.511627906976744
LEON CERRO GORDO,2023-02-17,36,10,26,0.722222222222222
LEON CERRO GORDO,2023-02-18,57,24,33,0.578947368421053
LEON CERRO GORDO,2023-02-19,30,11,19,0.633333333333333
LEON CERRO GORDO,2023-02-20,43,15,28,0.651162790697674
LEON CERRO GORDO,2023-02-21,37,20,17,0.459459459459459
LEON CERRO GORDO,2023-02-22,32,22,10,0.3125
LEON CERRO GORDO,2023-02-23,46,37,9,0.195652173913043
LEON CERRO GORDO,2023-02-24,29,25,4,0.137931034482759
LEON CERRO GORDO,2023-02-25,65,57,8,0.123076923076923
LEON CERRO GORDO,2023-02-26,33,24,9,0.272727272727273
LEON CERRO GORDO,2023-02-27,41,35,6,0.146341463414634
LEON CERRO GORDO,2023-02-28,46,42,4,0.0869565217391304
LEON CERRO GORDO,2023-03-01,46,40,6,0.130434782608696
LEON CERRO GORDO,2023-03-02,42,32,10,0.238095238095238
LEON CERRO GORDO,2023-03-03,59,49,10,0.169491525423729
LEON CERRO GORDO,2023-03-04,48,43,5,0.104166666666667
LEON CERRO GORDO,2023-03-05,25,22,3,0.12
LEON CERRO GORDO,2023-03-06,32,30,2,0.0625
LEON CERRO GORDO,2023-03-07,43,40,3,0.0697674418604651
LEON CERRO GORDO,2023-03-08,35,33,2,0.0571428571428571
LEON CERRO GORDO,2023-03-09,39,39,0,0
LEON CERRO GORDO,2023-03-10,43,39,4,0.0930232558139535
LEON CERRO GORDO,2023-03-11,43,42,1,0.0232558139534884
LEON CERRO GORDO,2023-03-12,37,33,4,0.108108108108108
LEON CERRO GORDO,2023-03-13,41,40,1,0.024390243902439
LEON CERRO GORDO,2023-03-14,47,45,2,0.0425531914893617
LEON CERRO GORDO,2023-03-15,32,30,2,0.0625
LEON CERRO GORDO,2023-03-16,43,41,2,0.0465116279069767
LEON CERRO GORDO,2023-03-17,65,61,4,0.0615384615384615
LEON CERRO GORDO,2023-03-18,67,62,5,0.0746268656716418
LEON CERRO GORDO,2023-03-19,42,39,3,0.0714285714285714
LEON CERRO GORDO,2023-03-20,59,55,4,0.0677966101694915
LEON CERRO GORDO,2023-03-21,45,45,0,0
LEON CERRO GORDO,2023-03-22,40,40,0,0
LEON CERRO GORDO,2023-03-23,35,35,0,0
LEON CERRO GORDO,2023-03-24,33,31,2,0.0606060606060606
LEON CERRO GORDO,2023-03-25,60,56,4,0.0666666666666667
LEON CERRO GORDO,2023-03-26,29,27,2,0.0689655172413793
LEON CERRO GORDO,2023-03-27,38,38,0,0
LEON CERRO GORDO,2023-03-28,36,36,0,0
LEON CERRO GORDO,2023-03-29,49,49,0,0
LEON CERRO GORDO,2023-03-30,50,50,0,0
LEON CERRO GORDO,2023-03-31,97,95,2,0.0206185567010309
LEON CERRO GORDO,2023-04-01,59,58,1,0.0169491525423729
LEON CERRO GORDO,2023-04-02,24,24,0,0
LEON CERRO GORDO,2023-04-03,36,36,0,0
LEON CERRO GORDO,2023-04-04,52,51,1,0.0192307692307692
LEON CERRO GORDO,2023-04-05,49,42,7,0.142857142857143
LEON CERRO GORDO,2023-04-06,30,30,0,0
LEON CERRO GORDO,2023-04-07,21,21,0,0
LEON CERRO GORDO,2023-04-08,19,19,0,0
LEON CERRO GORDO,2023-04-09,13,13,0,0
LEON CERRO GORDO,2023-04-10,43,41,2,0.0465116279069767
LEON CERRO GORDO,2023-04-11,55,53,2,0.0363636363636364
LEON CERRO GORDO,2023-04-12,37,35,2,0.0540540540540541
LEON CERRO GORDO,2023-04-13,32,32,0,0
LEON CERRO GORDO,2023-04-14,45,43,2,0.0444444444444444
LEON CERRO GORDO,2023-04-15,75,72,3,0.04
LEON CERRO GORDO,2023-04-16,34,32,2,0.0588235294117647
LEON CERRO GORDO,2023-04-17,45,45,0,0
LEON CERRO GORDO,2023-04-18,48,45,3,0.0625
LEON CERRO GORDO,2023-04-19,36,30,6,0.166666666666667
LEON CERRO GORDO,2023-04-20,29,29,0,0
LEON CERRO GORDO,2023-04-21,33,33,0,0
LEON CERRO GORDO,2023-04-22,53,51,2,0.0377358490566038
LEON CERRO GORDO,2023-04-23,33,32,1,0.0303030303030303
LEON CERRO GORDO,2023-04-24,46,45,1,0.0217391304347826
LEON CERRO GORDO,2023-04-25,58,56,2,0.0344827586206897
LEON CERRO GORDO,2023-04-26,55,49,6,0.109090909090909
LEON CERRO GORDO,2023-04-27,25,22,3,0.12
LEON CERRO GORDO,2023-04-28,53,51,2,0.0377358490566038
LEON CERRO GORDO,2023-04-29,68,66,2,0.0294117647058824
LEON CERRO GORDO,2023-04-30,41,41,0,0
LEON CERRO GORDO,2023-05-01,34,33,1,0.0294117647058824
LEON CERRO GORDO,2023-05-02,46,46,0,0
LEON CERRO GORDO,2023-05-03,30,29,1,0.0333333333333333
LEON CERRO GORDO,2023-05-04,35,34,1,0.0285714285714286
LEON CERRO GORDO,2023-05-05,39,35,4,0.102564102564103
LEON CERRO GORDO,2023-05-06,55,52,3,0.0545454545454545
LEON CERRO GORDO,2023-05-07,19,16,3,0.157894736842105
LEON CERRO GORDO,2023-05-08,35,34,1,0.0285714285714286
LEON DELTA,2023-01-02,28,24,4,0.142857142857143
LEON DELTA,2023-01-03,34,23,11,0.323529411764706
LEON DELTA,2023-01-04,39,33,6,0.153846153846154
LEON DELTA,2023-01-05,32,27,5,0.15625
LEON DELTA,2023-01-06,37,33,4,0.108108108108108
LEON DELTA,2023-01-07,50,43,7,0.14
LEON DELTA,2023-01-08,24,16,8,0.333333333333333
LEON DELTA,2023-01-09,38,34,4,0.105263157894737
LEON DELTA,2023-01-10,37,33,4,0.108108108108108
LEON DELTA,2023-01-11,45,38,7,0.155555555555556
LEON DELTA,2023-01-12,39,27,12,0.307692307692308
LEON DELTA,2023-01-13,35,33,2,0.0571428571428571
LEON DELTA,2023-01-14,56,49,7,0.125
LEON DELTA,2023-01-15,43,33,10,0.232558139534884
LEON DELTA,2023-01-16,33,31,2,0.0606060606060606
LEON DELTA,2023-01-17,40,34,6,0.15
LEON DELTA,2023-01-18,36,32,4,0.111111111111111
LEON DELTA,2023-01-19,27,23,4,0.148148148148148
LEON DELTA,2023-01-20,30,25,5,0.166666666666667
LEON DELTA,2023-01-21,42,35,7,0.166666666666667
LEON DELTA,2023-01-22,28,27,1,0.0357142857142857
LEON DELTA,2023-01-23,30,25,5,0.166666666666667
LEON DELTA,2023-01-24,28,18,10,0.357142857142857
LEON DELTA,2023-01-25,41,30,11,0.268292682926829
LEON DELTA,2023-01-26,32,29,3,0.09375
LEON DELTA,2023-01-27,63,49,14,0.222222222222222
LEON DELTA,2023-01-28,67,57,10,0.149253731343284
LEON DELTA,2023-01-29,30,22,8,0.266666666666667
LEON DELTA,2023-01-30,49,35,14,0.285714285714286
LEON DELTA,2023-01-31,39,28,11,0.282051282051282
LEON DELTA,2023-02-01,31,28,3,0.0967741935483871
LEON DELTA,2023-02-02,34,22,12,0.352941176470588
LEON DELTA,2023-02-03,46,40,6,0.130434782608696
LEON DELTA,2023-02-04,47,39,8,0.170212765957447
LEON DELTA,2023-02-05,38,29,9,0.236842105263158
LEON DELTA,2023-02-06,44,37,7,0.159090909090909
LEON DELTA,2023-02-07,39,31,8,0.205128205128205
LEON DELTA,2023-02-08,35,28,7,0.2
LEON DELTA,2023-02-09,34,24,10,0.294117647058824
LEON DELTA,2023-02-10,46,35,11,0.239130434782609
LEON DELTA,2023-02-11,55,37,18,0.327272727272727
LEON DELTA,2023-02-12,26,22,4,0.153846153846154
LEON DELTA,2023-02-13,33,22,11,0.333333333333333
LEON DELTA,2023-02-14,44,33,11,0.25
LEON DELTA,2023-02-15,41,32,9,0.219512195121951
LEON DELTA,2023-02-16,30,16,14,0.466666666666667
LEON DELTA,2023-02-17,32,20,12,0.375
LEON DELTA,2023-02-18,49,33,16,0.326530612244898
LEON DELTA,2023-02-19,30,24,6,0.2
LEON DELTA,2023-02-20,32,22,10,0.3125
LEON DELTA,2023-02-21,50,38,12,0.24
LEON DELTA,2023-02-22,43,35,8,0.186046511627907
LEON DELTA,2023-02-23,35,25,10,0.285714285714286
LEON DELTA,2023-02-24,44,38,6,0.136363636363636
LEON DELTA,2023-02-25,44,41,3,0.0681818181818182
LEON DELTA,2023-02-26,22,16,6,0.272727272727273
LEON DELTA,2023-02-27,44,39,5,0.113636363636364
LEON DELTA,2023-02-28,37,31,6,0.162162162162162
LEON DELTA,2023-03-01,30,26,4,0.133333333333333
LEON DELTA,2023-03-02,31,26,5,0.161290322580645
LEON DELTA,2023-03-03,41,30,11,0.268292682926829
LEON DELTA,2023-03-04,45,34,11,0.244444444444444
LEON DELTA,2023-03-05,30,23,7,0.233333333333333
LEON DELTA,2023-03-06,25,20,5,0.2
LEON DELTA,2023-03-07,33,24,9,0.272727272727273
LEON DELTA,2023-03-08,48,43,5,0.104166666666667
LEON DELTA,2023-03-09,46,37,9,0.195652173913043
LEON DELTA,2023-03-10,26,19,7,0.269230769230769
LEON DELTA,2023-03-11,47,37,10,0.212765957446809
LEON DELTA,2023-03-12,27,22,5,0.185185185185185
LEON DELTA,2023-03-13,25,21,4,0.16
LEON DELTA,2023-03-14,28,25,3,0.107142857142857
LEON DELTA,2023-03-15,41,36,5,0.121951219512195
LEON DELTA,2023-03-16,38,38,0,0
LEON DELTA,2023-03-17,42,32,10,0.238095238095238
LEON DELTA,2023-03-18,85,74,11,0.129411764705882
LEON DELTA,2023-03-19,36,31,5,0.138888888888889
LEON DELTA,2023-03-20,59,52,7,0.11864406779661
LEON DELTA,2023-03-21,31,29,2,0.0645161290322581
LEON DELTA,2023-03-22,38,37,1,0.0263157894736842
LEON DELTA,2023-03-23,50,48,2,0.04
LEON DELTA,2023-03-24,40,40,0,0
LEON DELTA,2023-03-25,56,56,0,0
LEON DELTA,2023-03-26,31,31,0,0
LEON DELTA,2023-03-27,34,34,0,0
LEON DELTA,2023-03-28,40,39,1,0.025
LEON DELTA,2023-03-29,38,38,0,0
LEON DELTA,2023-03-30,46,46,0,0
LEON DELTA,2023-03-31,52,52,0,0
LEON DELTA,2023-04-01,55,53,2,0.0363636363636364
LEON DELTA,2023-04-02,32,32,0,0
LEON DELTA,2023-04-03,52,52,0,0
LEON DELTA,2023-04-04,37,37,0,0
LEON DELTA,2023-04-05,40,39,1,0.025
LEON DELTA,2023-04-06,41,40,1,0.024390243902439
LEON DELTA,2023-04-07,38,36,2,0.0526315789473684
LEON DELTA,2023-04-08,24,24,0,0
LEON DELTA,2023-04-09,18,18,0,0
LEON DELTA,2023-04-10,36,35,1,0.0277777777777778
LEON DELTA,2023-04-11,27,26,1,0.037037037037037
LEON DELTA,2023-04-12,36,35,1,0.0277777777777778
LEON DELTA,2023-04-13,28,28,0,0
LEON DELTA,2023-04-14,41,41,0,0
LEON DELTA,2023-04-15,57,56,1,0.0175438596491228
LEON DELTA,2023-04-16,40,38,2,0.05
LEON DELTA,2023-04-17,37,37,0,0
LEON DELTA,2023-04-18,38,33,5,0.131578947368421
LEON DELTA,2023-04-19,48,48,0,0
LEON DELTA,2023-04-20,39,34,5,0.128205128205128
LEON DELTA,2023-04-21,40,37,3,0.075
LEON DELTA,2023-04-22,48,46,2,0.0416666666666667
LEON DELTA,2023-04-23,35,34,1,0.0285714285714286
LEON DELTA,2023-04-24,29,28,1,0.0344827586206897
LEON DELTA,2023-04-25,46,44,2,0.0434782608695652
LEON DELTA,2023-04-26,48,48,0,0
LEON DELTA,2023-04-27,21,19,2,0.0952380952380952
LEON DELTA,2023-04-28,41,40,1,0.024390243902439
LEON DELTA,2023-04-29,64,60,4,0.0625
LEON DELTA,2023-04-30,46,39,7,0.152173913043478
LEON DELTA,2023-05-01,41,35,6,0.146341463414634
LEON DELTA,2023-05-02,46,40,6,0.130434782608696
LEON DELTA,2023-05-03,35,32,3,0.0857142857142857
LEON DELTA,2023-05-04,41,37,4,0.0975609756097561
LEON DELTA,2023-05-05,33,29,4,0.121212121212121
LEON DELTA,2023-05-06,44,42,2,0.0454545454545455
LEON DELTA,2023-05-07,30,30,0,0
LEON DELTA,2023-05-08,27,25,2,0.0740740740740741
LOS REYES,2023-01-02,29,19,10,0.344827586206897
LOS REYES,2023-01-03,30,21,9,0.3
LOS REYES,2023-01-04,46,28,18,0.391304347826087
LOS REYES,2023-01-05,38,19,19,0.5
LOS REYES,2023-01-06,38,23,15,0.394736842105263
LOS REYES,2023-01-07,59,42,17,0.288135593220339
LOS REYES,2023-01-08,48,36,12,0.25
LOS REYES,2023-01-09,41,25,16,0.390243902439024
LOS REYES,2023-01-10,47,36,11,0.234042553191489
LOS REYES,2023-01-11,44,31,13,0.295454545454545
LOS REYES,2023-01-12,38,18,20,0.526315789473684
LOS REYES,2023-01-13,42,27,15,0.357142857142857
LOS REYES,2023-01-14,41,36,5,0.121951219512195
LOS REYES,2023-01-15,34,27,7,0.205882352941176
LOS REYES,2023-01-16,44,35,9,0.204545454545455
LOS REYES,2023-01-17,41,29,12,0.292682926829268
LOS REYES,2023-01-18,42,27,15,0.357142857142857
LOS REYES,2023-01-19,32,21,11,0.34375
LOS REYES,2023-01-20,41,29,12,0.292682926829268
LOS REYES,2023-01-21,45,27,18,0.4
LOS REYES,2023-01-22,38,22,16,0.421052631578947
LOS REYES,2023-01-23,44,35,9,0.204545454545455
LOS REYES,2023-01-24,40,29,11,0.275
LOS REYES,2023-01-25,49,30,19,0.387755102040816
LOS REYES,2023-01-26,36,23,13,0.361111111111111
LOS REYES,2023-01-27,46,32,14,0.304347826086957
LOS REYES,2023-01-28,41,26,15,0.365853658536585
LOS REYES,2023-01-29,49,30,19,0.387755102040816
LOS REYES,2023-01-30,50,37,13,0.26
LOS REYES,2023-01-31,51,28,23,0.450980392156863
LOS REYES,2023-02-01,41,23,18,0.439024390243902
LOS REYES,2023-02-02,40,29,11,0.275
LOS REYES,2023-02-03,33,25,8,0.242424242424242
LOS REYES,2023-02-04,41,23,18,0.439024390243902
LOS REYES,2023-02-05,53,33,20,0.377358490566038
LOS REYES,2023-02-06,46,30,16,0.347826086956522
LOS REYES,2023-02-07,35,15,20,0.571428571428571
LOS REYES,2023-02-08,30,12,18,0.6
LOS REYES,2023-02-09,31,12,19,0.612903225806452
LOS REYES,2023-02-10,44,20,24,0.545454545454545
LOS REYES,2023-02-11,44,23,21,0.477272727272727
LOS REYES,2023-02-12,44,17,27,0.613636363636364
LOS REYES,2023-02-13,35,17,18,0.514285714285714
LOS REYES,2023-02-14,30,16,14,0.466666666666667
LOS REYES,2023-02-15,41,15,26,0.634146341463415
LOS REYES,2023-02-16,38,12,26,0.684210526315789
LOS REYES,2023-02-17,40,22,18,0.45
LOS REYES,2023-02-18,55,26,29,0.527272727272727
LOS REYES,2023-02-19,55,26,29,0.527272727272727
LOS REYES,2023-02-20,59,29,30,0.508474576271186
LOS REYES,2023-02-21,45,30,15,0.333333333333333
LOS REYES,2023-02-22,36,30,6,0.166666666666667
LOS REYES,2023-02-23,43,35,8,0.186046511627907
LOS REYES,2023-02-24,33,28,5,0.151515151515152
LOS REYES,2023-02-25,45,36,9,0.2
LOS REYES,2023-02-26,60,49,11,0.183333333333333
LOS REYES,2023-02-27,47,34,13,0.276595744680851
LOS REYES,2023-02-28,39,31,8,0.205128205128205
LOS REYES,2023-03-01,38,30,8,0.210526315789474
LOS REYES,2023-03-02,49,46,3,0.0612244897959184
LOS REYES,2023-03-03,46,40,6,0.130434782608696
LOS REYES,2023-03-04,43,38,5,0.116279069767442
LOS REYES,2023-03-05,54,43,11,0.203703703703704
LOS REYES,2023-03-06,42,41,1,0.0238095238095238
LOS REYES,2023-03-07,51,44,7,0.137254901960784
LOS REYES,2023-03-08,63,59,4,0.0634920634920635
LOS REYES,2023-03-09,49,48,1,0.0204081632653061
LOS REYES,2023-03-10,43,40,3,0.0697674418604651
LOS REYES,2023-03-11,56,56,0,0
LOS REYES,2023-03-12,47,45,2,0.0425531914893617
LOS REYES,2023-03-13,66,66,0,0
LOS REYES,2023-03-14,45,45,0,0
LOS REYES,2023-03-15,40,40,0,0
LOS REYES,2023-03-16,53,53,0,0
LOS REYES,2023-03-17,68,66,2,0.0294117647058824
LOS REYES,2023-03-18,60,60,0,0
LOS REYES,2023-03-19,67,67,0,0
LOS REYES,2023-03-20,83,83,0,0
LOS REYES,2023-03-21,81,81,0,0
LOS REYES,2023-03-22,49,49,0,0
LOS REYES,2023-03-23,38,38,0,0
LOS REYES,2023-03-24,49,49,0,0
LOS REYES,2023-03-25,50,50,0,0
LOS REYES,2023-03-26,75,75,0,0
LOS REYES,2023-03-27,54,53,1,0.0185185185185185
LOS REYES,2023-03-28,40,40,0,0
LOS REYES,2023-03-29,41,41,0,0
LOS REYES,2023-03-30,58,58,0,0
LOS REYES,2023-03-31,71,71,0,0
LOS REYES,2023-04-01,73,72,1,0.0136986301369863
LOS REYES,2023-04-02,74,74,0,0
LOS REYES,2023-04-03,71,71,0,0
LOS REYES,2023-04-04,38,38,0,0
LOS REYES,2023-04-05,59,59,0,0
LOS REYES,2023-04-06,46,46,0,0
LOS REYES,2023-04-07,42,42,0,0
LOS REYES,2023-04-08,44,44,0,0
LOS REYES,2023-04-09,32,32,0,0
LOS REYES,2023-04-10,37,37,0,0
LOS REYES,2023-04-11,44,44,0,0
LOS REYES,2023-04-12,49,49,0,0
LOS REYES,2023-04-13,38,38,0,0
LOS REYES,2023-04-14,57,57,0,0
LOS REYES,2023-04-15,67,67,0,0
LOS REYES,2023-04-16,82,82,0,0
LOS REYES,2023-04-17,58,58,0,0
LOS REYES,2023-04-18,56,56,0,0
LOS REYES,2023-04-19,72,72,0,0
LOS REYES,2023-04-20,44,44,0,0
LOS REYES,2023-04-21,35,35,0,0
LOS REYES,2023-04-22,37,37,0,0
LOS REYES,2023-04-23,61,61,0,0
LOS REYES,2023-04-24,44,44,0,0
LOS REYES,2023-04-25,73,73,0,0
LOS REYES,2023-04-26,47,47,0,0
LOS REYES,2023-04-27,54,54,0,0
LOS REYES,2023-04-28,55,55,0,0
LOS REYES,2023-04-29,62,62,0,0
LOS REYES,2023-04-30,40,40,0,0
LOS REYES,2023-05-01,51,51,0,0
LOS REYES,2023-05-02,47,47,0,0
LOS REYES,2023-05-03,48,48,0,0
LOS REYES,2023-05-04,41,41,0,0
LOS REYES,2023-05-05,49,49,0,0
LOS REYES,2023-05-06,48,48,0,0
LOS REYES,2023-05-07,48,48,0,0
LOS REYES,2023-05-08,38,38,0,0
MATAMOROS,2023-01-02,56,56,0,0
MATAMOROS,2023-01-03,55,55,0,0
MATAMOROS,2023-01-04,52,52,0,0
MATAMOROS,2023-01-05,43,43,0,0
MATAMOROS,2023-01-06,42,42,0,0
MATAMOROS,2023-01-07,51,51,0,0
MATAMOROS,2023-01-08,31,31,0,0
MATAMOROS,2023-01-09,47,47,0,0
MATAMOROS,2023-01-10,39,39,0,0
MATAMOROS,2023-01-11,40,40,0,0
MATAMOROS,2023-01-12,43,43,0,0
MATAMOROS,2023-01-13,60,53,7,0.116666666666667
MATAMOROS,2023-01-14,52,50,2,0.0384615384615385
MATAMOROS,2023-01-15,51,46,5,0.0980392156862745
MATAMOROS,2023-01-16,46,43,3,0.0652173913043478
MATAMOROS,2023-01-17,51,46,5,0.0980392156862745
MATAMOROS,2023-01-18,41,36,5,0.121951219512195
MATAMOROS,2023-01-19,51,48,3,0.0588235294117647
MATAMOROS,2023-01-20,50,48,2,0.04
MATAMOROS,2023-01-21,50,50,0,0
MATAMOROS,2023-01-22,29,28,1,0.0344827586206897
MATAMOROS,2023-01-23,47,45,2,0.0425531914893617
MATAMOROS,2023-01-24,39,38,1,0.0256410256410256
MATAMOROS,2023-01-25,39,37,2,0.0512820512820513
MATAMOROS,2023-01-26,37,36,1,0.027027027027027
MATAMOROS,2023-01-27,44,44,0,0
MATAMOROS,2023-01-28,57,57,0,0
MATAMOROS,2023-01-29,42,41,1,0.0238095238095238
MATAMOROS,2023-01-30,45,44,1,0.0222222222222222
MATAMOROS,2023-01-31,29,28,1,0.0344827586206897
MATAMOROS,2023-02-01,42,40,2,0.0476190476190476
MATAMOROS,2023-02-02,31,31,0,0
MATAMOROS,2023-02-03,36,36,0,0
MATAMOROS,2023-02-04,62,61,1,0.0161290322580645
MATAMOROS,2023-02-05,33,33,0,0
MATAMOROS,2023-02-06,35,34,1,0.0285714285714286
MATAMOROS,2023-02-07,50,49,1,0.02
MATAMOROS,2023-02-08,39,38,1,0.0256410256410256
MATAMOROS,2023-02-09,35,35,0,0
MATAMOROS,2023-02-10,41,41,0,0
MATAMOROS,2023-02-11,31,31,0,0
MATAMOROS,2023-02-12,25,25,0,0
MATAMOROS,2023-02-13,41,40,1,0.024390243902439
MATAMOROS,2023-02-14,40,36,4,0.1
MATAMOROS,2023-02-15,43,43,0,0
MATAMOROS,2023-02-16,33,33,0,0
MATAMOROS,2023-02-17,29,29,0,0
MATAMOROS,2023-02-18,57,57,0,0
MATAMOROS,2023-02-19,31,29,2,0.0645161290322581
MATAMOROS,2023-02-20,52,50,2,0.0384615384615385
MATAMOROS,2023-02-21,38,38,0,0
MATAMOROS,2023-02-22,39,38,1,0.0256410256410256
MATAMOROS,2023-02-23,40,39,1,0.025
MATAMOROS,2023-02-24,39,38,1,0.0256410256410256
MATAMOROS,2023-02-25,42,41,1,0.0238095238095238
MATAMOROS,2023-02-26,26,26,0,0
MATAMOROS,2023-02-27,37,37,0,0
MATAMOROS,2023-02-28,46,46,0,0
MATAMOROS,2023-03-01,48,47,1,0.0208333333333333
MATAMOROS,2023-03-02,47,47,0,0
MATAMOROS,2023-03-03,48,48,0,0
MATAMOROS,2023-03-04,66,63,3,0.0454545454545455
MATAMOROS,2023-03-05,32,31,1,0.03125
MATAMOROS,2023-03-06,42,42,0,0
MATAMOROS,2023-03-07,44,41,3,0.0681818181818182
MATAMOROS,2023-03-08,62,59,3,0.0483870967741935
MATAMOROS,2023-03-09,54,54,0,0
MATAMOROS,2023-03-10,55,55,0,0
MATAMOROS,2023-03-11,49,48,1,0.0204081632653061
MATAMOROS,2023-03-12,49,49,0,0
MATAMOROS,2023-03-13,41,41,0,0
MATAMOROS,2023-03-14,56,56,0,0
MATAMOROS,2023-03-15,55,55,0,0
MATAMOROS,2023-03-16,53,52,1,0.0188679245283019
MATAMOROS,2023-03-17,77,77,0,0
MATAMOROS,2023-03-18,79,79,0,0
MATAMOROS,2023-03-19,56,56,0,0
MATAMOROS,2023-03-20,63,63,0,0
MATAMOROS,2023-03-21,52,51,1,0.0192307692307692
MATAMOROS,2023-03-22,46,46,0,0
MATAMOROS,2023-03-23,45,45,0,0
MATAMOROS,2023-03-24,59,59,0,0
MATAMOROS,2023-03-25,58,58,0,0
MATAMOROS,2023-03-26,46,45,1,0.0217391304347826
MATAMOROS,2023-03-27,36,36,0,0
MATAMOROS,2023-03-28,22,22,0,0
MATAMOROS,2023-03-29,42,42,0,0
MATAMOROS,2023-03-30,55,55,0,0
MATAMOROS,2023-03-31,73,73,0,0
MATAMOROS,2023-04-01,58,58,0,0
MATAMOROS,2023-04-02,29,29,0,0
MATAMOROS,2023-04-03,58,58,0,0
MATAMOROS,2023-04-04,52,52,0,0
MATAMOROS,2023-04-05,44,44,0,0
MATAMOROS,2023-04-06,53,53,0,0
MATAMOROS,2023-04-07,53,53,0,0
MATAMOROS,2023-04-08,50,50,0,0
MATAMOROS,2023-04-09,20,20,0,0
MATAMOROS,2023-04-10,46,45,1,0.0217391304347826
MATAMOROS,2023-04-11,47,47,0,0
MATAMOROS,2023-04-12,46,46,0,0
MATAMOROS,2023-04-13,45,45,0,0
MATAMOROS,2023-04-14,56,56,0,0
MATAMOROS,2023-04-15,61,61,0,0
MATAMOROS,2023-04-16,47,47,0,0
MATAMOROS,2023-04-17,69,69,0,0
MATAMOROS,2023-04-18,84,84,0,0
MATAMOROS,2023-04-19,53,53,0,0
MATAMOROS,2023-04-20,49,49,0,0
MATAMOROS,2023-04-21,66,66,0,0
MATAMOROS,2023-04-22,59,59,0,0
MATAMOROS,2023-04-23,41,41,0,0
MATAMOROS,2023-04-24,48,47,1,0.0208333333333333
MATAMOROS,2023-04-25,61,61,0,0
MATAMOROS,2023-04-26,50,50,0,0
MATAMOROS,2023-04-27,48,48,0,0
MATAMOROS,2023-04-28,62,62,0,0
MATAMOROS,2023-04-29,38,37,1,0.0263157894736842
MATAMOROS,2023-04-30,42,42,0,0
MATAMOROS,2023-05-01,39,39,0,0
MATAMOROS,2023-05-02,31,31,0,0
MATAMOROS,2023-05-03,30,30,0,0
MATAMOROS,2023-05-04,53,53,0,0
MATAMOROS,2023-05-05,49,49,0,0
MATAMOROS,2023-05-06,36,36,0,0
MATAMOROS,2023-05-07,70,70,0,0
MATAMOROS,2023-05-08,74,73,1,0.0135135135135135
MAZATLAN,2023-01-02,27,17,10,0.37037037037037
MAZATLAN,2023-01-03,22,14,8,0.363636363636364
MAZATLAN,2023-01-04,20,14,6,0.3
MAZATLAN,2023-01-05,4,3,1,0.25
MAZATLAN,2023-01-06,30,17,13,0.433333333333333
MAZATLAN,2023-01-07,31,24,7,0.225806451612903
MAZATLAN,2023-01-08,11,6,5,0.454545454545455
MAZATLAN,2023-01-09,26,17,9,0.346153846153846
MAZATLAN,2023-01-10,31,22,9,0.290322580645161
MAZATLAN,2023-01-11,21,14,7,0.333333333333333
MAZATLAN,2023-01-12,22,18,4,0.181818181818182
MAZATLAN,2023-01-13,20,11,9,0.45
MAZATLAN,2023-01-14,31,22,9,0.290322580645161
MAZATLAN,2023-01-15,14,11,3,0.214285714285714
MAZATLAN,2023-01-16,24,22,2,0.0833333333333333
MAZATLAN,2023-01-17,26,21,5,0.192307692307692
MAZATLAN,2023-01-18,20,14,6,0.3
MAZATLAN,2023-01-19,20,16,4,0.2
MAZATLAN,2023-01-20,22,16,6,0.272727272727273
MAZATLAN,2023-01-21,25,11,14,0.56
MAZATLAN,2023-01-22,17,7,10,0.588235294117647
MAZATLAN,2023-01-23,20,12,8,0.4
MAZATLAN,2023-01-24,18,12,6,0.333333333333333
MAZATLAN,2023-01-25,25,20,5,0.2
MAZATLAN,2023-01-26,13,10,3,0.230769230769231
MAZATLAN,2023-01-27,26,15,11,0.423076923076923
MAZATLAN,2023-01-28,21,17,4,0.19047619047619
MAZATLAN,2023-01-29,17,10,7,0.411764705882353
MAZATLAN,2023-01-30,27,19,8,0.296296296296296
MAZATLAN,2023-01-31,29,21,8,0.275862068965517
MAZATLAN,2023-02-01,20,15,5,0.25
MAZATLAN,2023-02-02,25,19,6,0.24
MAZATLAN,2023-02-03,20,14,6,0.3
MAZATLAN,2023-02-04,22,15,7,0.318181818181818
MAZATLAN,2023-02-05,9,6,3,0.333333333333333
MAZATLAN,2023-02-06,15,15,0,0
MAZATLAN,2023-02-07,19,12,7,0.368421052631579
MAZATLAN,2023-02-08,27,22,5,0.185185185185185
MAZATLAN,2023-02-09,19,14,5,0.263157894736842
MAZATLAN,2023-02-10,21,15,6,0.285714285714286
MAZATLAN,2023-02-11,27,17,10,0.37037037037037
MAZATLAN,2023-02-12,12,9,3,0.25
MAZATLAN,2023-02-13,14,10,4,0.285714285714286
MAZATLAN,2023-02-14,18,8,10,0.555555555555556
MAZATLAN,2023-02-15,29,23,6,0.206896551724138
MAZATLAN,2023-02-16,21,13,8,0.380952380952381
MAZATLAN,2023-02-17,21,18,3,0.142857142857143
MAZATLAN,2023-02-18,26,19,7,0.269230769230769
MAZATLAN,2023-02-19,4,3,1,0.25
MAZATLAN,2023-02-20,18,12,6,0.333333333333333
MAZATLAN,2023-02-21,17,13,4,0.235294117647059
MAZATLAN,2023-02-22,20,14,6,0.3
MAZATLAN,2023-02-23,19,9,10,0.526315789473684
MAZATLAN,2023-02-24,23,14,9,0.391304347826087
MAZATLAN,2023-02-25,20,14,6,0.3
MAZATLAN,2023-02-26,16,12,4,0.25
MAZATLAN,2023-02-27,31,21,10,0.32258064516129
MAZATLAN,2023-02-28,31,16,15,0.483870967741935
MAZATLAN,2023-03-01,24,18,6,0.25
MAZATLAN,2023-03-02,28,17,11,0.392857142857143
MAZATLAN,2023-03-03,21,17,4,0.19047619047619
MAZATLAN,2023-03-04,24,18,6,0.25
MAZATLAN,2023-03-05,18,11,7,0.388888888888889
MAZATLAN,2023-03-06,27,16,11,0.407407407407407
MAZATLAN,2023-03-07,23,18,5,0.217391304347826
MAZATLAN,2023-03-08,21,10,11,0.523809523809524
MAZATLAN,2023-03-09,20,18,2,0.1
MAZATLAN,2023-03-10,24,23,1,0.0416666666666667
MAZATLAN,2023-03-11,31,22,9,0.290322580645161
MAZATLAN,2023-03-12,10,6,4,0.4
MAZATLAN,2023-03-13,19,15,4,0.210526315789474
MAZATLAN,2023-03-14,32,31,1,0.03125
MAZATLAN,2023-03-15,18,17,1,0.0555555555555556
MAZATLAN,2023-03-16,25,22,3,0.12
MAZATLAN,2023-03-17,34,30,4,0.117647058823529
MAZATLAN,2023-03-18,29,25,4,0.137931034482759
MAZATLAN,2023-03-19,24,21,3,0.125
MAZATLAN,2023-03-20,37,33,4,0.108108108108108
MAZATLAN,2023-03-21,31,27,4,0.129032258064516
MAZATLAN,2023-03-22,29,26,3,0.103448275862069
MAZATLAN,2023-03-23,18,15,3,0.166666666666667
MAZATLAN,2023-03-24,26,22,4,0.153846153846154
MAZATLAN,2023-03-25,29,27,2,0.0689655172413793
MAZATLAN,2023-03-26,27,24,3,0.111111111111111
MAZATLAN,2023-03-27,12,11,1,0.0833333333333333
MAZATLAN,2023-03-28,29,22,7,0.241379310344828
MAZATLAN,2023-03-29,37,28,9,0.243243243243243
MAZATLAN,2023-03-30,32,29,3,0.09375
MAZATLAN,2023-03-31,31,23,8,0.258064516129032
MAZATLAN,2023-04-01,33,31,2,0.0606060606060606
MAZATLAN,2023-04-02,16,15,1,0.0625
MAZATLAN,2023-04-03,32,29,3,0.09375
MAZATLAN,2023-04-04,27,25,2,0.0740740740740741
MAZATLAN,2023-04-05,23,19,4,0.173913043478261
MAZATLAN,2023-04-06,21,21,0,0
MAZATLAN,2023-04-07,14,12,2,0.142857142857143
MAZATLAN,2023-04-08,13,13,0,0
MAZATLAN,2023-04-09,9,9,0,0
MAZATLAN,2023-04-10,22,17,5,0.227272727272727
MAZATLAN,2023-04-11,20,19,1,0.05
MAZATLAN,2023-04-12,18,15,3,0.166666666666667
MAZATLAN,2023-04-13,21,19,2,0.0952380952380952
MAZATLAN,2023-04-14,31,26,5,0.161290322580645
MAZATLAN,2023-04-15,36,33,3,0.0833333333333333
MAZATLAN,2023-04-16,25,24,1,0.04
MAZATLAN,2023-04-17,25,22,3,0.12
MAZATLAN,2023-04-18,27,26,1,0.037037037037037
MAZATLAN,2023-04-19,27,25,2,0.0740740740740741
MAZATLAN,2023-04-20,22,20,2,0.0909090909090909
MAZATLAN,2023-04-21,22,19,3,0.136363636363636
MAZATLAN,2023-04-22,25,23,2,0.08
MAZATLAN,2023-04-23,20,18,2,0.1
MAZATLAN,2023-04-24,20,20,0,0
MAZATLAN,2023-04-25,27,24,3,0.111111111111111
MAZATLAN,2023-04-26,25,25,0,0
MAZATLAN,2023-04-27,16,15,1,0.0625
MAZATLAN,2023-04-28,30,30,0,0
MAZATLAN,2023-04-29,28,27,1,0.0357142857142857
MAZATLAN,2023-04-30,26,24,2,0.0769230769230769
MAZATLAN,2023-05-01,19,17,2,0.105263157894737
MAZATLAN,2023-05-02,15,15,0,0
MAZATLAN,2023-05-03,25,25,0,0
MAZATLAN,2023-05-04,25,24,1,0.04
MAZATLAN,2023-05-05,24,23,1,0.0416666666666667
MAZATLAN,2023-05-06,24,22,2,0.0833333333333333
MAZATLAN,2023-05-07,14,14,0,0
MAZATLAN,2023-05-08,15,14,1,0.0666666666666667
MERIDA ORIENTE,2023-01-02,11,4,7,0.636363636363636
MERIDA ORIENTE,2023-01-03,8,1,7,0.875
MERIDA ORIENTE,2023-01-04,17,5,12,0.705882352941177
MERIDA ORIENTE,2023-01-05,25,11,14,0.56
MERIDA ORIENTE,2023-01-06,20,7,13,0.65
MERIDA ORIENTE,2023-01-07,19,8,11,0.578947368421053
MERIDA ORIENTE,2023-01-08,9,5,4,0.444444444444444
MERIDA ORIENTE,2023-01-09,21,10,11,0.523809523809524
MERIDA ORIENTE,2023-01-10,26,11,15,0.576923076923077
MERIDA ORIENTE,2023-01-11,27,11,16,0.592592592592593
MERIDA ORIENTE,2023-01-12,33,14,19,0.575757575757576
MERIDA ORIENTE,2023-01-13,14,6,8,0.571428571428571
MERIDA ORIENTE,2023-01-14,19,8,11,0.578947368421053
MERIDA ORIENTE,2023-01-15,10,5,5,0.5
MERIDA ORIENTE,2023-01-16,13,1,12,0.923076923076923
MERIDA ORIENTE,2023-01-17,16,8,8,0.5
MERIDA ORIENTE,2023-01-18,21,8,13,0.619047619047619
MERIDA ORIENTE,2023-01-19,17,9,8,0.470588235294118
MERIDA ORIENTE,2023-01-20,19,10,9,0.473684210526316
MERIDA ORIENTE,2023-01-21,15,8,7,0.466666666666667
MERIDA ORIENTE,2023-01-22,18,13,5,0.277777777777778
MERIDA ORIENTE,2023-01-23,22,6,16,0.727272727272727
MERIDA ORIENTE,2023-01-24,20,6,14,0.7
MERIDA ORIENTE,2023-01-25,19,10,9,0.473684210526316
MERIDA ORIENTE,2023-01-26,20,5,15,0.75
MERIDA ORIENTE,2023-01-27,19,4,15,0.789473684210526
MERIDA ORIENTE,2023-01-28,23,12,11,0.478260869565217
MERIDA ORIENTE,2023-01-29,18,12,6,0.333333333333333
MERIDA ORIENTE,2023-01-30,24,11,13,0.541666666666667
MERIDA ORIENTE,2023-01-31,33,20,13,0.393939393939394
MERIDA ORIENTE,2023-02-01,45,29,16,0.355555555555556
MERIDA ORIENTE,2023-02-02,45,30,15,0.333333333333333
MERIDA ORIENTE,2023-02-03,34,25,9,0.264705882352941
MERIDA ORIENTE,2023-02-04,50,31,19,0.38
MERIDA ORIENTE,2023-02-05,25,15,10,0.4
MERIDA ORIENTE,2023-02-06,36,27,9,0.25
MERIDA ORIENTE,2023-02-07,32,21,11,0.34375
MERIDA ORIENTE,2023-02-08,32,23,9,0.28125
MERIDA ORIENTE,2023-02-09,18,15,3,0.166666666666667
MERIDA ORIENTE,2023-02-10,34,20,14,0.411764705882353
MERIDA ORIENTE,2023-02-11,31,23,8,0.258064516129032
MERIDA ORIENTE,2023-02-12,29,19,10,0.344827586206897
MERIDA ORIENTE,2023-02-13,26,11,15,0.576923076923077
MERIDA ORIENTE,2023-02-14,28,19,9,0.321428571428571
MERIDA ORIENTE,2023-02-15,32,23,9,0.28125
MERIDA ORIENTE,2023-02-16,31,23,8,0.258064516129032
MERIDA ORIENTE,2023-02-17,32,16,16,0.5
MERIDA ORIENTE,2023-02-18,27,18,9,0.333333333333333
MERIDA ORIENTE,2023-02-19,22,14,8,0.363636363636364
MERIDA ORIENTE,2023-02-20,24,16,8,0.333333333333333
MERIDA ORIENTE,2023-02-21,30,22,8,0.266666666666667
MERIDA ORIENTE,2023-02-22,17,12,5,0.294117647058824
MERIDA ORIENTE,2023-02-23,22,17,5,0.227272727272727
MERIDA ORIENTE,2023-02-24,29,23,6,0.206896551724138
MERIDA ORIENTE,2023-02-25,35,27,8,0.228571428571429
MERIDA ORIENTE,2023-02-26,25,18,7,0.28
MERIDA ORIENTE,2023-02-27,19,13,6,0.315789473684211
MERIDA ORIENTE,2023-02-28,27,16,11,0.407407407407407
MERIDA ORIENTE,2023-03-01,27,17,10,0.37037037037037
MERIDA ORIENTE,2023-03-02,34,27,7,0.205882352941176
MERIDA ORIENTE,2023-03-03,28,22,6,0.214285714285714
MERIDA ORIENTE,2023-03-04,30,22,8,0.266666666666667
MERIDA ORIENTE,2023-03-05,31,21,10,0.32258064516129
MERIDA ORIENTE,2023-03-06,31,21,10,0.32258064516129
MERIDA ORIENTE,2023-03-07,32,22,10,0.3125
MERIDA ORIENTE,2023-03-08,36,27,9,0.25
MERIDA ORIENTE,2023-03-09,33,25,8,0.242424242424242
MERIDA ORIENTE,2023-03-10,33,26,7,0.212121212121212
MERIDA ORIENTE,2023-03-11,23,14,9,0.391304347826087
MERIDA ORIENTE,2023-03-12,21,15,6,0.285714285714286
MERIDA ORIENTE,2023-03-13,37,27,10,0.27027027027027
MERIDA ORIENTE,2023-03-14,25,20,5,0.2
MERIDA ORIENTE,2023-03-15,36,31,5,0.138888888888889
MERIDA ORIENTE,2023-03-16,35,30,5,0.142857142857143
MERIDA ORIENTE,2023-03-17,39,33,6,0.153846153846154
MERIDA ORIENTE,2023-03-18,45,39,6,0.133333333333333
MERIDA ORIENTE,2023-03-19,21,18,3,0.142857142857143
MERIDA ORIENTE,2023-03-20,40,36,4,0.1
MERIDA ORIENTE,2023-03-21,39,36,3,0.0769230769230769
MERIDA ORIENTE,2023-03-22,36,31,5,0.138888888888889
MERIDA ORIENTE,2023-03-23,43,38,5,0.116279069767442
MERIDA ORIENTE,2023-03-24,36,33,3,0.0833333333333333
MERIDA ORIENTE,2023-03-25,37,31,6,0.162162162162162
MERIDA ORIENTE,2023-03-26,31,27,4,0.129032258064516
MERIDA ORIENTE,2023-03-27,32,30,2,0.0625
MERIDA ORIENTE,2023-03-28,42,40,2,0.0476190476190476
MERIDA ORIENTE,2023-03-29,35,34,1,0.0285714285714286
MERIDA ORIENTE,2023-03-30,48,42,6,0.125
MERIDA ORIENTE,2023-03-31,41,35,6,0.146341463414634
MERIDA ORIENTE,2023-04-01,38,35,3,0.0789473684210526
MERIDA ORIENTE,2023-04-02,32,27,5,0.15625
MERIDA ORIENTE,2023-04-03,43,39,4,0.0930232558139535
MERIDA ORIENTE,2023-04-04,44,40,4,0.0909090909090909
MERIDA ORIENTE,2023-04-05,28,24,4,0.142857142857143
MERIDA ORIENTE,2023-04-06,32,31,1,0.03125
MERIDA ORIENTE,2023-04-07,52,47,5,0.0961538461538462
MERIDA ORIENTE,2023-04-08,44,39,5,0.113636363636364
MERIDA ORIENTE,2023-04-09,30,30,0,0
MERIDA ORIENTE,2023-04-10,41,36,5,0.121951219512195
MERIDA ORIENTE,2023-04-11,28,26,2,0.0714285714285714
MERIDA ORIENTE,2023-04-12,31,25,6,0.193548387096774
MERIDA ORIENTE,2023-04-13,23,21,2,0.0869565217391304
MERIDA ORIENTE,2023-04-14,33,32,1,0.0303030303030303
MERIDA ORIENTE,2023-04-15,27,27,0,0
MERIDA ORIENTE,2023-04-16,29,29,0,0
MERIDA ORIENTE,2023-04-17,32,30,2,0.0625
MERIDA ORIENTE,2023-04-18,27,26,1,0.037037037037037
MERIDA ORIENTE,2023-04-19,29,29,0,0
MERIDA ORIENTE,2023-04-20,38,36,2,0.0526315789473684
MERIDA ORIENTE,2023-04-21,24,24,0,0
MERIDA ORIENTE,2023-04-22,31,30,1,0.032258064516129
MERIDA ORIENTE,2023-04-23,48,46,2,0.0416666666666667
MERIDA ORIENTE,2023-04-24,29,28,1,0.0344827586206897
MERIDA ORIENTE,2023-04-25,28,27,1,0.0357142857142857
MERIDA ORIENTE,2023-04-26,42,39,3,0.0714285714285714
MERIDA ORIENTE,2023-04-27,30,30,0,0
MERIDA ORIENTE,2023-04-28,36,34,2,0.0555555555555556
MERIDA ORIENTE,2023-04-29,36,36,0,0
MERIDA ORIENTE,2023-04-30,18,18,0,0
MERIDA ORIENTE,2023-05-01,40,38,2,0.05
MERIDA ORIENTE,2023-05-02,23,23,0,0
MERIDA ORIENTE,2023-05-03,25,25,0,0
MERIDA ORIENTE,2023-05-04,24,24,0,0
MERIDA ORIENTE,2023-05-05,31,31,0,0
MERIDA ORIENTE,2023-05-06,29,29,0,0
MERIDA ORIENTE,2023-05-07,26,25,1,0.0384615384615385
MERIDA ORIENTE,2023-05-08,15,15,0,0
MERIDA PONIENTE,2023-01-02,15,7,8,0.533333333333333
MERIDA PONIENTE,2023-01-03,18,11,7,0.388888888888889
MERIDA PONIENTE,2023-01-04,22,13,9,0.409090909090909
MERIDA PONIENTE,2023-01-05,26,17,9,0.346153846153846
MERIDA PONIENTE,2023-01-06,22,14,8,0.363636363636364
MERIDA PONIENTE,2023-01-07,27,16,11,0.407407407407407
MERIDA PONIENTE,2023-01-08,22,14,8,0.363636363636364
MERIDA PONIENTE,2023-01-09,25,12,13,0.52
MERIDA PONIENTE,2023-01-10,22,12,10,0.454545454545455
MERIDA PONIENTE,2023-01-11,28,15,13,0.464285714285714
MERIDA PONIENTE,2023-01-12,15,6,9,0.6
MERIDA PONIENTE,2023-01-13,19,13,6,0.315789473684211
MERIDA PONIENTE,2023-01-14,23,14,9,0.391304347826087
MERIDA PONIENTE,2023-01-15,21,11,10,0.476190476190476
MERIDA PONIENTE,2023-01-16,26,15,11,0.423076923076923
MERIDA PONIENTE,2023-01-17,19,13,6,0.315789473684211
MERIDA PONIENTE,2023-01-18,16,10,6,0.375
MERIDA PONIENTE,2023-01-19,16,15,1,0.0625
MERIDA PONIENTE,2023-01-20,16,11,5,0.3125
MERIDA PONIENTE,2023-01-21,21,19,2,0.0952380952380952
MERIDA PONIENTE,2023-01-22,19,11,8,0.421052631578947
MERIDA PONIENTE,2023-01-23,18,11,7,0.388888888888889
MERIDA PONIENTE,2023-01-24,13,11,2,0.153846153846154
MERIDA PONIENTE,2023-01-25,26,14,12,0.461538461538462
MERIDA PONIENTE,2023-01-26,14,11,3,0.214285714285714
MERIDA PONIENTE,2023-01-27,28,19,9,0.321428571428571
MERIDA PONIENTE,2023-01-28,26,17,9,0.346153846153846
MERIDA PONIENTE,2023-01-29,22,11,11,0.5
MERIDA PONIENTE,2023-01-30,21,13,8,0.380952380952381
MERIDA PONIENTE,2023-01-31,30,23,7,0.233333333333333
MERIDA PONIENTE,2023-02-01,18,8,10,0.555555555555556
MERIDA PONIENTE,2023-02-02,28,16,12,0.428571428571429
MERIDA PONIENTE,2023-02-03,23,19,4,0.173913043478261
MERIDA PONIENTE,2023-02-04,23,17,6,0.260869565217391
MERIDA PONIENTE,2023-02-05,18,13,5,0.277777777777778
MERIDA PONIENTE,2023-02-06,21,16,5,0.238095238095238
MERIDA PONIENTE,2023-02-07,14,10,4,0.285714285714286
MERIDA PONIENTE,2023-02-08,14,9,5,0.357142857142857
MERIDA PONIENTE,2023-02-09,21,18,3,0.142857142857143
MERIDA PONIENTE,2023-02-10,26,17,9,0.346153846153846
MERIDA PONIENTE,2023-02-11,22,17,5,0.227272727272727
MERIDA PONIENTE,2023-02-12,10,7,3,0.3
MERIDA PONIENTE,2023-02-13,20,13,7,0.35
MERIDA PONIENTE,2023-02-14,26,10,16,0.615384615384615
MERIDA PONIENTE,2023-02-15,26,16,10,0.384615384615385
MERIDA PONIENTE,2023-02-16,16,9,7,0.4375
MERIDA PONIENTE,2023-02-17,27,13,14,0.518518518518518
MERIDA PONIENTE,2023-02-18,20,13,7,0.35
MERIDA PONIENTE,2023-02-19,13,10,3,0.230769230769231
MERIDA PONIENTE,2023-02-20,14,10,4,0.285714285714286
MERIDA PONIENTE,2023-02-21,25,20,5,0.2
MERIDA PONIENTE,2023-02-22,21,17,4,0.19047619047619
MERIDA PONIENTE,2023-02-23,13,10,3,0.230769230769231
MERIDA PONIENTE,2023-02-24,29,21,8,0.275862068965517
MERIDA PONIENTE,2023-02-25,27,23,4,0.148148148148148
MERIDA PONIENTE,2023-02-26,15,11,4,0.266666666666667
MERIDA PONIENTE,2023-02-27,21,13,8,0.380952380952381
MERIDA PONIENTE,2023-02-28,18,13,5,0.277777777777778
MERIDA PONIENTE,2023-03-01,17,14,3,0.176470588235294
MERIDA PONIENTE,2023-03-02,29,27,2,0.0689655172413793
MERIDA PONIENTE,2023-03-03,20,17,3,0.15
MERIDA PONIENTE,2023-03-04,22,18,4,0.181818181818182
MERIDA PONIENTE,2023-03-05,18,15,3,0.166666666666667
MERIDA PONIENTE,2023-03-06,20,17,3,0.15
MERIDA PONIENTE,2023-03-07,22,19,3,0.136363636363636
MERIDA PONIENTE,2023-03-08,27,22,5,0.185185185185185
MERIDA PONIENTE,2023-03-09,21,18,3,0.142857142857143
MERIDA PONIENTE,2023-03-10,20,19,1,0.05
MERIDA PONIENTE,2023-03-11,26,21,5,0.192307692307692
MERIDA PONIENTE,2023-03-12,22,20,2,0.0909090909090909
MERIDA PONIENTE,2023-03-13,21,15,6,0.285714285714286
MERIDA PONIENTE,2023-03-14,13,9,4,0.307692307692308
MERIDA PONIENTE,2023-03-15,27,25,2,0.0740740740740741
MERIDA PONIENTE,2023-03-16,26,26,0,0
MERIDA PONIENTE,2023-03-17,31,27,4,0.129032258064516
MERIDA PONIENTE,2023-03-18,41,35,6,0.146341463414634
MERIDA PONIENTE,2023-03-19,17,16,1,0.0588235294117647
MERIDA PONIENTE,2023-03-20,33,29,4,0.121212121212121
MERIDA PONIENTE,2023-03-21,28,28,0,0
MERIDA PONIENTE,2023-03-22,20,18,2,0.1
MERIDA PONIENTE,2023-03-23,24,22,2,0.0833333333333333
MERIDA PONIENTE,2023-03-24,30,28,2,0.0666666666666667
MERIDA PONIENTE,2023-03-25,21,20,1,0.0476190476190476
MERIDA PONIENTE,2023-03-26,24,23,1,0.0416666666666667
MERIDA PONIENTE,2023-03-27,15,14,1,0.0666666666666667
MERIDA PONIENTE,2023-03-28,19,19,0,0
MERIDA PONIENTE,2023-03-29,27,27,0,0
MERIDA PONIENTE,2023-03-30,17,16,1,0.0588235294117647
MERIDA PONIENTE,2023-03-31,40,37,3,0.075
MERIDA PONIENTE,2023-04-01,29,25,4,0.137931034482759
MERIDA PONIENTE,2023-04-02,17,16,1,0.0588235294117647
MERIDA PONIENTE,2023-04-03,30,29,1,0.0333333333333333
MERIDA PONIENTE,2023-04-04,20,18,2,0.1
MERIDA PONIENTE,2023-04-05,18,15,3,0.166666666666667
MERIDA PONIENTE,2023-04-06,17,16,1,0.0588235294117647
MERIDA PONIENTE,2023-04-07,31,30,1,0.032258064516129
MERIDA PONIENTE,2023-04-08,13,11,2,0.153846153846154
MERIDA PONIENTE,2023-04-09,13,13,0,0
MERIDA PONIENTE,2023-04-10,11,11,0,0
MERIDA PONIENTE,2023-04-11,22,20,2,0.0909090909090909
MERIDA PONIENTE,2023-04-12,13,12,1,0.0769230769230769
MERIDA PONIENTE,2023-04-13,14,14,0,0
MERIDA PONIENTE,2023-04-14,21,21,0,0
MERIDA PONIENTE,2023-04-15,36,36,0,0
MERIDA PONIENTE,2023-04-16,32,31,1,0.03125
MERIDA PONIENTE,2023-04-17,29,28,1,0.0344827586206897
MERIDA PONIENTE,2023-04-18,18,18,0,0
MERIDA PONIENTE,2023-04-19,22,22,0,0
MERIDA PONIENTE,2023-04-20,24,24,0,0
MERIDA PONIENTE,2023-04-21,18,17,1,0.0555555555555556
MERIDA PONIENTE,2023-04-22,43,40,3,0.0697674418604651
MERIDA PONIENTE,2023-04-23,29,27,2,0.0689655172413793
MERIDA PONIENTE,2023-04-24,33,31,2,0.0606060606060606
MERIDA PONIENTE,2023-04-25,29,29,0,0
MERIDA PONIENTE,2023-04-26,24,23,1,0.0416666666666667
MERIDA PONIENTE,2023-04-27,24,24,0,0
MERIDA PONIENTE,2023-04-28,26,26,0,0
MERIDA PONIENTE,2023-04-29,31,31,0,0
MERIDA PONIENTE,2023-04-30,15,14,1,0.0666666666666667
MERIDA PONIENTE,2023-05-01,26,23,3,0.115384615384615
MERIDA PONIENTE,2023-05-02,24,24,0,0
MERIDA PONIENTE,2023-05-03,14,13,1,0.0714285714285714
MERIDA PONIENTE,2023-05-04,11,11,0,0
MERIDA PONIENTE,2023-05-05,27,26,1,0.037037037037037
MERIDA PONIENTE,2023-05-06,28,28,0,0
MERIDA PONIENTE,2023-05-07,10,10,0,0
MERIDA PONIENTE,2023-05-08,22,22,0,0
MEXICALI,2023-01-02,38,26,12,0.315789473684211
MEXICALI,2023-01-03,39,28,11,0.282051282051282
MEXICALI,2023-01-04,44,27,17,0.386363636363636
MEXICALI,2023-01-05,26,16,10,0.384615384615385
MEXICALI,2023-01-06,30,16,14,0.466666666666667
MEXICALI,2023-01-07,43,33,10,0.232558139534884
MEXICALI,2023-01-08,31,22,9,0.290322580645161
MEXICALI,2023-01-09,26,17,9,0.346153846153846
MEXICALI,2023-01-10,51,31,20,0.392156862745098
MEXICALI,2023-01-11,34,28,6,0.176470588235294
MEXICALI,2023-01-12,37,27,10,0.27027027027027
MEXICALI,2023-01-13,50,35,15,0.3
MEXICALI,2023-01-14,35,29,6,0.171428571428571
MEXICALI,2023-01-15,35,26,9,0.257142857142857
MEXICALI,2023-01-16,24,17,7,0.291666666666667
MEXICALI,2023-01-17,35,25,10,0.285714285714286
MEXICALI,2023-01-18,24,2,22,0.916666666666667
MEXICALI,2023-01-19,43,7,36,0.837209302325581
MEXICALI,2023-01-20,43,7,36,0.837209302325581
MEXICALI,2023-01-21,46,13,33,0.717391304347826
MEXICALI,2023-01-22,25,2,23,0.92
MEXICALI,2023-01-23,36,6,30,0.833333333333333
MEXICALI,2023-01-24,31,7,24,0.774193548387097
MEXICALI,2023-01-25,23,7,16,0.695652173913043
MEXICALI,2023-01-26,40,4,36,0.9
MEXICALI,2023-01-27,34,5,29,0.852941176470588
MEXICALI,2023-01-28,44,7,37,0.840909090909091
MEXICALI,2023-01-29,32,5,27,0.84375
MEXICALI,2023-01-30,33,3,30,0.909090909090909
MEXICALI,2023-01-31,34,4,30,0.882352941176471
MEXICALI,2023-02-01,35,1,34,0.971428571428571
MEXICALI,2023-02-02,30,7,23,0.766666666666667
MEXICALI,2023-02-03,41,1,40,0.975609756097561
MEXICALI,2023-02-04,47,2,45,0.957446808510638
MEXICALI,2023-02-05,36,4,32,0.888888888888889
MEXICALI,2023-02-06,39,8,31,0.794871794871795
MEXICALI,2023-02-07,40,2,38,0.95
MEXICALI,2023-02-08,38,3,35,0.921052631578947
MEXICALI,2023-02-09,43,5,38,0.883720930232558
MEXICALI,2023-02-10,42,5,37,0.880952380952381
MEXICALI,2023-02-11,53,8,45,0.849056603773585
MEXICALI,2023-02-12,34,2,32,0.941176470588235
MEXICALI,2023-02-13,36,5,31,0.861111111111111
MEXICALI,2023-02-14,35,3,32,0.914285714285714
MEXICALI,2023-02-15,28,5,23,0.821428571428571
MEXICALI,2023-02-16,35,2,33,0.942857142857143
MEXICALI,2023-02-17,48,7,41,0.854166666666667
MEXICALI,2023-02-18,57,7,50,0.87719298245614
MEXICALI,2023-02-19,35,4,31,0.885714285714286
MEXICALI,2023-02-20,38,4,34,0.894736842105263
MEXICALI,2023-02-21,45,4,41,0.911111111111111
MEXICALI,2023-02-22,38,2,36,0.947368421052632
MEXICALI,2023-02-23,23,4,19,0.826086956521739
MEXICALI,2023-02-24,31,7,24,0.774193548387097
MEXICALI,2023-02-25,58,6,52,0.896551724137931
MEXICALI,2023-02-26,36,5,31,0.861111111111111
MEXICALI,2023-02-27,33,3,30,0.909090909090909
MEXICALI,2023-02-28,43,5,38,0.883720930232558
MEXICALI,2023-03-01,32,6,26,0.8125
MEXICALI,2023-03-02,29,5,24,0.827586206896552
MEXICALI,2023-03-03,44,7,37,0.840909090909091
MEXICALI,2023-03-04,54,5,49,0.907407407407407
MEXICALI,2023-03-05,30,5,25,0.833333333333333
MEXICALI,2023-03-06,37,6,31,0.837837837837838
MEXICALI,2023-03-07,52,6,46,0.884615384615385
MEXICALI,2023-03-08,43,6,37,0.86046511627907
MEXICALI,2023-03-09,45,11,34,0.755555555555556
MEXICALI,2023-03-10,46,5,41,0.891304347826087
MEXICALI,2023-03-11,45,12,33,0.733333333333333
MEXICALI,2023-03-12,43,16,27,0.627906976744186
MEXICALI,2023-03-13,44,11,33,0.75
MEXICALI,2023-03-14,44,17,27,0.613636363636364
MEXICALI,2023-03-15,47,44,3,0.0638297872340425
MEXICALI,2023-03-16,30,27,3,0.1
MEXICALI,2023-03-17,67,57,10,0.149253731343284
MEXICALI,2023-03-18,69,61,8,0.115942028985507
MEXICALI,2023-03-19,43,37,6,0.13953488372093
MEXICALI,2023-03-20,29,24,5,0.172413793103448
MEXICALI,2023-03-21,40,37,3,0.075
MEXICALI,2023-03-22,44,41,3,0.0681818181818182
MEXICALI,2023-03-23,45,43,2,0.0444444444444444
MEXICALI,2023-03-24,54,47,7,0.12962962962963
MEXICALI,2023-03-25,54,47,7,0.12962962962963
MEXICALI,2023-03-26,30,28,2,0.0666666666666667
MEXICALI,2023-03-27,29,28,1,0.0344827586206897
MEXICALI,2023-03-28,35,34,1,0.0285714285714286
MEXICALI,2023-03-29,41,40,1,0.024390243902439
MEXICALI,2023-03-30,42,35,7,0.166666666666667
MEXICALI,2023-03-31,56,52,4,0.0714285714285714
MEXICALI,2023-04-01,50,47,3,0.06
MEXICALI,2023-04-02,32,29,3,0.09375
MEXICALI,2023-04-03,39,37,2,0.0512820512820513
MEXICALI,2023-04-04,48,44,4,0.0833333333333333
MEXICALI,2023-04-05,39,36,3,0.0769230769230769
MEXICALI,2023-04-06,39,37,2,0.0512820512820513
MEXICALI,2023-04-07,30,29,1,0.0333333333333333
MEXICALI,2023-04-08,36,32,4,0.111111111111111
MEXICALI,2023-04-09,21,17,4,0.19047619047619
MEXICALI,2023-04-10,24,19,5,0.208333333333333
MEXICALI,2023-04-11,55,47,8,0.145454545454545
MEXICALI,2023-04-12,38,33,5,0.131578947368421
MEXICALI,2023-04-13,46,45,1,0.0217391304347826
MEXICALI,2023-04-14,40,36,4,0.1
MEXICALI,2023-04-15,53,50,3,0.0566037735849057
MEXICALI,2023-04-16,34,31,3,0.0882352941176471
MEXICALI,2023-04-17,42,38,4,0.0952380952380952
MEXICALI,2023-04-18,41,37,4,0.0975609756097561
MEXICALI,2023-04-19,39,32,7,0.179487179487179
MEXICALI,2023-04-20,36,32,4,0.111111111111111
MEXICALI,2023-04-21,50,38,12,0.24
MEXICALI,2023-04-22,55,47,8,0.145454545454545
MEXICALI,2023-04-23,38,32,6,0.157894736842105
MEXICALI,2023-04-24,41,37,4,0.0975609756097561
MEXICALI,2023-04-25,57,50,7,0.12280701754386
MEXICALI,2023-04-26,40,38,2,0.05
MEXICALI,2023-04-27,38,33,5,0.131578947368421
MEXICALI,2023-04-28,45,38,7,0.155555555555556
MEXICALI,2023-04-29,51,42,9,0.176470588235294
MEXICALI,2023-04-30,37,36,1,0.027027027027027
MEXICALI,2023-05-01,23,23,0,0
MEXICALI,2023-05-02,40,38,2,0.05
MEXICALI,2023-05-03,39,39,0,0
MEXICALI,2023-05-04,38,33,5,0.131578947368421
MEXICALI,2023-05-05,48,45,3,0.0625
MEXICALI,2023-05-06,44,37,7,0.159090909090909
MEXICALI,2023-05-07,35,34,1,0.0285714285714286
MEXICALI,2023-05-08,47,42,5,0.106382978723404
MILPA ALTA,2023-01-02,15,8,7,0.466666666666667
MILPA ALTA,2023-01-03,29,13,16,0.551724137931034
MILPA ALTA,2023-01-04,21,11,10,0.476190476190476
MILPA ALTA,2023-01-05,23,8,15,0.652173913043478
MILPA ALTA,2023-01-06,18,9,9,0.5
MILPA ALTA,2023-01-07,23,10,13,0.565217391304348
MILPA ALTA,2023-01-08,22,8,14,0.636363636363636
MILPA ALTA,2023-01-09,25,13,12,0.48
MILPA ALTA,2023-01-10,23,8,15,0.652173913043478
MILPA ALTA,2023-01-11,28,17,11,0.392857142857143
MILPA ALTA,2023-01-12,26,10,16,0.615384615384615
MILPA ALTA,2023-01-13,25,10,15,0.6
MILPA ALTA,2023-01-14,33,15,18,0.545454545454545
MILPA ALTA,2023-01-15,23,11,12,0.521739130434783
MILPA ALTA,2023-01-16,20,4,16,0.8
MILPA ALTA,2023-01-17,26,7,19,0.730769230769231
MILPA ALTA,2023-01-18,25,5,20,0.8
MILPA ALTA,2023-01-19,22,14,8,0.363636363636364
MILPA ALTA,2023-01-20,17,10,7,0.411764705882353
MILPA ALTA,2023-01-21,22,10,12,0.545454545454545
MILPA ALTA,2023-01-22,20,11,9,0.45
MILPA ALTA,2023-01-23,24,15,9,0.375
MILPA ALTA,2023-01-24,25,13,12,0.48
MILPA ALTA,2023-01-25,26,17,9,0.346153846153846
MILPA ALTA,2023-01-26,27,14,13,0.481481481481481
MILPA ALTA,2023-01-27,28,17,11,0.392857142857143
MILPA ALTA,2023-01-28,25,11,14,0.56
MILPA ALTA,2023-01-29,24,11,13,0.541666666666667
MILPA ALTA,2023-01-30,28,9,19,0.678571428571429
MILPA ALTA,2023-01-31,26,16,10,0.384615384615385
MILPA ALTA,2023-02-01,16,6,10,0.625
MILPA ALTA,2023-02-02,15,7,8,0.533333333333333
MILPA ALTA,2023-02-03,30,13,17,0.566666666666667
MILPA ALTA,2023-02-04,26,13,13,0.5
MILPA ALTA,2023-02-05,21,14,7,0.333333333333333
MILPA ALTA,2023-02-06,26,16,10,0.384615384615385
MILPA ALTA,2023-02-07,24,16,8,0.333333333333333
MILPA ALTA,2023-02-08,21,7,14,0.666666666666667
MILPA ALTA,2023-02-09,22,10,12,0.545454545454545
MILPA ALTA,2023-02-10,17,9,8,0.470588235294118
MILPA ALTA,2023-02-11,20,9,11,0.55
MILPA ALTA,2023-02-12,16,6,10,0.625
MILPA ALTA,2023-02-13,22,8,14,0.636363636363636
MILPA ALTA,2023-02-14,18,8,10,0.555555555555556
MILPA ALTA,2023-02-15,15,5,10,0.666666666666667
MILPA ALTA,2023-02-16,24,13,11,0.458333333333333
MILPA ALTA,2023-02-17,24,9,15,0.625
MILPA ALTA,2023-02-18,32,15,17,0.53125
MILPA ALTA,2023-02-19,11,4,7,0.636363636363636
MILPA ALTA,2023-02-20,21,11,10,0.476190476190476
MILPA ALTA,2023-02-21,15,4,11,0.733333333333333
MILPA ALTA,2023-02-22,20,13,7,0.35
MILPA ALTA,2023-02-23,29,19,10,0.344827586206897
MILPA ALTA,2023-02-24,19,9,10,0.526315789473684
MILPA ALTA,2023-02-25,36,15,21,0.583333333333333
MILPA ALTA,2023-02-26,18,11,7,0.388888888888889
MILPA ALTA,2023-02-27,16,8,8,0.5
MILPA ALTA,2023-02-28,24,13,11,0.458333333333333
MILPA ALTA,2023-03-01,25,12,13,0.52
MILPA ALTA,2023-03-02,19,7,12,0.631578947368421
MILPA ALTA,2023-03-03,23,13,10,0.434782608695652
MILPA ALTA,2023-03-04,24,10,14,0.583333333333333
MILPA ALTA,2023-03-05,20,6,14,0.7
MILPA ALTA,2023-03-06,18,8,10,0.555555555555556
MILPA ALTA,2023-03-07,22,14,8,0.363636363636364
MILPA ALTA,2023-03-08,29,14,15,0.517241379310345
MILPA ALTA,2023-03-09,30,21,9,0.3
MILPA ALTA,2023-03-10,23,15,8,0.347826086956522
MILPA ALTA,2023-03-11,21,12,9,0.428571428571429
MILPA ALTA,2023-03-12,13,9,4,0.307692307692308
MILPA ALTA,2023-03-13,17,13,4,0.235294117647059
MILPA ALTA,2023-03-14,14,10,4,0.285714285714286
MILPA ALTA,2023-03-15,17,16,1,0.0588235294117647
MILPA ALTA,2023-03-16,29,21,8,0.275862068965517
MILPA ALTA,2023-03-17,35,27,8,0.228571428571429
MILPA ALTA,2023-03-18,40,28,12,0.3
MILPA ALTA,2023-03-19,35,31,4,0.114285714285714
MILPA ALTA,2023-03-20,42,36,6,0.142857142857143
MILPA ALTA,2023-03-21,25,21,4,0.16
MILPA ALTA,2023-03-22,24,19,5,0.208333333333333
MILPA ALTA,2023-03-23,25,21,4,0.16
MILPA ALTA,2023-03-24,27,19,8,0.296296296296296
MILPA ALTA,2023-03-25,33,27,6,0.181818181818182
MILPA ALTA,2023-03-26,24,22,2,0.0833333333333333
MILPA ALTA,2023-03-27,18,15,3,0.166666666666667
MILPA ALTA,2023-03-28,18,17,1,0.0555555555555556
MILPA ALTA,2023-03-29,22,20,2,0.0909090909090909
MILPA ALTA,2023-03-30,30,26,4,0.133333333333333
MILPA ALTA,2023-03-31,40,30,10,0.25
MILPA ALTA,2023-04-01,25,24,1,0.04
MILPA ALTA,2023-04-02,24,22,2,0.0833333333333333
MILPA ALTA,2023-04-03,33,25,8,0.242424242424242
MILPA ALTA,2023-04-04,32,28,4,0.125
MILPA ALTA,2023-04-05,16,13,3,0.1875
MILPA ALTA,2023-04-06,28,25,3,0.107142857142857
MILPA ALTA,2023-04-07,22,21,1,0.0454545454545455
MILPA ALTA,2023-04-08,22,20,2,0.0909090909090909
MILPA ALTA,2023-04-09,18,17,1,0.0555555555555556
MILPA ALTA,2023-04-10,20,18,2,0.1
MILPA ALTA,2023-04-11,30,27,3,0.1
MILPA ALTA,2023-04-12,21,18,3,0.142857142857143
MILPA ALTA,2023-04-13,20,17,3,0.15
MILPA ALTA,2023-04-14,20,16,4,0.2
MILPA ALTA,2023-04-15,30,24,6,0.2
MILPA ALTA,2023-04-16,30,29,1,0.0333333333333333
MILPA ALTA,2023-04-17,25,23,2,0.08
MILPA ALTA,2023-04-18,37,33,4,0.108108108108108
MILPA ALTA,2023-04-19,22,20,2,0.0909090909090909
MILPA ALTA,2023-04-20,19,17,2,0.105263157894737
MILPA ALTA,2023-04-21,25,22,3,0.12
MILPA ALTA,2023-04-22,26,23,3,0.115384615384615
MILPA ALTA,2023-04-23,28,26,2,0.0714285714285714
MILPA ALTA,2023-04-24,25,22,3,0.12
MILPA ALTA,2023-04-25,23,19,4,0.173913043478261
MILPA ALTA,2023-04-26,25,23,2,0.08
MILPA ALTA,2023-04-27,27,20,7,0.259259259259259
MILPA ALTA,2023-04-28,27,25,2,0.0740740740740741
MILPA ALTA,2023-04-29,34,32,2,0.0588235294117647
MILPA ALTA,2023-04-30,24,17,7,0.291666666666667
MILPA ALTA,2023-05-01,24,13,11,0.458333333333333
MILPA ALTA,2023-05-02,27,22,5,0.185185185185185
MILPA ALTA,2023-05-03,17,13,4,0.235294117647059
MILPA ALTA,2023-05-04,28,25,3,0.107142857142857
MILPA ALTA,2023-05-05,32,29,3,0.09375
MILPA ALTA,2023-05-06,26,23,3,0.115384615384615
MILPA ALTA,2023-05-07,24,21,3,0.125
MILPA ALTA,2023-05-08,18,17,1,0.0555555555555556
MTY AEROPUERTO,2023-01-02,8,5,3,0.375
MTY AEROPUERTO,2023-01-03,19,11,8,0.421052631578947
MTY AEROPUERTO,2023-01-04,17,11,6,0.352941176470588
MTY AEROPUERTO,2023-01-05,16,11,5,0.3125
MTY AEROPUERTO,2023-01-06,15,6,9,0.6
MTY AEROPUERTO,2023-01-07,33,20,13,0.393939393939394
MTY AEROPUERTO,2023-01-08,17,10,7,0.411764705882353
MTY AEROPUERTO,2023-01-09,18,12,6,0.333333333333333
MTY AEROPUERTO,2023-01-10,23,13,10,0.434782608695652
MTY AEROPUERTO,2023-01-11,14,10,4,0.285714285714286
MTY AEROPUERTO,2023-01-12,13,9,4,0.307692307692308
MTY AEROPUERTO,2023-01-13,28,26,2,0.0714285714285714
MTY AEROPUERTO,2023-01-14,26,16,10,0.384615384615385
MTY AEROPUERTO,2023-01-15,12,9,3,0.25
MTY AEROPUERTO,2023-01-16,15,12,3,0.2
MTY AEROPUERTO,2023-01-17,18,13,5,0.277777777777778
MTY AEROPUERTO,2023-01-18,19,13,6,0.315789473684211
MTY AEROPUERTO,2023-01-19,20,13,7,0.35
MTY AEROPUERTO,2023-01-20,22,14,8,0.363636363636364
MTY AEROPUERTO,2023-01-21,34,22,12,0.352941176470588
MTY AEROPUERTO,2023-01-22,21,14,7,0.333333333333333
MTY AEROPUERTO,2023-01-23,20,14,6,0.3
MTY AEROPUERTO,2023-01-24,14,12,2,0.142857142857143
MTY AEROPUERTO,2023-01-25,26,16,10,0.384615384615385
MTY AEROPUERTO,2023-01-26,23,15,8,0.347826086956522
MTY AEROPUERTO,2023-01-27,29,20,9,0.310344827586207
MTY AEROPUERTO,2023-01-28,23,15,8,0.347826086956522
MTY AEROPUERTO,2023-01-29,26,17,9,0.346153846153846
MTY AEROPUERTO,2023-01-30,21,11,10,0.476190476190476
MTY AEROPUERTO,2023-01-31,23,12,11,0.478260869565217
MTY AEROPUERTO,2023-02-01,18,12,6,0.333333333333333
MTY AEROPUERTO,2023-02-02,35,18,17,0.485714285714286
MTY AEROPUERTO,2023-02-03,33,20,13,0.393939393939394
MTY AEROPUERTO,2023-02-04,40,27,13,0.325
MTY AEROPUERTO,2023-02-05,21,17,4,0.19047619047619
MTY AEROPUERTO,2023-02-06,13,8,5,0.384615384615385
MTY AEROPUERTO,2023-02-07,20,12,8,0.4
MTY AEROPUERTO,2023-02-08,18,12,6,0.333333333333333
MTY AEROPUERTO,2023-02-09,22,19,3,0.136363636363636
MTY AEROPUERTO,2023-02-10,22,18,4,0.181818181818182
MTY AEROPUERTO,2023-02-11,23,17,6,0.260869565217391
MTY AEROPUERTO,2023-02-12,24,16,8,0.333333333333333
MTY AEROPUERTO,2023-02-13,17,12,5,0.294117647058824
MTY AEROPUERTO,2023-02-14,24,16,8,0.333333333333333
MTY AEROPUERTO,2023-02-15,22,16,6,0.272727272727273
MTY AEROPUERTO,2023-02-16,21,15,6,0.285714285714286
MTY AEROPUERTO,2023-02-17,19,15,4,0.210526315789474
MTY AEROPUERTO,2023-02-18,31,23,8,0.258064516129032
MTY AEROPUERTO,2023-02-19,23,8,15,0.652173913043478
MTY AEROPUERTO,2023-02-20,21,8,13,0.619047619047619
MTY AEROPUERTO,2023-02-21,28,18,10,0.357142857142857
MTY AEROPUERTO,2023-02-22,28,13,15,0.535714285714286
MTY AEROPUERTO,2023-02-23,26,15,11,0.423076923076923
MTY AEROPUERTO,2023-02-24,17,9,8,0.470588235294118
MTY AEROPUERTO,2023-02-25,32,19,13,0.40625
MTY AEROPUERTO,2023-02-26,18,11,7,0.388888888888889
MTY AEROPUERTO,2023-02-27,24,16,8,0.333333333333333
MTY AEROPUERTO,2023-02-28,27,21,6,0.222222222222222
MTY AEROPUERTO,2023-03-01,18,14,4,0.222222222222222
MTY AEROPUERTO,2023-03-02,25,17,8,0.32
MTY AEROPUERTO,2023-03-03,30,16,14,0.466666666666667
MTY AEROPUERTO,2023-03-04,29,16,13,0.448275862068966
MTY AEROPUERTO,2023-03-05,12,7,5,0.416666666666667
MTY AEROPUERTO,2023-03-06,14,8,6,0.428571428571429
MTY AEROPUERTO,2023-03-07,17,8,9,0.529411764705882
MTY AEROPUERTO,2023-03-08,21,11,10,0.476190476190476
MTY AEROPUERTO,2023-03-09,24,20,4,0.166666666666667
MTY AEROPUERTO,2023-03-10,26,22,4,0.153846153846154
MTY AEROPUERTO,2023-03-11,34,25,9,0.264705882352941
MTY AEROPUERTO,2023-03-12,33,20,13,0.393939393939394
MTY AEROPUERTO,2023-03-13,18,12,6,0.333333333333333
MTY AEROPUERTO,2023-03-14,24,21,3,0.125
MTY AEROPUERTO,2023-03-15,13,12,1,0.0769230769230769
MTY AEROPUERTO,2023-03-16,12,10,2,0.166666666666667
MTY AEROPUERTO,2023-03-17,19,15,4,0.210526315789474
MTY AEROPUERTO,2023-03-18,22,13,9,0.409090909090909
MTY AEROPUERTO,2023-03-19,20,15,5,0.25
MTY AEROPUERTO,2023-03-20,17,12,5,0.294117647058824
MTY AEROPUERTO,2023-03-21,30,28,2,0.0666666666666667
MTY AEROPUERTO,2023-03-22,25,18,7,0.28
MTY AEROPUERTO,2023-03-23,30,23,7,0.233333333333333
MTY AEROPUERTO,2023-03-24,37,27,10,0.27027027027027
MTY AEROPUERTO,2023-03-25,19,11,8,0.421052631578947
MTY AEROPUERTO,2023-03-26,24,13,11,0.458333333333333
MTY AEROPUERTO,2023-03-27,19,16,3,0.157894736842105
MTY AEROPUERTO,2023-03-28,16,11,5,0.3125
MTY AEROPUERTO,2023-03-29,47,24,23,0.48936170212766
MTY AEROPUERTO,2023-03-30,38,17,21,0.552631578947368
MTY AEROPUERTO,2023-03-31,44,29,15,0.340909090909091
MTY AEROPUERTO,2023-04-01,25,13,12,0.48
MTY AEROPUERTO,2023-04-02,20,11,9,0.45
MTY AEROPUERTO,2023-04-03,23,18,5,0.217391304347826
MTY AEROPUERTO,2023-04-04,22,22,0,0
MTY AEROPUERTO,2023-04-05,13,13,0,0
MTY AEROPUERTO,2023-04-06,22,22,0,0
MTY AEROPUERTO,2023-04-07,32,32,0,0
MTY AEROPUERTO,2023-04-08,35,35,0,0
MTY AEROPUERTO,2023-04-09,30,30,0,0
MTY AEROPUERTO,2023-04-10,18,18,0,0
MTY AEROPUERTO,2023-04-11,20,20,0,0
MTY AEROPUERTO,2023-04-12,18,18,0,0
MTY AEROPUERTO,2023-04-13,18,18,0,0
MTY AEROPUERTO,2023-04-14,31,31,0,0
MTY AEROPUERTO,2023-04-15,25,25,0,0
MTY AEROPUERTO,2023-04-16,8,8,0,0
MTY AEROPUERTO,2023-04-17,18,18,0,0
MTY AEROPUERTO,2023-04-18,26,26,0,0
MTY AEROPUERTO,2023-04-19,33,33,0,0
MTY AEROPUERTO,2023-04-20,16,16,0,0
MTY AEROPUERTO,2023-04-21,35,35,0,0
MTY AEROPUERTO,2023-04-22,42,42,0,0
MTY AEROPUERTO,2023-04-23,39,39,0,0
MTY AEROPUERTO,2023-04-24,31,31,0,0
MTY AEROPUERTO,2023-04-25,42,42,0,0
MTY AEROPUERTO,2023-04-26,31,31,0,0
MTY AEROPUERTO,2023-04-27,30,30,0,0
MTY AEROPUERTO,2023-04-28,26,26,0,0
MTY AEROPUERTO,2023-04-29,36,36,0,0
MTY AEROPUERTO,2023-04-30,28,28,0,0
MTY AEROPUERTO,2023-05-01,14,14,0,0
MTY AEROPUERTO,2023-05-02,3,3,0,0
MTY AEROPUERTO,2023-05-03,32,32,0,0
MTY AEROPUERTO,2023-05-04,24,24,0,0
MTY AEROPUERTO,2023-05-05,33,33,0,0
MTY AEROPUERTO,2023-05-06,37,37,0,0
MTY AEROPUERTO,2023-05-07,24,24,0,0
MTY AEROPUERTO,2023-05-08,18,18,0,0
MTY CARRETERA NACIONAL,2023-01-02,22,9,13,0.590909090909091
MTY CARRETERA NACIONAL,2023-01-03,31,6,25,0.806451612903226
MTY CARRETERA NACIONAL,2023-01-04,37,6,31,0.837837837837838
MTY CARRETERA NACIONAL,2023-01-05,31,7,24,0.774193548387097
MTY CARRETERA NACIONAL,2023-01-06,46,9,37,0.804347826086957
MTY CARRETERA NACIONAL,2023-01-07,32,11,21,0.65625
MTY CARRETERA NACIONAL,2023-01-08,15,3,12,0.8
MTY CARRETERA NACIONAL,2023-01-09,32,10,22,0.6875
MTY CARRETERA NACIONAL,2023-01-10,33,10,23,0.696969696969697
MTY CARRETERA NACIONAL,2023-01-11,28,8,20,0.714285714285714
MTY CARRETERA NACIONAL,2023-01-12,31,11,20,0.645161290322581
MTY CARRETERA NACIONAL,2023-01-13,27,13,14,0.518518518518518
MTY CARRETERA NACIONAL,2023-01-14,30,15,15,0.5
MTY CARRETERA NACIONAL,2023-01-15,18,6,12,0.666666666666667
MTY CARRETERA NACIONAL,2023-01-16,32,9,23,0.71875
MTY CARRETERA NACIONAL,2023-01-17,28,9,19,0.678571428571429
MTY CARRETERA NACIONAL,2023-01-18,22,7,15,0.681818181818182
MTY CARRETERA NACIONAL,2023-01-19,26,10,16,0.615384615384615
MTY CARRETERA NACIONAL,2023-01-20,22,10,12,0.545454545454545
MTY CARRETERA NACIONAL,2023-01-21,38,19,19,0.5
MTY CARRETERA NACIONAL,2023-01-22,17,8,9,0.529411764705882
MTY CARRETERA NACIONAL,2023-01-23,29,9,20,0.689655172413793
MTY CARRETERA NACIONAL,2023-01-24,36,12,24,0.666666666666667
MTY CARRETERA NACIONAL,2023-01-25,25,13,12,0.48
MTY CARRETERA NACIONAL,2023-01-26,23,7,16,0.695652173913043
MTY CARRETERA NACIONAL,2023-01-27,37,14,23,0.621621621621622
MTY CARRETERA NACIONAL,2023-01-28,49,11,38,0.775510204081633
MTY CARRETERA NACIONAL,2023-01-29,29,9,20,0.689655172413793
MTY CARRETERA NACIONAL,2023-01-30,34,11,23,0.676470588235294
MTY CARRETERA NACIONAL,2023-01-31,32,14,18,0.5625
MTY CARRETERA NACIONAL,2023-02-01,27,10,17,0.62962962962963
MTY CARRETERA NACIONAL,2023-02-02,42,17,25,0.595238095238095
MTY CARRETERA NACIONAL,2023-02-03,33,18,15,0.454545454545455
MTY CARRETERA NACIONAL,2023-02-04,36,14,22,0.611111111111111
MTY CARRETERA NACIONAL,2023-02-05,20,6,14,0.7
MTY CARRETERA NACIONAL,2023-02-06,9,5,4,0.444444444444444
MTY CARRETERA NACIONAL,2023-02-07,36,17,19,0.527777777777778
MTY CARRETERA NACIONAL,2023-02-08,33,12,21,0.636363636363636
MTY CARRETERA NACIONAL,2023-02-09,33,14,19,0.575757575757576
MTY CARRETERA NACIONAL,2023-02-10,22,10,12,0.545454545454545
MTY CARRETERA NACIONAL,2023-02-11,33,8,25,0.757575757575758
MTY CARRETERA NACIONAL,2023-02-12,17,7,10,0.588235294117647
MTY CARRETERA NACIONAL,2023-02-13,23,7,16,0.695652173913043
MTY CARRETERA NACIONAL,2023-02-14,25,9,16,0.64
MTY CARRETERA NACIONAL,2023-02-15,38,12,26,0.684210526315789
MTY CARRETERA NACIONAL,2023-02-16,30,12,18,0.6
MTY CARRETERA NACIONAL,2023-02-17,28,12,16,0.571428571428571
MTY CARRETERA NACIONAL,2023-02-18,47,21,26,0.553191489361702
MTY CARRETERA NACIONAL,2023-02-19,23,7,16,0.695652173913043
MTY CARRETERA NACIONAL,2023-02-20,27,9,18,0.666666666666667
MTY CARRETERA NACIONAL,2023-02-21,29,13,16,0.551724137931034
MTY CARRETERA NACIONAL,2023-02-22,26,8,18,0.692307692307692
MTY CARRETERA NACIONAL,2023-02-23,30,13,17,0.566666666666667
MTY CARRETERA NACIONAL,2023-02-24,23,4,19,0.826086956521739
MTY CARRETERA NACIONAL,2023-02-25,46,12,34,0.739130434782609
MTY CARRETERA NACIONAL,2023-02-26,18,9,9,0.5
MTY CARRETERA NACIONAL,2023-02-27,36,15,21,0.583333333333333
MTY CARRETERA NACIONAL,2023-02-28,23,7,16,0.695652173913043
MTY CARRETERA NACIONAL,2023-03-01,20,4,16,0.8
MTY CARRETERA NACIONAL,2023-03-02,36,12,24,0.666666666666667
MTY CARRETERA NACIONAL,2023-03-03,32,17,15,0.46875
MTY CARRETERA NACIONAL,2023-03-04,54,27,27,0.5
MTY CARRETERA NACIONAL,2023-03-05,15,6,9,0.6
MTY CARRETERA NACIONAL,2023-03-06,28,12,16,0.571428571428571
MTY CARRETERA NACIONAL,2023-03-07,24,14,10,0.416666666666667
MTY CARRETERA NACIONAL,2023-03-08,36,19,17,0.472222222222222
MTY CARRETERA NACIONAL,2023-03-09,23,15,8,0.347826086956522
MTY CARRETERA NACIONAL,2023-03-10,24,14,10,0.416666666666667
MTY CARRETERA NACIONAL,2023-03-11,37,27,10,0.27027027027027
MTY CARRETERA NACIONAL,2023-03-12,17,10,7,0.411764705882353
MTY CARRETERA NACIONAL,2023-03-13,22,14,8,0.363636363636364
MTY CARRETERA NACIONAL,2023-03-14,26,18,8,0.307692307692308
MTY CARRETERA NACIONAL,2023-03-15,24,23,1,0.0416666666666667
MTY CARRETERA NACIONAL,2023-03-16,30,30,0,0
MTY CARRETERA NACIONAL,2023-03-17,39,34,5,0.128205128205128
MTY CARRETERA NACIONAL,2023-03-18,44,40,4,0.0909090909090909
MTY CARRETERA NACIONAL,2023-03-19,28,25,3,0.107142857142857
MTY CARRETERA NACIONAL,2023-03-20,26,23,3,0.115384615384615
MTY CARRETERA NACIONAL,2023-03-21,32,29,3,0.09375
MTY CARRETERA NACIONAL,2023-03-22,29,28,1,0.0344827586206897
MTY CARRETERA NACIONAL,2023-03-23,37,35,2,0.0540540540540541
MTY CARRETERA NACIONAL,2023-03-24,30,26,4,0.133333333333333
MTY CARRETERA NACIONAL,2023-03-25,53,45,8,0.150943396226415
MTY CARRETERA NACIONAL,2023-03-26,18,16,2,0.111111111111111
MTY CARRETERA NACIONAL,2023-03-27,50,49,1,0.02
MTY CARRETERA NACIONAL,2023-03-28,34,32,2,0.0588235294117647
MTY CARRETERA NACIONAL,2023-03-29,28,27,1,0.0357142857142857
MTY CARRETERA NACIONAL,2023-03-30,24,24,0,0
MTY CARRETERA NACIONAL,2023-03-31,50,50,0,0
MTY CARRETERA NACIONAL,2023-04-01,43,38,5,0.116279069767442
MTY CARRETERA NACIONAL,2023-04-02,19,18,1,0.0526315789473684
MTY CARRETERA NACIONAL,2023-04-03,31,28,3,0.0967741935483871
MTY CARRETERA NACIONAL,2023-04-04,16,16,0,0
MTY CARRETERA NACIONAL,2023-04-05,16,16,0,0
MTY CARRETERA NACIONAL,2023-04-06,37,37,0,0
MTY CARRETERA NACIONAL,2023-04-07,36,36,0,0
MTY CARRETERA NACIONAL,2023-04-08,34,34,0,0
MTY CARRETERA NACIONAL,2023-04-09,24,24,0,0
MTY CARRETERA NACIONAL,2023-04-10,29,29,0,0
MTY CARRETERA NACIONAL,2023-04-11,26,26,0,0
MTY CARRETERA NACIONAL,2023-04-12,31,31,0,0
MTY CARRETERA NACIONAL,2023-04-13,25,25,0,0
MTY CARRETERA NACIONAL,2023-04-14,36,36,0,0
MTY CARRETERA NACIONAL,2023-04-15,46,46,0,0
MTY CARRETERA NACIONAL,2023-04-16,25,25,0,0
MTY CARRETERA NACIONAL,2023-04-17,34,34,0,0
MTY CARRETERA NACIONAL,2023-04-18,33,33,0,0
MTY CARRETERA NACIONAL,2023-04-19,33,33,0,0
MTY CARRETERA NACIONAL,2023-04-20,31,31,0,0
MTY CARRETERA NACIONAL,2023-04-21,32,32,0,0
MTY CARRETERA NACIONAL,2023-04-22,36,36,0,0
MTY CARRETERA NACIONAL,2023-04-23,28,28,0,0
MTY CARRETERA NACIONAL,2023-04-24,40,40,0,0
MTY CARRETERA NACIONAL,2023-04-25,38,38,0,0
MTY CARRETERA NACIONAL,2023-04-26,42,42,0,0
MTY CARRETERA NACIONAL,2023-04-27,32,32,0,0
MTY CARRETERA NACIONAL,2023-04-28,39,39,0,0
MTY CARRETERA NACIONAL,2023-04-29,54,54,0,0
MTY CARRETERA NACIONAL,2023-04-30,39,39,0,0
MTY CARRETERA NACIONAL,2023-05-01,4,4,0,0
MTY CARRETERA NACIONAL,2023-05-02,48,48,0,0
MTY CARRETERA NACIONAL,2023-05-03,31,31,0,0
MTY CARRETERA NACIONAL,2023-05-04,42,42,0,0
MTY CARRETERA NACIONAL,2023-05-05,37,37,0,0
MTY CARRETERA NACIONAL,2023-05-06,45,45,0,0
MTY CARRETERA NACIONAL,2023-05-07,25,25,0,0
MTY CARRETERA NACIONAL,2023-05-08,32,32,0,0
MTY GARCIA,2023-01-02,20,10,10,0.5
MTY GARCIA,2023-01-03,30,19,11,0.366666666666667
MTY GARCIA,2023-01-04,37,30,7,0.189189189189189
MTY GARCIA,2023-01-05,25,19,6,0.24
MTY GARCIA,2023-01-06,31,24,7,0.225806451612903
MTY GARCIA,2023-01-07,47,30,17,0.361702127659574
MTY GARCIA,2023-01-08,25,14,11,0.44
MTY GARCIA,2023-01-09,35,20,15,0.428571428571429
MTY GARCIA,2023-01-10,38,28,10,0.263157894736842
MTY GARCIA,2023-01-11,32,19,13,0.40625
MTY GARCIA,2023-01-12,23,16,7,0.304347826086957
MTY GARCIA,2023-01-13,33,20,13,0.393939393939394
MTY GARCIA,2023-01-14,42,34,8,0.19047619047619
MTY GARCIA,2023-01-15,32,24,8,0.25
MTY GARCIA,2023-01-16,30,14,16,0.533333333333333
MTY GARCIA,2023-01-17,33,31,2,0.0606060606060606
MTY GARCIA,2023-01-18,23,15,8,0.347826086956522
MTY GARCIA,2023-01-19,29,18,11,0.379310344827586
MTY GARCIA,2023-01-20,33,25,8,0.242424242424242
MTY GARCIA,2023-01-21,41,28,13,0.317073170731707
MTY GARCIA,2023-01-22,16,10,6,0.375
MTY GARCIA,2023-01-23,32,25,7,0.21875
MTY GARCIA,2023-01-24,25,20,5,0.2
MTY GARCIA,2023-01-25,33,19,14,0.424242424242424
MTY GARCIA,2023-01-26,34,23,11,0.323529411764706
MTY GARCIA,2023-01-27,30,23,7,0.233333333333333
MTY GARCIA,2023-01-28,42,28,14,0.333333333333333
MTY GARCIA,2023-01-29,21,15,6,0.285714285714286
MTY GARCIA,2023-01-30,27,21,6,0.222222222222222
MTY GARCIA,2023-01-31,27,20,7,0.259259259259259
MTY GARCIA,2023-02-01,25,21,4,0.16
MTY GARCIA,2023-02-02,33,25,8,0.242424242424242
MTY GARCIA,2023-02-03,29,21,8,0.275862068965517
MTY GARCIA,2023-02-04,35,25,10,0.285714285714286
MTY GARCIA,2023-02-05,32,18,14,0.4375
MTY GARCIA,2023-02-06,20,14,6,0.3
MTY GARCIA,2023-02-07,28,24,4,0.142857142857143
MTY GARCIA,2023-02-08,30,22,8,0.266666666666667
MTY GARCIA,2023-02-09,31,24,7,0.225806451612903
MTY GARCIA,2023-02-10,32,17,15,0.46875
MTY GARCIA,2023-02-11,62,22,40,0.645161290322581
MTY GARCIA,2023-02-12,35,14,21,0.6
MTY GARCIA,2023-02-13,34,17,17,0.5
MTY GARCIA,2023-02-14,31,21,10,0.32258064516129
MTY GARCIA,2023-02-15,32,23,9,0.28125
MTY GARCIA,2023-02-16,27,18,9,0.333333333333333
MTY GARCIA,2023-02-17,34,21,13,0.382352941176471
MTY GARCIA,2023-02-18,44,30,14,0.318181818181818
MTY GARCIA,2023-02-19,20,15,5,0.25
MTY GARCIA,2023-02-20,22,16,6,0.272727272727273
MTY GARCIA,2023-02-21,26,16,10,0.384615384615385
MTY GARCIA,2023-02-22,22,13,9,0.409090909090909
MTY GARCIA,2023-02-23,19,12,7,0.368421052631579
MTY GARCIA,2023-02-24,29,20,9,0.310344827586207
MTY GARCIA,2023-02-25,43,28,15,0.348837209302326
MTY GARCIA,2023-02-26,24,19,5,0.208333333333333
MTY GARCIA,2023-02-27,23,15,8,0.347826086956522
MTY GARCIA,2023-02-28,34,22,12,0.352941176470588
MTY GARCIA,2023-03-01,35,25,10,0.285714285714286
MTY GARCIA,2023-03-02,37,23,14,0.378378378378378
MTY GARCIA,2023-03-03,27,23,4,0.148148148148148
MTY GARCIA,2023-03-04,38,32,6,0.157894736842105
MTY GARCIA,2023-03-05,15,13,2,0.133333333333333
MTY GARCIA,2023-03-06,20,17,3,0.15
MTY GARCIA,2023-03-07,37,24,13,0.351351351351351
MTY GARCIA,2023-03-08,33,22,11,0.333333333333333
MTY GARCIA,2023-03-09,42,34,8,0.19047619047619
MTY GARCIA,2023-03-10,44,25,19,0.431818181818182
MTY GARCIA,2023-03-11,58,37,21,0.362068965517241
MTY GARCIA,2023-03-12,34,28,6,0.176470588235294
MTY GARCIA,2023-03-13,29,22,7,0.241379310344828
MTY GARCIA,2023-03-14,34,24,10,0.294117647058824
MTY GARCIA,2023-03-15,40,38,2,0.05
MTY GARCIA,2023-03-16,32,32,0,0
MTY GARCIA,2023-03-17,37,32,5,0.135135135135135
MTY GARCIA,2023-03-18,41,38,3,0.0731707317073171
MTY GARCIA,2023-03-19,28,25,3,0.107142857142857
MTY GARCIA,2023-03-20,28,20,8,0.285714285714286
MTY GARCIA,2023-03-21,37,32,5,0.135135135135135
MTY GARCIA,2023-03-22,36,32,4,0.111111111111111
MTY GARCIA,2023-03-23,42,33,9,0.214285714285714
MTY GARCIA,2023-03-24,56,48,8,0.142857142857143
MTY GARCIA,2023-03-25,49,42,7,0.142857142857143
MTY GARCIA,2023-03-26,26,21,5,0.192307692307692
MTY GARCIA,2023-03-27,48,36,12,0.25
MTY GARCIA,2023-03-28,20,18,2,0.1
MTY GARCIA,2023-03-29,41,39,2,0.0487804878048781
MTY GARCIA,2023-03-30,44,43,1,0.0227272727272727
MTY GARCIA,2023-03-31,59,54,5,0.0847457627118644
MTY GARCIA,2023-04-01,46,45,1,0.0217391304347826
MTY GARCIA,2023-04-02,17,17,0,0
MTY GARCIA,2023-04-03,25,25,0,0
MTY GARCIA,2023-04-04,34,34,0,0
MTY GARCIA,2023-04-05,42,42,0,0
MTY GARCIA,2023-04-06,35,35,0,0
MTY GARCIA,2023-04-07,39,39,0,0
MTY GARCIA,2023-04-08,39,39,0,0
MTY GARCIA,2023-04-09,27,27,0,0
MTY GARCIA,2023-04-10,29,29,0,0
MTY GARCIA,2023-04-11,38,38,0,0
MTY GARCIA,2023-04-12,36,36,0,0
MTY GARCIA,2023-04-13,32,32,0,0
MTY GARCIA,2023-04-14,50,50,0,0
MTY GARCIA,2023-04-15,61,61,0,0
MTY GARCIA,2023-04-16,41,41,0,0
MTY GARCIA,2023-04-17,51,51,0,0
MTY GARCIA,2023-04-18,44,44,0,0
MTY GARCIA,2023-04-19,33,33,0,0
MTY GARCIA,2023-04-20,31,31,0,0
MTY GARCIA,2023-04-21,40,40,0,0
MTY GARCIA,2023-04-22,44,44,0,0
MTY GARCIA,2023-04-23,38,38,0,0
MTY GARCIA,2023-04-24,35,35,0,0
MTY GARCIA,2023-04-25,47,47,0,0
MTY GARCIA,2023-04-26,45,45,0,0
MTY GARCIA,2023-04-27,31,31,0,0
MTY GARCIA,2023-04-28,43,43,0,0
MTY GARCIA,2023-04-29,51,51,0,0
MTY GARCIA,2023-04-30,42,42,0,0
MTY GARCIA,2023-05-01,32,32,0,0
MTY GARCIA,2023-05-02,39,39,0,0
MTY GARCIA,2023-05-03,51,51,0,0
MTY GARCIA,2023-05-04,37,37,0,0
MTY GARCIA,2023-05-05,47,47,0,0
MTY GARCIA,2023-05-06,51,51,0,0
MTY GARCIA,2023-05-07,25,25,0,0
MTY GARCIA,2023-05-08,33,33,0,0
MTY MITRAS,2023-01-02,18,10,8,0.444444444444444
MTY MITRAS,2023-01-03,28,19,9,0.321428571428571
MTY MITRAS,2023-01-04,24,14,10,0.416666666666667
MTY MITRAS,2023-01-05,27,19,8,0.296296296296296
MTY MITRAS,2023-01-06,46,29,17,0.369565217391304
MTY MITRAS,2023-01-07,33,18,15,0.454545454545455
MTY MITRAS,2023-01-08,31,21,10,0.32258064516129
MTY MITRAS,2023-01-09,36,16,20,0.555555555555556
MTY MITRAS,2023-01-10,28,16,12,0.428571428571429
MTY MITRAS,2023-01-11,32,18,14,0.4375
MTY MITRAS,2023-01-12,26,16,10,0.384615384615385
MTY MITRAS,2023-01-13,35,23,12,0.342857142857143
MTY MITRAS,2023-01-14,27,20,7,0.259259259259259
MTY MITRAS,2023-01-15,26,21,5,0.192307692307692
MTY MITRAS,2023-01-16,25,16,9,0.36
MTY MITRAS,2023-01-17,35,17,18,0.514285714285714
MTY MITRAS,2023-01-18,31,21,10,0.32258064516129
MTY MITRAS,2023-01-19,38,21,17,0.447368421052632
MTY MITRAS,2023-01-20,38,27,11,0.289473684210526
MTY MITRAS,2023-01-21,44,34,10,0.227272727272727
MTY MITRAS,2023-01-22,21,14,7,0.333333333333333
MTY MITRAS,2023-01-23,36,20,16,0.444444444444444
MTY MITRAS,2023-01-24,27,15,12,0.444444444444444
MTY MITRAS,2023-01-25,29,19,10,0.344827586206897
MTY MITRAS,2023-01-26,22,10,12,0.545454545454545
MTY MITRAS,2023-01-27,34,17,17,0.5
MTY MITRAS,2023-01-28,44,17,27,0.613636363636364
MTY MITRAS,2023-01-29,24,14,10,0.416666666666667
MTY MITRAS,2023-01-30,32,21,11,0.34375
MTY MITRAS,2023-01-31,33,15,18,0.545454545454545
MTY MITRAS,2023-02-01,30,21,9,0.3
MTY MITRAS,2023-02-02,28,17,11,0.392857142857143
MTY MITRAS,2023-02-03,27,20,7,0.259259259259259
MTY MITRAS,2023-02-04,40,17,23,0.575
MTY MITRAS,2023-02-05,22,11,11,0.5
MTY MITRAS,2023-02-06,24,12,12,0.5
MTY MITRAS,2023-02-07,32,15,17,0.53125
MTY MITRAS,2023-02-08,31,19,12,0.387096774193548
MTY MITRAS,2023-02-09,33,22,11,0.333333333333333
MTY MITRAS,2023-02-10,36,27,9,0.25
MTY MITRAS,2023-02-11,43,21,22,0.511627906976744
MTY MITRAS,2023-02-12,22,11,11,0.5
MTY MITRAS,2023-02-13,35,17,18,0.514285714285714
MTY MITRAS,2023-02-14,28,8,20,0.714285714285714
MTY MITRAS,2023-02-15,31,20,11,0.354838709677419
MTY MITRAS,2023-02-16,35,21,14,0.4
MTY MITRAS,2023-02-17,36,16,20,0.555555555555556
MTY MITRAS,2023-02-18,43,27,16,0.372093023255814
MTY MITRAS,2023-02-19,37,18,19,0.513513513513513
MTY MITRAS,2023-02-20,37,12,25,0.675675675675676
MTY MITRAS,2023-02-21,47,21,26,0.553191489361702
MTY MITRAS,2023-02-22,57,28,29,0.508771929824561
MTY MITRAS,2023-02-23,44,23,21,0.477272727272727
MTY MITRAS,2023-02-24,35,14,21,0.6
MTY MITRAS,2023-02-25,82,43,39,0.475609756097561
MTY MITRAS,2023-02-26,45,24,21,0.466666666666667
MTY MITRAS,2023-02-27,43,20,23,0.534883720930233
MTY MITRAS,2023-02-28,56,30,26,0.464285714285714
MTY MITRAS,2023-03-01,28,15,13,0.464285714285714
MTY MITRAS,2023-03-02,50,21,29,0.58
MTY MITRAS,2023-03-03,50,27,23,0.46
MTY MITRAS,2023-03-04,65,28,37,0.569230769230769
MTY MITRAS,2023-03-05,32,12,20,0.625
MTY MITRAS,2023-03-06,35,18,17,0.485714285714286
MTY MITRAS,2023-03-07,44,26,18,0.409090909090909
MTY MITRAS,2023-03-08,40,17,23,0.575
MTY MITRAS,2023-03-09,45,35,10,0.222222222222222
MTY MITRAS,2023-03-10,48,38,10,0.208333333333333
MTY MITRAS,2023-03-11,43,29,14,0.325581395348837
MTY MITRAS,2023-03-12,25,18,7,0.28
MTY MITRAS,2023-03-13,50,31,19,0.38
MTY MITRAS,2023-03-14,38,22,16,0.421052631578947
MTY MITRAS,2023-03-15,28,20,8,0.285714285714286
MTY MITRAS,2023-03-16,35,32,3,0.0857142857142857
MTY MITRAS,2023-03-17,42,39,3,0.0714285714285714
MTY MITRAS,2023-03-18,42,33,9,0.214285714285714
MTY MITRAS,2023-03-19,22,16,6,0.272727272727273
MTY MITRAS,2023-03-20,37,33,4,0.108108108108108
MTY MITRAS,2023-03-21,44,41,3,0.0681818181818182
MTY MITRAS,2023-03-22,38,38,0,0
MTY MITRAS,2023-03-23,45,45,0,0
MTY MITRAS,2023-03-24,37,37,0,0
MTY MITRAS,2023-03-25,27,24,3,0.111111111111111
MTY MITRAS,2023-03-26,19,19,0,0
MTY MITRAS,2023-03-27,45,43,2,0.0444444444444444
MTY MITRAS,2023-03-28,38,38,0,0
MTY MITRAS,2023-03-29,24,23,1,0.0416666666666667
MTY MITRAS,2023-03-30,37,36,1,0.027027027027027
MTY MITRAS,2023-03-31,49,47,2,0.0408163265306122
MTY MITRAS,2023-04-01,20,20,0,0
MTY MITRAS,2023-04-02,22,22,0,0
MTY MITRAS,2023-04-03,29,28,1,0.0344827586206897
MTY MITRAS,2023-04-04,17,17,0,0
MTY MITRAS,2023-04-05,18,18,0,0
MTY MITRAS,2023-04-06,35,35,0,0
MTY MITRAS,2023-04-07,58,58,0,0
MTY MITRAS,2023-04-08,35,35,0,0
MTY MITRAS,2023-04-09,13,13,0,0
MTY MITRAS,2023-04-10,15,15,0,0
MTY MITRAS,2023-04-11,29,29,0,0
MTY MITRAS,2023-04-12,28,28,0,0
MTY MITRAS,2023-04-13,16,16,0,0
MTY MITRAS,2023-04-14,33,33,0,0
MTY MITRAS,2023-04-15,48,48,0,0
MTY MITRAS,2023-04-16,18,18,0,0
MTY MITRAS,2023-04-17,35,35,0,0
MTY MITRAS,2023-04-18,38,38,0,0
MTY MITRAS,2023-04-19,38,38,0,0
MTY MITRAS,2023-04-20,34,34,0,0
MTY MITRAS,2023-04-21,57,57,0,0
MTY MITRAS,2023-04-22,42,42,0,0
MTY MITRAS,2023-04-23,31,31,0,0
MTY MITRAS,2023-04-24,36,36,0,0
MTY MITRAS,2023-04-25,49,49,0,0
MTY MITRAS,2023-04-26,38,38,0,0
MTY MITRAS,2023-04-27,29,29,0,0
MTY MITRAS,2023-04-28,40,40,0,0
MTY MITRAS,2023-04-29,49,49,0,0
MTY MITRAS,2023-04-30,57,57,0,0
MTY MITRAS,2023-05-01,36,36,0,0
MTY MITRAS,2023-05-02,25,25,0,0
MTY MITRAS,2023-05-03,37,37,0,0
MTY MITRAS,2023-05-04,40,40,0,0
MTY MITRAS,2023-05-05,39,39,0,0
MTY MITRAS,2023-05-06,49,49,0,0
MTY MITRAS,2023-05-07,30,30,0,0
MTY MITRAS,2023-05-08,14,14,0,0
MTY SANTA LUCIA,2023-01-02,11,5,6,0.545454545454545
MTY SANTA LUCIA,2023-01-03,20,14,6,0.3
MTY SANTA LUCIA,2023-01-04,26,11,15,0.576923076923077
MTY SANTA LUCIA,2023-01-05,24,19,5,0.208333333333333
MTY SANTA LUCIA,2023-01-06,35,19,16,0.457142857142857
MTY SANTA LUCIA,2023-01-07,31,20,11,0.354838709677419
MTY SANTA LUCIA,2023-01-08,25,15,10,0.4
MTY SANTA LUCIA,2023-01-09,29,9,20,0.689655172413793
MTY SANTA LUCIA,2023-01-10,26,21,5,0.192307692307692
MTY SANTA LUCIA,2023-01-11,21,9,12,0.571428571428571
MTY SANTA LUCIA,2023-01-12,19,10,9,0.473684210526316
MTY SANTA LUCIA,2023-01-13,24,18,6,0.25
MTY SANTA LUCIA,2023-01-14,32,21,11,0.34375
MTY SANTA LUCIA,2023-01-15,23,15,8,0.347826086956522
MTY SANTA LUCIA,2023-01-16,29,17,12,0.413793103448276
MTY SANTA LUCIA,2023-01-17,24,13,11,0.458333333333333
MTY SANTA LUCIA,2023-01-18,25,15,10,0.4
MTY SANTA LUCIA,2023-01-19,12,11,1,0.0833333333333333
MTY SANTA LUCIA,2023-01-20,14,5,9,0.642857142857143
MTY SANTA LUCIA,2023-01-21,25,18,7,0.28
MTY SANTA LUCIA,2023-01-22,15,6,9,0.6
MTY SANTA LUCIA,2023-01-23,13,10,3,0.230769230769231
MTY SANTA LUCIA,2023-01-24,15,6,9,0.6
MTY SANTA LUCIA,2023-01-25,37,25,12,0.324324324324324
MTY SANTA LUCIA,2023-01-26,43,24,19,0.441860465116279
MTY SANTA LUCIA,2023-01-27,25,14,11,0.44
MTY SANTA LUCIA,2023-01-28,40,23,17,0.425
MTY SANTA LUCIA,2023-01-29,22,11,11,0.5
MTY SANTA LUCIA,2023-01-30,32,14,18,0.5625
MTY SANTA LUCIA,2023-01-31,26,14,12,0.461538461538462
MTY SANTA LUCIA,2023-02-01,23,17,6,0.260869565217391
MTY SANTA LUCIA,2023-02-02,24,17,7,0.291666666666667
MTY SANTA LUCIA,2023-02-03,35,22,13,0.371428571428571
MTY SANTA LUCIA,2023-02-04,34,24,10,0.294117647058824
MTY SANTA LUCIA,2023-02-05,23,13,10,0.434782608695652
MTY SANTA LUCIA,2023-02-06,14,9,5,0.357142857142857
MTY SANTA LUCIA,2023-02-07,23,13,10,0.434782608695652
MTY SANTA LUCIA,2023-02-08,16,14,2,0.125
MTY SANTA LUCIA,2023-02-09,24,16,8,0.333333333333333
MTY SANTA LUCIA,2023-02-10,21,14,7,0.333333333333333
MTY SANTA LUCIA,2023-02-11,31,18,13,0.419354838709677
MTY SANTA LUCIA,2023-02-12,31,21,10,0.32258064516129
MTY SANTA LUCIA,2023-02-13,14,9,5,0.357142857142857
MTY SANTA LUCIA,2023-02-14,22,11,11,0.5
MTY SANTA LUCIA,2023-02-15,14,7,7,0.5
MTY SANTA LUCIA,2023-02-16,31,23,8,0.258064516129032
MTY SANTA LUCIA,2023-02-17,23,16,7,0.304347826086957
MTY SANTA LUCIA,2023-02-18,42,20,22,0.523809523809524
MTY SANTA LUCIA,2023-02-19,27,9,18,0.666666666666667
MTY SANTA LUCIA,2023-02-20,27,17,10,0.37037037037037
MTY SANTA LUCIA,2023-02-21,25,14,11,0.44
MTY SANTA LUCIA,2023-02-22,21,9,12,0.571428571428571
MTY SANTA LUCIA,2023-02-23,21,10,11,0.523809523809524
MTY SANTA LUCIA,2023-02-24,23,8,15,0.652173913043478
MTY SANTA LUCIA,2023-02-25,49,25,24,0.489795918367347
MTY SANTA LUCIA,2023-02-26,21,7,14,0.666666666666667
MTY SANTA LUCIA,2023-02-27,15,9,6,0.4
MTY SANTA LUCIA,2023-02-28,23,10,13,0.565217391304348
MTY SANTA LUCIA,2023-03-01,25,15,10,0.4
MTY SANTA LUCIA,2023-03-02,20,11,9,0.45
MTY SANTA LUCIA,2023-03-03,28,16,12,0.428571428571429
MTY SANTA LUCIA,2023-03-04,39,27,12,0.307692307692308
MTY SANTA LUCIA,2023-03-05,28,16,12,0.428571428571429
MTY SANTA LUCIA,2023-03-06,28,18,10,0.357142857142857
MTY SANTA LUCIA,2023-03-07,19,12,7,0.368421052631579
MTY SANTA LUCIA,2023-03-08,35,24,11,0.314285714285714
MTY SANTA LUCIA,2023-03-09,32,18,14,0.4375
MTY SANTA LUCIA,2023-03-10,28,20,8,0.285714285714286
MTY SANTA LUCIA,2023-03-11,28,23,5,0.178571428571429
MTY SANTA LUCIA,2023-03-12,24,15,9,0.375
MTY SANTA LUCIA,2023-03-13,24,17,7,0.291666666666667
MTY SANTA LUCIA,2023-03-14,22,10,12,0.545454545454545
MTY SANTA LUCIA,2023-03-15,19,18,1,0.0526315789473684
MTY SANTA LUCIA,2023-03-16,18,14,4,0.222222222222222
MTY SANTA LUCIA,2023-03-17,34,27,7,0.205882352941176
MTY SANTA LUCIA,2023-03-18,41,34,7,0.170731707317073
MTY SANTA LUCIA,2023-03-19,21,18,3,0.142857142857143
MTY SANTA LUCIA,2023-03-20,23,18,5,0.217391304347826
MTY SANTA LUCIA,2023-03-21,36,28,8,0.222222222222222
MTY SANTA LUCIA,2023-03-22,31,27,4,0.129032258064516
MTY SANTA LUCIA,2023-03-23,31,27,4,0.129032258064516
MTY SANTA LUCIA,2023-03-24,34,27,7,0.205882352941176
MTY SANTA LUCIA,2023-03-25,28,25,3,0.107142857142857
MTY SANTA LUCIA,2023-03-26,25,21,4,0.16
MTY SANTA LUCIA,2023-03-27,23,22,1,0.0434782608695652
MTY SANTA LUCIA,2023-03-28,23,21,2,0.0869565217391304
MTY SANTA LUCIA,2023-03-29,22,18,4,0.181818181818182
MTY SANTA LUCIA,2023-03-30,41,39,2,0.0487804878048781
MTY SANTA LUCIA,2023-03-31,46,37,9,0.195652173913043
MTY SANTA LUCIA,2023-04-01,20,18,2,0.1
MTY SANTA LUCIA,2023-04-02,21,17,4,0.19047619047619
MTY SANTA LUCIA,2023-04-03,25,20,5,0.2
MTY SANTA LUCIA,2023-04-04,21,21,0,0
MTY SANTA LUCIA,2023-04-05,23,23,0,0
MTY SANTA LUCIA,2023-04-06,32,32,0,0
MTY SANTA LUCIA,2023-04-07,30,30,0,0
MTY SANTA LUCIA,2023-04-08,22,22,0,0
MTY SANTA LUCIA,2023-04-09,14,14,0,0
MTY SANTA LUCIA,2023-04-10,19,19,0,0
MTY SANTA LUCIA,2023-04-11,23,23,0,0
MTY SANTA LUCIA,2023-04-12,14,14,0,0
MTY SANTA LUCIA,2023-04-13,14,14,0,0
MTY SANTA LUCIA,2023-04-14,23,23,0,0
MTY SANTA LUCIA,2023-04-15,19,19,0,0
MTY SANTA LUCIA,2023-04-16,23,23,0,0
MTY SANTA LUCIA,2023-04-17,41,41,0,0
MTY SANTA LUCIA,2023-04-18,42,42,0,0
MTY SANTA LUCIA,2023-04-19,26,26,0,0
MTY SANTA LUCIA,2023-04-20,34,34,0,0
MTY SANTA LUCIA,2023-04-21,54,54,0,0
MTY SANTA LUCIA,2023-04-22,39,39,0,0
MTY SANTA LUCIA,2023-04-23,37,37,0,0
MTY SANTA LUCIA,2023-04-24,25,25,0,0
MTY SANTA LUCIA,2023-04-25,28,28,0,0
MTY SANTA LUCIA,2023-04-26,38,38,0,0
MTY SANTA LUCIA,2023-04-27,31,31,0,0
MTY SANTA LUCIA,2023-04-28,25,25,0,0
MTY SANTA LUCIA,2023-04-29,59,59,0,0
MTY SANTA LUCIA,2023-04-30,23,23,0,0
MTY SANTA LUCIA,2023-05-01,26,26,0,0
MTY SANTA LUCIA,2023-05-02,25,25,0,0
MTY SANTA LUCIA,2023-05-03,35,35,0,0
MTY SANTA LUCIA,2023-05-04,30,30,0,0
MTY SANTA LUCIA,2023-05-05,33,33,0,0
MTY SANTA LUCIA,2023-05-06,38,38,0,0
MTY SANTA LUCIA,2023-05-07,29,29,0,0
MTY SANTA LUCIA,2023-05-08,24,24,0,0
MTY SENDERO DIVISORIO,2023-01-02,23,9,14,0.608695652173913
MTY SENDERO DIVISORIO,2023-01-03,28,16,12,0.428571428571429
MTY SENDERO DIVISORIO,2023-01-04,33,13,20,0.606060606060606
MTY SENDERO DIVISORIO,2023-01-05,22,12,10,0.454545454545455
MTY SENDERO DIVISORIO,2023-01-06,31,16,15,0.483870967741935
MTY SENDERO DIVISORIO,2023-01-07,37,21,16,0.432432432432432
MTY SENDERO DIVISORIO,2023-01-08,19,9,10,0.526315789473684
MTY SENDERO DIVISORIO,2023-01-09,18,4,14,0.777777777777778
MTY SENDERO DIVISORIO,2023-01-10,26,17,9,0.346153846153846
MTY SENDERO DIVISORIO,2023-01-11,27,14,13,0.481481481481481
MTY SENDERO DIVISORIO,2023-01-12,20,7,13,0.65
MTY SENDERO DIVISORIO,2023-01-13,23,14,9,0.391304347826087
MTY SENDERO DIVISORIO,2023-01-14,36,16,20,0.555555555555556
MTY SENDERO DIVISORIO,2023-01-15,17,10,7,0.411764705882353
MTY SENDERO DIVISORIO,2023-01-16,28,17,11,0.392857142857143
MTY SENDERO DIVISORIO,2023-01-17,24,13,11,0.458333333333333
MTY SENDERO DIVISORIO,2023-01-18,22,10,12,0.545454545454545
MTY SENDERO DIVISORIO,2023-01-19,15,7,8,0.533333333333333
MTY SENDERO DIVISORIO,2023-01-20,24,12,12,0.5
MTY SENDERO DIVISORIO,2023-01-21,38,22,16,0.421052631578947
MTY SENDERO DIVISORIO,2023-01-22,16,8,8,0.5
MTY SENDERO DIVISORIO,2023-01-23,29,16,13,0.448275862068966
MTY SENDERO DIVISORIO,2023-01-24,23,16,7,0.304347826086957
MTY SENDERO DIVISORIO,2023-01-25,29,15,14,0.482758620689655
MTY SENDERO DIVISORIO,2023-01-26,25,15,10,0.4
MTY SENDERO DIVISORIO,2023-01-27,27,13,14,0.518518518518518
MTY SENDERO DIVISORIO,2023-01-28,92,21,71,0.771739130434783
MTY SENDERO DIVISORIO,2023-01-29,39,6,33,0.846153846153846
MTY SENDERO DIVISORIO,2023-01-30,34,16,18,0.529411764705882
MTY SENDERO DIVISORIO,2023-01-31,19,12,7,0.368421052631579
MTY SENDERO DIVISORIO,2023-02-01,21,13,8,0.380952380952381
MTY SENDERO DIVISORIO,2023-02-02,30,15,15,0.5
MTY SENDERO DIVISORIO,2023-02-03,29,10,19,0.655172413793103
MTY SENDERO DIVISORIO,2023-02-04,54,27,27,0.5
MTY SENDERO DIVISORIO,2023-02-05,25,12,13,0.52
MTY SENDERO DIVISORIO,2023-02-06,30,14,16,0.533333333333333
MTY SENDERO DIVISORIO,2023-02-07,31,13,18,0.580645161290323
MTY SENDERO DIVISORIO,2023-02-08,31,21,10,0.32258064516129
MTY SENDERO DIVISORIO,2023-02-09,26,18,8,0.307692307692308
MTY SENDERO DIVISORIO,2023-02-10,29,14,15,0.517241379310345
MTY SENDERO DIVISORIO,2023-02-11,22,13,9,0.409090909090909
MTY SENDERO DIVISORIO,2023-02-12,21,12,9,0.428571428571429
MTY SENDERO DIVISORIO,2023-02-13,22,10,12,0.545454545454545
MTY SENDERO DIVISORIO,2023-02-14,19,10,9,0.473684210526316
MTY SENDERO DIVISORIO,2023-02-15,27,13,14,0.518518518518518
MTY SENDERO DIVISORIO,2023-02-16,23,16,7,0.304347826086957
MTY SENDERO DIVISORIO,2023-02-17,37,14,23,0.621621621621622
MTY SENDERO DIVISORIO,2023-02-18,52,23,29,0.557692307692308
MTY SENDERO DIVISORIO,2023-02-19,23,8,15,0.652173913043478
MTY SENDERO DIVISORIO,2023-02-20,24,12,12,0.5
MTY SENDERO DIVISORIO,2023-02-21,17,8,9,0.529411764705882
MTY SENDERO DIVISORIO,2023-02-22,34,17,17,0.5
MTY SENDERO DIVISORIO,2023-02-23,26,13,13,0.5
MTY SENDERO DIVISORIO,2023-02-24,23,15,8,0.347826086956522
MTY SENDERO DIVISORIO,2023-02-25,54,19,35,0.648148148148148
MTY SENDERO DIVISORIO,2023-02-26,25,12,13,0.52
MTY SENDERO DIVISORIO,2023-02-27,41,18,23,0.560975609756098
MTY SENDERO DIVISORIO,2023-02-28,28,14,14,0.5
MTY SENDERO DIVISORIO,2023-03-01,32,13,19,0.59375
MTY SENDERO DIVISORIO,2023-03-02,25,14,11,0.44
MTY SENDERO DIVISORIO,2023-03-03,32,17,15,0.46875
MTY SENDERO DIVISORIO,2023-03-04,45,23,22,0.488888888888889
MTY SENDERO DIVISORIO,2023-03-05,16,9,7,0.4375
MTY SENDERO DIVISORIO,2023-03-06,26,13,13,0.5
MTY SENDERO DIVISORIO,2023-03-07,31,18,13,0.419354838709677
MTY SENDERO DIVISORIO,2023-03-08,42,23,19,0.452380952380952
MTY SENDERO DIVISORIO,2023-03-09,32,25,7,0.21875
MTY SENDERO DIVISORIO,2023-03-10,32,20,12,0.375
MTY SENDERO DIVISORIO,2023-03-11,46,25,21,0.456521739130435
MTY SENDERO DIVISORIO,2023-03-12,34,21,13,0.382352941176471
MTY SENDERO DIVISORIO,2023-03-13,24,14,10,0.416666666666667
MTY SENDERO DIVISORIO,2023-03-14,24,15,9,0.375
MTY SENDERO DIVISORIO,2023-03-15,34,23,11,0.323529411764706
MTY SENDERO DIVISORIO,2023-03-16,32,24,8,0.25
MTY SENDERO DIVISORIO,2023-03-17,27,18,9,0.333333333333333
MTY SENDERO DIVISORIO,2023-03-18,44,36,8,0.181818181818182
MTY SENDERO DIVISORIO,2023-03-19,17,11,6,0.352941176470588
MTY SENDERO DIVISORIO,2023-03-20,9,7,2,0.222222222222222
MTY SENDERO DIVISORIO,2023-03-21,30,23,7,0.233333333333333
MTY SENDERO DIVISORIO,2023-03-22,42,39,3,0.0714285714285714
MTY SENDERO DIVISORIO,2023-03-23,35,35,0,0
MTY SENDERO DIVISORIO,2023-03-24,44,44,0,0
MTY SENDERO DIVISORIO,2023-03-25,37,36,1,0.027027027027027
MTY SENDERO DIVISORIO,2023-03-26,18,16,2,0.111111111111111
MTY SENDERO DIVISORIO,2023-03-27,42,42,0,0
MTY SENDERO DIVISORIO,2023-03-28,25,25,0,0
MTY SENDERO DIVISORIO,2023-03-29,35,35,0,0
MTY SENDERO DIVISORIO,2023-03-30,30,30,0,0
MTY SENDERO DIVISORIO,2023-03-31,50,50,0,0
MTY SENDERO DIVISORIO,2023-04-01,20,19,1,0.05
MTY SENDERO DIVISORIO,2023-04-02,21,20,1,0.0476190476190476
MTY SENDERO DIVISORIO,2023-04-03,29,29,0,0
MTY SENDERO DIVISORIO,2023-04-04,24,24,0,0
MTY SENDERO DIVISORIO,2023-04-05,25,25,0,0
MTY SENDERO DIVISORIO,2023-04-06,38,38,0,0
MTY SENDERO DIVISORIO,2023-04-07,26,26,0,0
MTY SENDERO DIVISORIO,2023-04-08,43,43,0,0
MTY SENDERO DIVISORIO,2023-04-09,19,19,0,0
MTY SENDERO DIVISORIO,2023-04-10,22,22,0,0
MTY SENDERO DIVISORIO,2023-04-11,39,39,0,0
MTY SENDERO DIVISORIO,2023-04-12,21,21,0,0
MTY SENDERO DIVISORIO,2023-04-13,14,14,0,0
MTY SENDERO DIVISORIO,2023-04-14,31,31,0,0
MTY SENDERO DIVISORIO,2023-04-15,37,37,0,0
MTY SENDERO DIVISORIO,2023-04-16,8,8,0,0
MTY SENDERO DIVISORIO,2023-04-17,35,35,0,0
MTY SENDERO DIVISORIO,2023-04-18,31,31,0,0
MTY SENDERO DIVISORIO,2023-04-19,26,26,0,0
MTY SENDERO DIVISORIO,2023-04-20,24,24,0,0
MTY SENDERO DIVISORIO,2023-04-21,25,25,0,0
MTY SENDERO DIVISORIO,2023-04-22,37,37,0,0
MTY SENDERO DIVISORIO,2023-04-23,29,29,0,0
MTY SENDERO DIVISORIO,2023-04-24,33,33,0,0
MTY SENDERO DIVISORIO,2023-04-25,39,39,0,0
MTY SENDERO DIVISORIO,2023-04-26,44,44,0,0
MTY SENDERO DIVISORIO,2023-04-27,22,22,0,0
MTY SENDERO DIVISORIO,2023-04-28,26,26,0,0
MTY SENDERO DIVISORIO,2023-04-29,35,35,0,0
MTY SENDERO DIVISORIO,2023-04-30,30,30,0,0
MTY SENDERO DIVISORIO,2023-05-01,23,23,0,0
MTY SENDERO DIVISORIO,2023-05-02,37,37,0,0
MTY SENDERO DIVISORIO,2023-05-03,29,29,0,0
MTY SENDERO DIVISORIO,2023-05-04,33,33,0,0
MTY SENDERO DIVISORIO,2023-05-05,27,27,0,0
MTY SENDERO DIVISORIO,2023-05-06,31,31,0,0
MTY SENDERO DIVISORIO,2023-05-07,25,25,0,0
MTY SENDERO DIVISORIO,2023-05-08,22,22,0,0
MTY SIERRA MADRE,2023-01-02,11,8,3,0.272727272727273
MTY SIERRA MADRE,2023-01-03,23,13,10,0.434782608695652
MTY SIERRA MADRE,2023-01-04,26,16,10,0.384615384615385
MTY SIERRA MADRE,2023-01-05,24,19,5,0.208333333333333
MTY SIERRA MADRE,2023-01-06,30,24,6,0.2
MTY SIERRA MADRE,2023-01-07,33,26,7,0.212121212121212
MTY SIERRA MADRE,2023-01-08,11,10,1,0.0909090909090909
MTY SIERRA MADRE,2023-01-09,19,12,7,0.368421052631579
MTY SIERRA MADRE,2023-01-10,21,14,7,0.333333333333333
MTY SIERRA MADRE,2023-01-11,22,17,5,0.227272727272727
MTY SIERRA MADRE,2023-01-12,22,15,7,0.318181818181818
MTY SIERRA MADRE,2023-01-13,31,19,12,0.387096774193548
MTY SIERRA MADRE,2023-01-14,19,11,8,0.421052631578947
MTY SIERRA MADRE,2023-01-15,18,11,7,0.388888888888889
MTY SIERRA MADRE,2023-01-16,20,15,5,0.25
MTY SIERRA MADRE,2023-01-17,17,8,9,0.529411764705882
MTY SIERRA MADRE,2023-01-18,24,19,5,0.208333333333333
MTY SIERRA MADRE,2023-01-19,27,12,15,0.555555555555556
MTY SIERRA MADRE,2023-01-20,18,9,9,0.5
MTY SIERRA MADRE,2023-01-21,26,16,10,0.384615384615385
MTY SIERRA MADRE,2023-01-22,15,8,7,0.466666666666667
MTY SIERRA MADRE,2023-01-23,25,12,13,0.52
MTY SIERRA MADRE,2023-01-24,29,22,7,0.241379310344828
MTY SIERRA MADRE,2023-01-25,22,16,6,0.272727272727273
MTY SIERRA MADRE,2023-01-26,24,13,11,0.458333333333333
MTY SIERRA MADRE,2023-01-27,21,14,7,0.333333333333333
MTY SIERRA MADRE,2023-01-28,34,20,14,0.411764705882353
MTY SIERRA MADRE,2023-01-29,14,9,5,0.357142857142857
MTY SIERRA MADRE,2023-01-30,24,15,9,0.375
MTY SIERRA MADRE,2023-01-31,19,10,9,0.473684210526316
MTY SIERRA MADRE,2023-02-01,14,7,7,0.5
MTY SIERRA MADRE,2023-02-02,28,20,8,0.285714285714286
MTY SIERRA MADRE,2023-02-03,20,10,10,0.5
MTY SIERRA MADRE,2023-02-04,28,17,11,0.392857142857143
MTY SIERRA MADRE,2023-02-05,15,13,2,0.133333333333333
MTY SIERRA MADRE,2023-02-06,9,8,1,0.111111111111111
MTY SIERRA MADRE,2023-02-07,10,8,2,0.2
MTY SIERRA MADRE,2023-02-08,21,10,11,0.523809523809524
MTY SIERRA MADRE,2023-02-09,23,12,11,0.478260869565217
MTY SIERRA MADRE,2023-02-10,24,17,7,0.291666666666667
MTY SIERRA MADRE,2023-02-11,35,25,10,0.285714285714286
MTY SIERRA MADRE,2023-02-12,16,12,4,0.25
MTY SIERRA MADRE,2023-02-13,15,9,6,0.4
MTY SIERRA MADRE,2023-02-14,23,13,10,0.434782608695652
MTY SIERRA MADRE,2023-02-15,21,15,6,0.285714285714286
MTY SIERRA MADRE,2023-02-16,24,18,6,0.25
MTY SIERRA MADRE,2023-02-17,28,17,11,0.392857142857143
MTY SIERRA MADRE,2023-02-18,26,16,10,0.384615384615385
MTY SIERRA MADRE,2023-02-19,8,6,2,0.25
MTY SIERRA MADRE,2023-02-20,20,14,6,0.3
MTY SIERRA MADRE,2023-02-21,21,11,10,0.476190476190476
MTY SIERRA MADRE,2023-02-22,28,21,7,0.25
MTY SIERRA MADRE,2023-02-23,21,13,8,0.380952380952381
MTY SIERRA MADRE,2023-02-24,18,12,6,0.333333333333333
MTY SIERRA MADRE,2023-02-25,19,13,6,0.315789473684211
MTY SIERRA MADRE,2023-02-26,12,8,4,0.333333333333333
MTY SIERRA MADRE,2023-02-27,19,13,6,0.315789473684211
MTY SIERRA MADRE,2023-02-28,32,20,12,0.375
MTY SIERRA MADRE,2023-03-01,24,19,5,0.208333333333333
MTY SIERRA MADRE,2023-03-02,29,24,5,0.172413793103448
MTY SIERRA MADRE,2023-03-03,36,21,15,0.416666666666667
MTY SIERRA MADRE,2023-03-04,30,23,7,0.233333333333333
MTY SIERRA MADRE,2023-03-05,13,11,2,0.153846153846154
MTY SIERRA MADRE,2023-03-06,23,20,3,0.130434782608696
MTY SIERRA MADRE,2023-03-07,23,15,8,0.347826086956522
MTY SIERRA MADRE,2023-03-08,16,14,2,0.125
MTY SIERRA MADRE,2023-03-09,25,19,6,0.24
MTY SIERRA MADRE,2023-03-10,22,17,5,0.227272727272727
MTY SIERRA MADRE,2023-03-11,38,32,6,0.157894736842105
MTY SIERRA MADRE,2023-03-12,12,10,2,0.166666666666667
MTY SIERRA MADRE,2023-03-13,16,14,2,0.125
MTY SIERRA MADRE,2023-03-14,25,18,7,0.28
MTY SIERRA MADRE,2023-03-15,25,25,0,0
MTY SIERRA MADRE,2023-03-16,30,30,0,0
MTY SIERRA MADRE,2023-03-17,21,17,4,0.19047619047619
MTY SIERRA MADRE,2023-03-18,33,31,2,0.0606060606060606
MTY SIERRA MADRE,2023-03-19,11,11,0,0
MTY SIERRA MADRE,2023-03-20,19,16,3,0.157894736842105
MTY SIERRA MADRE,2023-03-21,23,22,1,0.0434782608695652
MTY SIERRA MADRE,2023-03-22,32,28,4,0.125
MTY SIERRA MADRE,2023-03-23,32,32,0,0
MTY SIERRA MADRE,2023-03-24,23,23,0,0
MTY SIERRA MADRE,2023-03-25,27,25,2,0.0740740740740741
MTY SIERRA MADRE,2023-03-26,26,24,2,0.0769230769230769
MTY SIERRA MADRE,2023-03-27,30,27,3,0.1
MTY SIERRA MADRE,2023-03-28,18,16,2,0.111111111111111
MTY SIERRA MADRE,2023-03-29,26,25,1,0.0384615384615385
MTY SIERRA MADRE,2023-03-30,23,21,2,0.0869565217391304
MTY SIERRA MADRE,2023-03-31,40,38,2,0.05
MTY SIERRA MADRE,2023-04-01,29,28,1,0.0344827586206897
MTY SIERRA MADRE,2023-04-02,17,17,0,0
MTY SIERRA MADRE,2023-04-03,26,26,0,0
MTY SIERRA MADRE,2023-04-04,15,15,0,0
MTY SIERRA MADRE,2023-04-05,21,21,0,0
MTY SIERRA MADRE,2023-04-06,25,25,0,0
MTY SIERRA MADRE,2023-04-07,29,29,0,0
MTY SIERRA MADRE,2023-04-08,24,24,0,0
MTY SIERRA MADRE,2023-04-09,9,9,0,0
MTY SIERRA MADRE,2023-04-10,18,18,0,0
MTY SIERRA MADRE,2023-04-11,26,26,0,0
MTY SIERRA MADRE,2023-04-12,21,21,0,0
MTY SIERRA MADRE,2023-04-13,16,16,0,0
MTY SIERRA MADRE,2023-04-14,25,25,0,0
MTY SIERRA MADRE,2023-04-15,45,45,0,0
MTY SIERRA MADRE,2023-04-16,20,20,0,0
MTY SIERRA MADRE,2023-04-17,20,20,0,0
MTY SIERRA MADRE,2023-04-18,28,28,0,0
MTY SIERRA MADRE,2023-04-19,25,25,0,0
MTY SIERRA MADRE,2023-04-20,22,22,0,0
MTY SIERRA MADRE,2023-04-21,27,27,0,0
MTY SIERRA MADRE,2023-04-22,34,34,0,0
MTY SIERRA MADRE,2023-04-23,20,20,0,0
MTY SIERRA MADRE,2023-04-24,23,23,0,0
MTY SIERRA MADRE,2023-04-25,19,19,0,0
MTY SIERRA MADRE,2023-04-26,20,20,0,0
MTY SIERRA MADRE,2023-04-27,14,14,0,0
MTY SIERRA MADRE,2023-04-28,17,17,0,0
MTY SIERRA MADRE,2023-04-29,29,29,0,0
MTY SIERRA MADRE,2023-04-30,30,30,0,0
MTY SIERRA MADRE,2023-05-01,10,10,0,0
MTY SIERRA MADRE,2023-05-02,20,20,0,0
MTY SIERRA MADRE,2023-05-03,25,25,0,0
MTY SIERRA MADRE,2023-05-04,21,21,0,0
MTY SIERRA MADRE,2023-05-05,29,29,0,0
MTY SIERRA MADRE,2023-05-06,33,33,0,0
MTY SIERRA MADRE,2023-05-07,22,22,0,0
MTY SIERRA MADRE,2023-05-08,18,18,0,0
NAUCALPAN,2023-01-02,24,19,5,0.208333333333333
NAUCALPAN,2023-01-03,25,20,5,0.2
NAUCALPAN,2023-01-04,27,25,2,0.0740740740740741
NAUCALPAN,2023-01-05,24,18,6,0.25
NAUCALPAN,2023-01-06,32,22,10,0.3125
NAUCALPAN,2023-01-07,43,37,6,0.13953488372093
NAUCALPAN,2023-01-08,34,21,13,0.382352941176471
NAUCALPAN,2023-01-09,33,19,14,0.424242424242424
NAUCALPAN,2023-01-10,27,14,13,0.481481481481481
NAUCALPAN,2023-01-11,31,23,8,0.258064516129032
NAUCALPAN,2023-01-12,24,16,8,0.333333333333333
NAUCALPAN,2023-01-13,35,24,11,0.314285714285714
NAUCALPAN,2023-01-14,46,34,12,0.260869565217391
NAUCALPAN,2023-01-15,44,32,12,0.272727272727273
NAUCALPAN,2023-01-16,39,13,26,0.666666666666667
NAUCALPAN,2023-01-17,34,16,18,0.529411764705882
NAUCALPAN,2023-01-18,40,21,19,0.475
NAUCALPAN,2023-01-19,29,14,15,0.517241379310345
NAUCALPAN,2023-01-20,35,24,11,0.314285714285714
NAUCALPAN,2023-01-21,50,33,17,0.34
NAUCALPAN,2023-01-22,30,25,5,0.166666666666667
NAUCALPAN,2023-01-23,38,29,9,0.236842105263158
NAUCALPAN,2023-01-24,48,35,13,0.270833333333333
NAUCALPAN,2023-01-25,23,17,6,0.260869565217391
NAUCALPAN,2023-01-26,31,24,7,0.225806451612903
NAUCALPAN,2023-01-27,30,25,5,0.166666666666667
NAUCALPAN,2023-01-28,38,27,11,0.289473684210526
NAUCALPAN,2023-01-29,35,28,7,0.2
NAUCALPAN,2023-01-30,36,29,7,0.194444444444444
NAUCALPAN,2023-01-31,34,25,9,0.264705882352941
NAUCALPAN,2023-02-01,27,18,9,0.333333333333333
NAUCALPAN,2023-02-02,32,25,7,0.21875
NAUCALPAN,2023-02-03,40,29,11,0.275
NAUCALPAN,2023-02-04,43,29,14,0.325581395348837
NAUCALPAN,2023-02-05,28,22,6,0.214285714285714
NAUCALPAN,2023-02-06,24,19,5,0.208333333333333
NAUCALPAN,2023-02-07,24,16,8,0.333333333333333
NAUCALPAN,2023-02-08,35,15,20,0.571428571428571
NAUCALPAN,2023-02-09,29,14,15,0.517241379310345
NAUCALPAN,2023-02-10,29,15,14,0.482758620689655
NAUCALPAN,2023-02-11,44,18,26,0.590909090909091
NAUCALPAN,2023-02-12,43,23,20,0.465116279069767
NAUCALPAN,2023-02-13,28,16,12,0.428571428571429
NAUCALPAN,2023-02-14,18,7,11,0.611111111111111
NAUCALPAN,2023-02-15,34,17,17,0.5
NAUCALPAN,2023-02-16,28,19,9,0.321428571428571
NAUCALPAN,2023-02-17,24,16,8,0.333333333333333
NAUCALPAN,2023-02-18,45,28,17,0.377777777777778
NAUCALPAN,2023-02-19,38,19,19,0.5
NAUCALPAN,2023-02-20,25,21,4,0.16
NAUCALPAN,2023-02-21,29,21,8,0.275862068965517
NAUCALPAN,2023-02-22,31,21,10,0.32258064516129
NAUCALPAN,2023-02-23,33,19,14,0.424242424242424
NAUCALPAN,2023-02-24,32,20,12,0.375
NAUCALPAN,2023-02-25,35,20,15,0.428571428571429
NAUCALPAN,2023-02-26,35,24,11,0.314285714285714
NAUCALPAN,2023-02-27,34,17,17,0.5
NAUCALPAN,2023-02-28,34,22,12,0.352941176470588
NAUCALPAN,2023-03-01,42,28,14,0.333333333333333
NAUCALPAN,2023-03-02,28,19,9,0.321428571428571
NAUCALPAN,2023-03-03,36,25,11,0.305555555555556
NAUCALPAN,2023-03-04,49,31,18,0.36734693877551
NAUCALPAN,2023-03-05,36,23,13,0.361111111111111
NAUCALPAN,2023-03-06,35,24,11,0.314285714285714
NAUCALPAN,2023-03-07,30,16,14,0.466666666666667
NAUCALPAN,2023-03-08,30,19,11,0.366666666666667
NAUCALPAN,2023-03-09,32,23,9,0.28125
NAUCALPAN,2023-03-10,28,21,7,0.25
NAUCALPAN,2023-03-11,39,28,11,0.282051282051282
NAUCALPAN,2023-03-12,30,24,6,0.2
NAUCALPAN,2023-03-13,27,18,9,0.333333333333333
NAUCALPAN,2023-03-14,35,27,8,0.228571428571429
NAUCALPAN,2023-03-15,39,29,10,0.256410256410256
NAUCALPAN,2023-03-16,35,25,10,0.285714285714286
NAUCALPAN,2023-03-17,47,37,10,0.212765957446809
NAUCALPAN,2023-03-18,61,48,13,0.213114754098361
NAUCALPAN,2023-03-19,58,44,14,0.241379310344828
NAUCALPAN,2023-03-20,46,37,9,0.195652173913043
NAUCALPAN,2023-03-21,42,39,3,0.0714285714285714
NAUCALPAN,2023-03-22,30,27,3,0.1
NAUCALPAN,2023-03-23,42,36,6,0.142857142857143
NAUCALPAN,2023-03-24,39,35,4,0.102564102564103
NAUCALPAN,2023-03-25,41,39,2,0.0487804878048781
NAUCALPAN,2023-03-26,30,28,2,0.0666666666666667
NAUCALPAN,2023-03-27,33,32,1,0.0303030303030303
NAUCALPAN,2023-03-28,27,24,3,0.111111111111111
NAUCALPAN,2023-03-29,32,30,2,0.0625
NAUCALPAN,2023-03-30,39,38,1,0.0256410256410256
NAUCALPAN,2023-03-31,53,48,5,0.0943396226415094
NAUCALPAN,2023-04-01,46,44,2,0.0434782608695652
NAUCALPAN,2023-04-02,32,28,4,0.125
NAUCALPAN,2023-04-03,29,29,0,0
NAUCALPAN,2023-04-04,39,32,7,0.179487179487179
NAUCALPAN,2023-04-05,36,30,6,0.166666666666667
NAUCALPAN,2023-04-06,36,34,2,0.0555555555555556
NAUCALPAN,2023-04-07,32,28,4,0.125
NAUCALPAN,2023-04-08,26,23,3,0.115384615384615
NAUCALPAN,2023-04-09,27,25,2,0.0740740740740741
NAUCALPAN,2023-04-10,19,16,3,0.157894736842105
NAUCALPAN,2023-04-11,30,27,3,0.1
NAUCALPAN,2023-04-12,31,31,0,0
NAUCALPAN,2023-04-13,32,31,1,0.03125
NAUCALPAN,2023-04-14,28,22,6,0.214285714285714
NAUCALPAN,2023-04-15,51,41,10,0.196078431372549
NAUCALPAN,2023-04-16,58,52,6,0.103448275862069
NAUCALPAN,2023-04-17,50,46,4,0.08
NAUCALPAN,2023-04-18,31,26,5,0.161290322580645
NAUCALPAN,2023-04-19,36,31,5,0.138888888888889
NAUCALPAN,2023-04-20,39,33,6,0.153846153846154
NAUCALPAN,2023-04-21,34,33,1,0.0294117647058824
NAUCALPAN,2023-04-22,46,42,4,0.0869565217391304
NAUCALPAN,2023-04-23,50,47,3,0.06
NAUCALPAN,2023-04-24,45,42,3,0.0666666666666667
NAUCALPAN,2023-04-25,51,41,10,0.196078431372549
NAUCALPAN,2023-04-26,34,33,1,0.0294117647058824
NAUCALPAN,2023-04-27,30,30,0,0
NAUCALPAN,2023-04-28,37,35,2,0.0540540540540541
NAUCALPAN,2023-04-29,65,58,7,0.107692307692308
NAUCALPAN,2023-04-30,42,37,5,0.119047619047619
NAUCALPAN,2023-05-01,13,13,0,0
NAUCALPAN,2023-05-02,42,36,6,0.142857142857143
NAUCALPAN,2023-05-03,23,17,6,0.260869565217391
NAUCALPAN,2023-05-04,50,46,4,0.08
NAUCALPAN,2023-05-05,27,25,2,0.0740740740740741
NAUCALPAN,2023-05-06,42,37,5,0.119047619047619
NAUCALPAN,2023-05-07,37,30,7,0.189189189189189
NAUCALPAN,2023-05-08,36,30,6,0.166666666666667
NEZA 1,2023-01-02,23,22,1,0.0434782608695652
NEZA 1,2023-01-03,26,23,3,0.115384615384615
NEZA 1,2023-01-04,35,34,1,0.0285714285714286
NEZA 1,2023-01-05,30,24,6,0.2
NEZA 1,2023-01-06,37,32,5,0.135135135135135
NEZA 1,2023-01-07,36,31,5,0.138888888888889
NEZA 1,2023-01-08,33,31,2,0.0606060606060606
NEZA 1,2023-01-09,27,25,2,0.0740740740740741
NEZA 1,2023-01-10,31,31,0,0
NEZA 1,2023-01-11,28,25,3,0.107142857142857
NEZA 1,2023-01-12,26,26,0,0
NEZA 1,2023-01-13,29,28,1,0.0344827586206897
NEZA 1,2023-01-14,44,36,8,0.181818181818182
NEZA 1,2023-01-15,35,31,4,0.114285714285714
NEZA 1,2023-01-16,24,18,6,0.25
NEZA 1,2023-01-17,33,28,5,0.151515151515152
NEZA 1,2023-01-18,39,32,7,0.179487179487179
NEZA 1,2023-01-19,32,29,3,0.09375
NEZA 1,2023-01-20,29,23,6,0.206896551724138
NEZA 1,2023-01-21,28,15,13,0.464285714285714
NEZA 1,2023-01-22,34,18,16,0.470588235294118
NEZA 1,2023-01-23,30,17,13,0.433333333333333
NEZA 1,2023-01-24,33,23,10,0.303030303030303
NEZA 1,2023-01-25,21,19,2,0.0952380952380952
NEZA 1,2023-01-26,40,30,10,0.25
NEZA 1,2023-01-27,23,18,5,0.217391304347826
NEZA 1,2023-01-28,34,26,8,0.235294117647059
NEZA 1,2023-01-29,38,32,6,0.157894736842105
NEZA 1,2023-01-30,37,28,9,0.243243243243243
NEZA 1,2023-01-31,52,46,6,0.115384615384615
NEZA 1,2023-02-01,25,23,2,0.08
NEZA 1,2023-02-02,40,37,3,0.075
NEZA 1,2023-02-03,30,30,0,0
NEZA 1,2023-02-04,32,32,0,0
NEZA 1,2023-02-05,36,33,3,0.0833333333333333
NEZA 1,2023-02-06,46,43,3,0.0652173913043478
NEZA 1,2023-02-07,27,25,2,0.0740740740740741
NEZA 1,2023-02-08,30,28,2,0.0666666666666667
NEZA 1,2023-02-09,34,32,2,0.0588235294117647
NEZA 1,2023-02-10,23,20,3,0.130434782608696
NEZA 1,2023-02-11,33,30,3,0.0909090909090909
NEZA 1,2023-02-12,25,24,1,0.04
NEZA 1,2023-02-13,27,25,2,0.0740740740740741
NEZA 1,2023-02-14,35,32,3,0.0857142857142857
NEZA 1,2023-02-15,31,29,2,0.0645161290322581
NEZA 1,2023-02-16,29,27,2,0.0689655172413793
NEZA 1,2023-02-17,34,32,2,0.0588235294117647
NEZA 1,2023-02-18,32,31,1,0.03125
NEZA 1,2023-02-19,28,26,2,0.0714285714285714
NEZA 1,2023-02-20,28,27,1,0.0357142857142857
NEZA 1,2023-02-21,26,25,1,0.0384615384615385
NEZA 1,2023-02-22,24,23,1,0.0416666666666667
NEZA 1,2023-02-23,26,25,1,0.0384615384615385
NEZA 1,2023-02-24,24,23,1,0.0416666666666667
NEZA 1,2023-02-25,36,34,2,0.0555555555555556
NEZA 1,2023-02-26,41,41,0,0
NEZA 1,2023-02-27,35,35,0,0
NEZA 1,2023-02-28,50,48,2,0.04
NEZA 1,2023-03-01,35,35,0,0
NEZA 1,2023-03-02,26,26,0,0
NEZA 1,2023-03-03,37,35,2,0.0540540540540541
NEZA 1,2023-03-04,40,40,0,0
NEZA 1,2023-03-05,32,32,0,0
NEZA 1,2023-03-06,30,30,0,0
NEZA 1,2023-03-07,27,26,1,0.037037037037037
NEZA 1,2023-03-08,29,29,0,0
NEZA 1,2023-03-09,30,28,2,0.0666666666666667
NEZA 1,2023-03-10,23,23,0,0
NEZA 1,2023-03-11,46,45,1,0.0217391304347826
NEZA 1,2023-03-12,31,31,0,0
NEZA 1,2023-03-13,33,33,0,0
NEZA 1,2023-03-14,32,32,0,0
NEZA 1,2023-03-15,34,34,0,0
NEZA 1,2023-03-16,56,56,0,0
NEZA 1,2023-03-17,61,61,0,0
NEZA 1,2023-03-18,55,54,1,0.0181818181818182
NEZA 1,2023-03-19,47,47,0,0
NEZA 1,2023-03-20,59,59,0,0
NEZA 1,2023-03-21,46,46,0,0
NEZA 1,2023-03-22,32,32,0,0
NEZA 1,2023-03-23,37,37,0,0
NEZA 1,2023-03-24,32,32,0,0
NEZA 1,2023-03-25,39,39,0,0
NEZA 1,2023-03-26,39,39,0,0
NEZA 1,2023-03-27,24,24,0,0
NEZA 1,2023-03-28,22,22,0,0
NEZA 1,2023-03-29,32,31,1,0.03125
NEZA 1,2023-03-30,48,47,1,0.0208333333333333
NEZA 1,2023-03-31,53,53,0,0
NEZA 1,2023-04-01,46,46,0,0
NEZA 1,2023-04-02,54,54,0,0
NEZA 1,2023-04-03,39,38,1,0.0256410256410256
NEZA 1,2023-04-04,33,33,0,0
NEZA 1,2023-04-05,34,34,0,0
NEZA 1,2023-04-06,37,37,0,0
NEZA 1,2023-04-07,22,22,0,0
NEZA 1,2023-04-08,19,19,0,0
NEZA 1,2023-04-09,33,33,0,0
NEZA 1,2023-04-10,29,29,0,0
NEZA 1,2023-04-11,26,26,0,0
NEZA 1,2023-04-12,44,44,0,0
NEZA 1,2023-04-13,30,30,0,0
NEZA 1,2023-04-14,45,45,0,0
NEZA 1,2023-04-15,51,51,0,0
NEZA 1,2023-04-16,64,64,0,0
NEZA 1,2023-04-17,43,43,0,0
NEZA 1,2023-04-18,32,32,0,0
NEZA 1,2023-04-19,34,34,0,0
NEZA 1,2023-04-20,25,25,0,0
NEZA 1,2023-04-21,38,38,0,0
NEZA 1,2023-04-22,47,47,0,0
NEZA 1,2023-04-23,27,27,0,0
NEZA 1,2023-04-24,32,32,0,0
NEZA 1,2023-04-25,43,43,0,0
NEZA 1,2023-04-26,36,36,0,0
NEZA 1,2023-04-27,34,34,0,0
NEZA 1,2023-04-28,44,44,0,0
NEZA 1,2023-04-29,46,46,0,0
NEZA 1,2023-04-30,43,43,0,0
NEZA 1,2023-05-01,43,43,0,0
NEZA 1,2023-05-02,30,30,0,0
NEZA 1,2023-05-03,29,29,0,0
NEZA 1,2023-05-04,35,35,0,0
NEZA 1,2023-05-05,33,33,0,0
NEZA 1,2023-05-06,48,48,0,0
NEZA 1,2023-05-07,29,29,0,0
NEZA 1,2023-05-08,31,31,0,0
NEZA 2,2023-01-02,25,25,0,0
NEZA 2,2023-01-03,28,27,1,0.0357142857142857
NEZA 2,2023-01-04,29,29,0,0
NEZA 2,2023-01-05,21,21,0,0
NEZA 2,2023-01-06,20,19,1,0.05
NEZA 2,2023-01-07,25,24,1,0.04
NEZA 2,2023-01-08,36,31,5,0.138888888888889
NEZA 2,2023-01-09,21,21,0,0
NEZA 2,2023-01-10,32,32,0,0
NEZA 2,2023-01-11,27,27,0,0
NEZA 2,2023-01-12,19,19,0,0
NEZA 2,2023-01-13,31,27,4,0.129032258064516
NEZA 2,2023-01-14,37,34,3,0.0810810810810811
NEZA 2,2023-01-15,34,30,4,0.117647058823529
NEZA 2,2023-01-16,26,24,2,0.0769230769230769
NEZA 2,2023-01-17,25,17,8,0.32
NEZA 2,2023-01-18,28,22,6,0.214285714285714
NEZA 2,2023-01-19,26,21,5,0.192307692307692
NEZA 2,2023-01-20,24,19,5,0.208333333333333
NEZA 2,2023-01-21,37,22,15,0.405405405405405
NEZA 2,2023-01-22,29,19,10,0.344827586206897
NEZA 2,2023-01-23,23,12,11,0.478260869565217
NEZA 2,2023-01-24,26,18,8,0.307692307692308
NEZA 2,2023-01-25,28,19,9,0.321428571428571
NEZA 2,2023-01-26,23,16,7,0.304347826086957
NEZA 2,2023-01-27,26,15,11,0.423076923076923
NEZA 2,2023-01-28,30,19,11,0.366666666666667
NEZA 2,2023-01-29,35,24,11,0.314285714285714
NEZA 2,2023-01-30,33,24,9,0.272727272727273
NEZA 2,2023-01-31,41,24,17,0.414634146341463
NEZA 2,2023-02-01,30,20,10,0.333333333333333
NEZA 2,2023-02-02,27,9,18,0.666666666666667
NEZA 2,2023-02-03,20,11,9,0.45
NEZA 2,2023-02-04,39,29,10,0.256410256410256
NEZA 2,2023-02-05,29,22,7,0.241379310344828
NEZA 2,2023-02-06,36,16,20,0.555555555555556
NEZA 2,2023-02-07,26,11,15,0.576923076923077
NEZA 2,2023-02-08,22,9,13,0.590909090909091
NEZA 2,2023-02-09,27,12,15,0.555555555555556
NEZA 2,2023-02-10,23,11,12,0.521739130434783
NEZA 2,2023-02-11,30,6,24,0.8
NEZA 2,2023-02-12,32,11,21,0.65625
NEZA 2,2023-02-13,35,10,25,0.714285714285714
NEZA 2,2023-02-14,33,14,19,0.575757575757576
NEZA 2,2023-02-15,37,13,24,0.648648648648649
NEZA 2,2023-02-16,23,10,13,0.565217391304348
NEZA 2,2023-02-17,29,9,20,0.689655172413793
NEZA 2,2023-02-18,33,11,22,0.666666666666667
NEZA 2,2023-02-19,33,9,24,0.727272727272727
NEZA 2,2023-02-20,24,7,17,0.708333333333333
NEZA 2,2023-02-21,25,25,0,0
NEZA 2,2023-02-22,25,25,0,0
NEZA 2,2023-02-23,29,28,1,0.0344827586206897
NEZA 2,2023-02-24,37,35,2,0.0540540540540541
NEZA 2,2023-02-25,28,25,3,0.107142857142857
NEZA 2,2023-02-26,32,29,3,0.09375
NEZA 2,2023-02-27,26,26,0,0
NEZA 2,2023-02-28,25,24,1,0.04
NEZA 2,2023-03-01,29,28,1,0.0344827586206897
NEZA 2,2023-03-02,20,18,2,0.1
NEZA 2,2023-03-03,32,30,2,0.0625
NEZA 2,2023-03-04,37,36,1,0.027027027027027
NEZA 2,2023-03-05,37,32,5,0.135135135135135
NEZA 2,2023-03-06,23,22,1,0.0434782608695652
NEZA 2,2023-03-07,36,32,4,0.111111111111111
NEZA 2,2023-03-08,31,30,1,0.032258064516129
NEZA 2,2023-03-09,28,28,0,0
NEZA 2,2023-03-10,28,28,0,0
NEZA 2,2023-03-11,23,23,0,0
NEZA 2,2023-03-12,28,27,1,0.0357142857142857
NEZA 2,2023-03-13,27,27,0,0
NEZA 2,2023-03-14,30,30,0,0
NEZA 2,2023-03-15,39,39,0,0
NEZA 2,2023-03-16,39,38,1,0.0256410256410256
NEZA 2,2023-03-17,43,43,0,0
NEZA 2,2023-03-18,46,46,0,0
NEZA 2,2023-03-19,50,49,1,0.02
NEZA 2,2023-03-20,43,43,0,0
NEZA 2,2023-03-21,29,28,1,0.0344827586206897
NEZA 2,2023-03-22,20,20,0,0
NEZA 2,2023-03-23,26,26,0,0
NEZA 2,2023-03-24,25,25,0,0
NEZA 2,2023-03-25,49,49,0,0
NEZA 2,2023-03-26,36,36,0,0
NEZA 2,2023-03-27,24,24,0,0
NEZA 2,2023-03-28,13,13,0,0
NEZA 2,2023-03-29,26,26,0,0
NEZA 2,2023-03-30,40,39,1,0.025
NEZA 2,2023-03-31,42,42,0,0
NEZA 2,2023-04-01,56,56,0,0
NEZA 2,2023-04-02,30,30,0,0
NEZA 2,2023-04-03,42,41,1,0.0238095238095238
NEZA 2,2023-04-04,22,22,0,0
NEZA 2,2023-04-05,25,25,0,0
NEZA 2,2023-04-06,29,29,0,0
NEZA 2,2023-04-07,28,28,0,0
NEZA 2,2023-04-08,28,28,0,0
NEZA 2,2023-04-09,15,15,0,0
NEZA 2,2023-04-10,36,36,0,0
NEZA 2,2023-04-11,31,31,0,0
NEZA 2,2023-04-12,27,27,0,0
NEZA 2,2023-04-13,25,25,0,0
NEZA 2,2023-04-14,21,21,0,0
NEZA 2,2023-04-15,41,41,0,0
NEZA 2,2023-04-16,72,72,0,0
NEZA 2,2023-04-17,40,40,0,0
NEZA 2,2023-04-18,40,40,0,0
NEZA 2,2023-04-19,35,35,0,0
NEZA 2,2023-04-20,24,24,0,0
NEZA 2,2023-04-21,31,31,0,0
NEZA 2,2023-04-22,30,30,0,0
NEZA 2,2023-04-23,33,33,0,0
NEZA 2,2023-04-24,31,31,0,0
NEZA 2,2023-04-25,43,43,0,0
NEZA 2,2023-04-26,23,23,0,0
NEZA 2,2023-04-27,29,29,0,0
NEZA 2,2023-04-28,39,39,0,0
NEZA 2,2023-04-29,40,40,0,0
NEZA 2,2023-04-30,40,40,0,0
NEZA 2,2023-05-01,26,26,0,0
NEZA 2,2023-05-02,27,27,0,0
NEZA 2,2023-05-03,34,34,0,0
NEZA 2,2023-05-04,31,31,0,0
NEZA 2,2023-05-05,28,28,0,0
NEZA 2,2023-05-06,37,37,0,0
NEZA 2,2023-05-07,19,19,0,0
NEZA 2,2023-05-08,30,30,0,0
NICOLAS ROMERO,2023-01-02,25,10,15,0.6
NICOLAS ROMERO,2023-01-03,38,24,14,0.368421052631579
NICOLAS ROMERO,2023-01-04,29,18,11,0.379310344827586
NICOLAS ROMERO,2023-01-05,22,15,7,0.318181818181818
NICOLAS ROMERO,2023-01-06,39,22,17,0.435897435897436
NICOLAS ROMERO,2023-01-07,40,23,17,0.425
NICOLAS ROMERO,2023-01-08,36,29,7,0.194444444444444
NICOLAS ROMERO,2023-01-09,20,14,6,0.3
NICOLAS ROMERO,2023-01-10,25,16,9,0.36
NICOLAS ROMERO,2023-01-11,27,14,13,0.481481481481481
NICOLAS ROMERO,2023-01-12,18,11,7,0.388888888888889
NICOLAS ROMERO,2023-01-13,38,10,28,0.736842105263158
NICOLAS ROMERO,2023-01-14,52,24,28,0.538461538461538
NICOLAS ROMERO,2023-01-15,58,30,28,0.482758620689655
NICOLAS ROMERO,2023-01-16,30,8,22,0.733333333333333
NICOLAS ROMERO,2023-01-17,43,18,25,0.581395348837209
NICOLAS ROMERO,2023-01-18,32,11,21,0.65625
NICOLAS ROMERO,2023-01-19,49,31,18,0.36734693877551
NICOLAS ROMERO,2023-01-20,45,26,19,0.422222222222222
NICOLAS ROMERO,2023-01-21,49,22,27,0.551020408163265
NICOLAS ROMERO,2023-01-22,46,17,29,0.630434782608696
NICOLAS ROMERO,2023-01-23,27,11,16,0.592592592592593
NICOLAS ROMERO,2023-01-24,27,10,17,0.62962962962963
NICOLAS ROMERO,2023-01-25,38,23,15,0.394736842105263
NICOLAS ROMERO,2023-01-26,29,11,18,0.620689655172414
NICOLAS ROMERO,2023-01-27,29,13,16,0.551724137931034
NICOLAS ROMERO,2023-01-28,42,17,25,0.595238095238095
NICOLAS ROMERO,2023-01-29,25,12,13,0.52
NICOLAS ROMERO,2023-01-30,36,15,21,0.583333333333333
NICOLAS ROMERO,2023-01-31,32,16,16,0.5
NICOLAS ROMERO,2023-02-01,40,23,17,0.425
NICOLAS ROMERO,2023-02-02,32,17,15,0.46875
NICOLAS ROMERO,2023-02-03,27,10,17,0.62962962962963
NICOLAS ROMERO,2023-02-04,36,16,20,0.555555555555556
NICOLAS ROMERO,2023-02-05,31,13,18,0.580645161290323
NICOLAS ROMERO,2023-02-06,40,16,24,0.6
NICOLAS ROMERO,2023-02-07,33,17,16,0.484848484848485
NICOLAS ROMERO,2023-02-08,20,9,11,0.55
NICOLAS ROMERO,2023-02-09,28,17,11,0.392857142857143
NICOLAS ROMERO,2023-02-10,34,18,16,0.470588235294118
NICOLAS ROMERO,2023-02-11,33,13,20,0.606060606060606
NICOLAS ROMERO,2023-02-12,32,15,17,0.53125
NICOLAS ROMERO,2023-02-13,26,14,12,0.461538461538462
NICOLAS ROMERO,2023-02-14,26,11,15,0.576923076923077
NICOLAS ROMERO,2023-02-15,33,16,17,0.515151515151515
NICOLAS ROMERO,2023-02-16,26,14,12,0.461538461538462
NICOLAS ROMERO,2023-02-17,32,14,18,0.5625
NICOLAS ROMERO,2023-02-18,40,17,23,0.575
NICOLAS ROMERO,2023-02-19,40,14,26,0.65
NICOLAS ROMERO,2023-02-20,34,19,15,0.441176470588235
NICOLAS ROMERO,2023-02-21,23,12,11,0.478260869565217
NICOLAS ROMERO,2023-02-22,27,16,11,0.407407407407407
NICOLAS ROMERO,2023-02-23,28,9,19,0.678571428571429
NICOLAS ROMERO,2023-02-24,30,14,16,0.533333333333333
NICOLAS ROMERO,2023-02-25,25,9,16,0.64
NICOLAS ROMERO,2023-02-26,29,14,15,0.517241379310345
NICOLAS ROMERO,2023-02-27,35,20,15,0.428571428571429
NICOLAS ROMERO,2023-02-28,33,18,15,0.454545454545455
NICOLAS ROMERO,2023-03-01,30,16,14,0.466666666666667
NICOLAS ROMERO,2023-03-02,21,13,8,0.380952380952381
NICOLAS ROMERO,2023-03-03,27,16,11,0.407407407407407
NICOLAS ROMERO,2023-03-04,36,16,20,0.555555555555556
NICOLAS ROMERO,2023-03-05,23,7,16,0.695652173913043
NICOLAS ROMERO,2023-03-06,24,10,14,0.583333333333333
NICOLAS ROMERO,2023-03-07,28,18,10,0.357142857142857
NICOLAS ROMERO,2023-03-08,29,15,14,0.482758620689655
NICOLAS ROMERO,2023-03-09,25,16,9,0.36
NICOLAS ROMERO,2023-03-10,26,19,7,0.269230769230769
NICOLAS ROMERO,2023-03-11,39,23,16,0.41025641025641
NICOLAS ROMERO,2023-03-12,29,15,14,0.482758620689655
NICOLAS ROMERO,2023-03-13,22,16,6,0.272727272727273
NICOLAS ROMERO,2023-03-14,28,25,3,0.107142857142857
NICOLAS ROMERO,2023-03-15,38,33,5,0.131578947368421
NICOLAS ROMERO,2023-03-16,33,26,7,0.212121212121212
NICOLAS ROMERO,2023-03-17,44,32,12,0.272727272727273
NICOLAS ROMERO,2023-03-18,43,36,7,0.162790697674419
NICOLAS ROMERO,2023-03-19,60,52,8,0.133333333333333
NICOLAS ROMERO,2023-03-20,68,60,8,0.117647058823529
NICOLAS ROMERO,2023-03-21,41,39,2,0.0487804878048781
NICOLAS ROMERO,2023-03-22,29,28,1,0.0344827586206897
NICOLAS ROMERO,2023-03-23,26,26,0,0
NICOLAS ROMERO,2023-03-24,32,31,1,0.03125
NICOLAS ROMERO,2023-03-25,45,45,0,0
NICOLAS ROMERO,2023-03-26,44,43,1,0.0227272727272727
NICOLAS ROMERO,2023-03-27,13,13,0,0
NICOLAS ROMERO,2023-03-28,23,21,2,0.0869565217391304
NICOLAS ROMERO,2023-03-29,27,27,0,0
NICOLAS ROMERO,2023-03-30,39,39,0,0
NICOLAS ROMERO,2023-03-31,58,58,0,0
NICOLAS ROMERO,2023-04-01,41,41,0,0
NICOLAS ROMERO,2023-04-02,45,36,9,0.2
NICOLAS ROMERO,2023-04-03,51,44,7,0.137254901960784
NICOLAS ROMERO,2023-04-04,24,24,0,0
NICOLAS ROMERO,2023-04-05,43,41,2,0.0465116279069767
NICOLAS ROMERO,2023-04-06,48,46,2,0.0416666666666667
NICOLAS ROMERO,2023-04-07,26,26,0,0
NICOLAS ROMERO,2023-04-08,15,15,0,0
NICOLAS ROMERO,2023-04-09,20,19,1,0.05
NICOLAS ROMERO,2023-04-10,41,41,0,0
NICOLAS ROMERO,2023-04-11,47,47,0,0
NICOLAS ROMERO,2023-04-12,28,28,0,0
NICOLAS ROMERO,2023-04-13,21,21,0,0
NICOLAS ROMERO,2023-04-14,39,35,4,0.102564102564103
NICOLAS ROMERO,2023-04-15,60,55,5,0.0833333333333333
NICOLAS ROMERO,2023-04-16,66,65,1,0.0151515151515152
NICOLAS ROMERO,2023-04-17,48,48,0,0
NICOLAS ROMERO,2023-04-18,29,28,1,0.0344827586206897
NICOLAS ROMERO,2023-04-19,29,29,0,0
NICOLAS ROMERO,2023-04-20,35,32,3,0.0857142857142857
NICOLAS ROMERO,2023-04-21,28,28,0,0
NICOLAS ROMERO,2023-04-22,51,51,0,0
NICOLAS ROMERO,2023-04-23,37,37,0,0
NICOLAS ROMERO,2023-04-24,37,37,0,0
NICOLAS ROMERO,2023-04-25,49,49,0,0
NICOLAS ROMERO,2023-04-26,33,33,0,0
NICOLAS ROMERO,2023-04-27,25,25,0,0
NICOLAS ROMERO,2023-04-28,32,32,0,0
NICOLAS ROMERO,2023-04-29,54,53,1,0.0185185185185185
NICOLAS ROMERO,2023-04-30,40,38,2,0.05
NICOLAS ROMERO,2023-05-01,32,32,0,0
NICOLAS ROMERO,2023-05-02,39,37,2,0.0512820512820513
NICOLAS ROMERO,2023-05-03,18,18,0,0
NICOLAS ROMERO,2023-05-04,32,30,2,0.0625
NICOLAS ROMERO,2023-05-05,27,26,1,0.037037037037037
NICOLAS ROMERO,2023-05-06,42,40,2,0.0476190476190476
NICOLAS ROMERO,2023-05-07,25,25,0,0
NICOLAS ROMERO,2023-05-08,38,36,2,0.0526315789473684
NUEVO LAREDO,2023-02-03,23,23,0,0
NUEVO LAREDO,2023-02-04,35,35,0,0
NUEVO LAREDO,2023-02-05,39,39,0,0
NUEVO LAREDO,2023-02-06,43,43,0,0
NUEVO LAREDO,2023-02-07,34,34,0,0
NUEVO LAREDO,2023-02-08,35,35,0,0
NUEVO LAREDO,2023-02-09,42,42,0,0
NUEVO LAREDO,2023-02-10,33,33,0,0
NUEVO LAREDO,2023-02-11,28,28,0,0
NUEVO LAREDO,2023-02-12,29,29,0,0
NUEVO LAREDO,2023-02-13,33,33,0,0
NUEVO LAREDO,2023-02-14,46,46,0,0
NUEVO LAREDO,2023-02-15,51,48,3,0.0588235294117647
NUEVO LAREDO,2023-02-16,41,39,2,0.0487804878048781
NUEVO LAREDO,2023-02-17,44,43,1,0.0227272727272727
NUEVO LAREDO,2023-02-18,38,38,0,0
NUEVO LAREDO,2023-02-19,31,31,0,0
NUEVO LAREDO,2023-02-20,31,30,1,0.032258064516129
NUEVO LAREDO,2023-02-21,33,33,0,0
NUEVO LAREDO,2023-02-22,30,30,0,0
NUEVO LAREDO,2023-02-23,26,26,0,0
NUEVO LAREDO,2023-02-24,41,41,0,0
NUEVO LAREDO,2023-02-25,34,34,0,0
NUEVO LAREDO,2023-02-26,27,26,1,0.037037037037037
NUEVO LAREDO,2023-02-27,32,32,0,0
NUEVO LAREDO,2023-02-28,43,42,1,0.0232558139534884
NUEVO LAREDO,2023-03-01,53,53,0,0
NUEVO LAREDO,2023-03-02,38,38,0,0
NUEVO LAREDO,2023-03-03,41,41,0,0
NUEVO LAREDO,2023-03-04,42,42,0,0
NUEVO LAREDO,2023-03-05,29,26,3,0.103448275862069
NUEVO LAREDO,2023-03-06,41,39,2,0.0487804878048781
NUEVO LAREDO,2023-03-07,43,43,0,0
NUEVO LAREDO,2023-03-08,49,49,0,0
NUEVO LAREDO,2023-03-09,37,37,0,0
NUEVO LAREDO,2023-03-10,52,52,0,0
NUEVO LAREDO,2023-03-11,51,51,0,0
NUEVO LAREDO,2023-03-12,47,47,0,0
NUEVO LAREDO,2023-03-13,62,62,0,0
NUEVO LAREDO,2023-03-14,53,53,0,0
NUEVO LAREDO,2023-03-15,47,47,0,0
NUEVO LAREDO,2023-03-16,50,50,0,0
NUEVO LAREDO,2023-03-17,46,46,0,0
NUEVO LAREDO,2023-03-18,53,53,0,0
NUEVO LAREDO,2023-03-19,36,36,0,0
NUEVO LAREDO,2023-03-20,67,67,0,0
NUEVO LAREDO,2023-03-21,66,66,0,0
NUEVO LAREDO,2023-03-22,52,52,0,0
NUEVO LAREDO,2023-03-23,59,59,0,0
NUEVO LAREDO,2023-03-24,59,59,0,0
NUEVO LAREDO,2023-03-25,64,64,0,0
NUEVO LAREDO,2023-03-26,41,41,0,0
NUEVO LAREDO,2023-03-27,71,71,0,0
NUEVO LAREDO,2023-03-28,55,55,0,0
NUEVO LAREDO,2023-03-29,63,63,0,0
NUEVO LAREDO,2023-03-30,49,49,0,0
NUEVO LAREDO,2023-03-31,68,68,0,0
NUEVO LAREDO,2023-04-01,52,52,0,0
NUEVO LAREDO,2023-04-02,44,44,0,0
NUEVO LAREDO,2023-04-03,68,68,0,0
NUEVO LAREDO,2023-04-04,53,52,1,0.0188679245283019
NUEVO LAREDO,2023-04-05,57,57,0,0
NUEVO LAREDO,2023-04-06,56,56,0,0
NUEVO LAREDO,2023-04-07,47,47,0,0
NUEVO LAREDO,2023-04-08,43,43,0,0
NUEVO LAREDO,2023-04-09,28,28,0,0
NUEVO LAREDO,2023-04-10,42,42,0,0
NUEVO LAREDO,2023-04-11,62,62,0,0
NUEVO LAREDO,2023-04-12,64,64,0,0
NUEVO LAREDO,2023-04-13,62,60,2,0.032258064516129
NUEVO LAREDO,2023-04-14,58,57,1,0.0172413793103448
NUEVO LAREDO,2023-04-15,56,56,0,0
NUEVO LAREDO,2023-04-16,23,23,0,0
NUEVO LAREDO,2023-04-17,54,53,1,0.0185185185185185
NUEVO LAREDO,2023-04-18,51,51,0,0
NUEVO LAREDO,2023-04-19,46,46,0,0
NUEVO LAREDO,2023-04-20,47,46,1,0.0212765957446809
NUEVO LAREDO,2023-04-21,48,44,4,0.0833333333333333
NUEVO LAREDO,2023-04-22,47,47,0,0
NUEVO LAREDO,2023-04-23,31,31,0,0
NUEVO LAREDO,2023-04-24,52,49,3,0.0576923076923077
NUEVO LAREDO,2023-04-25,57,55,2,0.0350877192982456
NUEVO LAREDO,2023-04-26,48,45,3,0.0625
NUEVO LAREDO,2023-04-27,38,36,2,0.0526315789473684
NUEVO LAREDO,2023-04-28,41,36,5,0.121951219512195
NUEVO LAREDO,2023-04-29,56,54,2,0.0357142857142857
NUEVO LAREDO,2023-04-30,29,29,0,0
NUEVO LAREDO,2023-05-01,29,28,1,0.0344827586206897
NUEVO LAREDO,2023-05-02,42,41,1,0.0238095238095238
NUEVO LAREDO,2023-05-03,43,43,0,0
NUEVO LAREDO,2023-05-04,42,41,1,0.0238095238095238
NUEVO LAREDO,2023-05-05,45,43,2,0.0444444444444444
NUEVO LAREDO,2023-05-06,39,36,3,0.0769230769230769
NUEVO LAREDO,2023-05-07,28,28,0,0
NUEVO LAREDO,2023-05-08,40,38,2,0.05
OJO DE AGUA,2023-01-02,35,21,14,0.4
OJO DE AGUA,2023-01-03,46,21,25,0.543478260869565
OJO DE AGUA,2023-01-04,56,31,25,0.446428571428571
OJO DE AGUA,2023-01-05,48,28,20,0.416666666666667
OJO DE AGUA,2023-01-06,53,30,23,0.433962264150943
OJO DE AGUA,2023-01-07,52,25,27,0.519230769230769
OJO DE AGUA,2023-01-08,33,20,13,0.393939393939394
OJO DE AGUA,2023-01-09,51,28,23,0.450980392156863
OJO DE AGUA,2023-01-10,55,29,26,0.472727272727273
OJO DE AGUA,2023-01-11,49,29,20,0.408163265306122
OJO DE AGUA,2023-01-12,47,25,22,0.468085106382979
OJO DE AGUA,2023-01-13,43,25,18,0.418604651162791
OJO DE AGUA,2023-01-14,39,27,12,0.307692307692308
OJO DE AGUA,2023-01-15,39,22,17,0.435897435897436
OJO DE AGUA,2023-01-16,34,23,11,0.323529411764706
OJO DE AGUA,2023-01-17,35,13,22,0.628571428571429
OJO DE AGUA,2023-01-18,28,13,15,0.535714285714286
OJO DE AGUA,2023-01-19,23,14,9,0.391304347826087
OJO DE AGUA,2023-01-20,27,15,12,0.444444444444444
OJO DE AGUA,2023-01-21,58,33,25,0.431034482758621
OJO DE AGUA,2023-01-22,48,34,14,0.291666666666667
OJO DE AGUA,2023-01-23,36,28,8,0.222222222222222
OJO DE AGUA,2023-01-24,15,11,4,0.266666666666667
OJO DE AGUA,2023-01-25,38,20,18,0.473684210526316
OJO DE AGUA,2023-01-26,49,34,15,0.306122448979592
OJO DE AGUA,2023-01-27,48,32,16,0.333333333333333
OJO DE AGUA,2023-01-28,39,26,13,0.333333333333333
OJO DE AGUA,2023-01-29,35,18,17,0.485714285714286
OJO DE AGUA,2023-01-30,32,14,18,0.5625
OJO DE AGUA,2023-01-31,56,31,25,0.446428571428571
OJO DE AGUA,2023-02-01,42,24,18,0.428571428571429
OJO DE AGUA,2023-02-02,38,24,14,0.368421052631579
OJO DE AGUA,2023-02-03,40,25,15,0.375
OJO DE AGUA,2023-02-04,36,21,15,0.416666666666667
OJO DE AGUA,2023-02-05,31,20,11,0.354838709677419
OJO DE AGUA,2023-02-06,54,33,21,0.388888888888889
OJO DE AGUA,2023-02-07,31,16,15,0.483870967741935
OJO DE AGUA,2023-02-08,38,18,20,0.526315789473684
OJO DE AGUA,2023-02-09,30,13,17,0.566666666666667
OJO DE AGUA,2023-02-10,42,18,24,0.571428571428571
OJO DE AGUA,2023-02-11,61,28,33,0.540983606557377
OJO DE AGUA,2023-02-12,33,16,17,0.515151515151515
OJO DE AGUA,2023-02-13,42,15,27,0.642857142857143
OJO DE AGUA,2023-02-14,48,18,30,0.625
OJO DE AGUA,2023-02-15,38,19,19,0.5
OJO DE AGUA,2023-02-16,34,15,19,0.558823529411765
OJO DE AGUA,2023-02-17,36,15,21,0.583333333333333
OJO DE AGUA,2023-02-18,46,18,28,0.608695652173913
OJO DE AGUA,2023-02-19,45,18,27,0.6
OJO DE AGUA,2023-02-20,41,19,22,0.536585365853659
OJO DE AGUA,2023-02-21,40,20,20,0.5
OJO DE AGUA,2023-02-22,48,30,18,0.375
OJO DE AGUA,2023-02-23,30,21,9,0.3
OJO DE AGUA,2023-02-24,39,31,8,0.205128205128205
OJO DE AGUA,2023-02-25,65,45,20,0.307692307692308
OJO DE AGUA,2023-02-26,56,33,23,0.410714285714286
OJO DE AGUA,2023-02-27,45,35,10,0.222222222222222
OJO DE AGUA,2023-02-28,60,48,12,0.2
OJO DE AGUA,2023-03-01,51,39,12,0.235294117647059
OJO DE AGUA,2023-03-02,47,37,10,0.212765957446809
OJO DE AGUA,2023-03-03,63,56,7,0.111111111111111
OJO DE AGUA,2023-03-04,54,38,16,0.296296296296296
OJO DE AGUA,2023-03-05,58,38,20,0.344827586206897
OJO DE AGUA,2023-03-06,45,33,12,0.266666666666667
OJO DE AGUA,2023-03-07,41,38,3,0.0731707317073171
OJO DE AGUA,2023-03-08,35,30,5,0.142857142857143
OJO DE AGUA,2023-03-09,34,33,1,0.0294117647058824
OJO DE AGUA,2023-03-10,29,28,1,0.0344827586206897
OJO DE AGUA,2023-03-11,38,34,4,0.105263157894737
OJO DE AGUA,2023-03-12,38,28,10,0.263157894736842
OJO DE AGUA,2023-03-13,35,33,2,0.0571428571428571
OJO DE AGUA,2023-03-14,54,51,3,0.0555555555555556
OJO DE AGUA,2023-03-15,40,37,3,0.075
OJO DE AGUA,2023-03-16,59,59,0,0
OJO DE AGUA,2023-03-17,59,59,0,0
OJO DE AGUA,2023-03-18,58,58,0,0
OJO DE AGUA,2023-03-19,103,91,12,0.116504854368932
OJO DE AGUA,2023-03-20,97,93,4,0.0412371134020619
OJO DE AGUA,2023-03-21,50,50,0,0
OJO DE AGUA,2023-03-22,76,76,0,0
OJO DE AGUA,2023-03-23,48,47,1,0.0208333333333333
OJO DE AGUA,2023-03-24,60,60,0,0
OJO DE AGUA,2023-03-25,79,79,0,0
OJO DE AGUA,2023-03-26,60,60,0,0
OJO DE AGUA,2023-03-27,40,40,0,0
OJO DE AGUA,2023-03-28,27,27,0,0
OJO DE AGUA,2023-03-29,33,33,0,0
OJO DE AGUA,2023-03-30,39,39,0,0
OJO DE AGUA,2023-03-31,73,73,0,0
OJO DE AGUA,2023-04-01,45,45,0,0
OJO DE AGUA,2023-04-02,61,61,0,0
OJO DE AGUA,2023-04-03,67,67,0,0
OJO DE AGUA,2023-04-04,27,27,0,0
OJO DE AGUA,2023-04-05,37,37,0,0
OJO DE AGUA,2023-04-06,53,53,0,0
OJO DE AGUA,2023-04-07,40,40,0,0
OJO DE AGUA,2023-04-08,42,42,0,0
OJO DE AGUA,2023-04-09,27,27,0,0
OJO DE AGUA,2023-04-10,28,28,0,0
OJO DE AGUA,2023-04-11,49,49,0,0
OJO DE AGUA,2023-04-12,48,48,0,0
OJO DE AGUA,2023-04-13,44,44,0,0
OJO DE AGUA,2023-04-14,37,37,0,0
OJO DE AGUA,2023-04-15,44,44,0,0
OJO DE AGUA,2023-04-16,55,55,0,0
OJO DE AGUA,2023-04-17,56,56,0,0
OJO DE AGUA,2023-04-18,39,39,0,0
OJO DE AGUA,2023-04-19,46,46,0,0
OJO DE AGUA,2023-04-20,42,42,0,0
OJO DE AGUA,2023-04-21,45,45,0,0
OJO DE AGUA,2023-04-22,49,49,0,0
OJO DE AGUA,2023-04-23,57,57,0,0
OJO DE AGUA,2023-04-24,46,46,0,0
OJO DE AGUA,2023-04-25,52,52,0,0
OJO DE AGUA,2023-04-26,47,47,0,0
OJO DE AGUA,2023-04-27,35,35,0,0
OJO DE AGUA,2023-04-28,47,47,0,0
OJO DE AGUA,2023-04-29,49,49,0,0
OJO DE AGUA,2023-04-30,54,54,0,0
OJO DE AGUA,2023-05-01,39,39,0,0
OJO DE AGUA,2023-05-02,35,35,0,0
OJO DE AGUA,2023-05-03,40,40,0,0
OJO DE AGUA,2023-05-04,23,23,0,0
OJO DE AGUA,2023-05-05,37,37,0,0
OJO DE AGUA,2023-05-06,29,29,0,0
OJO DE AGUA,2023-05-07,25,25,0,0
OJO DE AGUA,2023-05-08,29,29,0,0
PACHUCA,2023-01-02,19,11,8,0.421052631578947
PACHUCA,2023-01-03,47,25,22,0.468085106382979
PACHUCA,2023-01-04,44,18,26,0.590909090909091
PACHUCA,2023-01-05,55,31,24,0.436363636363636
PACHUCA,2023-01-06,42,21,21,0.5
PACHUCA,2023-01-07,29,22,7,0.241379310344828
PACHUCA,2023-01-08,37,21,16,0.432432432432432
PACHUCA,2023-01-09,36,17,19,0.527777777777778
PACHUCA,2023-01-10,48,29,19,0.395833333333333
PACHUCA,2023-01-11,49,30,19,0.387755102040816
PACHUCA,2023-01-12,32,14,18,0.5625
PACHUCA,2023-01-13,33,11,22,0.666666666666667
PACHUCA,2023-01-14,42,18,24,0.571428571428571
PACHUCA,2023-01-15,37,21,16,0.432432432432432
PACHUCA,2023-01-16,46,11,35,0.760869565217391
PACHUCA,2023-01-17,48,10,38,0.791666666666667
PACHUCA,2023-01-18,43,14,29,0.674418604651163
PACHUCA,2023-01-19,37,11,26,0.702702702702703
PACHUCA,2023-01-20,43,15,28,0.651162790697674
PACHUCA,2023-01-21,51,13,38,0.745098039215686
PACHUCA,2023-01-22,41,19,22,0.536585365853659
PACHUCA,2023-01-23,37,16,21,0.567567567567568
PACHUCA,2023-01-24,43,25,18,0.418604651162791
PACHUCA,2023-01-25,34,23,11,0.323529411764706
PACHUCA,2023-01-26,36,11,25,0.694444444444444
PACHUCA,2023-01-27,28,13,15,0.535714285714286
PACHUCA,2023-01-28,35,16,19,0.542857142857143
PACHUCA,2023-01-29,24,11,13,0.541666666666667
PACHUCA,2023-01-30,36,14,22,0.611111111111111
PACHUCA,2023-01-31,37,21,16,0.432432432432432
PACHUCA,2023-02-01,46,21,25,0.543478260869565
PACHUCA,2023-02-02,34,17,17,0.5
PACHUCA,2023-02-03,44,18,26,0.590909090909091
PACHUCA,2023-02-04,46,23,23,0.5
PACHUCA,2023-02-05,30,15,15,0.5
PACHUCA,2023-02-06,41,19,22,0.536585365853659
PACHUCA,2023-02-07,40,16,24,0.6
PACHUCA,2023-02-08,40,25,15,0.375
PACHUCA,2023-02-09,38,21,17,0.447368421052632
PACHUCA,2023-02-10,45,20,25,0.555555555555556
PACHUCA,2023-02-11,52,21,31,0.596153846153846
PACHUCA,2023-02-12,22,11,11,0.5
PACHUCA,2023-02-13,30,20,10,0.333333333333333
PACHUCA,2023-02-14,32,16,16,0.5
PACHUCA,2023-02-15,39,20,19,0.487179487179487
PACHUCA,2023-02-16,37,15,22,0.594594594594595
PACHUCA,2023-02-17,29,13,16,0.551724137931034
PACHUCA,2023-02-18,40,18,22,0.55
PACHUCA,2023-02-19,15,4,11,0.733333333333333
PACHUCA,2023-02-20,34,11,23,0.676470588235294
PACHUCA,2023-02-21,36,20,16,0.444444444444444
PACHUCA,2023-02-22,39,15,24,0.615384615384615
PACHUCA,2023-02-23,41,28,13,0.317073170731707
PACHUCA,2023-02-24,43,29,14,0.325581395348837
PACHUCA,2023-02-25,38,20,18,0.473684210526316
PACHUCA,2023-02-26,26,14,12,0.461538461538462
PACHUCA,2023-02-27,36,20,16,0.444444444444444
PACHUCA,2023-02-28,46,24,22,0.478260869565217
PACHUCA,2023-03-01,42,23,19,0.452380952380952
PACHUCA,2023-03-02,19,4,15,0.789473684210526
PACHUCA,2023-03-03,29,14,15,0.517241379310345
PACHUCA,2023-03-04,44,28,16,0.363636363636364
PACHUCA,2023-03-05,17,11,6,0.352941176470588
PACHUCA,2023-03-06,38,32,6,0.157894736842105
PACHUCA,2023-03-07,29,23,6,0.206896551724138
PACHUCA,2023-03-08,30,27,3,0.1
PACHUCA,2023-03-09,26,25,1,0.0384615384615385
PACHUCA,2023-03-10,24,23,1,0.0416666666666667
PACHUCA,2023-03-11,52,48,4,0.0769230769230769
PACHUCA,2023-03-12,22,20,2,0.0909090909090909
PACHUCA,2023-03-13,37,34,3,0.0810810810810811
PACHUCA,2023-03-14,36,35,1,0.0277777777777778
PACHUCA,2023-03-15,34,27,7,0.205882352941176
PACHUCA,2023-03-16,37,35,2,0.0540540540540541
PACHUCA,2023-03-17,47,45,2,0.0425531914893617
PACHUCA,2023-03-18,50,47,3,0.06
PACHUCA,2023-03-19,33,29,4,0.121212121212121
PACHUCA,2023-03-20,51,48,3,0.0588235294117647
PACHUCA,2023-03-21,50,49,1,0.02
PACHUCA,2023-03-22,39,38,1,0.0256410256410256
PACHUCA,2023-03-23,41,41,0,0
PACHUCA,2023-03-24,41,39,2,0.0487804878048781
PACHUCA,2023-03-25,42,38,4,0.0952380952380952
PACHUCA,2023-03-26,31,30,1,0.032258064516129
PACHUCA,2023-03-27,25,25,0,0
PACHUCA,2023-03-28,34,33,1,0.0294117647058824
PACHUCA,2023-03-29,35,34,1,0.0285714285714286
PACHUCA,2023-03-30,40,38,2,0.05
PACHUCA,2023-03-31,65,62,3,0.0461538461538462
PACHUCA,2023-04-01,58,53,5,0.0862068965517241
PACHUCA,2023-04-02,35,33,2,0.0571428571428571
PACHUCA,2023-04-03,45,45,0,0
PACHUCA,2023-04-04,42,42,0,0
PACHUCA,2023-04-05,35,31,4,0.114285714285714
PACHUCA,2023-04-06,34,34,0,0
PACHUCA,2023-04-07,17,16,1,0.0588235294117647
PACHUCA,2023-04-08,27,26,1,0.037037037037037
PACHUCA,2023-04-09,15,15,0,0
PACHUCA,2023-04-10,29,28,1,0.0344827586206897
PACHUCA,2023-04-11,29,26,3,0.103448275862069
PACHUCA,2023-04-12,33,29,4,0.121212121212121
PACHUCA,2023-04-13,36,35,1,0.0277777777777778
PACHUCA,2023-04-14,39,36,3,0.0769230769230769
PACHUCA,2023-04-15,48,37,11,0.229166666666667
PACHUCA,2023-04-16,45,40,5,0.111111111111111
PACHUCA,2023-04-17,43,42,1,0.0232558139534884
PACHUCA,2023-04-18,28,22,6,0.214285714285714
PACHUCA,2023-04-19,37,34,3,0.0810810810810811
PACHUCA,2023-04-20,27,26,1,0.037037037037037
PACHUCA,2023-04-21,28,26,2,0.0714285714285714
PACHUCA,2023-04-22,50,47,3,0.06
PACHUCA,2023-04-23,27,24,3,0.111111111111111
PACHUCA,2023-04-24,43,43,0,0
PACHUCA,2023-04-25,52,47,5,0.0961538461538462
PACHUCA,2023-04-26,42,41,1,0.0238095238095238
PACHUCA,2023-04-27,27,24,3,0.111111111111111
PACHUCA,2023-04-28,55,45,10,0.181818181818182
PACHUCA,2023-04-29,62,57,5,0.0806451612903226
PACHUCA,2023-04-30,34,32,2,0.0588235294117647
PACHUCA,2023-05-01,36,36,0,0
PACHUCA,2023-05-02,28,28,0,0
PACHUCA,2023-05-03,35,33,2,0.0571428571428571
PACHUCA,2023-05-04,31,27,4,0.129032258064516
PACHUCA,2023-05-05,33,30,3,0.0909090909090909
PACHUCA,2023-05-06,36,34,2,0.0555555555555556
PACHUCA,2023-05-07,17,15,2,0.117647058823529
PACHUCA,2023-05-08,30,27,3,0.1
PEDREGAL,2023-01-02,23,10,13,0.565217391304348
PEDREGAL,2023-01-03,25,12,13,0.52
PEDREGAL,2023-01-04,27,16,11,0.407407407407407
PEDREGAL,2023-01-05,21,11,10,0.476190476190476
PEDREGAL,2023-01-06,18,7,11,0.611111111111111
PEDREGAL,2023-01-07,31,17,14,0.451612903225806
PEDREGAL,2023-01-08,11,8,3,0.272727272727273
PEDREGAL,2023-01-09,26,16,10,0.384615384615385
PEDREGAL,2023-01-10,22,15,7,0.318181818181818
PEDREGAL,2023-01-11,21,8,13,0.619047619047619
PEDREGAL,2023-01-12,22,12,10,0.454545454545455
PEDREGAL,2023-01-13,18,13,5,0.277777777777778
PEDREGAL,2023-01-14,24,13,11,0.458333333333333
PEDREGAL,2023-01-15,16,10,6,0.375
PEDREGAL,2023-01-16,28,14,14,0.5
PEDREGAL,2023-01-17,26,3,23,0.884615384615385
PEDREGAL,2023-01-18,18,2,16,0.888888888888889
PEDREGAL,2023-01-19,18,8,10,0.555555555555556
PEDREGAL,2023-01-20,26,7,19,0.730769230769231
PEDREGAL,2023-01-21,28,11,17,0.607142857142857
PEDREGAL,2023-01-22,21,10,11,0.523809523809524
PEDREGAL,2023-01-23,15,4,11,0.733333333333333
PEDREGAL,2023-01-24,25,9,16,0.64
PEDREGAL,2023-01-25,20,8,12,0.6
PEDREGAL,2023-01-26,22,3,19,0.863636363636364
PEDREGAL,2023-01-27,24,8,16,0.666666666666667
PEDREGAL,2023-01-28,15,6,9,0.6
PEDREGAL,2023-01-29,18,3,15,0.833333333333333
PEDREGAL,2023-01-30,24,4,20,0.833333333333333
PEDREGAL,2023-01-31,29,7,22,0.758620689655172
PEDREGAL,2023-02-01,35,8,27,0.771428571428571
PEDREGAL,2023-02-02,29,7,22,0.758620689655172
PEDREGAL,2023-02-03,24,5,19,0.791666666666667
PEDREGAL,2023-02-04,32,7,25,0.78125
PEDREGAL,2023-02-05,22,4,18,0.818181818181818
PEDREGAL,2023-02-06,24,10,14,0.583333333333333
PEDREGAL,2023-02-07,19,3,16,0.842105263157895
PEDREGAL,2023-02-08,26,8,18,0.692307692307692
PEDREGAL,2023-02-09,19,4,15,0.789473684210526
PEDREGAL,2023-02-10,22,4,18,0.818181818181818
PEDREGAL,2023-02-11,23,3,20,0.869565217391304
PEDREGAL,2023-02-12,10,1,9,0.9
PEDREGAL,2023-02-13,21,4,17,0.80952380952381
PEDREGAL,2023-02-14,21,14,7,0.333333333333333
PEDREGAL,2023-02-15,20,15,5,0.25
PEDREGAL,2023-02-16,29,21,8,0.275862068965517
PEDREGAL,2023-02-17,29,11,18,0.620689655172414
PEDREGAL,2023-02-18,30,5,25,0.833333333333333
PEDREGAL,2023-02-19,20,7,13,0.65
PEDREGAL,2023-02-20,16,2,14,0.875
PEDREGAL,2023-02-21,23,16,7,0.304347826086957
PEDREGAL,2023-02-22,26,11,15,0.576923076923077
PEDREGAL,2023-02-23,23,10,13,0.565217391304348
PEDREGAL,2023-02-24,30,14,16,0.533333333333333
PEDREGAL,2023-02-25,27,12,15,0.555555555555556
PEDREGAL,2023-02-26,18,10,8,0.444444444444444
PEDREGAL,2023-02-27,20,7,13,0.65
PEDREGAL,2023-02-28,22,7,15,0.681818181818182
PEDREGAL,2023-03-01,28,9,19,0.678571428571429
PEDREGAL,2023-03-02,19,8,11,0.578947368421053
PEDREGAL,2023-03-03,36,13,23,0.638888888888889
PEDREGAL,2023-03-04,27,10,17,0.62962962962963
PEDREGAL,2023-03-05,26,9,17,0.653846153846154
PEDREGAL,2023-03-06,23,11,12,0.521739130434783
PEDREGAL,2023-03-07,23,9,14,0.608695652173913
PEDREGAL,2023-03-08,22,8,14,0.636363636363636
PEDREGAL,2023-03-09,21,7,14,0.666666666666667
PEDREGAL,2023-03-10,20,9,11,0.55
PEDREGAL,2023-03-11,19,11,8,0.421052631578947
PEDREGAL,2023-03-12,14,9,5,0.357142857142857
PEDREGAL,2023-03-13,23,11,12,0.521739130434783
PEDREGAL,2023-03-14,18,10,8,0.444444444444444
PEDREGAL,2023-03-15,22,15,7,0.318181818181818
PEDREGAL,2023-03-16,30,26,4,0.133333333333333
PEDREGAL,2023-03-17,28,21,7,0.25
PEDREGAL,2023-03-18,38,31,7,0.184210526315789
PEDREGAL,2023-03-19,25,24,1,0.04
PEDREGAL,2023-03-20,27,22,5,0.185185185185185
PEDREGAL,2023-03-21,19,15,4,0.210526315789474
PEDREGAL,2023-03-22,23,19,4,0.173913043478261
PEDREGAL,2023-03-23,34,33,1,0.0294117647058824
PEDREGAL,2023-03-24,18,18,0,0
PEDREGAL,2023-03-25,35,31,4,0.114285714285714
PEDREGAL,2023-03-26,16,13,3,0.1875
PEDREGAL,2023-03-27,19,19,0,0
PEDREGAL,2023-03-28,18,17,1,0.0555555555555556
PEDREGAL,2023-03-29,21,20,1,0.0476190476190476
PEDREGAL,2023-03-30,40,36,4,0.1
PEDREGAL,2023-03-31,30,27,3,0.1
PEDREGAL,2023-04-01,39,38,1,0.0256410256410256
PEDREGAL,2023-04-02,22,20,2,0.0909090909090909
PEDREGAL,2023-04-03,29,27,2,0.0689655172413793
PEDREGAL,2023-04-04,34,29,5,0.147058823529412
PEDREGAL,2023-04-05,17,10,7,0.411764705882353
PEDREGAL,2023-04-06,22,20,2,0.0909090909090909
PEDREGAL,2023-04-07,23,22,1,0.0434782608695652
PEDREGAL,2023-04-08,12,11,1,0.0833333333333333
PEDREGAL,2023-04-09,13,12,1,0.0769230769230769
PEDREGAL,2023-04-10,19,15,4,0.210526315789474
PEDREGAL,2023-04-11,21,15,6,0.285714285714286
PEDREGAL,2023-04-12,19,17,2,0.105263157894737
PEDREGAL,2023-04-13,24,23,1,0.0416666666666667
PEDREGAL,2023-04-14,37,32,5,0.135135135135135
PEDREGAL,2023-04-15,49,31,18,0.36734693877551
PEDREGAL,2023-04-16,30,26,4,0.133333333333333
PEDREGAL,2023-04-17,25,22,3,0.12
PEDREGAL,2023-04-18,21,18,3,0.142857142857143
PEDREGAL,2023-04-19,22,18,4,0.181818181818182
PEDREGAL,2023-04-20,25,21,4,0.16
PEDREGAL,2023-04-21,36,32,4,0.111111111111111
PEDREGAL,2023-04-22,27,26,1,0.037037037037037
PEDREGAL,2023-04-23,21,20,1,0.0476190476190476
PEDREGAL,2023-04-24,30,27,3,0.1
PEDREGAL,2023-04-25,36,32,4,0.111111111111111
PEDREGAL,2023-04-26,30,24,6,0.2
PEDREGAL,2023-04-27,28,28,0,0
PEDREGAL,2023-04-28,29,26,3,0.103448275862069
PEDREGAL,2023-04-29,34,29,5,0.147058823529412
PEDREGAL,2023-04-30,22,19,3,0.136363636363636
PEDREGAL,2023-05-01,22,19,3,0.136363636363636
PEDREGAL,2023-05-02,25,19,6,0.24
PEDREGAL,2023-05-03,27,20,7,0.259259259259259
PEDREGAL,2023-05-04,27,26,1,0.037037037037037
PEDREGAL,2023-05-05,37,31,6,0.162162162162162
PEDREGAL,2023-05-06,23,21,2,0.0869565217391304
PEDREGAL,2023-05-07,22,19,3,0.136363636363636
PEDREGAL,2023-05-08,20,18,2,0.1
PIEDRAS NEGRAS / MONCLOVA,2023-01-02,46,46,0,0
PIEDRAS NEGRAS / MONCLOVA,2023-01-03,52,52,0,0
PIEDRAS NEGRAS / MONCLOVA,2023-01-04,55,55,0,0
PIEDRAS NEGRAS / MONCLOVA,2023-01-05,56,55,1,0.0178571428571429
PIEDRAS NEGRAS / MONCLOVA,2023-01-06,64,63,1,0.015625
PIEDRAS NEGRAS / MONCLOVA,2023-01-07,64,64,0,0
PIEDRAS NEGRAS / MONCLOVA,2023-01-08,42,42,0,0
PIEDRAS NEGRAS / MONCLOVA,2023-01-09,52,52,0,0
PIEDRAS NEGRAS / MONCLOVA,2023-01-10,67,67,0,0
PIEDRAS NEGRAS / MONCLOVA,2023-01-11,58,57,1,0.0172413793103448
PIEDRAS NEGRAS / MONCLOVA,2023-01-12,53,53,0,0
PIEDRAS NEGRAS / MONCLOVA,2023-01-13,61,58,3,0.0491803278688525
PIEDRAS NEGRAS / MONCLOVA,2023-01-14,71,71,0,0
PIEDRAS NEGRAS / MONCLOVA,2023-01-15,38,38,0,0
PIEDRAS NEGRAS / MONCLOVA,2023-01-16,47,47,0,0
PIEDRAS NEGRAS / MONCLOVA,2023-01-17,51,51,0,0
PIEDRAS NEGRAS / MONCLOVA,2023-01-18,61,61,0,0
PIEDRAS NEGRAS / MONCLOVA,2023-01-19,55,54,1,0.0181818181818182
PIEDRAS NEGRAS / MONCLOVA,2023-01-20,57,57,0,0
PIEDRAS NEGRAS / MONCLOVA,2023-01-21,61,59,2,0.0327868852459016
PIEDRAS NEGRAS / MONCLOVA,2023-01-22,25,25,0,0
PIEDRAS NEGRAS / MONCLOVA,2023-01-23,43,42,1,0.0232558139534884
PIEDRAS NEGRAS / MONCLOVA,2023-01-24,50,50,0,0
PIEDRAS NEGRAS / MONCLOVA,2023-01-25,46,45,1,0.0217391304347826
PIEDRAS NEGRAS / MONCLOVA,2023-01-26,32,32,0,0
PIEDRAS NEGRAS / MONCLOVA,2023-01-27,52,52,0,0
PIEDRAS NEGRAS / MONCLOVA,2023-01-28,46,46,0,0
PIEDRAS NEGRAS / MONCLOVA,2023-01-29,29,29,0,0
PIEDRAS NEGRAS / MONCLOVA,2023-01-30,50,50,0,0
PIEDRAS NEGRAS / MONCLOVA,2023-01-31,39,38,1,0.0256410256410256
PIEDRAS NEGRAS / MONCLOVA,2023-02-01,38,38,0,0
PIEDRAS NEGRAS / MONCLOVA,2023-02-02,43,43,0,0
PIEDRAS NEGRAS / MONCLOVA,2023-02-03,40,39,1,0.025
PIEDRAS NEGRAS / MONCLOVA,2023-02-04,62,62,0,0
PIEDRAS NEGRAS / MONCLOVA,2023-02-05,42,41,1,0.0238095238095238
PIEDRAS NEGRAS / MONCLOVA,2023-02-06,37,37,0,0
PIEDRAS NEGRAS / MONCLOVA,2023-02-07,38,38,0,0
PIEDRAS NEGRAS / MONCLOVA,2023-02-08,44,44,0,0
PIEDRAS NEGRAS / MONCLOVA,2023-02-09,37,36,1,0.027027027027027
PIEDRAS NEGRAS / MONCLOVA,2023-02-10,49,49,0,0
PIEDRAS NEGRAS / MONCLOVA,2023-02-11,55,54,1,0.0181818181818182
PIEDRAS NEGRAS / MONCLOVA,2023-02-12,51,51,0,0
PIEDRAS NEGRAS / MONCLOVA,2023-02-13,46,46,0,0
PIEDRAS NEGRAS / MONCLOVA,2023-02-14,43,43,0,0
PIEDRAS NEGRAS / MONCLOVA,2023-02-15,43,43,0,0
PIEDRAS NEGRAS / MONCLOVA,2023-02-16,39,39,0,0
PIEDRAS NEGRAS / MONCLOVA,2023-02-17,66,66,0,0
PIEDRAS NEGRAS / MONCLOVA,2023-02-18,48,47,1,0.0208333333333333
PIEDRAS NEGRAS / MONCLOVA,2023-02-19,43,43,0,0
PIEDRAS NEGRAS / MONCLOVA,2023-02-20,36,36,0,0
PIEDRAS NEGRAS / MONCLOVA,2023-02-21,48,48,0,0
PIEDRAS NEGRAS / MONCLOVA,2023-02-22,52,52,0,0
PIEDRAS NEGRAS / MONCLOVA,2023-02-23,40,40,0,0
PIEDRAS NEGRAS / MONCLOVA,2023-02-24,36,35,1,0.0277777777777778
PIEDRAS NEGRAS / MONCLOVA,2023-02-25,49,49,0,0
PIEDRAS NEGRAS / MONCLOVA,2023-02-26,38,36,2,0.0526315789473684
PIEDRAS NEGRAS / MONCLOVA,2023-02-27,43,43,0,0
PIEDRAS NEGRAS / MONCLOVA,2023-02-28,49,49,0,0
PIEDRAS NEGRAS / MONCLOVA,2023-03-01,65,65,0,0
PIEDRAS NEGRAS / MONCLOVA,2023-03-02,63,63,0,0
PIEDRAS NEGRAS / MONCLOVA,2023-03-03,60,59,1,0.0166666666666667
PIEDRAS NEGRAS / MONCLOVA,2023-03-04,69,51,18,0.260869565217391
PIEDRAS NEGRAS / MONCLOVA,2023-03-05,39,30,9,0.230769230769231
PIEDRAS NEGRAS / MONCLOVA,2023-03-06,43,33,10,0.232558139534884
PIEDRAS NEGRAS / MONCLOVA,2023-03-07,66,62,4,0.0606060606060606
PIEDRAS NEGRAS / MONCLOVA,2023-03-08,44,41,3,0.0681818181818182
PIEDRAS NEGRAS / MONCLOVA,2023-03-09,42,42,0,0
PIEDRAS NEGRAS / MONCLOVA,2023-03-10,58,57,1,0.0172413793103448
PIEDRAS NEGRAS / MONCLOVA,2023-03-11,77,76,1,0.012987012987013
PIEDRAS NEGRAS / MONCLOVA,2023-03-12,42,41,1,0.0238095238095238
PIEDRAS NEGRAS / MONCLOVA,2023-03-13,43,43,0,0
PIEDRAS NEGRAS / MONCLOVA,2023-03-14,53,47,6,0.113207547169811
PIEDRAS NEGRAS / MONCLOVA,2023-03-15,53,53,0,0
PIEDRAS NEGRAS / MONCLOVA,2023-03-16,67,67,0,0
PIEDRAS NEGRAS / MONCLOVA,2023-03-17,50,50,0,0
PIEDRAS NEGRAS / MONCLOVA,2023-03-18,80,80,0,0
PIEDRAS NEGRAS / MONCLOVA,2023-03-19,52,52,0,0
PIEDRAS NEGRAS / MONCLOVA,2023-03-20,56,56,0,0
PIEDRAS NEGRAS / MONCLOVA,2023-03-21,48,48,0,0
PIEDRAS NEGRAS / MONCLOVA,2023-03-22,65,65,0,0
PIEDRAS NEGRAS / MONCLOVA,2023-03-23,53,53,0,0
PIEDRAS NEGRAS / MONCLOVA,2023-03-24,57,57,0,0
PIEDRAS NEGRAS / MONCLOVA,2023-03-25,76,76,0,0
PIEDRAS NEGRAS / MONCLOVA,2023-03-26,54,54,0,0
PIEDRAS NEGRAS / MONCLOVA,2023-03-27,56,56,0,0
PIEDRAS NEGRAS / MONCLOVA,2023-03-28,41,41,0,0
PIEDRAS NEGRAS / MONCLOVA,2023-03-29,50,50,0,0
PIEDRAS NEGRAS / MONCLOVA,2023-03-30,55,55,0,0
PIEDRAS NEGRAS / MONCLOVA,2023-03-31,80,80,0,0
PIEDRAS NEGRAS / MONCLOVA,2023-04-01,58,58,0,0
PIEDRAS NEGRAS / MONCLOVA,2023-04-02,31,31,0,0
PIEDRAS NEGRAS / MONCLOVA,2023-04-03,65,64,1,0.0153846153846154
PIEDRAS NEGRAS / MONCLOVA,2023-04-04,62,62,0,0
PIEDRAS NEGRAS / MONCLOVA,2023-04-05,35,35,0,0
PIEDRAS NEGRAS / MONCLOVA,2023-04-06,37,37,0,0
PIEDRAS NEGRAS / MONCLOVA,2023-04-07,44,44,0,0
PIEDRAS NEGRAS / MONCLOVA,2023-04-08,30,30,0,0
PIEDRAS NEGRAS / MONCLOVA,2023-04-09,19,19,0,0
PIEDRAS NEGRAS / MONCLOVA,2023-04-10,39,39,0,0
PIEDRAS NEGRAS / MONCLOVA,2023-04-11,43,43,0,0
PIEDRAS NEGRAS / MONCLOVA,2023-04-12,42,42,0,0
PIEDRAS NEGRAS / MONCLOVA,2023-04-13,45,44,1,0.0222222222222222
PIEDRAS NEGRAS / MONCLOVA,2023-04-14,39,39,0,0
PIEDRAS NEGRAS / MONCLOVA,2023-04-15,64,60,4,0.0625
PIEDRAS NEGRAS / MONCLOVA,2023-04-16,44,44,0,0
PIEDRAS NEGRAS / MONCLOVA,2023-04-17,49,49,0,0
PIEDRAS NEGRAS / MONCLOVA,2023-04-18,29,28,1,0.0344827586206897
PIEDRAS NEGRAS / MONCLOVA,2023-04-19,36,34,2,0.0555555555555556
PIEDRAS NEGRAS / MONCLOVA,2023-04-20,37,33,4,0.108108108108108
PIEDRAS NEGRAS / MONCLOVA,2023-04-21,50,49,1,0.02
PIEDRAS NEGRAS / MONCLOVA,2023-04-22,49,47,2,0.0408163265306122
PIEDRAS NEGRAS / MONCLOVA,2023-04-23,39,37,2,0.0512820512820513
PIEDRAS NEGRAS / MONCLOVA,2023-04-24,62,61,1,0.0161290322580645
PIEDRAS NEGRAS / MONCLOVA,2023-04-25,69,68,1,0.0144927536231884
PIEDRAS NEGRAS / MONCLOVA,2023-04-26,65,63,2,0.0307692307692308
PIEDRAS NEGRAS / MONCLOVA,2023-04-27,61,60,1,0.0163934426229508
PIEDRAS NEGRAS / MONCLOVA,2023-04-28,56,53,3,0.0535714285714286
PIEDRAS NEGRAS / MONCLOVA,2023-04-29,54,52,2,0.037037037037037
PIEDRAS NEGRAS / MONCLOVA,2023-04-30,47,47,0,0
PIEDRAS NEGRAS / MONCLOVA,2023-05-01,32,32,0,0
PIEDRAS NEGRAS / MONCLOVA,2023-05-02,54,52,2,0.037037037037037
PIEDRAS NEGRAS / MONCLOVA,2023-05-03,42,41,1,0.0238095238095238
PIEDRAS NEGRAS / MONCLOVA,2023-05-04,37,35,2,0.0540540540540541
PIEDRAS NEGRAS / MONCLOVA,2023-05-05,46,45,1,0.0217391304347826
PIEDRAS NEGRAS / MONCLOVA,2023-05-06,29,28,1,0.0344827586206897
PIEDRAS NEGRAS / MONCLOVA,2023-05-07,46,45,1,0.0217391304347826
PIEDRAS NEGRAS / MONCLOVA,2023-05-08,45,44,1,0.0222222222222222
POLANCO,2023-01-02,16,12,4,0.25
POLANCO,2023-01-03,17,13,4,0.235294117647059
POLANCO,2023-01-04,11,8,3,0.272727272727273
POLANCO,2023-01-05,22,14,8,0.363636363636364
POLANCO,2023-01-06,21,18,3,0.142857142857143
POLANCO,2023-01-07,10,7,3,0.3
POLANCO,2023-01-08,6,5,1,0.166666666666667
POLANCO,2023-01-09,17,12,5,0.294117647058824
POLANCO,2023-01-10,18,11,7,0.388888888888889
POLANCO,2023-01-11,20,13,7,0.35
POLANCO,2023-01-12,18,15,3,0.166666666666667
POLANCO,2023-01-13,13,7,6,0.461538461538462
POLANCO,2023-01-14,10,7,3,0.3
POLANCO,2023-01-15,6,4,2,0.333333333333333
POLANCO,2023-01-16,14,4,10,0.714285714285714
POLANCO,2023-01-17,9,2,7,0.777777777777778
POLANCO,2023-01-18,12,6,6,0.5
POLANCO,2023-01-19,12,4,8,0.666666666666667
POLANCO,2023-01-20,14,6,8,0.571428571428571
POLANCO,2023-01-21,15,7,8,0.533333333333333
POLANCO,2023-01-22,10,5,5,0.5
POLANCO,2023-01-23,16,6,10,0.625
POLANCO,2023-01-24,13,3,10,0.769230769230769
POLANCO,2023-01-25,15,4,11,0.733333333333333
POLANCO,2023-01-26,19,6,13,0.684210526315789
POLANCO,2023-01-27,18,6,12,0.666666666666667
POLANCO,2023-01-28,15,0,16,1
POLANCO,2023-01-29,6,0,6,1
POLANCO,2023-01-30,15,4,11,0.733333333333333
POLANCO,2023-01-31,25,3,22,0.88
POLANCO,2023-02-01,8,2,6,0.75
POLANCO,2023-02-02,18,3,15,0.833333333333333
POLANCO,2023-02-03,27,10,17,0.62962962962963
POLANCO,2023-02-04,18,3,15,0.833333333333333
POLANCO,2023-02-05,7,2,5,0.714285714285714
POLANCO,2023-02-06,18,3,15,0.833333333333333
POLANCO,2023-02-07,23,5,18,0.782608695652174
POLANCO,2023-02-08,25,8,17,0.68
POLANCO,2023-02-09,15,6,9,0.6
POLANCO,2023-02-10,22,11,11,0.5
POLANCO,2023-02-11,19,5,14,0.736842105263158
POLANCO,2023-02-12,4,2,2,0.5
POLANCO,2023-02-13,27,8,19,0.703703703703704
POLANCO,2023-02-14,23,10,13,0.565217391304348
POLANCO,2023-02-15,8,3,5,0.625
POLANCO,2023-02-16,20,8,12,0.6
POLANCO,2023-02-17,11,3,8,0.727272727272727
POLANCO,2023-02-18,11,5,6,0.545454545454545
POLANCO,2023-02-19,9,4,5,0.555555555555556
POLANCO,2023-02-20,24,10,14,0.583333333333333
POLANCO,2023-02-21,15,7,8,0.533333333333333
POLANCO,2023-02-22,16,8,8,0.5
POLANCO,2023-02-23,16,10,6,0.375
POLANCO,2023-02-24,13,8,5,0.384615384615385
POLANCO,2023-02-25,14,12,2,0.142857142857143
POLANCO,2023-02-26,3,2,1,0.333333333333333
POLANCO,2023-02-27,15,9,6,0.4
POLANCO,2023-02-28,18,11,7,0.388888888888889
POLANCO,2023-03-01,17,11,6,0.352941176470588
POLANCO,2023-03-02,25,10,15,0.6
POLANCO,2023-03-03,16,5,11,0.6875
POLANCO,2023-03-04,21,12,9,0.428571428571429
POLANCO,2023-03-05,14,6,8,0.571428571428571
POLANCO,2023-03-06,17,11,6,0.352941176470588
POLANCO,2023-03-07,17,16,1,0.0588235294117647
POLANCO,2023-03-08,16,13,3,0.1875
POLANCO,2023-03-09,23,15,8,0.347826086956522
POLANCO,2023-03-10,17,13,4,0.235294117647059
POLANCO,2023-03-11,25,22,3,0.12
POLANCO,2023-03-12,6,6,0,0
POLANCO,2023-03-13,20,17,3,0.15
POLANCO,2023-03-14,16,16,0,0
POLANCO,2023-03-15,12,11,1,0.0833333333333333
POLANCO,2023-03-16,14,14,0,0
POLANCO,2023-03-17,17,16,1,0.0588235294117647
POLANCO,2023-03-18,14,14,0,0
POLANCO,2023-03-19,5,4,1,0.2
POLANCO,2023-03-20,15,14,1,0.0666666666666667
POLANCO,2023-03-21,19,17,2,0.105263157894737
POLANCO,2023-03-22,16,14,2,0.125
POLANCO,2023-03-23,16,16,0,0
POLANCO,2023-03-24,11,9,2,0.181818181818182
POLANCO,2023-03-25,21,21,0,0
POLANCO,2023-03-26,6,6,0,0
POLANCO,2023-03-27,15,15,0,0
POLANCO,2023-03-28,12,12,0,0
POLANCO,2023-03-29,17,15,2,0.117647058823529
POLANCO,2023-03-30,18,18,0,0
POLANCO,2023-03-31,20,19,1,0.05
POLANCO,2023-04-01,16,16,0,0
POLANCO,2023-04-02,8,8,0,0
POLANCO,2023-04-03,20,20,0,0
POLANCO,2023-04-04,20,20,0,0
POLANCO,2023-04-05,16,14,2,0.125
POLANCO,2023-04-06,16,16,0,0
POLANCO,2023-04-07,5,5,0,0
POLANCO,2023-04-08,10,10,0,0
POLANCO,2023-04-09,5,5,0,0
POLANCO,2023-04-10,13,13,0,0
POLANCO,2023-04-11,15,13,2,0.133333333333333
POLANCO,2023-04-12,17,16,1,0.0588235294117647
POLANCO,2023-04-13,15,14,1,0.0666666666666667
POLANCO,2023-04-14,15,14,1,0.0666666666666667
POLANCO,2023-04-15,22,18,4,0.181818181818182
POLANCO,2023-04-16,7,6,1,0.142857142857143
POLANCO,2023-04-17,24,23,1,0.0416666666666667
POLANCO,2023-04-18,14,12,2,0.142857142857143
POLANCO,2023-04-19,15,13,2,0.133333333333333
POLANCO,2023-04-20,13,11,2,0.153846153846154
POLANCO,2023-04-21,18,17,1,0.0555555555555556
POLANCO,2023-04-22,18,17,1,0.0555555555555556
POLANCO,2023-04-23,6,6,0,0
POLANCO,2023-04-24,12,10,2,0.166666666666667
POLANCO,2023-04-25,20,19,1,0.05
POLANCO,2023-04-26,11,11,0,0
POLANCO,2023-04-27,18,15,3,0.166666666666667
POLANCO,2023-04-28,17,16,1,0.0588235294117647
POLANCO,2023-04-29,18,17,1,0.0555555555555556
POLANCO,2023-04-30,6,5,1,0.166666666666667
POLANCO,2023-05-01,9,9,0,0
POLANCO,2023-05-02,16,16,0,0
POLANCO,2023-05-03,16,14,2,0.125
POLANCO,2023-05-04,22,20,2,0.0909090909090909
POLANCO,2023-05-05,17,15,2,0.117647058823529
POLANCO,2023-05-06,14,13,1,0.0714285714285714
POLANCO,2023-05-07,7,6,1,0.142857142857143
POLANCO,2023-05-08,21,20,1,0.0476190476190476
PORTALES,2023-01-02,21,20,1,0.0476190476190476
PORTALES,2023-01-03,13,12,1,0.0769230769230769
PORTALES,2023-01-04,30,28,2,0.0666666666666667
PORTALES,2023-01-05,26,25,1,0.0384615384615385
PORTALES,2023-01-06,27,24,3,0.111111111111111
PORTALES,2023-01-07,33,30,3,0.0909090909090909
PORTALES,2023-01-08,25,23,2,0.08
PORTALES,2023-01-09,27,25,2,0.0740740740740741
PORTALES,2023-01-10,20,19,1,0.05
PORTALES,2023-01-11,27,27,0,0
PORTALES,2023-01-12,25,21,4,0.16
PORTALES,2023-01-13,28,23,5,0.178571428571429
PORTALES,2023-01-14,30,25,5,0.166666666666667
PORTALES,2023-01-15,32,27,5,0.15625
PORTALES,2023-01-16,23,7,16,0.695652173913043
PORTALES,2023-01-17,20,3,17,0.85
PORTALES,2023-01-18,25,12,13,0.52
PORTALES,2023-01-19,22,13,9,0.409090909090909
PORTALES,2023-01-20,23,16,7,0.304347826086957
PORTALES,2023-01-21,30,20,10,0.333333333333333
PORTALES,2023-01-22,26,15,11,0.423076923076923
PORTALES,2023-01-23,22,11,11,0.5
PORTALES,2023-01-24,23,14,9,0.391304347826087
PORTALES,2023-01-25,18,14,4,0.222222222222222
PORTALES,2023-01-26,22,12,10,0.454545454545455
PORTALES,2023-01-27,24,14,10,0.416666666666667
PORTALES,2023-01-28,29,19,10,0.344827586206897
PORTALES,2023-01-29,21,14,7,0.333333333333333
PORTALES,2023-01-30,19,10,9,0.473684210526316
PORTALES,2023-01-31,25,12,13,0.52
PORTALES,2023-02-01,35,24,11,0.314285714285714
PORTALES,2023-02-02,29,19,10,0.344827586206897
PORTALES,2023-02-03,24,16,8,0.333333333333333
PORTALES,2023-02-04,33,22,11,0.333333333333333
PORTALES,2023-02-05,32,20,12,0.375
PORTALES,2023-02-06,31,19,12,0.387096774193548
PORTALES,2023-02-07,27,19,8,0.296296296296296
PORTALES,2023-02-08,22,14,8,0.363636363636364
PORTALES,2023-02-09,27,20,7,0.259259259259259
PORTALES,2023-02-10,25,14,11,0.44
PORTALES,2023-02-11,29,16,13,0.448275862068966
PORTALES,2023-02-12,26,14,12,0.461538461538462
PORTALES,2023-02-13,27,18,9,0.333333333333333
PORTALES,2023-02-14,20,11,9,0.45
PORTALES,2023-02-15,25,19,6,0.24
PORTALES,2023-02-16,23,17,6,0.260869565217391
PORTALES,2023-02-17,23,19,4,0.173913043478261
PORTALES,2023-02-18,31,21,10,0.32258064516129
PORTALES,2023-02-19,18,10,8,0.444444444444444
PORTALES,2023-02-20,23,20,3,0.130434782608696
PORTALES,2023-02-21,29,21,8,0.275862068965517
PORTALES,2023-02-22,23,19,4,0.173913043478261
PORTALES,2023-02-23,28,21,7,0.25
PORTALES,2023-02-24,36,23,13,0.361111111111111
PORTALES,2023-02-25,23,12,11,0.478260869565217
PORTALES,2023-02-26,22,14,8,0.363636363636364
PORTALES,2023-02-27,21,12,9,0.428571428571429
PORTALES,2023-02-28,19,15,4,0.210526315789474
PORTALES,2023-03-01,34,28,6,0.176470588235294
PORTALES,2023-03-02,18,10,8,0.444444444444444
PORTALES,2023-03-03,30,23,7,0.233333333333333
PORTALES,2023-03-04,39,27,12,0.307692307692308
PORTALES,2023-03-05,27,17,10,0.37037037037037
PORTALES,2023-03-06,28,22,6,0.214285714285714
PORTALES,2023-03-07,23,20,3,0.130434782608696
PORTALES,2023-03-08,30,29,1,0.0333333333333333
PORTALES,2023-03-09,25,24,1,0.04
PORTALES,2023-03-10,17,17,0,0
PORTALES,2023-03-11,21,21,0,0
PORTALES,2023-03-12,21,21,0,0
PORTALES,2023-03-13,25,25,0,0
PORTALES,2023-03-14,25,25,0,0
PORTALES,2023-03-15,32,32,0,0
PORTALES,2023-03-16,29,29,0,0
PORTALES,2023-03-17,33,33,0,0
PORTALES,2023-03-18,38,38,0,0
PORTALES,2023-03-19,28,28,0,0
PORTALES,2023-03-20,29,29,0,0
PORTALES,2023-03-21,28,28,0,0
PORTALES,2023-03-22,30,30,0,0
PORTALES,2023-03-23,35,35,0,0
PORTALES,2023-03-24,22,22,0,0
PORTALES,2023-03-25,32,32,0,0
PORTALES,2023-03-26,24,24,0,0
PORTALES,2023-03-27,26,25,1,0.0384615384615385
PORTALES,2023-03-28,29,29,0,0
PORTALES,2023-03-29,26,26,0,0
PORTALES,2023-03-30,21,21,0,0
PORTALES,2023-03-31,45,45,0,0
PORTALES,2023-04-01,50,49,1,0.02
PORTALES,2023-04-02,22,22,0,0
PORTALES,2023-04-03,32,32,0,0
PORTALES,2023-04-04,33,33,0,0
PORTALES,2023-04-05,22,22,0,0
PORTALES,2023-04-06,28,28,0,0
PORTALES,2023-04-07,28,28,0,0
PORTALES,2023-04-08,18,18,0,0
PORTALES,2023-04-09,15,15,0,0
PORTALES,2023-04-10,16,16,0,0
PORTALES,2023-04-11,23,23,0,0
PORTALES,2023-04-12,29,28,1,0.0344827586206897
PORTALES,2023-04-13,25,25,0,0
PORTALES,2023-04-14,33,33,0,0
PORTALES,2023-04-15,44,44,0,0
PORTALES,2023-04-16,36,35,1,0.0277777777777778
PORTALES,2023-04-17,29,27,2,0.0689655172413793
PORTALES,2023-04-18,36,35,1,0.0277777777777778
PORTALES,2023-04-19,33,33,0,0
PORTALES,2023-04-20,32,32,0,0
PORTALES,2023-04-21,36,36,0,0
PORTALES,2023-04-22,26,26,0,0
PORTALES,2023-04-23,26,26,0,0
PORTALES,2023-04-24,25,25,0,0
PORTALES,2023-04-25,28,28,0,0
PORTALES,2023-04-26,27,27,0,0
PORTALES,2023-04-27,31,30,1,0.032258064516129
PORTALES,2023-04-28,35,34,1,0.0285714285714286
PORTALES,2023-04-29,49,48,1,0.0204081632653061
PORTALES,2023-04-30,33,30,3,0.0909090909090909
PORTALES,2023-05-01,45,39,6,0.133333333333333
PORTALES,2023-05-02,34,32,2,0.0588235294117647
PORTALES,2023-05-03,22,20,2,0.0909090909090909
PORTALES,2023-05-04,26,25,1,0.0384615384615385
PORTALES,2023-05-05,38,38,0,0
PORTALES,2023-05-06,22,22,0,0
PORTALES,2023-05-07,29,29,0,0
PORTALES,2023-05-08,21,21,0,0
POZA RICA / TUXPAN,2023-01-02,20,11,9,0.45
POZA RICA / TUXPAN,2023-01-03,26,16,10,0.384615384615385
POZA RICA / TUXPAN,2023-01-04,14,6,8,0.571428571428571
POZA RICA / TUXPAN,2023-01-05,20,10,10,0.5
POZA RICA / TUXPAN,2023-01-06,27,19,8,0.296296296296296
POZA RICA / TUXPAN,2023-01-07,25,16,9,0.36
POZA RICA / TUXPAN,2023-01-08,12,8,4,0.333333333333333
POZA RICA / TUXPAN,2023-01-09,11,6,5,0.454545454545455
POZA RICA / TUXPAN,2023-01-10,20,8,12,0.6
POZA RICA / TUXPAN,2023-01-11,13,7,6,0.461538461538462
POZA RICA / TUXPAN,2023-01-12,17,8,9,0.529411764705882
POZA RICA / TUXPAN,2023-01-13,17,7,10,0.588235294117647
POZA RICA / TUXPAN,2023-01-14,16,8,8,0.5
POZA RICA / TUXPAN,2023-01-15,13,6,7,0.538461538461538
POZA RICA / TUXPAN,2023-01-16,17,9,8,0.470588235294118
POZA RICA / TUXPAN,2023-01-17,22,11,11,0.5
POZA RICA / TUXPAN,2023-01-18,21,11,10,0.476190476190476
POZA RICA / TUXPAN,2023-01-19,17,8,9,0.529411764705882
POZA RICA / TUXPAN,2023-01-20,19,7,12,0.631578947368421
POZA RICA / TUXPAN,2023-01-21,15,5,10,0.666666666666667
POZA RICA / TUXPAN,2023-01-22,15,4,11,0.733333333333333
POZA RICA / TUXPAN,2023-01-23,16,2,14,0.875
POZA RICA / TUXPAN,2023-01-24,15,4,11,0.733333333333333
POZA RICA / TUXPAN,2023-01-25,15,6,9,0.6
POZA RICA / TUXPAN,2023-01-26,16,6,10,0.625
POZA RICA / TUXPAN,2023-01-27,19,7,12,0.631578947368421
POZA RICA / TUXPAN,2023-01-28,16,6,10,0.625
POZA RICA / TUXPAN,2023-01-29,10,4,6,0.6
POZA RICA / TUXPAN,2023-01-30,10,4,6,0.6
POZA RICA / TUXPAN,2023-01-31,17,6,11,0.647058823529412
POZA RICA / TUXPAN,2023-02-01,25,10,15,0.6
POZA RICA / TUXPAN,2023-02-02,21,4,17,0.80952380952381
POZA RICA / TUXPAN,2023-02-03,16,6,10,0.625
POZA RICA / TUXPAN,2023-02-04,21,9,12,0.571428571428571
POZA RICA / TUXPAN,2023-02-05,13,4,9,0.692307692307692
POZA RICA / TUXPAN,2023-02-06,23,6,17,0.739130434782609
POZA RICA / TUXPAN,2023-02-07,24,7,17,0.708333333333333
POZA RICA / TUXPAN,2023-02-08,16,8,8,0.5
POZA RICA / TUXPAN,2023-02-09,18,7,11,0.611111111111111
POZA RICA / TUXPAN,2023-02-10,12,4,8,0.666666666666667
POZA RICA / TUXPAN,2023-02-11,16,4,12,0.75
POZA RICA / TUXPAN,2023-02-12,11,3,8,0.727272727272727
POZA RICA / TUXPAN,2023-02-13,13,3,10,0.769230769230769
POZA RICA / TUXPAN,2023-02-14,11,3,8,0.727272727272727
POZA RICA / TUXPAN,2023-02-15,14,4,10,0.714285714285714
POZA RICA / TUXPAN,2023-02-16,20,7,13,0.65
POZA RICA / TUXPAN,2023-02-17,13,5,8,0.615384615384615
POZA RICA / TUXPAN,2023-02-18,11,5,6,0.545454545454545
POZA RICA / TUXPAN,2023-02-19,12,3,9,0.75
POZA RICA / TUXPAN,2023-02-20,7,3,4,0.571428571428571
POZA RICA / TUXPAN,2023-02-21,15,3,12,0.8
POZA RICA / TUXPAN,2023-02-22,18,2,16,0.888888888888889
POZA RICA / TUXPAN,2023-02-23,21,11,10,0.476190476190476
POZA RICA / TUXPAN,2023-02-24,15,3,12,0.8
POZA RICA / TUXPAN,2023-02-25,12,4,8,0.666666666666667
POZA RICA / TUXPAN,2023-02-26,9,1,8,0.888888888888889
POZA RICA / TUXPAN,2023-02-27,18,3,15,0.833333333333333
POZA RICA / TUXPAN,2023-02-28,15,1,14,0.933333333333333
POZA RICA / TUXPAN,2023-03-01,29,8,21,0.724137931034483
POZA RICA / TUXPAN,2023-03-02,19,3,16,0.842105263157895
POZA RICA / TUXPAN,2023-03-03,13,3,10,0.769230769230769
POZA RICA / TUXPAN,2023-03-04,13,2,11,0.846153846153846
POZA RICA / TUXPAN,2023-03-05,7,1,6,0.857142857142857
POZA RICA / TUXPAN,2023-03-06,21,4,17,0.80952380952381
POZA RICA / TUXPAN,2023-03-07,16,5,11,0.6875
POZA RICA / TUXPAN,2023-03-08,14,7,7,0.5
POZA RICA / TUXPAN,2023-03-09,12,8,4,0.333333333333333
POZA RICA / TUXPAN,2023-03-10,17,15,2,0.117647058823529
POZA RICA / TUXPAN,2023-03-11,11,10,1,0.0909090909090909
POZA RICA / TUXPAN,2023-03-12,9,9,0,0
POZA RICA / TUXPAN,2023-03-13,12,11,1,0.0833333333333333
POZA RICA / TUXPAN,2023-03-14,18,16,2,0.111111111111111
POZA RICA / TUXPAN,2023-03-15,16,15,1,0.0625
POZA RICA / TUXPAN,2023-03-16,25,24,1,0.04
POZA RICA / TUXPAN,2023-03-17,21,20,1,0.0476190476190476
POZA RICA / TUXPAN,2023-03-18,17,17,0,0
POZA RICA / TUXPAN,2023-03-19,17,17,0,0
POZA RICA / TUXPAN,2023-03-20,18,17,1,0.0555555555555556
POZA RICA / TUXPAN,2023-03-21,15,15,0,0
POZA RICA / TUXPAN,2023-03-22,18,17,1,0.0555555555555556
POZA RICA / TUXPAN,2023-03-23,18,18,0,0
POZA RICA / TUXPAN,2023-03-24,21,21,0,0
POZA RICA / TUXPAN,2023-03-25,22,22,0,0
POZA RICA / TUXPAN,2023-03-26,12,12,0,0
POZA RICA / TUXPAN,2023-03-27,10,10,0,0
POZA RICA / TUXPAN,2023-03-28,13,13,0,0
POZA RICA / TUXPAN,2023-03-29,12,12,0,0
POZA RICA / TUXPAN,2023-03-30,23,22,1,0.0434782608695652
POZA RICA / TUXPAN,2023-03-31,28,28,0,0
POZA RICA / TUXPAN,2023-04-01,19,18,1,0.0526315789473684
POZA RICA / TUXPAN,2023-04-02,11,11,0,0
POZA RICA / TUXPAN,2023-04-03,16,16,0,0
POZA RICA / TUXPAN,2023-04-04,10,10,0,0
POZA RICA / TUXPAN,2023-04-05,19,19,0,0
POZA RICA / TUXPAN,2023-04-06,17,17,0,0
POZA RICA / TUXPAN,2023-04-07,12,12,0,0
POZA RICA / TUXPAN,2023-04-08,16,16,0,0
POZA RICA / TUXPAN,2023-04-09,14,14,0,0
POZA RICA / TUXPAN,2023-04-10,12,11,1,0.0833333333333333
POZA RICA / TUXPAN,2023-04-11,18,18,0,0
POZA RICA / TUXPAN,2023-04-12,20,20,0,0
POZA RICA / TUXPAN,2023-04-13,16,16,0,0
POZA RICA / TUXPAN,2023-04-14,23,23,0,0
POZA RICA / TUXPAN,2023-04-15,28,25,3,0.107142857142857
POZA RICA / TUXPAN,2023-04-16,26,26,0,0
POZA RICA / TUXPAN,2023-04-17,21,18,3,0.142857142857143
POZA RICA / TUXPAN,2023-04-18,16,15,1,0.0625
POZA RICA / TUXPAN,2023-04-19,17,17,0,0
POZA RICA / TUXPAN,2023-04-20,15,13,2,0.133333333333333
POZA RICA / TUXPAN,2023-04-21,20,19,1,0.05
POZA RICA / TUXPAN,2023-04-22,21,20,1,0.0476190476190476
POZA RICA / TUXPAN,2023-04-23,11,11,0,0
POZA RICA / TUXPAN,2023-04-24,19,19,0,0
POZA RICA / TUXPAN,2023-04-25,27,25,2,0.0740740740740741
POZA RICA / TUXPAN,2023-04-26,19,18,1,0.0526315789473684
POZA RICA / TUXPAN,2023-04-27,9,9,0,0
POZA RICA / TUXPAN,2023-04-28,18,16,2,0.111111111111111
POZA RICA / TUXPAN,2023-04-29,22,21,1,0.0454545454545455
POZA RICA / TUXPAN,2023-04-30,20,19,1,0.05
POZA RICA / TUXPAN,2023-05-01,17,17,0,0
POZA RICA / TUXPAN,2023-05-02,20,20,0,0
POZA RICA / TUXPAN,2023-05-03,23,22,1,0.0434782608695652
POZA RICA / TUXPAN,2023-05-04,25,25,0,0
POZA RICA / TUXPAN,2023-05-05,23,23,0,0
POZA RICA / TUXPAN,2023-05-06,21,18,3,0.142857142857143
POZA RICA / TUXPAN,2023-05-07,7,7,0,0
POZA RICA / TUXPAN,2023-05-08,15,14,1,0.0666666666666667
PUE LA NORIA,2023-01-02,29,28,1,0.0344827586206897
PUE LA NORIA,2023-01-03,30,22,8,0.266666666666667
PUE LA NORIA,2023-01-04,32,27,5,0.15625
PUE LA NORIA,2023-01-05,34,27,7,0.205882352941176
PUE LA NORIA,2023-01-06,40,36,4,0.1
PUE LA NORIA,2023-01-07,42,36,6,0.142857142857143
PUE LA NORIA,2023-01-08,27,23,4,0.148148148148148
PUE LA NORIA,2023-01-09,40,34,6,0.15
PUE LA NORIA,2023-01-10,43,37,6,0.13953488372093
PUE LA NORIA,2023-01-11,42,35,7,0.166666666666667
PUE LA NORIA,2023-01-12,42,36,6,0.142857142857143
PUE LA NORIA,2023-01-13,40,30,10,0.25
PUE LA NORIA,2023-01-14,49,37,12,0.244897959183673
PUE LA NORIA,2023-01-15,41,34,7,0.170731707317073
PUE LA NORIA,2023-01-16,40,24,16,0.4
PUE LA NORIA,2023-01-17,38,26,12,0.315789473684211
PUE LA NORIA,2023-01-18,45,32,13,0.288888888888889
PUE LA NORIA,2023-01-19,38,24,14,0.368421052631579
PUE LA NORIA,2023-01-20,40,29,11,0.275
PUE LA NORIA,2023-01-21,51,34,17,0.333333333333333
PUE LA NORIA,2023-01-22,37,30,7,0.189189189189189
PUE LA NORIA,2023-01-23,44,36,8,0.181818181818182
PUE LA NORIA,2023-01-24,33,24,9,0.272727272727273
PUE LA NORIA,2023-01-25,35,26,9,0.257142857142857
PUE LA NORIA,2023-01-26,42,33,9,0.214285714285714
PUE LA NORIA,2023-01-27,36,24,12,0.333333333333333
PUE LA NORIA,2023-01-28,42,25,17,0.404761904761905
PUE LA NORIA,2023-01-29,35,23,12,0.342857142857143
PUE LA NORIA,2023-01-30,32,27,5,0.15625
PUE LA NORIA,2023-01-31,34,27,7,0.205882352941176
PUE LA NORIA,2023-02-01,39,29,10,0.256410256410256
PUE LA NORIA,2023-02-02,34,22,12,0.352941176470588
PUE LA NORIA,2023-02-03,44,29,15,0.340909090909091
PUE LA NORIA,2023-02-04,43,29,14,0.325581395348837
PUE LA NORIA,2023-02-05,32,26,6,0.1875
PUE LA NORIA,2023-02-06,32,23,9,0.28125
PUE LA NORIA,2023-02-07,39,22,17,0.435897435897436
PUE LA NORIA,2023-02-08,45,33,12,0.266666666666667
PUE LA NORIA,2023-02-09,42,26,16,0.380952380952381
PUE LA NORIA,2023-02-10,39,26,13,0.333333333333333
PUE LA NORIA,2023-02-11,37,34,3,0.0810810810810811
PUE LA NORIA,2023-02-12,23,12,11,0.478260869565217
PUE LA NORIA,2023-02-13,28,22,6,0.214285714285714
PUE LA NORIA,2023-02-14,29,20,9,0.310344827586207
PUE LA NORIA,2023-02-15,36,21,15,0.416666666666667
PUE LA NORIA,2023-02-16,36,25,11,0.305555555555556
PUE LA NORIA,2023-02-17,19,13,6,0.315789473684211
PUE LA NORIA,2023-02-18,41,30,11,0.268292682926829
PUE LA NORIA,2023-02-19,17,9,8,0.470588235294118
PUE LA NORIA,2023-02-20,27,20,7,0.259259259259259
PUE LA NORIA,2023-02-21,28,20,8,0.285714285714286
PUE LA NORIA,2023-02-22,25,22,3,0.12
PUE LA NORIA,2023-02-23,28,19,9,0.321428571428571
PUE LA NORIA,2023-02-24,35,24,11,0.314285714285714
PUE LA NORIA,2023-02-25,43,35,8,0.186046511627907
PUE LA NORIA,2023-02-26,19,11,8,0.421052631578947
PUE LA NORIA,2023-02-27,44,32,12,0.272727272727273
PUE LA NORIA,2023-02-28,42,32,10,0.238095238095238
PUE LA NORIA,2023-03-01,26,16,10,0.384615384615385
PUE LA NORIA,2023-03-02,28,20,8,0.285714285714286
PUE LA NORIA,2023-03-03,31,24,7,0.225806451612903
PUE LA NORIA,2023-03-04,25,16,9,0.36
PUE LA NORIA,2023-03-05,25,15,10,0.4
PUE LA NORIA,2023-03-06,37,28,9,0.243243243243243
PUE LA NORIA,2023-03-07,40,36,4,0.1
PUE LA NORIA,2023-03-08,34,23,11,0.323529411764706
PUE LA NORIA,2023-03-09,31,26,5,0.161290322580645
PUE LA NORIA,2023-03-10,26,26,0,0
PUE LA NORIA,2023-03-11,20,17,3,0.15
PUE LA NORIA,2023-03-12,34,32,2,0.0588235294117647
PUE LA NORIA,2023-03-13,30,27,3,0.1
PUE LA NORIA,2023-03-14,34,29,5,0.147058823529412
PUE LA NORIA,2023-03-15,40,35,5,0.125
PUE LA NORIA,2023-03-16,47,38,9,0.191489361702128
PUE LA NORIA,2023-03-17,46,30,16,0.347826086956522
PUE LA NORIA,2023-03-18,71,59,12,0.169014084507042
PUE LA NORIA,2023-03-19,48,35,13,0.270833333333333
PUE LA NORIA,2023-03-20,53,44,9,0.169811320754717
PUE LA NORIA,2023-03-21,35,29,6,0.171428571428571
PUE LA NORIA,2023-03-22,35,30,5,0.142857142857143
PUE LA NORIA,2023-03-23,34,29,5,0.147058823529412
PUE LA NORIA,2023-03-24,32,26,6,0.1875
PUE LA NORIA,2023-03-25,36,33,3,0.0833333333333333
PUE LA NORIA,2023-03-26,35,30,5,0.142857142857143
PUE LA NORIA,2023-03-27,38,35,3,0.0789473684210526
PUE LA NORIA,2023-03-28,31,26,5,0.161290322580645
PUE LA NORIA,2023-03-29,37,35,2,0.0540540540540541
PUE LA NORIA,2023-03-30,42,38,4,0.0952380952380952
PUE LA NORIA,2023-03-31,60,54,6,0.1
PUE LA NORIA,2023-04-01,53,50,3,0.0566037735849057
PUE LA NORIA,2023-04-02,30,29,1,0.0333333333333333
PUE LA NORIA,2023-04-03,45,42,3,0.0666666666666667
PUE LA NORIA,2023-04-04,36,34,2,0.0555555555555556
PUE LA NORIA,2023-04-05,27,25,2,0.0740740740740741
PUE LA NORIA,2023-04-06,48,48,0,0
PUE LA NORIA,2023-04-07,29,26,3,0.103448275862069
PUE LA NORIA,2023-04-08,26,25,1,0.0384615384615385
PUE LA NORIA,2023-04-09,8,8,0,0
PUE LA NORIA,2023-04-10,31,30,1,0.032258064516129
PUE LA NORIA,2023-04-11,39,33,6,0.153846153846154
PUE LA NORIA,2023-04-12,30,28,2,0.0666666666666667
PUE LA NORIA,2023-04-13,29,27,2,0.0689655172413793
PUE LA NORIA,2023-04-14,28,27,1,0.0357142857142857
PUE LA NORIA,2023-04-15,48,48,0,0
PUE LA NORIA,2023-04-16,37,37,0,0
PUE LA NORIA,2023-04-17,32,31,1,0.03125
PUE LA NORIA,2023-04-18,32,32,0,0
PUE LA NORIA,2023-04-19,28,28,0,0
PUE LA NORIA,2023-04-20,32,32,0,0
PUE LA NORIA,2023-04-21,25,25,0,0
PUE LA NORIA,2023-04-22,38,38,0,0
PUE LA NORIA,2023-04-23,40,37,3,0.075
PUE LA NORIA,2023-04-24,41,41,0,0
PUE LA NORIA,2023-04-25,48,47,1,0.0208333333333333
PUE LA NORIA,2023-04-26,29,28,1,0.0344827586206897
PUE LA NORIA,2023-04-27,31,31,0,0
PUE LA NORIA,2023-04-28,45,45,0,0
PUE LA NORIA,2023-04-29,59,58,1,0.0169491525423729
PUE LA NORIA,2023-04-30,37,36,1,0.027027027027027
PUE LA NORIA,2023-05-01,28,26,2,0.0714285714285714
PUE LA NORIA,2023-05-02,38,36,2,0.0526315789473684
PUE LA NORIA,2023-05-03,24,24,0,0
PUE LA NORIA,2023-05-04,30,29,1,0.0333333333333333
PUE LA NORIA,2023-05-05,32,32,0,0
PUE LA NORIA,2023-05-06,38,37,1,0.0263157894736842
PUE LA NORIA,2023-05-07,18,17,1,0.0555555555555556
PUE LA NORIA,2023-05-08,24,24,0,0
PUE LORETO,2023-01-02,13,11,2,0.153846153846154
PUE LORETO,2023-01-03,28,26,2,0.0714285714285714
PUE LORETO,2023-01-04,43,39,4,0.0930232558139535
PUE LORETO,2023-01-05,25,23,2,0.08
PUE LORETO,2023-01-06,40,38,2,0.05
PUE LORETO,2023-01-07,39,38,1,0.0256410256410256
PUE LORETO,2023-01-08,25,23,2,0.08
PUE LORETO,2023-01-09,35,33,2,0.0571428571428571
PUE LORETO,2023-01-10,34,30,4,0.117647058823529
PUE LORETO,2023-01-11,36,32,4,0.111111111111111
PUE LORETO,2023-01-12,31,29,2,0.0645161290322581
PUE LORETO,2023-01-13,39,35,4,0.102564102564103
PUE LORETO,2023-01-14,30,29,1,0.0333333333333333
PUE LORETO,2023-01-15,29,24,5,0.172413793103448
PUE LORETO,2023-01-16,25,14,11,0.44
PUE LORETO,2023-01-17,35,17,18,0.514285714285714
PUE LORETO,2023-01-18,25,9,16,0.64
PUE LORETO,2023-01-19,27,15,12,0.444444444444444
PUE LORETO,2023-01-20,40,21,19,0.475
PUE LORETO,2023-01-21,37,21,16,0.432432432432432
PUE LORETO,2023-01-22,48,21,27,0.5625
PUE LORETO,2023-01-23,42,22,20,0.476190476190476
PUE LORETO,2023-01-24,30,14,16,0.533333333333333
PUE LORETO,2023-01-25,36,20,16,0.444444444444444
PUE LORETO,2023-01-26,33,18,15,0.454545454545455
PUE LORETO,2023-01-27,32,15,17,0.53125
PUE LORETO,2023-01-28,50,23,27,0.54
PUE LORETO,2023-01-29,38,16,22,0.578947368421053
PUE LORETO,2023-01-30,37,19,18,0.486486486486487
PUE LORETO,2023-01-31,45,29,16,0.355555555555556
PUE LORETO,2023-02-01,41,24,17,0.414634146341463
PUE LORETO,2023-02-02,27,20,7,0.259259259259259
PUE LORETO,2023-02-03,23,14,9,0.391304347826087
PUE LORETO,2023-02-04,32,19,13,0.40625
PUE LORETO,2023-02-05,18,12,6,0.333333333333333
PUE LORETO,2023-02-06,15,12,3,0.2
PUE LORETO,2023-02-07,29,23,6,0.206896551724138
PUE LORETO,2023-02-08,38,26,12,0.315789473684211
PUE LORETO,2023-02-09,31,24,7,0.225806451612903
PUE LORETO,2023-02-10,33,25,8,0.242424242424242
PUE LORETO,2023-02-11,29,22,7,0.241379310344828
PUE LORETO,2023-02-12,25,11,14,0.56
PUE LORETO,2023-02-13,21,9,12,0.571428571428571
PUE LORETO,2023-02-14,31,21,10,0.32258064516129
PUE LORETO,2023-02-15,24,20,4,0.166666666666667
PUE LORETO,2023-02-16,32,23,9,0.28125
PUE LORETO,2023-02-17,28,21,7,0.25
PUE LORETO,2023-02-18,36,32,4,0.111111111111111
PUE LORETO,2023-02-19,35,26,9,0.257142857142857
PUE LORETO,2023-02-20,25,20,5,0.2
PUE LORETO,2023-02-21,34,24,10,0.294117647058824
PUE LORETO,2023-02-22,28,20,8,0.285714285714286
PUE LORETO,2023-02-23,33,28,5,0.151515151515152
PUE LORETO,2023-02-24,32,27,5,0.15625
PUE LORETO,2023-02-25,35,32,3,0.0857142857142857
PUE LORETO,2023-02-26,35,29,6,0.171428571428571
PUE LORETO,2023-02-27,42,27,15,0.357142857142857
PUE LORETO,2023-02-28,46,36,10,0.217391304347826
PUE LORETO,2023-03-01,22,12,10,0.454545454545455
PUE LORETO,2023-03-02,20,12,8,0.4
PUE LORETO,2023-03-03,38,33,5,0.131578947368421
PUE LORETO,2023-03-04,25,18,7,0.28
PUE LORETO,2023-03-05,23,18,5,0.217391304347826
PUE LORETO,2023-03-06,25,19,6,0.24
PUE LORETO,2023-03-07,34,29,5,0.147058823529412
PUE LORETO,2023-03-08,34,28,6,0.176470588235294
PUE LORETO,2023-03-09,26,24,2,0.0769230769230769
PUE LORETO,2023-03-10,24,23,1,0.0416666666666667
PUE LORETO,2023-03-11,46,46,0,0
PUE LORETO,2023-03-12,28,26,2,0.0714285714285714
PUE LORETO,2023-03-13,23,23,0,0
PUE LORETO,2023-03-14,25,25,0,0
PUE LORETO,2023-03-15,34,34,0,0
PUE LORETO,2023-03-16,33,32,1,0.0303030303030303
PUE LORETO,2023-03-17,33,33,0,0
PUE LORETO,2023-03-18,39,39,0,0
PUE LORETO,2023-03-19,41,41,0,0
PUE LORETO,2023-03-20,29,29,0,0
PUE LORETO,2023-03-21,36,35,1,0.0277777777777778
PUE LORETO,2023-03-22,35,35,0,0
PUE LORETO,2023-03-23,33,33,0,0
PUE LORETO,2023-03-24,32,32,0,0
PUE LORETO,2023-03-25,27,27,0,0
PUE LORETO,2023-03-26,26,26,0,0
PUE LORETO,2023-03-27,20,20,0,0
PUE LORETO,2023-03-28,23,23,0,0
PUE LORETO,2023-03-29,24,24,0,0
PUE LORETO,2023-03-30,36,36,0,0
PUE LORETO,2023-03-31,37,37,0,0
PUE LORETO,2023-04-01,34,34,0,0
PUE LORETO,2023-04-02,19,19,0,0
PUE LORETO,2023-04-03,18,18,0,0
PUE LORETO,2023-04-04,28,28,0,0
PUE LORETO,2023-04-05,22,22,0,0
PUE LORETO,2023-04-06,27,27,0,0
PUE LORETO,2023-04-07,28,28,0,0
PUE LORETO,2023-04-08,14,14,0,0
PUE LORETO,2023-04-09,13,13,0,0
PUE LORETO,2023-04-10,21,21,0,0
PUE LORETO,2023-04-11,28,28,0,0
PUE LORETO,2023-04-12,27,27,0,0
PUE LORETO,2023-04-13,30,30,0,0
PUE LORETO,2023-04-14,30,30,0,0
PUE LORETO,2023-04-15,36,35,1,0.0277777777777778
PUE LORETO,2023-04-16,38,38,0,0
PUE LORETO,2023-04-17,31,31,0,0
PUE LORETO,2023-04-18,28,28,0,0
PUE LORETO,2023-04-19,33,32,1,0.0303030303030303
PUE LORETO,2023-04-20,28,28,0,0
PUE LORETO,2023-04-21,38,38,0,0
PUE LORETO,2023-04-22,24,24,0,0
PUE LORETO,2023-04-23,23,23,0,0
PUE LORETO,2023-04-24,25,25,0,0
PUE LORETO,2023-04-25,29,29,0,0
PUE LORETO,2023-04-26,39,39,0,0
PUE LORETO,2023-04-27,24,22,2,0.0833333333333333
PUE LORETO,2023-04-28,39,35,4,0.102564102564103
PUE LORETO,2023-04-29,44,42,2,0.0454545454545455
PUE LORETO,2023-04-30,43,41,2,0.0465116279069767
PUE LORETO,2023-05-01,26,26,0,0
PUE LORETO,2023-05-02,31,30,1,0.032258064516129
PUE LORETO,2023-05-03,24,23,1,0.0416666666666667
PUE LORETO,2023-05-04,23,21,2,0.0869565217391304
PUE LORETO,2023-05-05,27,25,2,0.0740740740740741
PUE LORETO,2023-05-06,27,27,0,0
PUE LORETO,2023-05-07,22,21,1,0.0454545454545455
PUE LORETO,2023-05-08,27,25,2,0.0740740740740741
PUERTO VALLARTA,2023-01-02,28,17,11,0.392857142857143
PUERTO VALLARTA,2023-01-03,41,24,17,0.414634146341463
PUERTO VALLARTA,2023-01-04,25,10,15,0.6
PUERTO VALLARTA,2023-01-05,23,9,14,0.608695652173913
PUERTO VALLARTA,2023-01-06,42,21,21,0.5
PUERTO VALLARTA,2023-01-07,35,18,17,0.485714285714286
PUERTO VALLARTA,2023-01-08,28,18,10,0.357142857142857
PUERTO VALLARTA,2023-01-09,36,19,17,0.472222222222222
PUERTO VALLARTA,2023-01-10,29,20,9,0.310344827586207
PUERTO VALLARTA,2023-01-11,32,18,14,0.4375
PUERTO VALLARTA,2023-01-12,29,16,13,0.448275862068966
PUERTO VALLARTA,2023-01-13,31,18,13,0.419354838709677
PUERTO VALLARTA,2023-01-14,37,26,11,0.297297297297297
PUERTO VALLARTA,2023-01-15,32,23,9,0.28125
PUERTO VALLARTA,2023-01-16,37,20,17,0.459459459459459
PUERTO VALLARTA,2023-01-17,39,19,20,0.512820512820513
PUERTO VALLARTA,2023-01-18,36,24,12,0.333333333333333
PUERTO VALLARTA,2023-01-19,28,15,13,0.464285714285714
PUERTO VALLARTA,2023-01-20,27,18,9,0.333333333333333
PUERTO VALLARTA,2023-01-21,35,9,26,0.742857142857143
PUERTO VALLARTA,2023-01-22,33,8,25,0.757575757575758
PUERTO VALLARTA,2023-01-23,34,7,27,0.794117647058823
PUERTO VALLARTA,2023-01-24,38,2,36,0.947368421052632
PUERTO VALLARTA,2023-01-25,36,5,31,0.861111111111111
PUERTO VALLARTA,2023-01-26,38,12,26,0.684210526315789
PUERTO VALLARTA,2023-01-27,36,3,33,0.916666666666667
PUERTO VALLARTA,2023-01-28,36,6,30,0.833333333333333
PUERTO VALLARTA,2023-01-29,32,4,28,0.875
PUERTO VALLARTA,2023-01-30,36,5,31,0.861111111111111
PUERTO VALLARTA,2023-01-31,23,2,21,0.91304347826087
PUERTO VALLARTA,2023-02-01,25,6,19,0.76
PUERTO VALLARTA,2023-02-02,39,2,37,0.948717948717949
PUERTO VALLARTA,2023-02-03,43,10,33,0.767441860465116
PUERTO VALLARTA,2023-02-04,34,5,29,0.852941176470588
PUERTO VALLARTA,2023-02-05,27,4,23,0.851851851851852
PUERTO VALLARTA,2023-02-06,36,8,28,0.777777777777778
PUERTO VALLARTA,2023-02-07,46,11,35,0.760869565217391
PUERTO VALLARTA,2023-02-08,23,5,18,0.782608695652174
PUERTO VALLARTA,2023-02-09,38,11,27,0.710526315789474
PUERTO VALLARTA,2023-02-10,32,5,27,0.84375
PUERTO VALLARTA,2023-02-11,26,6,20,0.769230769230769
PUERTO VALLARTA,2023-02-12,29,3,26,0.896551724137931
PUERTO VALLARTA,2023-02-13,27,6,21,0.777777777777778
PUERTO VALLARTA,2023-02-14,24,1,23,0.958333333333333
PUERTO VALLARTA,2023-02-15,17,2,15,0.882352941176471
PUERTO VALLARTA,2023-02-16,27,0,28,1
PUERTO VALLARTA,2023-02-17,29,0,29,1
PUERTO VALLARTA,2023-02-18,30,3,27,0.9
PUERTO VALLARTA,2023-02-19,20,2,18,0.9
PUERTO VALLARTA,2023-02-20,33,4,29,0.878787878787879
PUERTO VALLARTA,2023-02-21,23,5,18,0.782608695652174
PUERTO VALLARTA,2023-02-22,33,9,24,0.727272727272727
PUERTO VALLARTA,2023-02-23,28,8,20,0.714285714285714
PUERTO VALLARTA,2023-02-24,28,12,16,0.571428571428571
PUERTO VALLARTA,2023-02-25,32,19,13,0.40625
PUERTO VALLARTA,2023-02-26,17,7,10,0.588235294117647
PUERTO VALLARTA,2023-02-27,34,17,17,0.5
PUERTO VALLARTA,2023-02-28,28,15,13,0.464285714285714
PUERTO VALLARTA,2023-03-01,27,8,19,0.703703703703704
PUERTO VALLARTA,2023-03-02,38,27,11,0.289473684210526
PUERTO VALLARTA,2023-03-03,29,13,16,0.551724137931034
PUERTO VALLARTA,2023-03-04,30,16,14,0.466666666666667
PUERTO VALLARTA,2023-03-05,19,13,6,0.315789473684211
PUERTO VALLARTA,2023-03-06,25,10,15,0.6
PUERTO VALLARTA,2023-03-07,34,19,15,0.441176470588235
PUERTO VALLARTA,2023-03-08,24,16,8,0.333333333333333
PUERTO VALLARTA,2023-03-09,30,22,8,0.266666666666667
PUERTO VALLARTA,2023-03-10,32,24,8,0.25
PUERTO VALLARTA,2023-03-11,29,22,7,0.241379310344828
PUERTO VALLARTA,2023-03-12,29,23,6,0.206896551724138
PUERTO VALLARTA,2023-03-13,22,16,6,0.272727272727273
PUERTO VALLARTA,2023-03-14,37,33,4,0.108108108108108
PUERTO VALLARTA,2023-03-15,25,17,8,0.32
PUERTO VALLARTA,2023-03-16,35,28,7,0.2
PUERTO VALLARTA,2023-03-17,35,28,7,0.2
PUERTO VALLARTA,2023-03-18,38,33,5,0.131578947368421
PUERTO VALLARTA,2023-03-19,22,21,1,0.0454545454545455
PUERTO VALLARTA,2023-03-20,40,36,4,0.1
PUERTO VALLARTA,2023-03-21,38,32,6,0.157894736842105
PUERTO VALLARTA,2023-03-22,37,32,5,0.135135135135135
PUERTO VALLARTA,2023-03-23,32,30,2,0.0625
PUERTO VALLARTA,2023-03-24,29,24,5,0.172413793103448
PUERTO VALLARTA,2023-03-25,45,42,3,0.0666666666666667
PUERTO VALLARTA,2023-03-26,26,22,4,0.153846153846154
PUERTO VALLARTA,2023-03-27,31,28,3,0.0967741935483871
PUERTO VALLARTA,2023-03-28,25,22,3,0.12
PUERTO VALLARTA,2023-03-29,40,36,4,0.1
PUERTO VALLARTA,2023-03-30,37,30,7,0.189189189189189
PUERTO VALLARTA,2023-03-31,27,22,5,0.185185185185185
PUERTO VALLARTA,2023-04-01,35,31,4,0.114285714285714
PUERTO VALLARTA,2023-04-02,25,23,2,0.08
PUERTO VALLARTA,2023-04-03,30,28,2,0.0666666666666667
PUERTO VALLARTA,2023-04-04,41,35,6,0.146341463414634
PUERTO VALLARTA,2023-04-05,40,32,8,0.2
PUERTO VALLARTA,2023-04-06,37,36,1,0.027027027027027
PUERTO VALLARTA,2023-04-07,22,21,1,0.0454545454545455
PUERTO VALLARTA,2023-04-08,11,10,1,0.0909090909090909
PUERTO VALLARTA,2023-04-09,15,15,0,0
PUERTO VALLARTA,2023-04-10,21,20,1,0.0476190476190476
PUERTO VALLARTA,2023-04-11,33,29,4,0.121212121212121
PUERTO VALLARTA,2023-04-12,31,28,3,0.0967741935483871
PUERTO VALLARTA,2023-04-13,34,30,4,0.117647058823529
PUERTO VALLARTA,2023-04-14,20,17,3,0.15
PUERTO VALLARTA,2023-04-15,29,28,1,0.0344827586206897
PUERTO VALLARTA,2023-04-16,20,19,1,0.05
PUERTO VALLARTA,2023-04-17,31,29,2,0.0645161290322581
PUERTO VALLARTA,2023-04-18,28,22,6,0.214285714285714
PUERTO VALLARTA,2023-04-19,28,26,2,0.0714285714285714
PUERTO VALLARTA,2023-04-20,18,17,1,0.0555555555555556
PUERTO VALLARTA,2023-04-21,24,21,3,0.125
PUERTO VALLARTA,2023-04-22,31,29,2,0.0645161290322581
PUERTO VALLARTA,2023-04-23,18,16,2,0.111111111111111
PUERTO VALLARTA,2023-04-24,39,35,4,0.102564102564103
PUERTO VALLARTA,2023-04-25,30,27,3,0.1
PUERTO VALLARTA,2023-04-26,28,26,2,0.0714285714285714
PUERTO VALLARTA,2023-04-27,25,22,3,0.12
PUERTO VALLARTA,2023-04-28,34,32,2,0.0588235294117647
PUERTO VALLARTA,2023-04-29,23,21,2,0.0869565217391304
PUERTO VALLARTA,2023-04-30,19,19,0,0
PUERTO VALLARTA,2023-05-01,22,20,2,0.0909090909090909
PUERTO VALLARTA,2023-05-02,32,30,2,0.0625
PUERTO VALLARTA,2023-05-03,27,26,1,0.037037037037037
PUERTO VALLARTA,2023-05-04,25,22,3,0.12
PUERTO VALLARTA,2023-05-05,23,21,2,0.0869565217391304
PUERTO VALLARTA,2023-05-06,23,20,3,0.130434782608696
PUERTO VALLARTA,2023-05-07,20,20,0,0
PUERTO VALLARTA,2023-05-08,29,27,2,0.0689655172413793
QRO CORREGIDORA,2023-01-02,21,16,5,0.238095238095238
QRO CORREGIDORA,2023-01-03,28,20,8,0.285714285714286
QRO CORREGIDORA,2023-01-04,33,22,11,0.333333333333333
QRO CORREGIDORA,2023-01-05,26,21,5,0.192307692307692
QRO CORREGIDORA,2023-01-06,20,14,6,0.3
QRO CORREGIDORA,2023-01-07,25,21,4,0.16
QRO CORREGIDORA,2023-01-08,17,13,4,0.235294117647059
QRO CORREGIDORA,2023-01-09,26,17,9,0.346153846153846
QRO CORREGIDORA,2023-01-10,36,26,10,0.277777777777778
QRO CORREGIDORA,2023-01-11,21,17,4,0.19047619047619
QRO CORREGIDORA,2023-01-12,39,25,14,0.358974358974359
QRO CORREGIDORA,2023-01-13,25,18,7,0.28
QRO CORREGIDORA,2023-01-14,25,17,8,0.32
QRO CORREGIDORA,2023-01-15,23,17,6,0.260869565217391
QRO CORREGIDORA,2023-01-16,19,8,11,0.578947368421053
QRO CORREGIDORA,2023-01-17,25,6,19,0.76
QRO CORREGIDORA,2023-01-18,23,11,12,0.521739130434783
QRO CORREGIDORA,2023-01-19,12,9,3,0.25
QRO CORREGIDORA,2023-01-20,17,11,6,0.352941176470588
QRO CORREGIDORA,2023-01-21,27,18,9,0.333333333333333
QRO CORREGIDORA,2023-01-22,9,6,3,0.333333333333333
QRO CORREGIDORA,2023-01-23,22,17,5,0.227272727272727
QRO CORREGIDORA,2023-01-24,16,13,3,0.1875
QRO CORREGIDORA,2023-01-25,24,14,10,0.416666666666667
QRO CORREGIDORA,2023-01-26,18,12,6,0.333333333333333
QRO CORREGIDORA,2023-01-27,25,16,9,0.36
QRO CORREGIDORA,2023-01-28,31,18,13,0.419354838709677
QRO CORREGIDORA,2023-01-29,17,10,7,0.411764705882353
QRO CORREGIDORA,2023-01-30,21,13,8,0.380952380952381
QRO CORREGIDORA,2023-01-31,38,26,12,0.315789473684211
QRO CORREGIDORA,2023-02-01,30,16,14,0.466666666666667
QRO CORREGIDORA,2023-02-02,17,12,5,0.294117647058824
QRO CORREGIDORA,2023-02-03,22,8,14,0.636363636363636
QRO CORREGIDORA,2023-02-04,24,15,9,0.375
QRO CORREGIDORA,2023-02-05,17,11,6,0.352941176470588
QRO CORREGIDORA,2023-02-06,16,10,6,0.375
QRO CORREGIDORA,2023-02-07,17,13,4,0.235294117647059
QRO CORREGIDORA,2023-02-08,33,22,11,0.333333333333333
QRO CORREGIDORA,2023-02-09,24,15,9,0.375
QRO CORREGIDORA,2023-02-10,23,14,9,0.391304347826087
QRO CORREGIDORA,2023-02-11,24,16,8,0.333333333333333
QRO CORREGIDORA,2023-02-12,8,2,6,0.75
QRO CORREGIDORA,2023-02-13,21,14,7,0.333333333333333
QRO CORREGIDORA,2023-02-14,27,16,11,0.407407407407407
QRO CORREGIDORA,2023-02-15,28,18,10,0.357142857142857
QRO CORREGIDORA,2023-02-16,26,15,11,0.423076923076923
QRO CORREGIDORA,2023-02-17,19,9,10,0.526315789473684
QRO CORREGIDORA,2023-02-18,30,18,12,0.4
QRO CORREGIDORA,2023-02-19,11,9,2,0.181818181818182
QRO CORREGIDORA,2023-02-20,17,11,6,0.352941176470588
QRO CORREGIDORA,2023-02-21,24,14,10,0.416666666666667
QRO CORREGIDORA,2023-02-22,26,19,7,0.269230769230769
QRO CORREGIDORA,2023-02-23,20,8,12,0.6
QRO CORREGIDORA,2023-02-24,26,16,10,0.384615384615385
QRO CORREGIDORA,2023-02-25,28,22,6,0.214285714285714
QRO CORREGIDORA,2023-02-26,11,5,6,0.545454545454545
QRO CORREGIDORA,2023-02-27,29,18,11,0.379310344827586
QRO CORREGIDORA,2023-02-28,28,17,11,0.392857142857143
QRO CORREGIDORA,2023-03-01,21,13,8,0.380952380952381
QRO CORREGIDORA,2023-03-02,15,9,6,0.4
QRO CORREGIDORA,2023-03-03,19,10,9,0.473684210526316
QRO CORREGIDORA,2023-03-04,25,13,12,0.48
QRO CORREGIDORA,2023-03-05,16,12,4,0.25
QRO CORREGIDORA,2023-03-06,17,12,5,0.294117647058824
QRO CORREGIDORA,2023-03-07,11,7,4,0.363636363636364
QRO CORREGIDORA,2023-03-08,29,22,7,0.241379310344828
QRO CORREGIDORA,2023-03-09,27,22,5,0.185185185185185
QRO CORREGIDORA,2023-03-10,30,21,9,0.3
QRO CORREGIDORA,2023-03-11,18,14,4,0.222222222222222
QRO CORREGIDORA,2023-03-12,16,11,5,0.3125
QRO CORREGIDORA,2023-03-13,21,19,2,0.0952380952380952
QRO CORREGIDORA,2023-03-14,20,16,4,0.2
QRO CORREGIDORA,2023-03-15,21,17,4,0.19047619047619
QRO CORREGIDORA,2023-03-16,32,26,6,0.1875
QRO CORREGIDORA,2023-03-17,36,30,6,0.166666666666667
QRO CORREGIDORA,2023-03-18,28,21,7,0.25
QRO CORREGIDORA,2023-03-19,16,14,2,0.125
QRO CORREGIDORA,2023-03-20,22,14,8,0.363636363636364
QRO CORREGIDORA,2023-03-21,21,19,2,0.0952380952380952
QRO CORREGIDORA,2023-03-22,22,20,2,0.0909090909090909
QRO CORREGIDORA,2023-03-23,23,22,1,0.0434782608695652
QRO CORREGIDORA,2023-03-24,16,15,1,0.0625
QRO CORREGIDORA,2023-03-25,29,26,3,0.103448275862069
QRO CORREGIDORA,2023-03-26,18,17,1,0.0555555555555556
QRO CORREGIDORA,2023-03-27,17,13,4,0.235294117647059
QRO CORREGIDORA,2023-03-28,18,15,3,0.166666666666667
QRO CORREGIDORA,2023-03-29,22,19,3,0.136363636363636
QRO CORREGIDORA,2023-03-30,21,15,6,0.285714285714286
QRO CORREGIDORA,2023-03-31,33,31,2,0.0606060606060606
QRO CORREGIDORA,2023-04-01,24,23,1,0.0416666666666667
QRO CORREGIDORA,2023-04-02,10,10,0,0
QRO CORREGIDORA,2023-04-03,31,29,2,0.0645161290322581
QRO CORREGIDORA,2023-04-04,37,37,0,0
QRO CORREGIDORA,2023-04-05,18,16,2,0.111111111111111
QRO CORREGIDORA,2023-04-06,21,19,2,0.0952380952380952
QRO CORREGIDORA,2023-04-07,9,9,0,0
QRO CORREGIDORA,2023-04-08,13,10,3,0.230769230769231
QRO CORREGIDORA,2023-04-09,7,7,0,0
QRO CORREGIDORA,2023-04-10,16,14,2,0.125
QRO CORREGIDORA,2023-04-11,22,20,2,0.0909090909090909
QRO CORREGIDORA,2023-04-12,29,25,4,0.137931034482759
QRO CORREGIDORA,2023-04-13,24,24,0,0
QRO CORREGIDORA,2023-04-14,33,32,1,0.0303030303030303
QRO CORREGIDORA,2023-04-15,40,37,3,0.075
QRO CORREGIDORA,2023-04-16,24,20,4,0.166666666666667
QRO CORREGIDORA,2023-04-17,19,15,4,0.210526315789474
QRO CORREGIDORA,2023-04-18,30,23,7,0.233333333333333
QRO CORREGIDORA,2023-04-19,18,15,3,0.166666666666667
QRO CORREGIDORA,2023-04-20,17,16,1,0.0588235294117647
QRO CORREGIDORA,2023-04-21,19,18,1,0.0526315789473684
QRO CORREGIDORA,2023-04-22,21,19,2,0.0952380952380952
QRO CORREGIDORA,2023-04-23,16,16,0,0
QRO CORREGIDORA,2023-04-24,34,34,0,0
QRO CORREGIDORA,2023-04-25,27,25,2,0.0740740740740741
QRO CORREGIDORA,2023-04-26,27,24,3,0.111111111111111
QRO CORREGIDORA,2023-04-27,17,16,1,0.0588235294117647
QRO CORREGIDORA,2023-04-28,21,20,1,0.0476190476190476
QRO CORREGIDORA,2023-04-29,22,22,0,0
QRO CORREGIDORA,2023-04-30,17,15,2,0.117647058823529
QRO CORREGIDORA,2023-05-01,22,17,5,0.227272727272727
QRO CORREGIDORA,2023-05-02,18,15,3,0.166666666666667
QRO CORREGIDORA,2023-05-03,27,26,1,0.037037037037037
QRO CORREGIDORA,2023-05-04,26,21,5,0.192307692307692
QRO CORREGIDORA,2023-05-05,16,15,1,0.0625
QRO CORREGIDORA,2023-05-06,26,25,1,0.0384615384615385
QRO CORREGIDORA,2023-05-07,14,13,1,0.0714285714285714
QRO CORREGIDORA,2023-05-08,15,13,2,0.133333333333333
QRO SANTIAGO,2023-01-02,11,8,3,0.272727272727273
QRO SANTIAGO,2023-01-03,21,14,7,0.333333333333333
QRO SANTIAGO,2023-01-04,24,17,7,0.291666666666667
QRO SANTIAGO,2023-01-05,18,13,5,0.277777777777778
QRO SANTIAGO,2023-01-06,25,20,5,0.2
QRO SANTIAGO,2023-01-07,23,11,12,0.521739130434783
QRO SANTIAGO,2023-01-08,20,10,10,0.5
QRO SANTIAGO,2023-01-09,19,14,5,0.263157894736842
QRO SANTIAGO,2023-01-10,22,16,6,0.272727272727273
QRO SANTIAGO,2023-01-11,20,12,8,0.4
QRO SANTIAGO,2023-01-12,20,9,11,0.55
QRO SANTIAGO,2023-01-13,15,5,10,0.666666666666667
QRO SANTIAGO,2023-01-14,33,17,16,0.484848484848485
QRO SANTIAGO,2023-01-15,22,11,11,0.5
QRO SANTIAGO,2023-01-16,32,18,14,0.4375
QRO SANTIAGO,2023-01-17,32,22,10,0.3125
QRO SANTIAGO,2023-01-18,22,15,7,0.318181818181818
QRO SANTIAGO,2023-01-19,14,8,6,0.428571428571429
QRO SANTIAGO,2023-01-20,17,13,4,0.235294117647059
QRO SANTIAGO,2023-01-21,26,16,10,0.384615384615385
QRO SANTIAGO,2023-01-22,15,10,5,0.333333333333333
QRO SANTIAGO,2023-01-23,27,22,5,0.185185185185185
QRO SANTIAGO,2023-01-24,21,15,6,0.285714285714286
QRO SANTIAGO,2023-01-25,19,13,6,0.315789473684211
QRO SANTIAGO,2023-01-26,26,9,17,0.653846153846154
QRO SANTIAGO,2023-01-27,20,11,9,0.45
QRO SANTIAGO,2023-01-28,29,13,16,0.551724137931034
QRO SANTIAGO,2023-01-29,20,15,5,0.25
QRO SANTIAGO,2023-01-30,21,11,10,0.476190476190476
QRO SANTIAGO,2023-01-31,24,15,9,0.375
QRO SANTIAGO,2023-02-01,27,14,13,0.481481481481481
QRO SANTIAGO,2023-02-02,19,12,7,0.368421052631579
QRO SANTIAGO,2023-02-03,19,14,5,0.263157894736842
QRO SANTIAGO,2023-02-04,31,19,12,0.387096774193548
QRO SANTIAGO,2023-02-05,14,8,6,0.428571428571429
QRO SANTIAGO,2023-02-06,22,13,9,0.409090909090909
QRO SANTIAGO,2023-02-07,23,15,8,0.347826086956522
QRO SANTIAGO,2023-02-08,28,16,12,0.428571428571429
QRO SANTIAGO,2023-02-09,31,19,12,0.387096774193548
QRO SANTIAGO,2023-02-10,24,15,9,0.375
QRO SANTIAGO,2023-02-11,33,20,13,0.393939393939394
QRO SANTIAGO,2023-02-12,20,14,6,0.3
QRO SANTIAGO,2023-02-13,17,12,5,0.294117647058824
QRO SANTIAGO,2023-02-14,30,21,9,0.3
QRO SANTIAGO,2023-02-15,15,5,10,0.666666666666667
QRO SANTIAGO,2023-02-16,20,6,14,0.7
QRO SANTIAGO,2023-02-17,13,11,2,0.153846153846154
QRO SANTIAGO,2023-02-18,22,10,12,0.545454545454545
QRO SANTIAGO,2023-02-19,16,14,2,0.125
QRO SANTIAGO,2023-02-20,14,10,4,0.285714285714286
QRO SANTIAGO,2023-02-21,16,14,2,0.125
QRO SANTIAGO,2023-02-22,21,13,8,0.380952380952381
QRO SANTIAGO,2023-02-23,17,13,4,0.235294117647059
QRO SANTIAGO,2023-02-24,18,12,6,0.333333333333333
QRO SANTIAGO,2023-02-25,33,25,8,0.242424242424242
QRO SANTIAGO,2023-02-26,17,9,8,0.470588235294118
QRO SANTIAGO,2023-02-27,27,12,15,0.555555555555556
QRO SANTIAGO,2023-02-28,48,28,20,0.416666666666667
QRO SANTIAGO,2023-03-01,16,8,8,0.5
QRO SANTIAGO,2023-03-02,29,13,16,0.551724137931034
QRO SANTIAGO,2023-03-03,27,15,12,0.444444444444444
QRO SANTIAGO,2023-03-04,26,15,11,0.423076923076923
QRO SANTIAGO,2023-03-05,10,5,5,0.5
QRO SANTIAGO,2023-03-06,13,9,4,0.307692307692308
QRO SANTIAGO,2023-03-07,20,10,10,0.5
QRO SANTIAGO,2023-03-08,21,12,9,0.428571428571429
QRO SANTIAGO,2023-03-09,21,14,7,0.333333333333333
QRO SANTIAGO,2023-03-10,33,26,7,0.212121212121212
QRO SANTIAGO,2023-03-11,22,14,8,0.363636363636364
QRO SANTIAGO,2023-03-12,15,7,8,0.533333333333333
QRO SANTIAGO,2023-03-13,17,14,3,0.176470588235294
QRO SANTIAGO,2023-03-14,23,15,8,0.347826086956522
QRO SANTIAGO,2023-03-15,19,13,6,0.315789473684211
QRO SANTIAGO,2023-03-16,14,12,2,0.142857142857143
QRO SANTIAGO,2023-03-17,30,16,14,0.466666666666667
QRO SANTIAGO,2023-03-18,30,16,14,0.466666666666667
QRO SANTIAGO,2023-03-19,22,14,8,0.363636363636364
QRO SANTIAGO,2023-03-20,24,14,10,0.416666666666667
QRO SANTIAGO,2023-03-21,27,24,3,0.111111111111111
QRO SANTIAGO,2023-03-22,30,18,12,0.4
QRO SANTIAGO,2023-03-23,29,22,7,0.241379310344828
QRO SANTIAGO,2023-03-24,18,15,3,0.166666666666667
QRO SANTIAGO,2023-03-25,33,23,10,0.303030303030303
QRO SANTIAGO,2023-03-26,29,20,9,0.310344827586207
QRO SANTIAGO,2023-03-27,17,13,4,0.235294117647059
QRO SANTIAGO,2023-03-28,17,16,1,0.0588235294117647
QRO SANTIAGO,2023-03-29,21,21,0,0
QRO SANTIAGO,2023-03-30,28,28,0,0
QRO SANTIAGO,2023-03-31,36,36,0,0
QRO SANTIAGO,2023-04-01,25,25,0,0
QRO SANTIAGO,2023-04-02,13,13,0,0
QRO SANTIAGO,2023-04-03,14,14,0,0
QRO SANTIAGO,2023-04-04,21,21,0,0
QRO SANTIAGO,2023-04-05,11,11,0,0
QRO SANTIAGO,2023-04-06,19,19,0,0
QRO SANTIAGO,2023-04-07,12,12,0,0
QRO SANTIAGO,2023-04-08,11,11,0,0
QRO SANTIAGO,2023-04-09,11,11,0,0
QRO SANTIAGO,2023-04-10,18,17,1,0.0555555555555556
QRO SANTIAGO,2023-04-11,17,17,0,0
QRO SANTIAGO,2023-04-12,28,28,0,0
QRO SANTIAGO,2023-04-13,23,23,0,0
QRO SANTIAGO,2023-04-14,24,24,0,0
QRO SANTIAGO,2023-04-15,32,31,1,0.03125
QRO SANTIAGO,2023-04-16,27,27,0,0
QRO SANTIAGO,2023-04-17,27,27,0,0
QRO SANTIAGO,2023-04-18,23,23,0,0
QRO SANTIAGO,2023-04-19,23,23,0,0
QRO SANTIAGO,2023-04-20,18,17,1,0.0555555555555556
QRO SANTIAGO,2023-04-21,20,19,1,0.05
QRO SANTIAGO,2023-04-22,30,28,2,0.0666666666666667
QRO SANTIAGO,2023-04-23,16,16,0,0
QRO SANTIAGO,2023-04-24,21,21,0,0
QRO SANTIAGO,2023-04-25,23,23,0,0
QRO SANTIAGO,2023-04-26,31,31,0,0
QRO SANTIAGO,2023-04-27,27,26,1,0.037037037037037
QRO SANTIAGO,2023-04-28,27,26,1,0.037037037037037
QRO SANTIAGO,2023-04-29,29,28,1,0.0344827586206897
QRO SANTIAGO,2023-04-30,29,28,1,0.0344827586206897
QRO SANTIAGO,2023-05-01,25,24,1,0.04
QRO SANTIAGO,2023-05-02,14,14,0,0
QRO SANTIAGO,2023-05-03,21,21,0,0
QRO SANTIAGO,2023-05-04,21,21,0,0
QRO SANTIAGO,2023-05-05,22,22,0,0
QRO SANTIAGO,2023-05-06,21,21,0,0
QRO SANTIAGO,2023-05-07,16,15,1,0.0625
QRO SANTIAGO,2023-05-08,15,15,0,0
REYNOSA,2023-01-02,62,48,14,0.225806451612903
REYNOSA,2023-01-03,54,45,9,0.166666666666667
REYNOSA,2023-01-04,55,44,11,0.2
REYNOSA,2023-01-05,77,71,6,0.0779220779220779
REYNOSA,2023-01-06,70,59,11,0.157142857142857
REYNOSA,2023-01-07,78,65,13,0.166666666666667
REYNOSA,2023-01-08,49,39,10,0.204081632653061
REYNOSA,2023-01-09,59,50,9,0.152542372881356
REYNOSA,2023-01-10,68,53,15,0.220588235294118
REYNOSA,2023-01-11,74,66,8,0.108108108108108
REYNOSA,2023-01-12,59,49,10,0.169491525423729
REYNOSA,2023-01-13,69,59,10,0.144927536231884
REYNOSA,2023-01-14,70,59,11,0.157142857142857
REYNOSA,2023-01-15,45,39,6,0.133333333333333
REYNOSA,2023-01-16,82,68,14,0.170731707317073
REYNOSA,2023-01-17,59,55,4,0.0677966101694915
REYNOSA,2023-01-18,63,58,5,0.0793650793650794
REYNOSA,2023-01-19,57,55,2,0.0350877192982456
REYNOSA,2023-01-20,73,69,4,0.0547945205479452
REYNOSA,2023-01-21,62,58,4,0.0645161290322581
REYNOSA,2023-01-22,40,36,4,0.1
REYNOSA,2023-01-23,60,59,1,0.0166666666666667
REYNOSA,2023-01-24,67,65,2,0.0298507462686567
REYNOSA,2023-01-25,55,53,2,0.0363636363636364
REYNOSA,2023-01-26,61,57,4,0.0655737704918033
REYNOSA,2023-01-27,58,56,2,0.0344827586206897
REYNOSA,2023-01-28,64,61,3,0.046875
REYNOSA,2023-01-29,41,40,1,0.024390243902439
REYNOSA,2023-01-30,64,61,3,0.046875
REYNOSA,2023-01-31,72,70,2,0.0277777777777778
REYNOSA,2023-02-01,44,42,2,0.0454545454545455
REYNOSA,2023-02-02,54,53,1,0.0185185185185185
REYNOSA,2023-02-03,66,64,2,0.0303030303030303
REYNOSA,2023-02-04,65,60,5,0.0769230769230769
REYNOSA,2023-02-05,44,43,1,0.0227272727272727
REYNOSA,2023-02-06,59,56,3,0.0508474576271186
REYNOSA,2023-02-07,54,53,1,0.0185185185185185
REYNOSA,2023-02-08,45,44,1,0.0222222222222222
REYNOSA,2023-02-09,55,52,3,0.0545454545454545
REYNOSA,2023-02-10,53,53,0,0
REYNOSA,2023-02-11,56,55,1,0.0178571428571429
REYNOSA,2023-02-12,60,56,4,0.0666666666666667
REYNOSA,2023-02-13,61,58,3,0.0491803278688525
REYNOSA,2023-02-14,48,48,0,0
REYNOSA,2023-02-15,49,48,1,0.0204081632653061
REYNOSA,2023-02-16,68,67,1,0.0147058823529412
REYNOSA,2023-02-17,60,53,7,0.116666666666667
REYNOSA,2023-02-18,85,84,1,0.0117647058823529
REYNOSA,2023-02-19,66,63,3,0.0454545454545455
REYNOSA,2023-02-20,53,52,1,0.0188679245283019
REYNOSA,2023-02-21,44,42,2,0.0454545454545455
REYNOSA,2023-02-22,35,35,0,0
REYNOSA,2023-02-23,72,72,0,0
REYNOSA,2023-02-24,62,61,1,0.0161290322580645
REYNOSA,2023-02-25,87,81,6,0.0689655172413793
REYNOSA,2023-02-26,77,75,2,0.025974025974026
REYNOSA,2023-02-27,55,54,1,0.0181818181818182
REYNOSA,2023-02-28,61,60,1,0.0163934426229508
REYNOSA,2023-03-01,46,43,3,0.0652173913043478
REYNOSA,2023-03-02,58,53,5,0.0862068965517241
REYNOSA,2023-03-03,81,78,3,0.037037037037037
REYNOSA,2023-03-04,85,84,1,0.0117647058823529
REYNOSA,2023-03-05,49,48,1,0.0204081632653061
REYNOSA,2023-03-06,56,56,0,0
REYNOSA,2023-03-07,57,57,0,0
REYNOSA,2023-03-08,52,50,2,0.0384615384615385
REYNOSA,2023-03-09,48,48,0,0
REYNOSA,2023-03-10,56,55,1,0.0178571428571429
REYNOSA,2023-03-11,76,73,3,0.0394736842105263
REYNOSA,2023-03-12,54,50,4,0.0740740740740741
REYNOSA,2023-03-13,66,66,0,0
REYNOSA,2023-03-14,72,70,2,0.0277777777777778
REYNOSA,2023-03-15,45,45,0,0
REYNOSA,2023-03-16,57,57,0,0
REYNOSA,2023-03-17,99,98,1,0.0101010101010101
REYNOSA,2023-03-18,118,118,0,0
REYNOSA,2023-03-19,86,86,0,0
REYNOSA,2023-03-20,87,87,0,0
REYNOSA,2023-03-21,89,89,0,0
REYNOSA,2023-03-22,83,83,0,0
REYNOSA,2023-03-23,83,83,0,0
REYNOSA,2023-03-24,64,64,0,0
REYNOSA,2023-03-25,93,93,0,0
REYNOSA,2023-03-26,66,66,0,0
REYNOSA,2023-03-27,65,65,0,0
REYNOSA,2023-03-28,49,48,1,0.0204081632653061
REYNOSA,2023-03-29,60,59,1,0.0166666666666667
REYNOSA,2023-03-30,83,81,2,0.0240963855421687
REYNOSA,2023-03-31,92,92,0,0
REYNOSA,2023-04-01,104,104,0,0
REYNOSA,2023-04-02,73,72,1,0.0136986301369863
REYNOSA,2023-04-03,86,86,0,0
REYNOSA,2023-04-04,72,72,0,0
REYNOSA,2023-04-05,62,62,0,0
REYNOSA,2023-04-06,72,72,0,0
REYNOSA,2023-04-07,63,63,0,0
REYNOSA,2023-04-08,61,61,0,0
REYNOSA,2023-04-09,50,50,0,0
REYNOSA,2023-04-10,61,61,0,0
REYNOSA,2023-04-11,56,56,0,0
REYNOSA,2023-04-12,50,50,0,0
REYNOSA,2023-04-13,62,62,0,0
REYNOSA,2023-04-14,81,81,0,0
REYNOSA,2023-04-15,70,70,0,0
REYNOSA,2023-04-16,67,67,0,0
REYNOSA,2023-04-17,52,52,0,0
REYNOSA,2023-04-18,53,53,0,0
REYNOSA,2023-04-19,69,69,0,0
REYNOSA,2023-04-20,69,69,0,0
REYNOSA,2023-04-21,62,62,0,0
REYNOSA,2023-04-22,64,64,0,0
REYNOSA,2023-04-23,57,57,0,0
REYNOSA,2023-04-24,43,43,0,0
REYNOSA,2023-04-25,46,46,0,0
REYNOSA,2023-04-26,79,79,0,0
REYNOSA,2023-04-27,62,62,0,0
REYNOSA,2023-04-28,76,76,0,0
REYNOSA,2023-04-29,69,68,1,0.0144927536231884
REYNOSA,2023-04-30,65,61,4,0.0615384615384615
REYNOSA,2023-05-01,65,64,1,0.0153846153846154
REYNOSA,2023-05-02,69,67,2,0.0289855072463768
REYNOSA,2023-05-03,58,55,3,0.0517241379310345
REYNOSA,2023-05-04,67,65,2,0.0298507462686567
REYNOSA,2023-05-05,99,97,2,0.0202020202020202
REYNOSA,2023-05-06,99,97,2,0.0202020202020202
REYNOSA,2023-05-07,94,90,4,0.0425531914893617
REYNOSA,2023-05-08,82,77,5,0.0609756097560976
SALTILLO,2023-01-02,49,35,14,0.285714285714286
SALTILLO,2023-01-03,48,39,9,0.1875
SALTILLO,2023-01-04,40,25,15,0.375
SALTILLO,2023-01-05,66,53,13,0.196969696969697
SALTILLO,2023-01-06,52,43,9,0.173076923076923
SALTILLO,2023-01-07,68,52,16,0.235294117647059
SALTILLO,2023-01-08,34,24,10,0.294117647058824
SALTILLO,2023-01-09,57,47,10,0.175438596491228
SALTILLO,2023-01-10,39,30,9,0.230769230769231
SALTILLO,2023-01-11,58,51,7,0.120689655172414
SALTILLO,2023-01-12,48,38,10,0.208333333333333
SALTILLO,2023-01-13,56,48,8,0.142857142857143
SALTILLO,2023-01-14,55,43,12,0.218181818181818
SALTILLO,2023-01-15,32,26,6,0.1875
SALTILLO,2023-01-16,38,33,5,0.131578947368421
SALTILLO,2023-01-17,57,41,16,0.280701754385965
SALTILLO,2023-01-18,36,30,6,0.166666666666667
SALTILLO,2023-01-19,34,29,5,0.147058823529412
SALTILLO,2023-01-20,61,55,6,0.0983606557377049
SALTILLO,2023-01-21,68,61,7,0.102941176470588
SALTILLO,2023-01-22,35,30,5,0.142857142857143
SALTILLO,2023-01-23,33,31,2,0.0606060606060606
SALTILLO,2023-01-24,42,36,6,0.142857142857143
SALTILLO,2023-01-25,38,31,7,0.184210526315789
SALTILLO,2023-01-26,41,29,12,0.292682926829268
SALTILLO,2023-01-27,38,32,6,0.157894736842105
SALTILLO,2023-01-28,58,50,8,0.137931034482759
SALTILLO,2023-01-29,23,22,1,0.0434782608695652
SALTILLO,2023-01-30,43,38,5,0.116279069767442
SALTILLO,2023-01-31,53,48,5,0.0943396226415094
SALTILLO,2023-02-01,33,27,6,0.181818181818182
SALTILLO,2023-02-02,36,31,5,0.138888888888889
SALTILLO,2023-02-03,50,41,9,0.18
SALTILLO,2023-02-04,60,53,7,0.116666666666667
SALTILLO,2023-02-05,25,20,5,0.2
SALTILLO,2023-02-06,41,34,7,0.170731707317073
SALTILLO,2023-02-07,37,34,3,0.0810810810810811
SALTILLO,2023-02-08,48,43,5,0.104166666666667
SALTILLO,2023-02-09,48,41,7,0.145833333333333
SALTILLO,2023-02-10,43,36,7,0.162790697674419
SALTILLO,2023-02-11,64,53,11,0.171875
SALTILLO,2023-02-12,40,33,7,0.175
SALTILLO,2023-02-13,37,30,7,0.189189189189189
SALTILLO,2023-02-14,42,36,6,0.142857142857143
SALTILLO,2023-02-15,34,28,6,0.176470588235294
SALTILLO,2023-02-16,53,43,10,0.188679245283019
SALTILLO,2023-02-17,48,38,10,0.208333333333333
SALTILLO,2023-02-18,70,58,12,0.171428571428571
SALTILLO,2023-02-19,34,31,3,0.0882352941176471
SALTILLO,2023-02-20,44,36,8,0.181818181818182
SALTILLO,2023-02-21,40,35,5,0.125
SALTILLO,2023-02-22,42,30,12,0.285714285714286
SALTILLO,2023-02-23,40,28,12,0.3
SALTILLO,2023-02-24,43,26,17,0.395348837209302
SALTILLO,2023-02-25,66,39,27,0.409090909090909
SALTILLO,2023-02-26,31,19,12,0.387096774193548
SALTILLO,2023-02-27,39,22,17,0.435897435897436
SALTILLO,2023-02-28,57,32,25,0.43859649122807
SALTILLO,2023-03-01,48,28,20,0.416666666666667
SALTILLO,2023-03-02,44,25,19,0.431818181818182
SALTILLO,2023-03-03,56,34,22,0.392857142857143
SALTILLO,2023-03-04,54,25,29,0.537037037037037
SALTILLO,2023-03-05,40,21,19,0.475
SALTILLO,2023-03-06,43,21,22,0.511627906976744
SALTILLO,2023-03-07,52,26,26,0.5
SALTILLO,2023-03-08,49,25,24,0.489795918367347
SALTILLO,2023-03-09,48,41,7,0.145833333333333
SALTILLO,2023-03-10,63,50,13,0.206349206349206
SALTILLO,2023-03-11,77,64,13,0.168831168831169
SALTILLO,2023-03-12,45,35,10,0.222222222222222
SALTILLO,2023-03-13,32,24,8,0.25
SALTILLO,2023-03-14,54,47,7,0.12962962962963
SALTILLO,2023-03-15,47,41,6,0.127659574468085
SALTILLO,2023-03-16,75,67,8,0.106666666666667
SALTILLO,2023-03-17,68,67,1,0.0147058823529412
SALTILLO,2023-03-18,113,110,3,0.0265486725663717
SALTILLO,2023-03-19,43,42,1,0.0232558139534884
SALTILLO,2023-03-20,67,63,4,0.0597014925373134
SALTILLO,2023-03-21,66,66,0,0
SALTILLO,2023-03-22,53,52,1,0.0188679245283019
SALTILLO,2023-03-23,47,47,0,0
SALTILLO,2023-03-24,62,61,1,0.0161290322580645
SALTILLO,2023-03-25,72,70,2,0.0277777777777778
SALTILLO,2023-03-26,30,30,0,0
SALTILLO,2023-03-27,44,44,0,0
SALTILLO,2023-03-28,44,44,0,0
SALTILLO,2023-03-29,50,50,0,0
SALTILLO,2023-03-30,56,56,0,0
SALTILLO,2023-03-31,90,90,0,0
SALTILLO,2023-04-01,71,71,0,0
SALTILLO,2023-04-02,39,39,0,0
SALTILLO,2023-04-03,55,55,0,0
SALTILLO,2023-04-04,59,59,0,0
SALTILLO,2023-04-05,61,55,6,0.0983606557377049
SALTILLO,2023-04-06,52,50,2,0.0384615384615385
SALTILLO,2023-04-07,48,48,0,0
SALTILLO,2023-04-08,34,34,0,0
SALTILLO,2023-04-09,16,16,0,0
SALTILLO,2023-04-10,36,36,0,0
SALTILLO,2023-04-11,40,40,0,0
SALTILLO,2023-04-12,49,49,0,0
SALTILLO,2023-04-13,55,52,3,0.0545454545454545
SALTILLO,2023-04-14,78,78,0,0
SALTILLO,2023-04-15,75,72,3,0.04
SALTILLO,2023-04-16,66,64,2,0.0303030303030303
SALTILLO,2023-04-17,47,47,0,0
SALTILLO,2023-04-18,43,43,0,0
SALTILLO,2023-04-19,39,37,2,0.0512820512820513
SALTILLO,2023-04-20,59,58,1,0.0169491525423729
SALTILLO,2023-04-21,68,63,5,0.0735294117647059
SALTILLO,2023-04-22,66,64,2,0.0303030303030303
SALTILLO,2023-04-23,35,34,1,0.0285714285714286
SALTILLO,2023-04-24,49,47,2,0.0408163265306122
SALTILLO,2023-04-25,57,57,0,0
SALTILLO,2023-04-26,48,48,0,0
SALTILLO,2023-04-27,47,47,0,0
SALTILLO,2023-04-28,63,63,0,0
SALTILLO,2023-04-29,68,67,1,0.0147058823529412
SALTILLO,2023-04-30,49,49,0,0
SALTILLO,2023-05-01,55,55,0,0
SALTILLO,2023-05-02,51,51,0,0
SALTILLO,2023-05-03,34,34,0,0
SALTILLO,2023-05-04,54,53,1,0.0185185185185185
SALTILLO,2023-05-05,64,64,0,0
SALTILLO,2023-05-06,66,65,1,0.0151515151515152
SALTILLO,2023-05-07,28,28,0,0
SALTILLO,2023-05-08,42,41,1,0.0238095238095238
SAN LUIS POTOSI ORIENTE,2023-01-02,23,5,18,0.782608695652174
SAN LUIS POTOSI ORIENTE,2023-01-03,18,7,11,0.611111111111111
SAN LUIS POTOSI ORIENTE,2023-01-04,33,13,20,0.606060606060606
SAN LUIS POTOSI ORIENTE,2023-01-05,30,11,19,0.633333333333333
SAN LUIS POTOSI ORIENTE,2023-01-06,35,14,21,0.6
SAN LUIS POTOSI ORIENTE,2023-01-07,37,14,23,0.621621621621622
SAN LUIS POTOSI ORIENTE,2023-01-08,18,8,10,0.555555555555556
SAN LUIS POTOSI ORIENTE,2023-01-09,31,14,17,0.548387096774194
SAN LUIS POTOSI ORIENTE,2023-01-10,37,15,22,0.594594594594595
SAN LUIS POTOSI ORIENTE,2023-01-11,34,18,16,0.470588235294118
SAN LUIS POTOSI ORIENTE,2023-01-12,44,20,24,0.545454545454545
SAN LUIS POTOSI ORIENTE,2023-01-13,36,11,25,0.694444444444444
SAN LUIS POTOSI ORIENTE,2023-01-14,30,11,19,0.633333333333333
SAN LUIS POTOSI ORIENTE,2023-01-15,29,19,10,0.344827586206897
SAN LUIS POTOSI ORIENTE,2023-01-16,36,18,18,0.5
SAN LUIS POTOSI ORIENTE,2023-01-17,37,17,20,0.540540540540541
SAN LUIS POTOSI ORIENTE,2023-01-18,24,12,12,0.5
SAN LUIS POTOSI ORIENTE,2023-01-19,27,14,13,0.481481481481481
SAN LUIS POTOSI ORIENTE,2023-01-20,32,6,26,0.8125
SAN LUIS POTOSI ORIENTE,2023-01-21,39,20,19,0.487179487179487
SAN LUIS POTOSI ORIENTE,2023-01-22,14,6,8,0.571428571428571
SAN LUIS POTOSI ORIENTE,2023-01-23,27,7,20,0.740740740740741
SAN LUIS POTOSI ORIENTE,2023-01-24,46,12,34,0.739130434782609
SAN LUIS POTOSI ORIENTE,2023-01-25,35,9,26,0.742857142857143
SAN LUIS POTOSI ORIENTE,2023-01-26,37,12,25,0.675675675675676
SAN LUIS POTOSI ORIENTE,2023-01-27,39,14,25,0.641025641025641
SAN LUIS POTOSI ORIENTE,2023-01-28,37,9,28,0.756756756756757
SAN LUIS POTOSI ORIENTE,2023-01-29,21,10,11,0.523809523809524
SAN LUIS POTOSI ORIENTE,2023-01-30,39,9,30,0.769230769230769
SAN LUIS POTOSI ORIENTE,2023-01-31,34,13,21,0.617647058823529
SAN LUIS POTOSI ORIENTE,2023-02-01,37,14,23,0.621621621621622
SAN LUIS POTOSI ORIENTE,2023-02-02,29,11,18,0.620689655172414
SAN LUIS POTOSI ORIENTE,2023-02-03,32,12,20,0.625
SAN LUIS POTOSI ORIENTE,2023-02-04,36,13,23,0.638888888888889
SAN LUIS POTOSI ORIENTE,2023-02-05,18,9,9,0.5
SAN LUIS POTOSI ORIENTE,2023-02-06,29,14,15,0.517241379310345
SAN LUIS POTOSI ORIENTE,2023-02-07,24,8,16,0.666666666666667
SAN LUIS POTOSI ORIENTE,2023-02-08,28,9,19,0.678571428571429
SAN LUIS POTOSI ORIENTE,2023-02-09,24,8,16,0.666666666666667
SAN LUIS POTOSI ORIENTE,2023-02-10,28,12,16,0.571428571428571
SAN LUIS POTOSI ORIENTE,2023-02-11,28,5,23,0.821428571428571
SAN LUIS POTOSI ORIENTE,2023-02-12,28,10,18,0.642857142857143
SAN LUIS POTOSI ORIENTE,2023-02-13,21,7,14,0.666666666666667
SAN LUIS POTOSI ORIENTE,2023-02-14,24,4,20,0.833333333333333
SAN LUIS POTOSI ORIENTE,2023-02-15,26,5,21,0.807692307692308
SAN LUIS POTOSI ORIENTE,2023-02-16,37,5,32,0.864864864864865
SAN LUIS POTOSI ORIENTE,2023-02-17,33,6,27,0.818181818181818
SAN LUIS POTOSI ORIENTE,2023-02-18,28,4,24,0.857142857142857
SAN LUIS POTOSI ORIENTE,2023-02-19,10,4,6,0.6
SAN LUIS POTOSI ORIENTE,2023-02-20,24,1,23,0.958333333333333
SAN LUIS POTOSI ORIENTE,2023-02-21,32,4,28,0.875
SAN LUIS POTOSI ORIENTE,2023-02-22,34,16,18,0.529411764705882
SAN LUIS POTOSI ORIENTE,2023-02-23,19,8,11,0.578947368421053
SAN LUIS POTOSI ORIENTE,2023-02-24,27,14,13,0.481481481481481
SAN LUIS POTOSI ORIENTE,2023-02-25,36,15,21,0.583333333333333
SAN LUIS POTOSI ORIENTE,2023-02-26,13,4,9,0.692307692307692
SAN LUIS POTOSI ORIENTE,2023-02-27,19,10,9,0.473684210526316
SAN LUIS POTOSI ORIENTE,2023-02-28,33,20,13,0.393939393939394
SAN LUIS POTOSI ORIENTE,2023-03-01,26,10,16,0.615384615384615
SAN LUIS POTOSI ORIENTE,2023-03-02,28,9,19,0.678571428571429
SAN LUIS POTOSI ORIENTE,2023-03-03,34,15,19,0.558823529411765
SAN LUIS POTOSI ORIENTE,2023-03-04,31,14,17,0.548387096774194
SAN LUIS POTOSI ORIENTE,2023-03-05,16,4,12,0.75
SAN LUIS POTOSI ORIENTE,2023-03-06,18,12,6,0.333333333333333
SAN LUIS POTOSI ORIENTE,2023-03-07,33,25,8,0.242424242424242
SAN LUIS POTOSI ORIENTE,2023-03-08,34,20,14,0.411764705882353
SAN LUIS POTOSI ORIENTE,2023-03-09,19,13,6,0.315789473684211
SAN LUIS POTOSI ORIENTE,2023-03-10,32,26,6,0.1875
SAN LUIS POTOSI ORIENTE,2023-03-11,35,17,18,0.514285714285714
SAN LUIS POTOSI ORIENTE,2023-03-12,19,11,8,0.421052631578947
SAN LUIS POTOSI ORIENTE,2023-03-13,27,19,8,0.296296296296296
SAN LUIS POTOSI ORIENTE,2023-03-14,23,16,7,0.304347826086957
SAN LUIS POTOSI ORIENTE,2023-03-15,31,25,6,0.193548387096774
SAN LUIS POTOSI ORIENTE,2023-03-16,22,17,5,0.227272727272727
SAN LUIS POTOSI ORIENTE,2023-03-17,48,31,17,0.354166666666667
SAN LUIS POTOSI ORIENTE,2023-03-18,67,47,20,0.298507462686567
SAN LUIS POTOSI ORIENTE,2023-03-19,27,23,4,0.148148148148148
SAN LUIS POTOSI ORIENTE,2023-03-20,29,20,9,0.310344827586207
SAN LUIS POTOSI ORIENTE,2023-03-21,34,29,5,0.147058823529412
SAN LUIS POTOSI ORIENTE,2023-03-22,35,31,4,0.114285714285714
SAN LUIS POTOSI ORIENTE,2023-03-23,24,20,4,0.166666666666667
SAN LUIS POTOSI ORIENTE,2023-03-24,35,30,5,0.142857142857143
SAN LUIS POTOSI ORIENTE,2023-03-25,26,24,2,0.0769230769230769
SAN LUIS POTOSI ORIENTE,2023-03-26,18,12,6,0.333333333333333
SAN LUIS POTOSI ORIENTE,2023-03-27,18,17,1,0.0555555555555556
SAN LUIS POTOSI ORIENTE,2023-03-28,24,21,3,0.125
SAN LUIS POTOSI ORIENTE,2023-03-29,25,17,8,0.32
SAN LUIS POTOSI ORIENTE,2023-03-30,28,19,9,0.321428571428571
SAN LUIS POTOSI ORIENTE,2023-03-31,57,45,12,0.210526315789474
SAN LUIS POTOSI ORIENTE,2023-04-01,29,25,4,0.137931034482759
SAN LUIS POTOSI ORIENTE,2023-04-02,19,17,2,0.105263157894737
SAN LUIS POTOSI ORIENTE,2023-04-03,28,27,1,0.0357142857142857
SAN LUIS POTOSI ORIENTE,2023-04-04,32,28,4,0.125
SAN LUIS POTOSI ORIENTE,2023-04-05,24,19,5,0.208333333333333
SAN LUIS POTOSI ORIENTE,2023-04-06,32,29,3,0.09375
SAN LUIS POTOSI ORIENTE,2023-04-07,22,17,5,0.227272727272727
SAN LUIS POTOSI ORIENTE,2023-04-08,16,16,0,0
SAN LUIS POTOSI ORIENTE,2023-04-09,8,7,1,0.125
SAN LUIS POTOSI ORIENTE,2023-04-10,22,21,1,0.0454545454545455
SAN LUIS POTOSI ORIENTE,2023-04-11,23,22,1,0.0434782608695652
SAN LUIS POTOSI ORIENTE,2023-04-12,31,28,3,0.0967741935483871
SAN LUIS POTOSI ORIENTE,2023-04-13,20,18,2,0.1
SAN LUIS POTOSI ORIENTE,2023-04-14,23,21,2,0.0869565217391304
SAN LUIS POTOSI ORIENTE,2023-04-15,51,46,5,0.0980392156862745
SAN LUIS POTOSI ORIENTE,2023-04-16,27,26,1,0.037037037037037
SAN LUIS POTOSI ORIENTE,2023-04-17,21,18,3,0.142857142857143
SAN LUIS POTOSI ORIENTE,2023-04-18,36,34,2,0.0555555555555556
SAN LUIS POTOSI ORIENTE,2023-04-19,29,25,4,0.137931034482759
SAN LUIS POTOSI ORIENTE,2023-04-20,24,23,1,0.0416666666666667
SAN LUIS POTOSI ORIENTE,2023-04-21,28,26,2,0.0714285714285714
SAN LUIS POTOSI ORIENTE,2023-04-22,38,35,3,0.0789473684210526
SAN LUIS POTOSI ORIENTE,2023-04-23,24,23,1,0.0416666666666667
SAN LUIS POTOSI ORIENTE,2023-04-24,24,19,5,0.208333333333333
SAN LUIS POTOSI ORIENTE,2023-04-25,32,30,2,0.0625
SAN LUIS POTOSI ORIENTE,2023-04-26,40,39,1,0.025
SAN LUIS POTOSI ORIENTE,2023-04-27,28,26,2,0.0714285714285714
SAN LUIS POTOSI ORIENTE,2023-04-28,29,27,2,0.0689655172413793
SAN LUIS POTOSI ORIENTE,2023-04-29,32,25,7,0.21875
SAN LUIS POTOSI ORIENTE,2023-04-30,24,22,2,0.0833333333333333
SAN LUIS POTOSI ORIENTE,2023-05-01,28,22,6,0.214285714285714
SAN LUIS POTOSI ORIENTE,2023-05-02,30,28,2,0.0666666666666667
SAN LUIS POTOSI ORIENTE,2023-05-03,29,25,4,0.137931034482759
SAN LUIS POTOSI ORIENTE,2023-05-04,27,25,2,0.0740740740740741
SAN LUIS POTOSI ORIENTE,2023-05-05,23,22,1,0.0434782608695652
SAN LUIS POTOSI ORIENTE,2023-05-06,25,23,2,0.08
SAN LUIS POTOSI ORIENTE,2023-05-07,27,27,0,0
SAN LUIS POTOSI ORIENTE,2023-05-08,31,28,3,0.0967741935483871
SAN LUIS POTOSI PONIENTE,2023-01-02,19,15,4,0.210526315789474
SAN LUIS POTOSI PONIENTE,2023-01-03,23,17,6,0.260869565217391
SAN LUIS POTOSI PONIENTE,2023-01-04,22,16,6,0.272727272727273
SAN LUIS POTOSI PONIENTE,2023-01-05,13,8,5,0.384615384615385
SAN LUIS POTOSI PONIENTE,2023-01-06,19,8,11,0.578947368421053
SAN LUIS POTOSI PONIENTE,2023-01-07,20,12,8,0.4
SAN LUIS POTOSI PONIENTE,2023-01-08,15,12,3,0.2
SAN LUIS POTOSI PONIENTE,2023-01-09,26,19,7,0.269230769230769
SAN LUIS POTOSI PONIENTE,2023-01-10,18,14,4,0.222222222222222
SAN LUIS POTOSI PONIENTE,2023-01-11,21,14,7,0.333333333333333
SAN LUIS POTOSI PONIENTE,2023-01-12,22,14,8,0.363636363636364
SAN LUIS POTOSI PONIENTE,2023-01-13,29,22,7,0.241379310344828
SAN LUIS POTOSI PONIENTE,2023-01-14,33,26,7,0.212121212121212
SAN LUIS POTOSI PONIENTE,2023-01-15,14,10,4,0.285714285714286
SAN LUIS POTOSI PONIENTE,2023-01-16,21,16,5,0.238095238095238
SAN LUIS POTOSI PONIENTE,2023-01-17,24,14,10,0.416666666666667
SAN LUIS POTOSI PONIENTE,2023-01-18,8,6,2,0.25
SAN LUIS POTOSI PONIENTE,2023-01-19,19,17,2,0.105263157894737
SAN LUIS POTOSI PONIENTE,2023-01-20,22,16,6,0.272727272727273
SAN LUIS POTOSI PONIENTE,2023-01-21,30,26,4,0.133333333333333
SAN LUIS POTOSI PONIENTE,2023-01-22,11,6,5,0.454545454545455
SAN LUIS POTOSI PONIENTE,2023-01-23,23,20,3,0.130434782608696
SAN LUIS POTOSI PONIENTE,2023-01-24,30,25,5,0.166666666666667
SAN LUIS POTOSI PONIENTE,2023-01-25,22,18,4,0.181818181818182
SAN LUIS POTOSI PONIENTE,2023-01-26,7,6,1,0.142857142857143
SAN LUIS POTOSI PONIENTE,2023-01-27,17,14,3,0.176470588235294
SAN LUIS POTOSI PONIENTE,2023-01-28,19,13,6,0.315789473684211
SAN LUIS POTOSI PONIENTE,2023-01-29,21,19,2,0.0952380952380952
SAN LUIS POTOSI PONIENTE,2023-01-30,24,19,5,0.208333333333333
SAN LUIS POTOSI PONIENTE,2023-01-31,27,24,3,0.111111111111111
SAN LUIS POTOSI PONIENTE,2023-02-01,31,26,5,0.161290322580645
SAN LUIS POTOSI PONIENTE,2023-02-02,35,28,7,0.2
SAN LUIS POTOSI PONIENTE,2023-02-03,31,27,4,0.129032258064516
SAN LUIS POTOSI PONIENTE,2023-02-04,21,18,3,0.142857142857143
SAN LUIS POTOSI PONIENTE,2023-02-05,15,13,2,0.133333333333333
SAN LUIS POTOSI PONIENTE,2023-02-06,25,19,6,0.24
SAN LUIS POTOSI PONIENTE,2023-02-07,21,12,9,0.428571428571429
SAN LUIS POTOSI PONIENTE,2023-02-08,25,17,8,0.32
SAN LUIS POTOSI PONIENTE,2023-02-09,25,23,2,0.08
SAN LUIS POTOSI PONIENTE,2023-02-10,21,18,3,0.142857142857143
SAN LUIS POTOSI PONIENTE,2023-02-11,25,22,3,0.12
SAN LUIS POTOSI PONIENTE,2023-02-12,7,3,4,0.571428571428571
SAN LUIS POTOSI PONIENTE,2023-02-13,25,19,6,0.24
SAN LUIS POTOSI PONIENTE,2023-02-14,23,19,4,0.173913043478261
SAN LUIS POTOSI PONIENTE,2023-02-15,25,22,3,0.12
SAN LUIS POTOSI PONIENTE,2023-02-16,35,28,7,0.2
SAN LUIS POTOSI PONIENTE,2023-02-17,20,15,5,0.25
SAN LUIS POTOSI PONIENTE,2023-02-18,32,22,10,0.3125
SAN LUIS POTOSI PONIENTE,2023-02-19,12,10,2,0.166666666666667
SAN LUIS POTOSI PONIENTE,2023-02-20,26,24,2,0.0769230769230769
SAN LUIS POTOSI PONIENTE,2023-02-21,18,14,4,0.222222222222222
SAN LUIS POTOSI PONIENTE,2023-02-22,18,15,3,0.166666666666667
SAN LUIS POTOSI PONIENTE,2023-02-23,17,13,4,0.235294117647059
SAN LUIS POTOSI PONIENTE,2023-02-24,25,25,0,0
SAN LUIS POTOSI PONIENTE,2023-02-25,34,32,2,0.0588235294117647
SAN LUIS POTOSI PONIENTE,2023-02-26,20,20,0,0
SAN LUIS POTOSI PONIENTE,2023-02-27,25,23,2,0.08
SAN LUIS POTOSI PONIENTE,2023-02-28,28,23,5,0.178571428571429
SAN LUIS POTOSI PONIENTE,2023-03-01,23,23,0,0
SAN LUIS POTOSI PONIENTE,2023-03-02,22,20,2,0.0909090909090909
SAN LUIS POTOSI PONIENTE,2023-03-03,24,23,1,0.0416666666666667
SAN LUIS POTOSI PONIENTE,2023-03-04,18,17,1,0.0555555555555556
SAN LUIS POTOSI PONIENTE,2023-03-05,10,10,0,0
SAN LUIS POTOSI PONIENTE,2023-03-06,18,16,2,0.111111111111111
SAN LUIS POTOSI PONIENTE,2023-03-07,21,19,2,0.0952380952380952
SAN LUIS POTOSI PONIENTE,2023-03-08,20,17,3,0.15
SAN LUIS POTOSI PONIENTE,2023-03-09,23,23,0,0
SAN LUIS POTOSI PONIENTE,2023-03-10,19,18,1,0.0526315789473684
SAN LUIS POTOSI PONIENTE,2023-03-11,23,23,0,0
SAN LUIS POTOSI PONIENTE,2023-03-12,21,19,2,0.0952380952380952
SAN LUIS POTOSI PONIENTE,2023-03-13,20,18,2,0.1
SAN LUIS POTOSI PONIENTE,2023-03-14,14,14,0,0
SAN LUIS POTOSI PONIENTE,2023-03-15,27,27,0,0
SAN LUIS POTOSI PONIENTE,2023-03-16,25,25,0,0
SAN LUIS POTOSI PONIENTE,2023-03-17,19,19,0,0
SAN LUIS POTOSI PONIENTE,2023-03-18,28,27,1,0.0357142857142857
SAN LUIS POTOSI PONIENTE,2023-03-19,13,13,0,0
SAN LUIS POTOSI PONIENTE,2023-03-20,26,26,0,0
SAN LUIS POTOSI PONIENTE,2023-03-21,28,28,0,0
SAN LUIS POTOSI PONIENTE,2023-03-22,20,20,0,0
SAN LUIS POTOSI PONIENTE,2023-03-23,25,25,0,0
SAN LUIS POTOSI PONIENTE,2023-03-24,28,28,0,0
SAN LUIS POTOSI PONIENTE,2023-03-25,26,23,3,0.115384615384615
SAN LUIS POTOSI PONIENTE,2023-03-26,16,15,1,0.0625
SAN LUIS POTOSI PONIENTE,2023-03-27,24,24,0,0
SAN LUIS POTOSI PONIENTE,2023-03-28,22,21,1,0.0454545454545455
SAN LUIS POTOSI PONIENTE,2023-03-29,16,16,0,0
SAN LUIS POTOSI PONIENTE,2023-03-30,21,21,0,0
SAN LUIS POTOSI PONIENTE,2023-03-31,37,37,0,0
SAN LUIS POTOSI PONIENTE,2023-04-01,25,25,0,0
SAN LUIS POTOSI PONIENTE,2023-04-02,11,11,0,0
SAN LUIS POTOSI PONIENTE,2023-04-03,20,20,0,0
SAN LUIS POTOSI PONIENTE,2023-04-04,25,25,0,0
SAN LUIS POTOSI PONIENTE,2023-04-05,25,25,0,0
SAN LUIS POTOSI PONIENTE,2023-04-06,22,22,0,0
SAN LUIS POTOSI PONIENTE,2023-04-07,13,13,0,0
SAN LUIS POTOSI PONIENTE,2023-04-08,9,9,0,0
SAN LUIS POTOSI PONIENTE,2023-04-09,10,10,0,0
SAN LUIS POTOSI PONIENTE,2023-04-10,18,18,0,0
SAN LUIS POTOSI PONIENTE,2023-04-11,14,14,0,0
SAN LUIS POTOSI PONIENTE,2023-04-12,24,23,1,0.0416666666666667
SAN LUIS POTOSI PONIENTE,2023-04-13,24,23,1,0.0416666666666667
SAN LUIS POTOSI PONIENTE,2023-04-14,24,24,0,0
SAN LUIS POTOSI PONIENTE,2023-04-15,32,32,0,0
SAN LUIS POTOSI PONIENTE,2023-04-16,15,15,0,0
SAN LUIS POTOSI PONIENTE,2023-04-17,12,12,0,0
SAN LUIS POTOSI PONIENTE,2023-04-18,27,25,2,0.0740740740740741
SAN LUIS POTOSI PONIENTE,2023-04-19,26,26,0,0
SAN LUIS POTOSI PONIENTE,2023-04-20,23,23,0,0
SAN LUIS POTOSI PONIENTE,2023-04-21,19,18,1,0.0526315789473684
SAN LUIS POTOSI PONIENTE,2023-04-22,25,25,0,0
SAN LUIS POTOSI PONIENTE,2023-04-23,16,15,1,0.0625
SAN LUIS POTOSI PONIENTE,2023-04-24,21,21,0,0
SAN LUIS POTOSI PONIENTE,2023-04-25,22,20,2,0.0909090909090909
SAN LUIS POTOSI PONIENTE,2023-04-26,21,20,1,0.0476190476190476
SAN LUIS POTOSI PONIENTE,2023-04-27,27,24,3,0.111111111111111
SAN LUIS POTOSI PONIENTE,2023-04-28,25,24,1,0.04
SAN LUIS POTOSI PONIENTE,2023-04-29,23,20,3,0.130434782608696
SAN LUIS POTOSI PONIENTE,2023-04-30,21,21,0,0
SAN LUIS POTOSI PONIENTE,2023-05-01,25,24,1,0.04
SAN LUIS POTOSI PONIENTE,2023-05-02,34,34,0,0
SAN LUIS POTOSI PONIENTE,2023-05-03,22,22,0,0
SAN LUIS POTOSI PONIENTE,2023-05-04,19,17,2,0.105263157894737
SAN LUIS POTOSI PONIENTE,2023-05-05,16,16,0,0
SAN LUIS POTOSI PONIENTE,2023-05-06,25,25,0,0
SAN LUIS POTOSI PONIENTE,2023-05-07,11,11,0,0
SAN LUIS POTOSI PONIENTE,2023-05-08,13,12,1,0.0769230769230769
SANTA FE,2023-01-02,28,8,20,0.714285714285714
SANTA FE,2023-01-03,32,13,19,0.59375
SANTA FE,2023-01-04,32,13,19,0.59375
SANTA FE,2023-01-05,38,16,22,0.578947368421053
SANTA FE,2023-01-06,25,15,10,0.4
SANTA FE,2023-01-07,36,18,18,0.5
SANTA FE,2023-01-08,16,7,9,0.5625
SANTA FE,2023-01-09,32,15,17,0.53125
SANTA FE,2023-01-10,34,18,16,0.470588235294118
SANTA FE,2023-01-11,33,18,15,0.454545454545455
SANTA FE,2023-01-12,36,10,26,0.722222222222222
SANTA FE,2023-01-13,29,14,15,0.517241379310345
SANTA FE,2023-01-14,43,19,24,0.558139534883721
SANTA FE,2023-01-15,29,13,16,0.551724137931034
SANTA FE,2023-01-16,38,12,26,0.684210526315789
SANTA FE,2023-01-17,38,7,31,0.815789473684211
SANTA FE,2023-01-18,24,1,23,0.958333333333333
SANTA FE,2023-01-19,29,6,23,0.793103448275862
SANTA FE,2023-01-20,32,10,22,0.6875
SANTA FE,2023-01-21,36,8,28,0.777777777777778
SANTA FE,2023-01-22,11,2,9,0.818181818181818
SANTA FE,2023-01-23,28,7,21,0.75
SANTA FE,2023-01-24,34,5,29,0.852941176470588
SANTA FE,2023-01-25,31,1,30,0.967741935483871
SANTA FE,2023-01-26,36,6,30,0.833333333333333
SANTA FE,2023-01-27,29,5,24,0.827586206896552
SANTA FE,2023-01-28,39,3,36,0.923076923076923
SANTA FE,2023-01-29,27,2,25,0.925925925925926
SANTA FE,2023-01-30,36,2,34,0.944444444444444
SANTA FE,2023-01-31,33,2,31,0.939393939393939
SANTA FE,2023-02-01,27,3,24,0.888888888888889
SANTA FE,2023-02-02,27,3,24,0.888888888888889
SANTA FE,2023-02-03,28,1,27,0.964285714285714
SANTA FE,2023-02-04,41,6,35,0.853658536585366
SANTA FE,2023-02-05,26,2,24,0.923076923076923
SANTA FE,2023-02-06,40,2,38,0.95
SANTA FE,2023-02-07,33,3,30,0.909090909090909
SANTA FE,2023-02-08,27,0,29,1
SANTA FE,2023-02-09,30,4,26,0.866666666666667
SANTA FE,2023-02-10,38,0,39,1
SANTA FE,2023-02-11,27,1,26,0.962962962962963
SANTA FE,2023-02-12,21,0,21,1
SANTA FE,2023-02-13,29,0,29,1
SANTA FE,2023-02-14,37,7,30,0.810810810810811
SANTA FE,2023-02-15,40,6,34,0.85
SANTA FE,2023-02-16,36,5,31,0.861111111111111
SANTA FE,2023-02-17,35,5,30,0.857142857142857
SANTA FE,2023-02-18,40,4,36,0.9
SANTA FE,2023-02-19,23,1,22,0.956521739130435
SANTA FE,2023-02-20,38,6,32,0.842105263157895
SANTA FE,2023-02-21,31,5,26,0.838709677419355
SANTA FE,2023-02-22,35,10,25,0.714285714285714
SANTA FE,2023-02-23,21,5,16,0.761904761904762
SANTA FE,2023-02-24,35,4,31,0.885714285714286
SANTA FE,2023-02-25,34,10,24,0.705882352941177
SANTA FE,2023-02-26,21,5,16,0.761904761904762
SANTA FE,2023-02-27,35,3,32,0.914285714285714
SANTA FE,2023-02-28,41,11,30,0.731707317073171
SANTA FE,2023-03-01,35,11,24,0.685714285714286
SANTA FE,2023-03-02,33,8,25,0.757575757575758
SANTA FE,2023-03-03,38,14,24,0.631578947368421
SANTA FE,2023-03-04,44,10,34,0.772727272727273
SANTA FE,2023-03-05,28,9,19,0.678571428571429
SANTA FE,2023-03-06,28,2,26,0.928571428571429
SANTA FE,2023-03-07,40,7,33,0.825
SANTA FE,2023-03-08,39,15,24,0.615384615384615
SANTA FE,2023-03-09,36,15,21,0.583333333333333
SANTA FE,2023-03-10,21,11,10,0.476190476190476
SANTA FE,2023-03-11,34,18,16,0.470588235294118
SANTA FE,2023-03-12,22,13,9,0.409090909090909
SANTA FE,2023-03-13,41,11,30,0.731707317073171
SANTA FE,2023-03-14,34,18,16,0.470588235294118
SANTA FE,2023-03-15,37,20,17,0.459459459459459
SANTA FE,2023-03-16,34,19,15,0.441176470588235
SANTA FE,2023-03-17,44,32,12,0.272727272727273
SANTA FE,2023-03-18,46,32,14,0.304347826086957
SANTA FE,2023-03-19,31,24,7,0.225806451612903
SANTA FE,2023-03-20,35,27,8,0.228571428571429
SANTA FE,2023-03-21,36,32,4,0.111111111111111
SANTA FE,2023-03-22,37,31,6,0.162162162162162
SANTA FE,2023-03-23,24,21,3,0.125
SANTA FE,2023-03-24,42,37,5,0.119047619047619
SANTA FE,2023-03-25,41,35,6,0.146341463414634
SANTA FE,2023-03-26,22,22,0,0
SANTA FE,2023-03-27,34,29,5,0.147058823529412
SANTA FE,2023-03-28,31,27,4,0.129032258064516
SANTA FE,2023-03-29,27,25,2,0.0740740740740741
SANTA FE,2023-03-30,30,28,2,0.0666666666666667
SANTA FE,2023-03-31,53,48,5,0.0943396226415094
SANTA FE,2023-04-01,48,41,7,0.145833333333333
SANTA FE,2023-04-02,16,15,1,0.0625
SANTA FE,2023-04-03,44,43,1,0.0227272727272727
SANTA FE,2023-04-04,46,46,0,0
SANTA FE,2023-04-05,34,29,5,0.147058823529412
SANTA FE,2023-04-06,29,28,1,0.0344827586206897
SANTA FE,2023-04-07,26,25,1,0.0384615384615385
SANTA FE,2023-04-08,17,17,0,0
SANTA FE,2023-04-09,16,15,1,0.0625
SANTA FE,2023-04-10,36,34,2,0.0555555555555556
SANTA FE,2023-04-11,34,29,5,0.147058823529412
SANTA FE,2023-04-12,32,26,6,0.1875
SANTA FE,2023-04-13,35,29,6,0.171428571428571
SANTA FE,2023-04-14,31,29,2,0.0645161290322581
SANTA FE,2023-04-15,46,43,3,0.0652173913043478
SANTA FE,2023-04-16,39,37,2,0.0512820512820513
SANTA FE,2023-04-17,39,35,4,0.102564102564103
SANTA FE,2023-04-18,34,29,5,0.147058823529412
SANTA FE,2023-04-19,34,30,4,0.117647058823529
SANTA FE,2023-04-20,25,21,4,0.16
SANTA FE,2023-04-21,28,24,4,0.142857142857143
SANTA FE,2023-04-22,37,33,4,0.108108108108108
SANTA FE,2023-04-23,31,29,2,0.0645161290322581
SANTA FE,2023-04-24,37,27,10,0.27027027027027
SANTA FE,2023-04-25,43,34,9,0.209302325581395
SANTA FE,2023-04-26,30,25,5,0.166666666666667
SANTA FE,2023-04-27,31,27,4,0.129032258064516
SANTA FE,2023-04-28,35,27,8,0.228571428571429
SANTA FE,2023-04-29,49,44,5,0.102040816326531
SANTA FE,2023-04-30,36,29,7,0.194444444444444
SANTA FE,2023-05-01,31,28,3,0.0967741935483871
SANTA FE,2023-05-02,36,32,4,0.111111111111111
SANTA FE,2023-05-03,24,20,4,0.166666666666667
SANTA FE,2023-05-04,43,40,3,0.0697674418604651
SANTA FE,2023-05-05,41,33,8,0.195121951219512
SANTA FE,2023-05-06,39,32,7,0.179487179487179
SANTA FE,2023-05-07,30,30,0,0
SANTA FE,2023-05-08,24,17,7,0.291666666666667
SATELITE,2023-01-02,19,14,5,0.263157894736842
SATELITE,2023-01-03,22,20,2,0.0909090909090909
SATELITE,2023-01-04,16,10,6,0.375
SATELITE,2023-01-05,27,17,10,0.37037037037037
SATELITE,2023-01-06,14,10,4,0.285714285714286
SATELITE,2023-01-07,15,12,3,0.2
SATELITE,2023-01-08,12,11,1,0.0833333333333333
SATELITE,2023-01-09,18,16,2,0.111111111111111
SATELITE,2023-01-10,13,5,8,0.615384615384615
SATELITE,2023-01-11,28,18,10,0.357142857142857
SATELITE,2023-01-12,22,11,11,0.5
SATELITE,2023-01-13,34,21,13,0.382352941176471
SATELITE,2023-01-14,28,19,9,0.321428571428571
SATELITE,2023-01-15,20,13,7,0.35
SATELITE,2023-01-16,30,10,20,0.666666666666667
SATELITE,2023-01-17,28,11,17,0.607142857142857
SATELITE,2023-01-18,18,7,11,0.611111111111111
SATELITE,2023-01-19,26,16,10,0.384615384615385
SATELITE,2023-01-20,31,16,15,0.483870967741935
SATELITE,2023-01-21,26,14,12,0.461538461538462
SATELITE,2023-01-22,12,9,3,0.25
SATELITE,2023-01-23,20,8,12,0.6
SATELITE,2023-01-24,25,11,14,0.56
SATELITE,2023-01-25,24,16,8,0.333333333333333
SATELITE,2023-01-26,28,15,13,0.464285714285714
SATELITE,2023-01-27,20,7,13,0.65
SATELITE,2023-01-28,31,18,13,0.419354838709677
SATELITE,2023-01-29,27,13,14,0.518518518518518
SATELITE,2023-01-30,30,15,15,0.5
SATELITE,2023-01-31,25,14,11,0.44
SATELITE,2023-02-01,21,12,9,0.428571428571429
SATELITE,2023-02-02,21,13,8,0.380952380952381
SATELITE,2023-02-03,15,9,6,0.4
SATELITE,2023-02-04,30,16,14,0.466666666666667
SATELITE,2023-02-05,15,10,5,0.333333333333333
SATELITE,2023-02-06,18,9,9,0.5
SATELITE,2023-02-07,20,10,10,0.5
SATELITE,2023-02-08,24,9,15,0.625
SATELITE,2023-02-09,16,11,5,0.3125
SATELITE,2023-02-10,28,18,10,0.357142857142857
SATELITE,2023-02-11,19,14,5,0.263157894736842
SATELITE,2023-02-12,13,9,4,0.307692307692308
SATELITE,2023-02-13,18,11,7,0.388888888888889
SATELITE,2023-02-14,26,17,9,0.346153846153846
SATELITE,2023-02-15,13,11,2,0.153846153846154
SATELITE,2023-02-16,24,15,9,0.375
SATELITE,2023-02-17,15,10,5,0.333333333333333
SATELITE,2023-02-18,20,14,6,0.3
SATELITE,2023-02-19,19,10,9,0.473684210526316
SATELITE,2023-02-20,21,14,7,0.333333333333333
SATELITE,2023-02-21,21,11,10,0.476190476190476
SATELITE,2023-02-22,18,11,7,0.388888888888889
SATELITE,2023-02-23,23,18,5,0.217391304347826
SATELITE,2023-02-24,19,15,4,0.210526315789474
SATELITE,2023-02-25,26,17,9,0.346153846153846
SATELITE,2023-02-26,18,12,6,0.333333333333333
SATELITE,2023-02-27,26,18,8,0.307692307692308
SATELITE,2023-02-28,23,13,10,0.434782608695652
SATELITE,2023-03-01,25,14,11,0.44
SATELITE,2023-03-02,12,5,7,0.583333333333333
SATELITE,2023-03-03,30,21,9,0.3
SATELITE,2023-03-04,24,19,5,0.208333333333333
SATELITE,2023-03-05,14,8,6,0.428571428571429
SATELITE,2023-03-06,18,12,6,0.333333333333333
SATELITE,2023-03-07,23,14,9,0.391304347826087
SATELITE,2023-03-08,23,19,4,0.173913043478261
SATELITE,2023-03-09,15,12,3,0.2
SATELITE,2023-03-10,23,19,4,0.173913043478261
SATELITE,2023-03-11,25,19,6,0.24
SATELITE,2023-03-12,22,14,8,0.363636363636364
SATELITE,2023-03-13,24,17,7,0.291666666666667
SATELITE,2023-03-14,23,15,8,0.347826086956522
SATELITE,2023-03-15,27,21,6,0.222222222222222
SATELITE,2023-03-16,25,19,6,0.24
SATELITE,2023-03-17,32,27,5,0.15625
SATELITE,2023-03-18,30,21,9,0.3
SATELITE,2023-03-19,23,18,5,0.217391304347826
SATELITE,2023-03-20,24,19,5,0.208333333333333
SATELITE,2023-03-21,36,32,4,0.111111111111111
SATELITE,2023-03-22,25,24,1,0.04
SATELITE,2023-03-23,22,16,6,0.272727272727273
SATELITE,2023-03-24,26,24,2,0.0769230769230769
SATELITE,2023-03-25,24,24,0,0
SATELITE,2023-03-26,16,15,1,0.0625
SATELITE,2023-03-27,14,13,1,0.0714285714285714
SATELITE,2023-03-28,17,15,2,0.117647058823529
SATELITE,2023-03-29,24,22,2,0.0833333333333333
SATELITE,2023-03-30,20,15,5,0.25
SATELITE,2023-03-31,31,26,5,0.161290322580645
SATELITE,2023-04-01,34,30,4,0.117647058823529
SATELITE,2023-04-02,17,14,3,0.176470588235294
SATELITE,2023-04-03,28,28,0,0
SATELITE,2023-04-04,27,20,7,0.259259259259259
SATELITE,2023-04-05,23,19,4,0.173913043478261
SATELITE,2023-04-06,26,23,3,0.115384615384615
SATELITE,2023-04-07,15,15,0,0
SATELITE,2023-04-08,8,8,0,0
SATELITE,2023-04-09,9,8,1,0.111111111111111
SATELITE,2023-04-10,25,24,1,0.04
SATELITE,2023-04-11,19,18,1,0.0526315789473684
SATELITE,2023-04-12,34,30,4,0.117647058823529
SATELITE,2023-04-13,23,21,2,0.0869565217391304
SATELITE,2023-04-14,24,19,5,0.208333333333333
SATELITE,2023-04-15,37,34,3,0.0810810810810811
SATELITE,2023-04-16,26,24,2,0.0769230769230769
SATELITE,2023-04-17,34,30,4,0.117647058823529
SATELITE,2023-04-18,32,27,5,0.15625
SATELITE,2023-04-19,28,23,5,0.178571428571429
SATELITE,2023-04-20,20,17,3,0.15
SATELITE,2023-04-21,21,18,3,0.142857142857143
SATELITE,2023-04-22,35,30,5,0.142857142857143
SATELITE,2023-04-23,36,31,5,0.138888888888889
SATELITE,2023-04-24,38,34,4,0.105263157894737
SATELITE,2023-04-25,37,31,6,0.162162162162162
SATELITE,2023-04-26,29,25,4,0.137931034482759
SATELITE,2023-04-27,20,18,2,0.1
SATELITE,2023-04-28,29,22,7,0.241379310344828
SATELITE,2023-04-29,35,27,8,0.228571428571429
SATELITE,2023-04-30,30,26,4,0.133333333333333
SATELITE,2023-05-01,22,18,4,0.181818181818182
SATELITE,2023-05-02,27,23,4,0.148148148148148
SATELITE,2023-05-03,26,22,4,0.153846153846154
SATELITE,2023-05-04,26,23,3,0.115384615384615
SATELITE,2023-05-05,29,26,3,0.103448275862069
SATELITE,2023-05-06,31,21,10,0.32258064516129
SATELITE,2023-05-07,18,16,2,0.111111111111111
SATELITE,2023-05-08,21,20,1,0.0476190476190476
TAMPICO,2023-01-02,26,24,2,0.0769230769230769
TAMPICO,2023-01-03,33,26,7,0.212121212121212
TAMPICO,2023-01-04,45,40,5,0.111111111111111
TAMPICO,2023-01-05,43,38,5,0.116279069767442
TAMPICO,2023-01-06,56,47,9,0.160714285714286
TAMPICO,2023-01-07,48,42,6,0.125
TAMPICO,2023-01-08,34,31,3,0.0882352941176471
TAMPICO,2023-01-09,49,45,4,0.0816326530612245
TAMPICO,2023-01-10,36,32,4,0.111111111111111
TAMPICO,2023-01-11,35,32,3,0.0857142857142857
TAMPICO,2023-01-12,41,38,3,0.0731707317073171
TAMPICO,2023-01-13,45,40,5,0.111111111111111
TAMPICO,2023-01-14,52,49,3,0.0576923076923077
TAMPICO,2023-01-15,25,23,2,0.08
TAMPICO,2023-01-16,45,38,7,0.155555555555556
TAMPICO,2023-01-17,46,39,7,0.152173913043478
TAMPICO,2023-01-18,42,36,6,0.142857142857143
TAMPICO,2023-01-19,45,40,5,0.111111111111111
TAMPICO,2023-01-20,42,36,6,0.142857142857143
TAMPICO,2023-01-21,48,41,7,0.145833333333333
TAMPICO,2023-01-22,30,26,4,0.133333333333333
TAMPICO,2023-01-23,29,24,5,0.172413793103448
TAMPICO,2023-01-24,40,37,3,0.075
TAMPICO,2023-01-25,49,43,6,0.122448979591837
TAMPICO,2023-01-26,37,33,4,0.108108108108108
TAMPICO,2023-01-27,39,38,1,0.0256410256410256
TAMPICO,2023-01-28,40,35,5,0.125
TAMPICO,2023-01-29,34,30,4,0.117647058823529
TAMPICO,2023-01-30,37,34,3,0.0810810810810811
TAMPICO,2023-01-31,64,62,2,0.03125
TAMPICO,2023-02-01,52,48,4,0.0769230769230769
TAMPICO,2023-02-02,47,44,3,0.0638297872340425
TAMPICO,2023-02-03,43,38,5,0.116279069767442
TAMPICO,2023-02-04,43,40,3,0.0697674418604651
TAMPICO,2023-02-05,23,20,3,0.130434782608696
TAMPICO,2023-02-06,31,28,3,0.0967741935483871
TAMPICO,2023-02-07,44,42,2,0.0454545454545455
TAMPICO,2023-02-08,40,38,2,0.05
TAMPICO,2023-02-09,50,43,7,0.14
TAMPICO,2023-02-10,34,29,5,0.147058823529412
TAMPICO,2023-02-11,45,36,9,0.2
TAMPICO,2023-02-12,31,28,3,0.0967741935483871
TAMPICO,2023-02-13,32,30,2,0.0625
TAMPICO,2023-02-14,28,26,2,0.0714285714285714
TAMPICO,2023-02-15,41,39,2,0.0487804878048781
TAMPICO,2023-02-16,37,33,4,0.108108108108108
TAMPICO,2023-02-17,46,43,3,0.0652173913043478
TAMPICO,2023-02-18,40,37,3,0.075
TAMPICO,2023-02-19,32,26,6,0.1875
TAMPICO,2023-02-20,26,25,1,0.0384615384615385
TAMPICO,2023-02-21,32,27,5,0.15625
TAMPICO,2023-02-22,42,42,0,0
TAMPICO,2023-02-23,37,33,4,0.108108108108108
TAMPICO,2023-02-24,46,41,5,0.108695652173913
TAMPICO,2023-02-25,38,32,6,0.157894736842105
TAMPICO,2023-02-26,30,28,2,0.0666666666666667
TAMPICO,2023-02-27,40,36,4,0.1
TAMPICO,2023-02-28,55,49,6,0.109090909090909
TAMPICO,2023-03-01,52,49,3,0.0576923076923077
TAMPICO,2023-03-02,47,45,2,0.0425531914893617
TAMPICO,2023-03-03,50,44,6,0.12
TAMPICO,2023-03-04,44,42,2,0.0454545454545455
TAMPICO,2023-03-05,14,14,0,0
TAMPICO,2023-03-06,40,38,2,0.05
TAMPICO,2023-03-07,37,35,2,0.0540540540540541
TAMPICO,2023-03-08,45,44,1,0.0222222222222222
TAMPICO,2023-03-09,36,35,1,0.0277777777777778
TAMPICO,2023-03-10,43,43,0,0
TAMPICO,2023-03-11,58,58,0,0
TAMPICO,2023-03-12,29,29,0,0
TAMPICO,2023-03-13,39,39,0,0
TAMPICO,2023-03-14,51,50,1,0.0196078431372549
TAMPICO,2023-03-15,47,47,0,0
TAMPICO,2023-03-16,58,58,0,0
TAMPICO,2023-03-17,79,79,0,0
TAMPICO,2023-03-18,82,82,0,0
TAMPICO,2023-03-19,65,65,0,0
TAMPICO,2023-03-20,57,56,1,0.0175438596491228
TAMPICO,2023-03-21,43,43,0,0
TAMPICO,2023-03-22,50,50,0,0
TAMPICO,2023-03-23,50,49,1,0.02
TAMPICO,2023-03-24,51,51,0,0
TAMPICO,2023-03-25,62,61,1,0.0161290322580645
TAMPICO,2023-03-26,31,31,0,0
TAMPICO,2023-03-27,33,33,0,0
TAMPICO,2023-03-28,55,55,0,0
TAMPICO,2023-03-29,39,39,0,0
TAMPICO,2023-03-30,64,64,0,0
TAMPICO,2023-03-31,77,77,0,0
TAMPICO,2023-04-01,67,67,0,0
TAMPICO,2023-04-02,22,22,0,0
TAMPICO,2023-04-03,60,59,1,0.0166666666666667
TAMPICO,2023-04-04,45,44,1,0.0222222222222222
TAMPICO,2023-04-05,38,38,0,0
TAMPICO,2023-04-06,41,39,2,0.0487804878048781
TAMPICO,2023-04-07,32,32,0,0
TAMPICO,2023-04-08,35,35,0,0
TAMPICO,2023-04-09,21,21,0,0
TAMPICO,2023-04-10,30,28,2,0.0666666666666667
TAMPICO,2023-04-11,36,36,0,0
TAMPICO,2023-04-12,39,37,2,0.0512820512820513
TAMPICO,2023-04-13,38,38,0,0
TAMPICO,2023-04-14,45,43,2,0.0444444444444444
TAMPICO,2023-04-15,79,76,3,0.0379746835443038
TAMPICO,2023-04-16,43,42,1,0.0232558139534884
TAMPICO,2023-04-17,45,44,1,0.0222222222222222
TAMPICO,2023-04-18,45,41,4,0.0888888888888889
TAMPICO,2023-04-19,35,34,1,0.0285714285714286
TAMPICO,2023-04-20,33,33,0,0
TAMPICO,2023-04-21,47,47,0,0
TAMPICO,2023-04-22,67,65,2,0.0298507462686567
TAMPICO,2023-04-23,50,49,1,0.02
TAMPICO,2023-04-24,45,45,0,0
TAMPICO,2023-04-25,68,67,1,0.0147058823529412
TAMPICO,2023-04-26,39,38,1,0.0256410256410256
TAMPICO,2023-04-27,54,52,2,0.037037037037037
TAMPICO,2023-04-28,60,58,2,0.0333333333333333
TAMPICO,2023-04-29,66,65,1,0.0151515151515152
TAMPICO,2023-04-30,36,35,1,0.0277777777777778
TAMPICO,2023-05-01,47,45,2,0.0425531914893617
TAMPICO,2023-05-02,35,34,1,0.0285714285714286
TAMPICO,2023-05-03,24,21,3,0.125
TAMPICO,2023-05-04,35,35,0,0
TAMPICO,2023-05-05,35,35,0,0
TAMPICO,2023-05-06,39,38,1,0.0256410256410256
TAMPICO,2023-05-07,28,28,0,0
TAMPICO,2023-05-08,32,30,2,0.0625
TECAMAC,2023-01-02,26,22,4,0.153846153846154
TECAMAC,2023-01-03,23,20,3,0.130434782608696
TECAMAC,2023-01-04,25,18,7,0.28
TECAMAC,2023-01-05,26,18,8,0.307692307692308
TECAMAC,2023-01-06,32,26,6,0.1875
TECAMAC,2023-01-07,50,40,10,0.2
TECAMAC,2023-01-08,35,27,8,0.228571428571429
TECAMAC,2023-01-09,32,25,7,0.21875
TECAMAC,2023-01-10,40,32,8,0.2
TECAMAC,2023-01-11,46,37,9,0.195652173913043
TECAMAC,2023-01-12,39,35,4,0.102564102564103
TECAMAC,2023-01-13,31,28,3,0.0967741935483871
TECAMAC,2023-01-14,39,35,4,0.102564102564103
TECAMAC,2023-01-15,35,31,4,0.114285714285714
TECAMAC,2023-01-16,34,30,4,0.117647058823529
TECAMAC,2023-01-17,33,29,4,0.121212121212121
TECAMAC,2023-01-18,23,19,4,0.173913043478261
TECAMAC,2023-01-19,31,28,3,0.0967741935483871
TECAMAC,2023-01-20,27,26,1,0.037037037037037
TECAMAC,2023-01-21,31,30,1,0.032258064516129
TECAMAC,2023-01-22,34,30,4,0.117647058823529
TECAMAC,2023-01-23,27,26,1,0.037037037037037
TECAMAC,2023-01-24,29,24,5,0.172413793103448
TECAMAC,2023-01-25,32,22,10,0.3125
TECAMAC,2023-01-26,31,24,7,0.225806451612903
TECAMAC,2023-01-27,31,20,11,0.354838709677419
TECAMAC,2023-01-28,42,30,12,0.285714285714286
TECAMAC,2023-01-29,25,16,9,0.36
TECAMAC,2023-01-30,36,22,14,0.388888888888889
TECAMAC,2023-01-31,32,25,7,0.21875
TECAMAC,2023-02-01,35,29,6,0.171428571428571
TECAMAC,2023-02-02,28,16,12,0.428571428571429
TECAMAC,2023-02-03,23,19,4,0.173913043478261
TECAMAC,2023-02-04,30,24,6,0.2
TECAMAC,2023-02-05,30,25,5,0.166666666666667
TECAMAC,2023-02-06,37,28,9,0.243243243243243
TECAMAC,2023-02-07,41,25,16,0.390243902439024
TECAMAC,2023-02-08,28,18,10,0.357142857142857
TECAMAC,2023-02-09,25,14,11,0.44
TECAMAC,2023-02-10,26,10,16,0.615384615384615
TECAMAC,2023-02-11,37,19,18,0.486486486486487
TECAMAC,2023-02-12,33,23,10,0.303030303030303
TECAMAC,2023-02-13,27,17,10,0.37037037037037
TECAMAC,2023-02-14,25,14,11,0.44
TECAMAC,2023-02-15,28,16,12,0.428571428571429
TECAMAC,2023-02-16,28,19,9,0.321428571428571
TECAMAC,2023-02-17,28,16,12,0.428571428571429
TECAMAC,2023-02-18,33,17,16,0.484848484848485
TECAMAC,2023-02-19,27,22,5,0.185185185185185
TECAMAC,2023-02-20,29,19,10,0.344827586206897
TECAMAC,2023-02-21,23,15,8,0.347826086956522
TECAMAC,2023-02-22,22,19,3,0.136363636363636
TECAMAC,2023-02-23,27,19,8,0.296296296296296
TECAMAC,2023-02-24,32,25,7,0.21875
TECAMAC,2023-02-25,35,26,9,0.257142857142857
TECAMAC,2023-02-26,18,10,8,0.444444444444444
TECAMAC,2023-02-27,36,25,11,0.305555555555556
TECAMAC,2023-02-28,44,31,13,0.295454545454545
TECAMAC,2023-03-01,37,28,9,0.243243243243243
TECAMAC,2023-03-02,32,24,8,0.25
TECAMAC,2023-03-03,30,24,6,0.2
TECAMAC,2023-03-04,40,35,5,0.125
TECAMAC,2023-03-05,32,28,4,0.125
TECAMAC,2023-03-06,37,28,9,0.243243243243243
TECAMAC,2023-03-07,37,27,10,0.27027027027027
TECAMAC,2023-03-08,37,29,8,0.216216216216216
TECAMAC,2023-03-09,29,25,4,0.137931034482759
TECAMAC,2023-03-10,27,23,4,0.148148148148148
TECAMAC,2023-03-11,35,32,3,0.0857142857142857
TECAMAC,2023-03-12,43,39,4,0.0930232558139535
TECAMAC,2023-03-13,28,25,3,0.107142857142857
TECAMAC,2023-03-14,37,37,0,0
TECAMAC,2023-03-15,38,38,0,0
TECAMAC,2023-03-16,46,46,0,0
TECAMAC,2023-03-17,53,53,0,0
TECAMAC,2023-03-18,55,55,0,0
TECAMAC,2023-03-19,68,68,0,0
TECAMAC,2023-03-20,60,60,0,0
TECAMAC,2023-03-21,43,43,0,0
TECAMAC,2023-03-22,47,47,0,0
TECAMAC,2023-03-23,36,36,0,0
TECAMAC,2023-03-24,36,36,0,0
TECAMAC,2023-03-25,43,43,0,0
TECAMAC,2023-03-26,49,49,0,0
TECAMAC,2023-03-27,35,35,0,0
TECAMAC,2023-03-28,18,18,0,0
TECAMAC,2023-03-29,32,32,0,0
TECAMAC,2023-03-30,33,33,0,0
TECAMAC,2023-03-31,59,59,0,0
TECAMAC,2023-04-01,48,48,0,0
TECAMAC,2023-04-02,45,45,0,0
TECAMAC,2023-04-03,50,50,0,0
TECAMAC,2023-04-04,19,19,0,0
TECAMAC,2023-04-05,48,48,0,0
TECAMAC,2023-04-06,32,32,0,0
TECAMAC,2023-04-07,34,34,0,0
TECAMAC,2023-04-08,21,21,0,0
TECAMAC,2023-04-09,19,19,0,0
TECAMAC,2023-04-10,23,23,0,0
TECAMAC,2023-04-11,31,31,0,0
TECAMAC,2023-04-12,33,33,0,0
TECAMAC,2023-04-13,29,29,0,0
TECAMAC,2023-04-14,42,42,0,0
TECAMAC,2023-04-15,74,74,0,0
TECAMAC,2023-04-16,49,49,0,0
TECAMAC,2023-04-17,38,38,0,0
TECAMAC,2023-04-18,24,24,0,0
TECAMAC,2023-04-19,22,22,0,0
TECAMAC,2023-04-20,32,32,0,0
TECAMAC,2023-04-21,38,38,0,0
TECAMAC,2023-04-22,45,45,0,0
TECAMAC,2023-04-23,44,44,0,0
TECAMAC,2023-04-24,48,48,0,0
TECAMAC,2023-04-25,45,45,0,0
TECAMAC,2023-04-26,42,42,0,0
TECAMAC,2023-04-27,25,25,0,0
TECAMAC,2023-04-28,38,38,0,0
TECAMAC,2023-04-29,50,50,0,0
TECAMAC,2023-04-30,44,44,0,0
TECAMAC,2023-05-01,45,45,0,0
TECAMAC,2023-05-02,39,39,0,0
TECAMAC,2023-05-03,29,29,0,0
TECAMAC,2023-05-04,34,34,0,0
TECAMAC,2023-05-05,34,34,0,0
TECAMAC,2023-05-06,38,38,0,0
TECAMAC,2023-05-07,37,37,0,0
TECAMAC,2023-05-08,34,34,0,0
TEPIC,2023-01-02,9,4,5,0.555555555555556
TEPIC,2023-01-03,19,12,7,0.368421052631579
TEPIC,2023-01-04,23,14,9,0.391304347826087
TEPIC,2023-01-05,14,9,5,0.357142857142857
TEPIC,2023-01-06,18,7,11,0.611111111111111
TEPIC,2023-01-07,16,9,7,0.4375
TEPIC,2023-01-08,7,5,2,0.285714285714286
TEPIC,2023-01-09,17,10,7,0.411764705882353
TEPIC,2023-01-10,23,9,14,0.608695652173913
TEPIC,2023-01-11,17,13,4,0.235294117647059
TEPIC,2023-01-12,14,8,6,0.428571428571429
TEPIC,2023-01-13,11,8,3,0.272727272727273
TEPIC,2023-01-14,16,12,4,0.25
TEPIC,2023-01-15,9,6,3,0.333333333333333
TEPIC,2023-01-16,17,7,10,0.588235294117647
TEPIC,2023-01-17,14,10,4,0.285714285714286
TEPIC,2023-01-18,12,8,4,0.333333333333333
TEPIC,2023-01-19,20,15,5,0.25
TEPIC,2023-01-20,14,10,4,0.285714285714286
TEPIC,2023-01-21,20,4,16,0.8
TEPIC,2023-01-22,8,1,7,0.875
TEPIC,2023-01-23,14,1,13,0.928571428571429
TEPIC,2023-01-24,10,3,7,0.7
TEPIC,2023-01-25,16,3,13,0.8125
TEPIC,2023-01-26,9,0,9,1
TEPIC,2023-01-27,18,4,14,0.777777777777778
TEPIC,2023-01-28,14,2,12,0.857142857142857
TEPIC,2023-01-29,7,0,7,1
TEPIC,2023-01-30,21,1,20,0.952380952380952
TEPIC,2023-01-31,18,1,17,0.944444444444444
TEPIC,2023-02-01,16,1,15,0.9375
TEPIC,2023-02-02,19,0,19,1
TEPIC,2023-02-03,11,1,10,0.909090909090909
TEPIC,2023-02-04,20,4,16,0.8
TEPIC,2023-02-05,7,0,7,1
TEPIC,2023-02-06,13,1,12,0.923076923076923
TEPIC,2023-02-07,14,1,13,0.928571428571429
TEPIC,2023-02-08,7,2,5,0.714285714285714
TEPIC,2023-02-09,20,3,17,0.85
TEPIC,2023-02-10,10,3,7,0.7
TEPIC,2023-02-11,16,1,15,0.9375
TEPIC,2023-02-12,7,1,6,0.857142857142857
TEPIC,2023-02-13,10,0,10,1
TEPIC,2023-02-14,12,1,11,0.916666666666667
TEPIC,2023-02-15,13,1,12,0.923076923076923
TEPIC,2023-02-16,25,2,23,0.92
TEPIC,2023-02-17,22,6,16,0.727272727272727
TEPIC,2023-02-18,15,1,14,0.933333333333333
TEPIC,2023-02-19,5,1,4,0.8
TEPIC,2023-02-20,17,3,14,0.823529411764706
TEPIC,2023-02-21,16,7,9,0.5625
TEPIC,2023-02-22,11,2,9,0.818181818181818
TEPIC,2023-02-23,16,6,10,0.625
TEPIC,2023-02-24,8,4,4,0.5
TEPIC,2023-02-25,21,10,11,0.523809523809524
TEPIC,2023-02-26,4,2,2,0.5
TEPIC,2023-02-27,12,6,6,0.5
TEPIC,2023-02-28,17,8,9,0.529411764705882
TEPIC,2023-03-01,16,7,9,0.5625
TEPIC,2023-03-02,18,5,13,0.722222222222222
TEPIC,2023-03-03,10,8,2,0.2
TEPIC,2023-03-04,13,7,6,0.461538461538462
TEPIC,2023-03-05,10,5,5,0.5
TEPIC,2023-03-06,5,1,4,0.8
TEPIC,2023-03-07,21,12,9,0.428571428571429
TEPIC,2023-03-08,16,9,7,0.4375
TEPIC,2023-03-09,15,14,1,0.0666666666666667
TEPIC,2023-03-10,13,11,2,0.153846153846154
TEPIC,2023-03-11,17,16,1,0.0588235294117647
TEPIC,2023-03-12,11,10,1,0.0909090909090909
TEPIC,2023-03-13,17,15,2,0.117647058823529
TEPIC,2023-03-14,13,13,0,0
TEPIC,2023-03-15,16,15,1,0.0625
TEPIC,2023-03-16,24,20,4,0.166666666666667
TEPIC,2023-03-17,15,14,1,0.0666666666666667
TEPIC,2023-03-18,19,17,2,0.105263157894737
TEPIC,2023-03-19,19,17,2,0.105263157894737
TEPIC,2023-03-20,22,21,1,0.0454545454545455
TEPIC,2023-03-21,14,13,1,0.0714285714285714
TEPIC,2023-03-22,16,16,0,0
TEPIC,2023-03-23,14,14,0,0
TEPIC,2023-03-24,21,21,0,0
TEPIC,2023-03-25,15,14,1,0.0666666666666667
TEPIC,2023-03-26,15,15,0,0
TEPIC,2023-03-27,9,8,1,0.111111111111111
TEPIC,2023-03-28,17,17,0,0
TEPIC,2023-03-29,15,13,2,0.133333333333333
TEPIC,2023-03-30,17,16,1,0.0588235294117647
TEPIC,2023-03-31,27,27,0,0
TEPIC,2023-04-01,13,12,1,0.0769230769230769
TEPIC,2023-04-02,6,6,0,0
TEPIC,2023-04-03,23,23,0,0
TEPIC,2023-04-04,23,20,3,0.130434782608696
TEPIC,2023-04-05,20,17,3,0.15
TEPIC,2023-04-06,14,14,0,0
TEPIC,2023-04-07,11,11,0,0
TEPIC,2023-04-08,7,7,0,0
TEPIC,2023-04-09,3,3,0,0
TEPIC,2023-04-10,13,12,1,0.0769230769230769
TEPIC,2023-04-11,18,15,3,0.166666666666667
TEPIC,2023-04-12,15,15,0,0
TEPIC,2023-04-13,15,14,1,0.0666666666666667
TEPIC,2023-04-14,21,21,0,0
TEPIC,2023-04-15,24,22,2,0.0833333333333333
TEPIC,2023-04-16,18,15,3,0.166666666666667
TEPIC,2023-04-17,16,15,1,0.0625
TEPIC,2023-04-18,12,9,3,0.25
TEPIC,2023-04-19,13,13,0,0
TEPIC,2023-04-20,15,13,2,0.133333333333333
TEPIC,2023-04-21,14,13,1,0.0714285714285714
TEPIC,2023-04-22,14,13,1,0.0714285714285714
TEPIC,2023-04-23,11,10,1,0.0909090909090909
TEPIC,2023-04-24,20,20,0,0
TEPIC,2023-04-25,20,18,2,0.1
TEPIC,2023-04-26,25,22,3,0.12
TEPIC,2023-04-27,19,18,1,0.0526315789473684
TEPIC,2023-04-28,19,16,3,0.157894736842105
TEPIC,2023-04-29,20,17,3,0.15
TEPIC,2023-04-30,10,8,2,0.2
TEPIC,2023-05-01,20,17,3,0.15
TEPIC,2023-05-02,13,13,0,0
TEPIC,2023-05-03,18,18,0,0
TEPIC,2023-05-04,12,10,2,0.166666666666667
TEPIC,2023-05-05,25,24,1,0.04
TEPIC,2023-05-06,13,13,0,0
TEPIC,2023-05-07,9,9,0,0
TEPIC,2023-05-08,19,19,0,0
TIJ FRONTERA,2023-01-02,23,7,16,0.695652173913043
TIJ FRONTERA,2023-01-03,29,7,22,0.758620689655172
TIJ FRONTERA,2023-01-04,31,11,20,0.645161290322581
TIJ FRONTERA,2023-01-05,66,23,43,0.651515151515151
TIJ FRONTERA,2023-01-06,47,19,28,0.595744680851064
TIJ FRONTERA,2023-01-07,44,14,30,0.681818181818182
TIJ FRONTERA,2023-01-08,30,15,15,0.5
TIJ FRONTERA,2023-01-09,36,9,27,0.75
TIJ FRONTERA,2023-01-10,30,9,21,0.7
TIJ FRONTERA,2023-01-11,41,13,28,0.682926829268293
TIJ FRONTERA,2023-01-12,42,17,25,0.595238095238095
TIJ FRONTERA,2023-01-13,47,18,29,0.617021276595745
TIJ FRONTERA,2023-01-14,34,15,19,0.558823529411765
TIJ FRONTERA,2023-01-15,31,16,15,0.483870967741935
TIJ FRONTERA,2023-01-16,4,1,3,0.75
TIJ FRONTERA,2023-01-17,25,11,14,0.56
TIJ FRONTERA,2023-01-18,41,6,35,0.853658536585366
TIJ FRONTERA,2023-01-19,35,4,31,0.885714285714286
TIJ FRONTERA,2023-01-20,29,0,30,1
TIJ FRONTERA,2023-01-21,33,0,33,1
TIJ FRONTERA,2023-01-22,32,1,31,0.96875
TIJ FRONTERA,2023-01-23,31,0,31,1
TIJ FRONTERA,2023-01-24,39,0,39,1
TIJ FRONTERA,2023-01-25,44,1,43,0.977272727272727
TIJ FRONTERA,2023-01-26,39,3,36,0.923076923076923
TIJ FRONTERA,2023-01-27,45,2,43,0.955555555555556
TIJ FRONTERA,2023-01-28,44,0,44,1
TIJ FRONTERA,2023-01-29,36,0,36,1
TIJ FRONTERA,2023-01-30,30,0,30,1
TIJ FRONTERA,2023-01-31,32,0,32,1
TIJ FRONTERA,2023-02-01,30,1,29,0.966666666666667
TIJ FRONTERA,2023-02-02,50,0,50,1
TIJ FRONTERA,2023-02-03,31,1,30,0.967741935483871
TIJ FRONTERA,2023-02-04,43,3,40,0.930232558139535
TIJ FRONTERA,2023-02-05,22,0,22,1
TIJ FRONTERA,2023-02-06,36,1,35,0.972222222222222
TIJ FRONTERA,2023-02-07,39,4,35,0.897435897435897
TIJ FRONTERA,2023-02-08,37,3,34,0.918918918918919
TIJ FRONTERA,2023-02-09,25,4,21,0.84
TIJ FRONTERA,2023-02-10,56,0,56,1
TIJ FRONTERA,2023-02-11,38,1,37,0.973684210526316
TIJ FRONTERA,2023-02-12,39,4,35,0.897435897435897
TIJ FRONTERA,2023-02-13,40,0,41,1
TIJ FRONTERA,2023-02-14,37,1,36,0.972972972972973
TIJ FRONTERA,2023-02-15,36,3,33,0.916666666666667
TIJ FRONTERA,2023-02-16,38,1,37,0.973684210526316
TIJ FRONTERA,2023-02-17,40,0,40,1
TIJ FRONTERA,2023-02-18,37,1,36,0.972972972972973
TIJ FRONTERA,2023-02-19,37,1,36,0.972972972972973
TIJ FRONTERA,2023-02-20,34,0,34,1
TIJ FRONTERA,2023-02-21,39,1,38,0.974358974358974
TIJ FRONTERA,2023-02-22,45,9,36,0.8
TIJ FRONTERA,2023-02-23,22,5,17,0.772727272727273
TIJ FRONTERA,2023-02-24,18,3,15,0.833333333333333
TIJ FRONTERA,2023-02-25,4,0,4,1
TIJ FRONTERA,2023-02-26,24,2,22,0.916666666666667
TIJ FRONTERA,2023-02-27,35,4,31,0.885714285714286
TIJ FRONTERA,2023-02-28,27,0,27,1
TIJ FRONTERA,2023-03-01,12,0,12,1
TIJ FRONTERA,2023-03-02,27,3,24,0.888888888888889
TIJ FRONTERA,2023-03-03,45,6,39,0.866666666666667
TIJ FRONTERA,2023-03-04,56,7,49,0.875
TIJ FRONTERA,2023-03-05,40,8,32,0.8
TIJ FRONTERA,2023-03-06,33,5,28,0.848484848484849
TIJ FRONTERA,2023-03-08,56,4,52,0.928571428571429
TIJ FRONTERA,2023-03-09,51,2,49,0.96078431372549
TIJ FRONTERA,2023-03-10,41,6,35,0.853658536585366
TIJ FRONTERA,2023-03-11,44,4,40,0.909090909090909
TIJ FRONTERA,2023-03-12,46,7,39,0.847826086956522
TIJ FRONTERA,2023-03-13,30,3,27,0.9
TIJ FRONTERA,2023-03-14,5,0,6,1
TIJ FRONTERA,2023-03-15,23,10,13,0.565217391304348
TIJ FRONTERA,2023-03-16,34,13,21,0.617647058823529
TIJ FRONTERA,2023-03-17,62,36,26,0.419354838709677
TIJ FRONTERA,2023-03-18,50,30,20,0.4
TIJ FRONTERA,2023-03-19,33,24,9,0.272727272727273
TIJ FRONTERA,2023-03-20,18,11,7,0.388888888888889
TIJ FRONTERA,2023-03-21,3,3,0,0
TIJ FRONTERA,2023-03-22,6,6,0,0
TIJ FRONTERA,2023-03-23,6,5,1,0.166666666666667
TIJ FRONTERA,2023-03-24,47,33,14,0.297872340425532
TIJ FRONTERA,2023-03-25,34,23,11,0.323529411764706
TIJ FRONTERA,2023-03-26,49,34,15,0.306122448979592
TIJ FRONTERA,2023-03-27,39,31,8,0.205128205128205
TIJ FRONTERA,2023-03-28,29,25,4,0.137931034482759
TIJ FRONTERA,2023-03-29,21,19,2,0.0952380952380952
TIJ FRONTERA,2023-03-30,54,46,8,0.148148148148148
TIJ FRONTERA,2023-03-31,28,21,7,0.25
TIJ FRONTERA,2023-04-01,42,37,5,0.119047619047619
TIJ FRONTERA,2023-04-02,39,34,5,0.128205128205128
TIJ FRONTERA,2023-04-03,32,26,6,0.1875
TIJ FRONTERA,2023-04-04,42,41,1,0.0238095238095238
TIJ FRONTERA,2023-04-05,38,32,6,0.157894736842105
TIJ FRONTERA,2023-04-06,32,25,7,0.21875
TIJ FRONTERA,2023-04-07,19,18,1,0.0526315789473684
TIJ FRONTERA,2023-04-08,37,33,4,0.108108108108108
TIJ FRONTERA,2023-04-09,33,32,1,0.0303030303030303
TIJ FRONTERA,2023-04-10,28,25,3,0.107142857142857
TIJ FRONTERA,2023-04-11,49,47,2,0.0408163265306122
TIJ FRONTERA,2023-04-12,27,25,2,0.0740740740740741
TIJ FRONTERA,2023-04-13,26,25,1,0.0384615384615385
TIJ FRONTERA,2023-04-14,26,25,1,0.0384615384615385
TIJ FRONTERA,2023-04-15,25,23,2,0.08
TIJ FRONTERA,2023-04-16,38,34,4,0.105263157894737
TIJ FRONTERA,2023-04-17,41,39,2,0.0487804878048781
TIJ FRONTERA,2023-04-18,29,27,2,0.0689655172413793
TIJ FRONTERA,2023-04-19,32,32,0,0
TIJ FRONTERA,2023-04-20,30,29,1,0.0333333333333333
TIJ FRONTERA,2023-04-21,24,23,1,0.0416666666666667
TIJ FRONTERA,2023-04-22,38,38,0,0
TIJ FRONTERA,2023-04-23,24,22,2,0.0833333333333333
TIJ FRONTERA,2023-04-24,37,37,0,0
TIJ FRONTERA,2023-04-25,46,45,1,0.0217391304347826
TIJ FRONTERA,2023-04-26,24,24,0,0
TIJ FRONTERA,2023-04-27,33,31,2,0.0606060606060606
TIJ FRONTERA,2023-04-28,32,30,2,0.0625
TIJ FRONTERA,2023-04-29,47,44,3,0.0638297872340425
TIJ FRONTERA,2023-04-30,26,25,1,0.0384615384615385
TIJ FRONTERA,2023-05-01,19,19,0,0
TIJ FRONTERA,2023-05-02,32,31,1,0.03125
TIJ FRONTERA,2023-05-03,37,34,3,0.0810810810810811
TIJ FRONTERA,2023-05-04,29,28,1,0.0344827586206897
TIJ FRONTERA,2023-05-05,37,36,1,0.027027027027027
TIJ FRONTERA,2023-05-06,50,49,1,0.02
TIJ FRONTERA,2023-05-07,45,42,3,0.0666666666666667
TIJ FRONTERA,2023-05-08,34,31,3,0.0882352941176471
TIJ PLAYAS,2023-01-02,42,37,5,0.119047619047619
TIJ PLAYAS,2023-01-03,38,33,5,0.131578947368421
TIJ PLAYAS,2023-01-04,33,28,5,0.151515151515152
TIJ PLAYAS,2023-01-05,33,23,10,0.303030303030303
TIJ PLAYAS,2023-01-06,46,38,8,0.173913043478261
TIJ PLAYAS,2023-01-07,47,37,10,0.212765957446809
TIJ PLAYAS,2023-01-08,49,43,6,0.122448979591837
TIJ PLAYAS,2023-01-09,35,31,4,0.114285714285714
TIJ PLAYAS,2023-01-10,42,35,7,0.166666666666667
TIJ PLAYAS,2023-01-11,41,35,6,0.146341463414634
TIJ PLAYAS,2023-01-12,49,36,13,0.26530612244898
TIJ PLAYAS,2023-01-13,50,40,10,0.2
TIJ PLAYAS,2023-01-14,28,19,9,0.321428571428571
TIJ PLAYAS,2023-01-15,37,31,6,0.162162162162162
TIJ PLAYAS,2023-01-16,17,15,2,0.117647058823529
TIJ PLAYAS,2023-01-17,29,26,3,0.103448275862069
TIJ PLAYAS,2023-01-18,30,17,13,0.433333333333333
TIJ PLAYAS,2023-01-19,36,18,18,0.5
TIJ PLAYAS,2023-01-20,38,13,25,0.657894736842105
TIJ PLAYAS,2023-01-21,48,22,26,0.541666666666667
TIJ PLAYAS,2023-01-22,35,20,15,0.428571428571429
TIJ PLAYAS,2023-01-23,44,23,21,0.477272727272727
TIJ PLAYAS,2023-01-24,38,14,24,0.631578947368421
TIJ PLAYAS,2023-01-25,36,17,19,0.527777777777778
TIJ PLAYAS,2023-01-26,41,15,26,0.634146341463415
TIJ PLAYAS,2023-01-27,42,16,26,0.619047619047619
TIJ PLAYAS,2023-01-28,39,17,22,0.564102564102564
TIJ PLAYAS,2023-01-29,36,22,14,0.388888888888889
TIJ PLAYAS,2023-01-30,19,9,10,0.526315789473684
TIJ PLAYAS,2023-01-31,39,25,14,0.358974358974359
TIJ PLAYAS,2023-02-01,42,17,25,0.595238095238095
TIJ PLAYAS,2023-02-02,50,18,32,0.64
TIJ PLAYAS,2023-02-03,52,19,33,0.634615384615385
TIJ PLAYAS,2023-02-04,60,23,37,0.616666666666667
TIJ PLAYAS,2023-02-05,47,19,28,0.595744680851064
TIJ PLAYAS,2023-02-06,59,14,45,0.76271186440678
TIJ PLAYAS,2023-02-07,57,20,37,0.649122807017544
TIJ PLAYAS,2023-02-08,50,24,26,0.52
TIJ PLAYAS,2023-02-09,44,21,23,0.522727272727273
TIJ PLAYAS,2023-02-10,72,26,46,0.638888888888889
TIJ PLAYAS,2023-02-11,58,32,26,0.448275862068966
TIJ PLAYAS,2023-02-12,35,17,18,0.514285714285714
TIJ PLAYAS,2023-02-13,44,22,22,0.5
TIJ PLAYAS,2023-02-14,47,23,24,0.51063829787234
TIJ PLAYAS,2023-02-15,53,24,29,0.547169811320755
TIJ PLAYAS,2023-02-16,45,21,24,0.533333333333333
TIJ PLAYAS,2023-02-17,42,16,26,0.619047619047619
TIJ PLAYAS,2023-02-18,64,33,31,0.484375
TIJ PLAYAS,2023-02-19,39,17,22,0.564102564102564
TIJ PLAYAS,2023-02-20,57,19,38,0.666666666666667
TIJ PLAYAS,2023-02-21,48,22,26,0.541666666666667
TIJ PLAYAS,2023-02-22,51,18,33,0.647058823529412
TIJ PLAYAS,2023-02-23,36,21,15,0.416666666666667
TIJ PLAYAS,2023-02-24,45,18,27,0.6
TIJ PLAYAS,2023-02-25,15,3,12,0.8
TIJ PLAYAS,2023-02-26,65,37,28,0.430769230769231
TIJ PLAYAS,2023-02-27,50,23,27,0.54
TIJ PLAYAS,2023-02-28,47,23,24,0.51063829787234
TIJ PLAYAS,2023-03-01,11,4,7,0.636363636363636
TIJ PLAYAS,2023-03-02,36,18,18,0.5
TIJ PLAYAS,2023-03-03,49,27,22,0.448979591836735
TIJ PLAYAS,2023-03-04,69,43,26,0.376811594202899
TIJ PLAYAS,2023-03-05,74,38,36,0.486486486486487
TIJ PLAYAS,2023-03-06,45,21,24,0.533333333333333
TIJ PLAYAS,2023-03-07,47,25,22,0.468085106382979
TIJ PLAYAS,2023-03-08,61,32,29,0.475409836065574
TIJ PLAYAS,2023-03-09,44,29,15,0.340909090909091
TIJ PLAYAS,2023-03-10,30,16,14,0.466666666666667
TIJ PLAYAS,2023-03-11,56,39,17,0.303571428571429
TIJ PLAYAS,2023-03-12,63,37,26,0.412698412698413
TIJ PLAYAS,2023-03-13,43,28,15,0.348837209302326
TIJ PLAYAS,2023-03-14,44,29,15,0.340909090909091
TIJ PLAYAS,2023-03-15,26,24,2,0.0769230769230769
TIJ PLAYAS,2023-03-16,51,40,11,0.215686274509804
TIJ PLAYAS,2023-03-17,56,45,11,0.196428571428571
TIJ PLAYAS,2023-03-18,61,46,15,0.245901639344262
TIJ PLAYAS,2023-03-19,54,45,9,0.166666666666667
TIJ PLAYAS,2023-03-20,43,34,9,0.209302325581395
TIJ PLAYAS,2023-03-21,18,13,5,0.277777777777778
TIJ PLAYAS,2023-03-22,36,27,9,0.25
TIJ PLAYAS,2023-03-23,53,38,15,0.283018867924528
TIJ PLAYAS,2023-03-24,48,42,6,0.125
TIJ PLAYAS,2023-03-25,59,54,5,0.0847457627118644
TIJ PLAYAS,2023-03-26,63,54,9,0.142857142857143
TIJ PLAYAS,2023-03-27,44,40,4,0.0909090909090909
TIJ PLAYAS,2023-03-28,62,54,8,0.129032258064516
TIJ PLAYAS,2023-03-29,37,30,7,0.189189189189189
TIJ PLAYAS,2023-03-30,41,37,4,0.0975609756097561
TIJ PLAYAS,2023-03-31,51,49,2,0.0392156862745098
TIJ PLAYAS,2023-04-01,75,67,8,0.106666666666667
TIJ PLAYAS,2023-04-02,54,50,4,0.0740740740740741
TIJ PLAYAS,2023-04-03,59,58,1,0.0169491525423729
TIJ PLAYAS,2023-04-04,59,59,0,0
TIJ PLAYAS,2023-04-05,63,61,2,0.0317460317460317
TIJ PLAYAS,2023-04-06,39,39,0,0
TIJ PLAYAS,2023-04-07,42,41,1,0.0238095238095238
TIJ PLAYAS,2023-04-08,54,54,0,0
TIJ PLAYAS,2023-04-09,45,45,0,0
TIJ PLAYAS,2023-04-10,51,49,2,0.0392156862745098
TIJ PLAYAS,2023-04-11,63,63,0,0
TIJ PLAYAS,2023-04-12,59,59,0,0
TIJ PLAYAS,2023-04-13,50,50,0,0
TIJ PLAYAS,2023-04-14,44,43,1,0.0227272727272727
TIJ PLAYAS,2023-04-15,53,53,0,0
TIJ PLAYAS,2023-04-16,69,67,2,0.0289855072463768
TIJ PLAYAS,2023-04-17,53,53,0,0
TIJ PLAYAS,2023-04-18,48,48,0,0
TIJ PLAYAS,2023-04-19,53,53,0,0
TIJ PLAYAS,2023-04-20,46,46,0,0
TIJ PLAYAS,2023-04-21,57,57,0,0
TIJ PLAYAS,2023-04-22,64,64,0,0
TIJ PLAYAS,2023-04-23,63,61,2,0.0317460317460317
TIJ PLAYAS,2023-04-24,49,49,0,0
TIJ PLAYAS,2023-04-25,66,66,0,0
TIJ PLAYAS,2023-04-26,37,37,0,0
TIJ PLAYAS,2023-04-27,49,49,0,0
TIJ PLAYAS,2023-04-28,53,53,0,0
TIJ PLAYAS,2023-04-29,49,49,0,0
TIJ PLAYAS,2023-04-30,61,60,1,0.0163934426229508
TIJ PLAYAS,2023-05-01,27,27,0,0
TIJ PLAYAS,2023-05-02,50,50,0,0
TIJ PLAYAS,2023-05-03,49,49,0,0
TIJ PLAYAS,2023-05-04,45,45,0,0
TIJ PLAYAS,2023-05-05,62,62,0,0
TIJ PLAYAS,2023-05-06,67,67,0,0
TIJ PLAYAS,2023-05-07,56,56,0,0
TIJ PLAYAS,2023-05-08,51,51,0,0
TIJ RIO,2023-01-02,28,13,15,0.535714285714286
TIJ RIO,2023-01-03,24,15,9,0.375
TIJ RIO,2023-01-04,21,12,9,0.428571428571429
TIJ RIO,2023-01-05,24,10,14,0.583333333333333
TIJ RIO,2023-01-06,32,16,16,0.5
TIJ RIO,2023-01-07,37,18,19,0.513513513513513
TIJ RIO,2023-01-08,40,17,23,0.575
TIJ RIO,2023-01-09,12,8,4,0.333333333333333
TIJ RIO,2023-01-10,24,10,14,0.583333333333333
TIJ RIO,2023-01-11,26,9,17,0.653846153846154
TIJ RIO,2023-01-12,26,8,18,0.692307692307692
TIJ RIO,2023-01-13,33,21,12,0.363636363636364
TIJ RIO,2023-01-14,23,12,11,0.478260869565217
TIJ RIO,2023-01-15,34,20,14,0.411764705882353
TIJ RIO,2023-01-16,22,13,9,0.409090909090909
TIJ RIO,2023-01-17,26,13,13,0.5
TIJ RIO,2023-01-18,20,3,17,0.85
TIJ RIO,2023-01-19,25,0,26,1
TIJ RIO,2023-01-20,32,0,32,1
TIJ RIO,2023-01-21,33,0,33,1
TIJ RIO,2023-01-22,31,1,30,0.967741935483871
TIJ RIO,2023-01-23,22,0,22,1
TIJ RIO,2023-01-24,36,0,36,1
TIJ RIO,2023-01-25,29,0,29,1
TIJ RIO,2023-01-26,28,0,28,1
TIJ RIO,2023-01-27,31,1,30,0.967741935483871
TIJ RIO,2023-01-28,35,1,34,0.971428571428571
TIJ RIO,2023-01-29,22,0,22,1
TIJ RIO,2023-01-30,22,0,23,1
TIJ RIO,2023-01-31,38,0,38,1
TIJ RIO,2023-02-01,25,0,25,1
TIJ RIO,2023-02-02,20,0,20,1
TIJ RIO,2023-02-03,22,1,21,0.954545454545455
TIJ RIO,2023-02-04,21,0,22,1
TIJ RIO,2023-02-05,20,1,19,0.95
TIJ RIO,2023-02-06,26,0,27,1
TIJ RIO,2023-02-07,25,2,23,0.92
TIJ RIO,2023-02-08,27,0,28,1
TIJ RIO,2023-02-09,24,2,22,0.916666666666667
TIJ RIO,2023-02-10,33,3,30,0.909090909090909
TIJ RIO,2023-02-11,42,1,41,0.976190476190476
TIJ RIO,2023-02-12,23,0,24,1
TIJ RIO,2023-02-13,40,0,41,1
TIJ RIO,2023-02-14,26,0,26,1
TIJ RIO,2023-02-15,34,0,34,1
TIJ RIO,2023-02-16,22,1,21,0.954545454545455
TIJ RIO,2023-02-17,29,0,29,1
TIJ RIO,2023-02-18,33,0,33,1
TIJ RIO,2023-02-19,26,0,27,1
TIJ RIO,2023-02-20,36,0,36,1
TIJ RIO,2023-02-21,21,1,20,0.952380952380952
TIJ RIO,2023-02-22,23,1,22,0.956521739130435
TIJ RIO,2023-02-23,27,0,27,1
TIJ RIO,2023-02-24,22,0,22,1
TIJ RIO,2023-02-25,26,0,26,1
TIJ RIO,2023-02-26,29,0,29,1
TIJ RIO,2023-02-27,35,2,33,0.942857142857143
TIJ RIO,2023-02-28,25,1,24,0.96
TIJ RIO,2023-03-01,26,0,26,1
TIJ RIO,2023-03-02,30,0,30,1
TIJ RIO,2023-03-03,35,0,36,1
TIJ RIO,2023-03-04,26,2,24,0.923076923076923
TIJ RIO,2023-03-05,42,2,40,0.952380952380952
TIJ RIO,2023-03-06,31,2,29,0.935483870967742
TIJ RIO,2023-03-07,25,2,23,0.92
TIJ RIO,2023-03-08,39,2,37,0.948717948717949
TIJ RIO,2023-03-09,32,0,32,1
TIJ RIO,2023-03-10,31,4,27,0.870967741935484
TIJ RIO,2023-03-11,42,4,38,0.904761904761905
TIJ RIO,2023-03-12,31,3,28,0.903225806451613
TIJ RIO,2023-03-13,31,3,28,0.903225806451613
TIJ RIO,2023-03-14,32,8,24,0.75
TIJ RIO,2023-03-15,30,23,7,0.233333333333333
TIJ RIO,2023-03-16,16,14,2,0.125
TIJ RIO,2023-03-17,27,21,6,0.222222222222222
TIJ RIO,2023-03-18,26,25,1,0.0384615384615385
TIJ RIO,2023-03-19,19,14,5,0.263157894736842
TIJ RIO,2023-03-20,37,32,5,0.135135135135135
TIJ RIO,2023-03-21,18,14,4,0.222222222222222
TIJ RIO,2023-03-22,18,14,4,0.222222222222222
TIJ RIO,2023-03-23,29,26,3,0.103448275862069
TIJ RIO,2023-03-24,34,29,5,0.147058823529412
TIJ RIO,2023-03-25,36,31,5,0.138888888888889
TIJ RIO,2023-03-26,26,20,6,0.230769230769231
TIJ RIO,2023-03-27,19,17,2,0.105263157894737
TIJ RIO,2023-03-28,22,19,3,0.136363636363636
TIJ RIO,2023-03-29,24,23,1,0.0416666666666667
TIJ RIO,2023-03-30,24,19,5,0.208333333333333
TIJ RIO,2023-03-31,22,17,5,0.227272727272727
TIJ RIO,2023-04-01,26,22,4,0.153846153846154
TIJ RIO,2023-04-02,31,25,6,0.193548387096774
TIJ RIO,2023-04-03,21,19,2,0.0952380952380952
TIJ RIO,2023-04-04,29,25,4,0.137931034482759
TIJ RIO,2023-04-05,26,24,2,0.0769230769230769
TIJ RIO,2023-04-06,21,19,2,0.0952380952380952
TIJ RIO,2023-04-07,32,32,0,0
TIJ RIO,2023-04-08,37,37,0,0
TIJ RIO,2023-04-09,22,19,3,0.136363636363636
TIJ RIO,2023-04-10,27,27,0,0
TIJ RIO,2023-04-11,24,20,4,0.166666666666667
TIJ RIO,2023-04-12,30,29,1,0.0333333333333333
TIJ RIO,2023-04-13,34,34,0,0
TIJ RIO,2023-04-14,22,19,3,0.136363636363636
TIJ RIO,2023-04-15,38,36,2,0.0526315789473684
TIJ RIO,2023-04-16,39,36,3,0.0769230769230769
TIJ RIO,2023-04-17,26,26,0,0
TIJ RIO,2023-04-18,33,31,2,0.0606060606060606
TIJ RIO,2023-04-19,25,25,0,0
TIJ RIO,2023-04-20,21,18,3,0.142857142857143
TIJ RIO,2023-04-21,19,17,2,0.105263157894737
TIJ RIO,2023-04-22,34,34,0,0
TIJ RIO,2023-04-23,29,26,3,0.103448275862069
TIJ RIO,2023-04-24,25,23,2,0.08
TIJ RIO,2023-04-25,28,28,0,0
TIJ RIO,2023-04-26,38,37,1,0.0263157894736842
TIJ RIO,2023-04-27,24,22,2,0.0833333333333333
TIJ RIO,2023-04-28,26,22,4,0.153846153846154
TIJ RIO,2023-04-29,27,24,3,0.111111111111111
TIJ RIO,2023-04-30,19,16,3,0.157894736842105
TIJ RIO,2023-05-01,26,20,6,0.230769230769231
TIJ RIO,2023-05-02,29,27,2,0.0689655172413793
TIJ RIO,2023-05-03,20,17,3,0.15
TIJ RIO,2023-05-04,43,41,2,0.0465116279069767
TIJ RIO,2023-05-05,30,27,3,0.1
TIJ RIO,2023-05-06,32,29,3,0.09375
TIJ RIO,2023-05-07,22,21,1,0.0454545454545455
TIJ RIO,2023-05-08,30,24,6,0.2
TIJ TECATE,2023-01-02,32,19,13,0.40625
TIJ TECATE,2023-01-03,38,18,20,0.526315789473684
TIJ TECATE,2023-01-04,44,28,16,0.363636363636364
TIJ TECATE,2023-01-05,35,14,21,0.6
TIJ TECATE,2023-01-06,46,29,17,0.369565217391304
TIJ TECATE,2023-01-07,42,27,15,0.357142857142857
TIJ TECATE,2023-01-08,58,37,21,0.362068965517241
TIJ TECATE,2023-01-09,59,42,17,0.288135593220339
TIJ TECATE,2023-01-10,34,15,19,0.558823529411765
TIJ TECATE,2023-01-11,47,23,24,0.51063829787234
TIJ TECATE,2023-01-12,40,24,16,0.4
TIJ TECATE,2023-01-13,49,28,21,0.428571428571429
TIJ TECATE,2023-01-14,27,18,9,0.333333333333333
TIJ TECATE,2023-01-15,15,7,8,0.533333333333333
TIJ TECATE,2023-01-16,33,17,16,0.484848484848485
TIJ TECATE,2023-01-17,37,24,13,0.351351351351351
TIJ TECATE,2023-01-18,21,3,18,0.857142857142857
TIJ TECATE,2023-01-19,18,0,18,1
TIJ TECATE,2023-01-20,31,3,28,0.903225806451613
TIJ TECATE,2023-01-21,28,3,25,0.892857142857143
TIJ TECATE,2023-01-22,34,2,32,0.941176470588235
TIJ TECATE,2023-01-23,38,0,38,1
TIJ TECATE,2023-01-24,28,3,25,0.892857142857143
TIJ TECATE,2023-01-25,41,3,38,0.926829268292683
TIJ TECATE,2023-01-26,46,0,47,1
TIJ TECATE,2023-01-27,46,1,45,0.978260869565217
TIJ TECATE,2023-01-28,53,0,53,1
TIJ TECATE,2023-01-29,49,2,47,0.959183673469388
TIJ TECATE,2023-01-30,49,0,49,1
TIJ TECATE,2023-01-31,34,1,33,0.970588235294118
TIJ TECATE,2023-02-01,35,2,33,0.942857142857143
TIJ TECATE,2023-02-02,29,0,30,1
TIJ TECATE,2023-02-03,24,0,24,1
TIJ TECATE,2023-02-04,24,1,23,0.958333333333333
TIJ TECATE,2023-02-05,37,0,38,1
TIJ TECATE,2023-02-06,30,0,30,1
TIJ TECATE,2023-02-07,22,1,21,0.954545454545455
TIJ TECATE,2023-02-08,29,2,27,0.931034482758621
TIJ TECATE,2023-02-09,38,6,32,0.842105263157895
TIJ TECATE,2023-02-10,64,0,64,1
TIJ TECATE,2023-02-11,56,4,52,0.928571428571429
TIJ TECATE,2023-02-12,27,0,27,1
TIJ TECATE,2023-02-13,38,2,36,0.947368421052632
TIJ TECATE,2023-02-14,35,1,34,0.971428571428571
TIJ TECATE,2023-02-15,65,0,65,1
TIJ TECATE,2023-02-16,29,0,29,1
TIJ TECATE,2023-02-17,52,1,51,0.980769230769231
TIJ TECATE,2023-02-18,59,2,57,0.966101694915254
TIJ TECATE,2023-02-19,44,0,45,1
TIJ TECATE,2023-02-20,53,0,54,1
TIJ TECATE,2023-02-21,49,0,49,1
TIJ TECATE,2023-02-22,39,0,39,1
TIJ TECATE,2023-02-23,28,4,24,0.857142857142857
TIJ TECATE,2023-02-24,49,0,49,1
TIJ TECATE,2023-02-25,29,2,27,0.931034482758621
TIJ TECATE,2023-02-26,39,0,40,1
TIJ TECATE,2023-02-27,45,4,41,0.911111111111111
TIJ TECATE,2023-02-28,31,0,31,1
TIJ TECATE,2023-03-01,24,0,24,1
TIJ TECATE,2023-03-02,43,3,40,0.930232558139535
TIJ TECATE,2023-03-03,49,3,46,0.938775510204082
TIJ TECATE,2023-03-04,84,3,81,0.964285714285714
TIJ TECATE,2023-03-05,58,0,59,1
TIJ TECATE,2023-03-06,15,0,16,1
TIJ TECATE,2023-03-07,23,0,23,1
TIJ TECATE,2023-03-08,47,2,45,0.957446808510638
TIJ TECATE,2023-03-09,48,5,43,0.895833333333333
TIJ TECATE,2023-03-10,6,0,6,1
TIJ TECATE,2023-03-11,68,9,59,0.867647058823529
TIJ TECATE,2023-03-12,42,10,32,0.761904761904762
TIJ TECATE,2023-03-13,24,7,17,0.708333333333333
TIJ TECATE,2023-03-14,26,7,19,0.730769230769231
TIJ TECATE,2023-03-15,17,10,7,0.411764705882353
TIJ TECATE,2023-03-16,6,5,1,0.166666666666667
TIJ TECATE,2023-03-17,11,7,4,0.363636363636364
TIJ TECATE,2023-03-18,11,7,4,0.363636363636364
TIJ TECATE,2023-03-19,15,10,5,0.333333333333333
TIJ TECATE,2023-03-20,20,10,10,0.5
TIJ TECATE,2023-03-21,18,13,5,0.277777777777778
TIJ TECATE,2023-03-22,35,23,12,0.342857142857143
TIJ TECATE,2023-03-23,27,12,15,0.555555555555556
TIJ TECATE,2023-03-24,25,18,7,0.28
TIJ TECATE,2023-03-25,14,11,3,0.214285714285714
TIJ TECATE,2023-03-26,18,13,5,0.277777777777778
TIJ TECATE,2023-03-27,27,22,5,0.185185185185185
TIJ TECATE,2023-03-28,26,20,6,0.230769230769231
TIJ TECATE,2023-03-29,35,29,6,0.171428571428571
TIJ TECATE,2023-03-30,33,28,5,0.151515151515152
TIJ TECATE,2023-03-31,55,36,19,0.345454545454545
TIJ TECATE,2023-04-01,54,41,13,0.240740740740741
TIJ TECATE,2023-04-02,14,12,2,0.142857142857143
TIJ TECATE,2023-04-03,35,27,8,0.228571428571429
TIJ TECATE,2023-04-04,39,31,8,0.205128205128205
TIJ TECATE,2023-04-05,53,47,6,0.113207547169811
TIJ TECATE,2023-04-06,49,38,11,0.224489795918367
TIJ TECATE,2023-04-07,40,29,11,0.275
TIJ TECATE,2023-04-08,34,26,8,0.235294117647059
TIJ TECATE,2023-04-09,38,31,7,0.184210526315789
TIJ TECATE,2023-04-10,47,45,2,0.0425531914893617
TIJ TECATE,2023-04-11,37,35,2,0.0540540540540541
TIJ TECATE,2023-04-12,50,45,5,0.1
TIJ TECATE,2023-04-13,40,38,2,0.05
TIJ TECATE,2023-04-14,72,67,5,0.0694444444444444
TIJ TECATE,2023-04-15,63,60,3,0.0476190476190476
TIJ TECATE,2023-04-16,60,56,4,0.0666666666666667
TIJ TECATE,2023-04-17,49,48,1,0.0204081632653061
TIJ TECATE,2023-04-18,48,46,2,0.0416666666666667
TIJ TECATE,2023-04-19,36,36,0,0
TIJ TECATE,2023-04-20,44,43,1,0.0227272727272727
TIJ TECATE,2023-04-21,55,52,3,0.0545454545454545
TIJ TECATE,2023-04-22,45,44,1,0.0222222222222222
TIJ TECATE,2023-04-23,36,35,1,0.0277777777777778
TIJ TECATE,2023-04-24,34,34,0,0
TIJ TECATE,2023-04-25,48,47,1,0.0208333333333333
TIJ TECATE,2023-04-26,39,35,4,0.102564102564103
TIJ TECATE,2023-04-27,44,42,2,0.0454545454545455
TIJ TECATE,2023-04-28,68,66,2,0.0294117647058824
TIJ TECATE,2023-04-29,65,64,1,0.0153846153846154
TIJ TECATE,2023-04-30,43,37,6,0.13953488372093
TIJ TECATE,2023-05-01,42,39,3,0.0714285714285714
TIJ TECATE,2023-05-02,40,38,2,0.05
TIJ TECATE,2023-05-03,37,35,2,0.0540540540540541
TIJ TECATE,2023-05-04,42,40,2,0.0476190476190476
TIJ TECATE,2023-05-05,49,46,3,0.0612244897959184
TIJ TECATE,2023-05-06,67,65,2,0.0298507462686567
TIJ TECATE,2023-05-07,54,52,2,0.037037037037037
TIJ TECATE,2023-05-08,57,57,0,0
TLALNEPANTLA,2023-01-02,23,19,4,0.173913043478261
TLALNEPANTLA,2023-01-03,25,22,3,0.12
TLALNEPANTLA,2023-01-04,37,32,5,0.135135135135135
TLALNEPANTLA,2023-01-05,28,23,5,0.178571428571429
TLALNEPANTLA,2023-01-06,29,24,5,0.172413793103448
TLALNEPANTLA,2023-01-07,31,24,7,0.225806451612903
TLALNEPANTLA,2023-01-08,25,20,5,0.2
TLALNEPANTLA,2023-01-09,29,12,17,0.586206896551724
TLALNEPANTLA,2023-01-10,30,20,10,0.333333333333333
TLALNEPANTLA,2023-01-11,32,20,12,0.375
TLALNEPANTLA,2023-01-12,31,18,13,0.419354838709677
TLALNEPANTLA,2023-01-13,37,21,16,0.432432432432432
TLALNEPANTLA,2023-01-14,33,23,10,0.303030303030303
TLALNEPANTLA,2023-01-15,37,25,12,0.324324324324324
TLALNEPANTLA,2023-01-16,31,11,20,0.645161290322581
TLALNEPANTLA,2023-01-17,33,13,20,0.606060606060606
TLALNEPANTLA,2023-01-18,26,17,9,0.346153846153846
TLALNEPANTLA,2023-01-19,25,16,9,0.36
TLALNEPANTLA,2023-01-20,28,15,13,0.464285714285714
TLALNEPANTLA,2023-01-21,26,9,17,0.653846153846154
TLALNEPANTLA,2023-01-22,41,26,15,0.365853658536585
TLALNEPANTLA,2023-01-23,21,13,8,0.380952380952381
TLALNEPANTLA,2023-01-24,19,7,12,0.631578947368421
TLALNEPANTLA,2023-01-25,22,12,10,0.454545454545455
TLALNEPANTLA,2023-01-26,26,15,11,0.423076923076923
TLALNEPANTLA,2023-01-27,35,19,16,0.457142857142857
TLALNEPANTLA,2023-01-28,39,19,20,0.512820512820513
TLALNEPANTLA,2023-01-29,36,20,16,0.444444444444444
TLALNEPANTLA,2023-01-30,37,19,18,0.486486486486487
TLALNEPANTLA,2023-01-31,37,20,17,0.459459459459459
TLALNEPANTLA,2023-02-01,37,24,13,0.351351351351351
TLALNEPANTLA,2023-02-02,31,23,8,0.258064516129032
TLALNEPANTLA,2023-02-03,28,18,10,0.357142857142857
TLALNEPANTLA,2023-02-04,43,26,17,0.395348837209302
TLALNEPANTLA,2023-02-05,33,22,11,0.333333333333333
TLALNEPANTLA,2023-02-06,36,26,10,0.277777777777778
TLALNEPANTLA,2023-02-07,38,24,14,0.368421052631579
TLALNEPANTLA,2023-02-08,27,20,7,0.259259259259259
TLALNEPANTLA,2023-02-09,37,20,17,0.459459459459459
TLALNEPANTLA,2023-02-10,29,18,11,0.379310344827586
TLALNEPANTLA,2023-02-11,36,26,10,0.277777777777778
TLALNEPANTLA,2023-02-12,42,30,12,0.285714285714286
TLALNEPANTLA,2023-02-13,35,19,16,0.457142857142857
TLALNEPANTLA,2023-02-14,19,14,5,0.263157894736842
TLALNEPANTLA,2023-02-15,41,26,15,0.365853658536585
TLALNEPANTLA,2023-02-16,34,22,12,0.352941176470588
TLALNEPANTLA,2023-02-17,42,28,14,0.333333333333333
TLALNEPANTLA,2023-02-18,38,26,12,0.315789473684211
TLALNEPANTLA,2023-02-19,36,25,11,0.305555555555556
TLALNEPANTLA,2023-02-20,26,16,10,0.384615384615385
TLALNEPANTLA,2023-02-21,34,27,7,0.205882352941176
TLALNEPANTLA,2023-02-22,37,31,6,0.162162162162162
TLALNEPANTLA,2023-02-23,26,22,4,0.153846153846154
TLALNEPANTLA,2023-02-24,21,15,6,0.285714285714286
TLALNEPANTLA,2023-02-25,37,24,13,0.351351351351351
TLALNEPANTLA,2023-02-26,38,28,10,0.263157894736842
TLALNEPANTLA,2023-02-27,30,22,8,0.266666666666667
TLALNEPANTLA,2023-02-28,40,34,6,0.15
TLALNEPANTLA,2023-03-01,28,21,7,0.25
TLALNEPANTLA,2023-03-02,28,22,6,0.214285714285714
TLALNEPANTLA,2023-03-03,44,36,8,0.181818181818182
TLALNEPANTLA,2023-03-04,33,29,4,0.121212121212121
TLALNEPANTLA,2023-03-05,38,29,9,0.236842105263158
TLALNEPANTLA,2023-03-06,24,17,7,0.291666666666667
TLALNEPANTLA,2023-03-07,31,21,10,0.32258064516129
TLALNEPANTLA,2023-03-08,28,21,7,0.25
TLALNEPANTLA,2023-03-09,22,17,5,0.227272727272727
TLALNEPANTLA,2023-03-10,35,31,4,0.114285714285714
TLALNEPANTLA,2023-03-11,30,23,7,0.233333333333333
TLALNEPANTLA,2023-03-12,34,26,8,0.235294117647059
TLALNEPANTLA,2023-03-13,25,21,4,0.16
TLALNEPANTLA,2023-03-14,46,42,4,0.0869565217391304
TLALNEPANTLA,2023-03-15,37,33,4,0.108108108108108
TLALNEPANTLA,2023-03-16,43,39,4,0.0930232558139535
TLALNEPANTLA,2023-03-17,48,43,5,0.104166666666667
TLALNEPANTLA,2023-03-18,50,49,1,0.02
TLALNEPANTLA,2023-03-19,59,52,7,0.11864406779661
TLALNEPANTLA,2023-03-20,70,63,7,0.1
TLALNEPANTLA,2023-03-21,40,40,0,0
TLALNEPANTLA,2023-03-22,32,32,0,0
TLALNEPANTLA,2023-03-23,36,35,1,0.0277777777777778
TLALNEPANTLA,2023-03-24,46,43,3,0.0652173913043478
TLALNEPANTLA,2023-03-25,47,47,0,0
TLALNEPANTLA,2023-03-26,45,45,0,0
TLALNEPANTLA,2023-03-27,23,23,0,0
TLALNEPANTLA,2023-03-28,32,32,0,0
TLALNEPANTLA,2023-03-29,38,38,0,0
TLALNEPANTLA,2023-03-30,29,29,0,0
TLALNEPANTLA,2023-03-31,54,54,0,0
TLALNEPANTLA,2023-04-01,48,47,1,0.0208333333333333
TLALNEPANTLA,2023-04-02,39,38,1,0.0256410256410256
TLALNEPANTLA,2023-04-03,53,53,0,0
TLALNEPANTLA,2023-04-04,36,34,2,0.0555555555555556
TLALNEPANTLA,2023-04-05,45,42,3,0.0666666666666667
TLALNEPANTLA,2023-04-06,40,40,0,0
TLALNEPANTLA,2023-04-07,28,28,0,0
TLALNEPANTLA,2023-04-08,18,18,0,0
TLALNEPANTLA,2023-04-09,18,17,1,0.0555555555555556
TLALNEPANTLA,2023-04-10,30,30,0,0
TLALNEPANTLA,2023-04-11,24,23,1,0.0416666666666667
TLALNEPANTLA,2023-04-12,26,25,1,0.0384615384615385
TLALNEPANTLA,2023-04-13,33,33,0,0
TLALNEPANTLA,2023-04-14,43,38,5,0.116279069767442
TLALNEPANTLA,2023-04-15,62,59,3,0.0483870967741935
TLALNEPANTLA,2023-04-16,52,50,2,0.0384615384615385
TLALNEPANTLA,2023-04-17,47,46,1,0.0212765957446809
TLALNEPANTLA,2023-04-18,40,38,2,0.05
TLALNEPANTLA,2023-04-19,32,28,4,0.125
TLALNEPANTLA,2023-04-20,35,33,2,0.0571428571428571
TLALNEPANTLA,2023-04-21,33,31,2,0.0606060606060606
TLALNEPANTLA,2023-04-22,40,37,3,0.075
TLALNEPANTLA,2023-04-23,51,50,1,0.0196078431372549
TLALNEPANTLA,2023-04-24,37,37,0,0
TLALNEPANTLA,2023-04-25,42,40,2,0.0476190476190476
TLALNEPANTLA,2023-04-26,24,24,0,0
TLALNEPANTLA,2023-04-27,25,25,0,0
TLALNEPANTLA,2023-04-28,29,28,1,0.0344827586206897
TLALNEPANTLA,2023-04-29,48,45,3,0.0625
TLALNEPANTLA,2023-04-30,46,45,1,0.0217391304347826
TLALNEPANTLA,2023-05-01,34,34,0,0
TLALNEPANTLA,2023-05-02,41,39,2,0.0487804878048781
TLALNEPANTLA,2023-05-03,43,43,0,0
TLALNEPANTLA,2023-05-04,25,24,1,0.04
TLALNEPANTLA,2023-05-05,36,35,1,0.0277777777777778
TLALNEPANTLA,2023-05-06,40,36,4,0.1
TLALNEPANTLA,2023-05-07,32,31,1,0.03125
TLALNEPANTLA,2023-05-08,31,28,3,0.0967741935483871
TLALPAN,2023-01-02,24,16,8,0.333333333333333
TLALPAN,2023-01-03,31,15,16,0.516129032258065
TLALPAN,2023-01-04,33,18,15,0.454545454545455
TLALPAN,2023-01-05,35,18,17,0.485714285714286
TLALPAN,2023-01-06,35,18,17,0.485714285714286
TLALPAN,2023-01-07,46,26,20,0.434782608695652
TLALPAN,2023-01-08,44,31,13,0.295454545454545
TLALPAN,2023-01-09,33,22,11,0.333333333333333
TLALPAN,2023-01-10,33,15,18,0.545454545454545
TLALPAN,2023-01-11,27,13,14,0.518518518518518
TLALPAN,2023-01-12,34,16,18,0.529411764705882
TLALPAN,2023-01-13,29,15,14,0.482758620689655
TLALPAN,2023-01-14,37,9,28,0.756756756756757
TLALPAN,2023-01-15,37,12,25,0.675675675675676
TLALPAN,2023-01-16,35,9,26,0.742857142857143
TLALPAN,2023-01-17,29,6,23,0.793103448275862
TLALPAN,2023-01-18,23,11,12,0.521739130434783
TLALPAN,2023-01-19,32,12,20,0.625
TLALPAN,2023-01-20,25,10,15,0.6
TLALPAN,2023-01-21,34,16,18,0.529411764705882
TLALPAN,2023-01-22,30,14,16,0.533333333333333
TLALPAN,2023-01-23,26,10,16,0.615384615384615
TLALPAN,2023-01-24,27,11,16,0.592592592592593
TLALPAN,2023-01-25,24,10,14,0.583333333333333
TLALPAN,2023-01-26,28,13,15,0.535714285714286
TLALPAN,2023-01-27,28,10,18,0.642857142857143
TLALPAN,2023-01-28,38,17,21,0.552631578947368
TLALPAN,2023-01-29,28,16,12,0.428571428571429
TLALPAN,2023-01-30,24,12,12,0.5
TLALPAN,2023-01-31,37,15,22,0.594594594594595
TLALPAN,2023-02-01,31,11,20,0.645161290322581
TLALPAN,2023-02-02,34,19,15,0.441176470588235
TLALPAN,2023-02-03,25,15,10,0.4
TLALPAN,2023-02-04,41,23,18,0.439024390243902
TLALPAN,2023-02-05,36,18,18,0.5
TLALPAN,2023-02-06,38,19,19,0.5
TLALPAN,2023-02-07,26,11,15,0.576923076923077
TLALPAN,2023-02-08,34,16,18,0.529411764705882
TLALPAN,2023-02-09,30,16,14,0.466666666666667
TLALPAN,2023-02-10,34,19,15,0.441176470588235
TLALPAN,2023-02-11,32,12,20,0.625
TLALPAN,2023-02-12,21,11,10,0.476190476190476
TLALPAN,2023-02-13,26,16,10,0.384615384615385
TLALPAN,2023-02-14,25,15,10,0.4
TLALPAN,2023-02-15,29,23,6,0.206896551724138
TLALPAN,2023-02-16,22,16,6,0.272727272727273
TLALPAN,2023-02-17,18,11,7,0.388888888888889
TLALPAN,2023-02-18,41,27,14,0.341463414634146
TLALPAN,2023-02-19,28,12,16,0.571428571428571
TLALPAN,2023-02-20,23,14,9,0.391304347826087
TLALPAN,2023-02-21,17,12,5,0.294117647058824
TLALPAN,2023-02-22,35,23,12,0.342857142857143
TLALPAN,2023-02-23,19,7,12,0.631578947368421
TLALPAN,2023-02-24,26,13,13,0.5
TLALPAN,2023-02-25,38,20,18,0.473684210526316
TLALPAN,2023-02-26,27,20,7,0.259259259259259
TLALPAN,2023-02-27,26,15,11,0.423076923076923
TLALPAN,2023-02-28,32,22,10,0.3125
TLALPAN,2023-03-01,37,18,19,0.513513513513513
TLALPAN,2023-03-02,22,15,7,0.318181818181818
TLALPAN,2023-03-03,23,11,12,0.521739130434783
TLALPAN,2023-03-04,52,30,22,0.423076923076923
TLALPAN,2023-03-05,38,19,19,0.5
TLALPAN,2023-03-06,22,8,14,0.636363636363636
TLALPAN,2023-03-07,31,15,16,0.516129032258065
TLALPAN,2023-03-08,23,16,7,0.304347826086957
TLALPAN,2023-03-09,21,13,8,0.380952380952381
TLALPAN,2023-03-10,31,24,7,0.225806451612903
TLALPAN,2023-03-11,33,23,10,0.303030303030303
TLALPAN,2023-03-12,32,25,7,0.21875
TLALPAN,2023-03-13,27,22,5,0.185185185185185
TLALPAN,2023-03-14,23,19,4,0.173913043478261
TLALPAN,2023-03-15,18,18,0,0
TLALPAN,2023-03-16,31,29,2,0.0645161290322581
TLALPAN,2023-03-17,34,33,1,0.0294117647058824
TLALPAN,2023-03-18,58,55,3,0.0517241379310345
TLALPAN,2023-03-19,38,37,1,0.0263157894736842
TLALPAN,2023-03-20,37,32,5,0.135135135135135
TLALPAN,2023-03-21,47,44,3,0.0638297872340425
TLALPAN,2023-03-22,31,31,0,0
TLALPAN,2023-03-23,27,27,0,0
TLALPAN,2023-03-24,23,21,2,0.0869565217391304
TLALPAN,2023-03-25,28,26,2,0.0714285714285714
TLALPAN,2023-03-26,44,41,3,0.0681818181818182
TLALPAN,2023-03-27,31,29,2,0.0645161290322581
TLALPAN,2023-03-28,29,27,2,0.0689655172413793
TLALPAN,2023-03-29,22,20,2,0.0909090909090909
TLALPAN,2023-03-30,39,37,2,0.0512820512820513
TLALPAN,2023-03-31,34,32,2,0.0588235294117647
TLALPAN,2023-04-01,38,37,1,0.0263157894736842
TLALPAN,2023-04-02,25,22,3,0.12
TLALPAN,2023-04-03,30,29,1,0.0333333333333333
TLALPAN,2023-04-04,30,30,0,0
TLALPAN,2023-04-05,36,29,7,0.194444444444444
TLALPAN,2023-04-06,39,36,3,0.0769230769230769
TLALPAN,2023-04-07,24,23,1,0.0416666666666667
TLALPAN,2023-04-08,15,12,3,0.2
TLALPAN,2023-04-09,22,20,2,0.0909090909090909
TLALPAN,2023-04-10,19,18,1,0.0526315789473684
TLALPAN,2023-04-11,26,20,6,0.230769230769231
TLALPAN,2023-04-12,33,31,2,0.0606060606060606
TLALPAN,2023-04-13,20,19,1,0.05
TLALPAN,2023-04-14,29,25,4,0.137931034482759
TLALPAN,2023-04-15,40,34,6,0.15
TLALPAN,2023-04-16,52,50,2,0.0384615384615385
TLALPAN,2023-04-17,33,30,3,0.0909090909090909
TLALPAN,2023-04-18,30,22,8,0.266666666666667
TLALPAN,2023-04-19,24,23,1,0.0416666666666667
TLALPAN,2023-04-20,23,20,3,0.130434782608696
TLALPAN,2023-04-21,23,22,1,0.0434782608695652
TLALPAN,2023-04-22,28,28,0,0
TLALPAN,2023-04-23,29,26,3,0.103448275862069
TLALPAN,2023-04-24,37,32,5,0.135135135135135
TLALPAN,2023-04-25,37,34,3,0.0810810810810811
TLALPAN,2023-04-26,41,38,3,0.0731707317073171
TLALPAN,2023-04-27,20,18,2,0.1
TLALPAN,2023-04-28,41,35,6,0.146341463414634
TLALPAN,2023-04-29,45,42,3,0.0666666666666667
TLALPAN,2023-04-30,31,26,5,0.161290322580645
TLALPAN,2023-05-01,27,23,4,0.148148148148148
TLALPAN,2023-05-02,35,33,2,0.0571428571428571
TLALPAN,2023-05-03,13,12,1,0.0769230769230769
TLALPAN,2023-05-04,27,24,3,0.111111111111111
TLALPAN,2023-05-05,28,26,2,0.0714285714285714
TLALPAN,2023-05-06,25,23,2,0.08
TLALPAN,2023-05-07,25,23,2,0.08
TLALPAN,2023-05-08,24,23,1,0.0416666666666667
TOL LERMA SAN MATEO,2023-01-02,21,12,9,0.428571428571429
TOL LERMA SAN MATEO,2023-01-03,35,26,9,0.257142857142857
TOL LERMA SAN MATEO,2023-01-04,44,26,18,0.409090909090909
TOL LERMA SAN MATEO,2023-01-05,36,24,12,0.333333333333333
TOL LERMA SAN MATEO,2023-01-06,37,23,14,0.378378378378378
TOL LERMA SAN MATEO,2023-01-07,41,18,23,0.560975609756098
TOL LERMA SAN MATEO,2023-01-08,25,18,7,0.28
TOL LERMA SAN MATEO,2023-01-09,37,22,15,0.405405405405405
TOL LERMA SAN MATEO,2023-01-10,39,19,20,0.512820512820513
TOL LERMA SAN MATEO,2023-01-11,37,22,15,0.405405405405405
TOL LERMA SAN MATEO,2023-01-12,45,26,19,0.422222222222222
TOL LERMA SAN MATEO,2023-01-13,36,20,16,0.444444444444444
TOL LERMA SAN MATEO,2023-01-14,57,31,26,0.456140350877193
TOL LERMA SAN MATEO,2023-01-15,47,28,19,0.404255319148936
TOL LERMA SAN MATEO,2023-01-16,38,17,21,0.552631578947368
TOL LERMA SAN MATEO,2023-01-17,27,15,12,0.444444444444444
TOL LERMA SAN MATEO,2023-01-18,39,13,26,0.666666666666667
TOL LERMA SAN MATEO,2023-01-19,49,20,29,0.591836734693878
TOL LERMA SAN MATEO,2023-01-20,49,21,28,0.571428571428571
TOL LERMA SAN MATEO,2023-01-21,45,23,22,0.488888888888889
TOL LERMA SAN MATEO,2023-01-22,28,17,11,0.392857142857143
TOL LERMA SAN MATEO,2023-01-23,30,14,16,0.533333333333333
TOL LERMA SAN MATEO,2023-01-24,34,14,20,0.588235294117647
TOL LERMA SAN MATEO,2023-01-25,39,12,27,0.692307692307692
TOL LERMA SAN MATEO,2023-01-26,37,8,29,0.783783783783784
TOL LERMA SAN MATEO,2023-01-27,35,9,26,0.742857142857143
TOL LERMA SAN MATEO,2023-01-28,55,19,36,0.654545454545455
TOL LERMA SAN MATEO,2023-01-29,37,13,24,0.648648648648649
TOL LERMA SAN MATEO,2023-01-30,47,14,33,0.702127659574468
TOL LERMA SAN MATEO,2023-01-31,46,15,31,0.673913043478261
TOL LERMA SAN MATEO,2023-02-01,51,16,35,0.686274509803922
TOL LERMA SAN MATEO,2023-02-02,37,16,21,0.567567567567568
TOL LERMA SAN MATEO,2023-02-03,40,21,19,0.475
TOL LERMA SAN MATEO,2023-02-04,50,22,28,0.56
TOL LERMA SAN MATEO,2023-02-05,40,14,26,0.65
TOL LERMA SAN MATEO,2023-02-06,56,24,32,0.571428571428571
TOL LERMA SAN MATEO,2023-02-07,40,19,21,0.525
TOL LERMA SAN MATEO,2023-02-08,50,22,28,0.56
TOL LERMA SAN MATEO,2023-02-09,41,14,27,0.658536585365854
TOL LERMA SAN MATEO,2023-02-10,35,17,18,0.514285714285714
TOL LERMA SAN MATEO,2023-02-11,44,21,23,0.522727272727273
TOL LERMA SAN MATEO,2023-02-12,37,11,26,0.702702702702703
TOL LERMA SAN MATEO,2023-02-13,36,21,15,0.416666666666667
TOL LERMA SAN MATEO,2023-02-14,32,17,15,0.46875
TOL LERMA SAN MATEO,2023-02-15,38,24,14,0.368421052631579
TOL LERMA SAN MATEO,2023-02-16,38,19,19,0.5
TOL LERMA SAN MATEO,2023-02-17,28,16,12,0.428571428571429
TOL LERMA SAN MATEO,2023-02-18,43,18,25,0.581395348837209
TOL LERMA SAN MATEO,2023-02-19,56,21,35,0.625
TOL LERMA SAN MATEO,2023-02-20,38,17,21,0.552631578947368
TOL LERMA SAN MATEO,2023-02-21,43,27,16,0.372093023255814
TOL LERMA SAN MATEO,2023-02-22,34,19,15,0.441176470588235
TOL LERMA SAN MATEO,2023-02-23,33,25,8,0.242424242424242
TOL LERMA SAN MATEO,2023-02-24,41,24,17,0.414634146341463
TOL LERMA SAN MATEO,2023-02-25,40,20,20,0.5
TOL LERMA SAN MATEO,2023-02-26,43,18,25,0.581395348837209
TOL LERMA SAN MATEO,2023-02-27,34,23,11,0.323529411764706
TOL LERMA SAN MATEO,2023-02-28,40,24,16,0.4
TOL LERMA SAN MATEO,2023-03-01,41,20,21,0.51219512195122
TOL LERMA SAN MATEO,2023-03-02,52,26,26,0.5
TOL LERMA SAN MATEO,2023-03-03,39,21,18,0.461538461538462
TOL LERMA SAN MATEO,2023-03-04,49,20,29,0.591836734693878
TOL LERMA SAN MATEO,2023-03-05,49,19,30,0.612244897959184
TOL LERMA SAN MATEO,2023-03-06,25,11,14,0.56
TOL LERMA SAN MATEO,2023-03-07,62,25,37,0.596774193548387
TOL LERMA SAN MATEO,2023-03-08,45,23,22,0.488888888888889
TOL LERMA SAN MATEO,2023-03-09,56,34,22,0.392857142857143
TOL LERMA SAN MATEO,2023-03-10,34,23,11,0.323529411764706
TOL LERMA SAN MATEO,2023-03-11,47,32,15,0.319148936170213
TOL LERMA SAN MATEO,2023-03-12,32,19,13,0.40625
TOL LERMA SAN MATEO,2023-03-13,41,27,14,0.341463414634146
TOL LERMA SAN MATEO,2023-03-14,34,28,6,0.176470588235294
TOL LERMA SAN MATEO,2023-03-15,35,33,2,0.0571428571428571
TOL LERMA SAN MATEO,2023-03-16,44,42,2,0.0454545454545455
TOL LERMA SAN MATEO,2023-03-17,46,42,4,0.0869565217391304
TOL LERMA SAN MATEO,2023-03-18,56,41,15,0.267857142857143
TOL LERMA SAN MATEO,2023-03-19,37,24,13,0.351351351351351
TOL LERMA SAN MATEO,2023-03-20,64,57,7,0.109375
TOL LERMA SAN MATEO,2023-03-21,37,32,5,0.135135135135135
TOL LERMA SAN MATEO,2023-03-22,32,31,1,0.03125
TOL LERMA SAN MATEO,2023-03-23,49,45,4,0.0816326530612245
TOL LERMA SAN MATEO,2023-03-24,45,45,0,0
TOL LERMA SAN MATEO,2023-03-25,51,50,1,0.0196078431372549
TOL LERMA SAN MATEO,2023-03-26,48,44,4,0.0833333333333333
TOL LERMA SAN MATEO,2023-03-27,36,35,1,0.0277777777777778
TOL LERMA SAN MATEO,2023-03-28,32,31,1,0.03125
TOL LERMA SAN MATEO,2023-03-29,44,44,0,0
TOL LERMA SAN MATEO,2023-03-30,43,42,1,0.0232558139534884
TOL LERMA SAN MATEO,2023-03-31,69,64,5,0.072463768115942
TOL LERMA SAN MATEO,2023-04-01,71,67,4,0.0563380281690141
TOL LERMA SAN MATEO,2023-04-02,50,49,1,0.02
TOL LERMA SAN MATEO,2023-04-03,65,63,2,0.0307692307692308
TOL LERMA SAN MATEO,2023-04-04,45,45,0,0
TOL LERMA SAN MATEO,2023-04-05,45,45,0,0
TOL LERMA SAN MATEO,2023-04-06,39,39,0,0
TOL LERMA SAN MATEO,2023-04-07,24,24,0,0
TOL LERMA SAN MATEO,2023-04-08,25,25,0,0
TOL LERMA SAN MATEO,2023-04-09,17,17,0,0
TOL LERMA SAN MATEO,2023-04-10,30,30,0,0
TOL LERMA SAN MATEO,2023-04-11,42,42,0,0
TOL LERMA SAN MATEO,2023-04-12,45,45,0,0
TOL LERMA SAN MATEO,2023-04-13,47,47,0,0
TOL LERMA SAN MATEO,2023-04-14,48,48,0,0
TOL LERMA SAN MATEO,2023-04-15,59,59,0,0
TOL LERMA SAN MATEO,2023-04-16,42,42,0,0
TOL LERMA SAN MATEO,2023-04-17,41,41,0,0
TOL LERMA SAN MATEO,2023-04-18,38,38,0,0
TOL LERMA SAN MATEO,2023-04-19,35,35,0,0
TOL LERMA SAN MATEO,2023-04-20,30,30,0,0
TOL LERMA SAN MATEO,2023-04-21,35,35,0,0
TOL LERMA SAN MATEO,2023-04-22,46,46,0,0
TOL LERMA SAN MATEO,2023-04-23,39,39,0,0
TOL LERMA SAN MATEO,2023-04-24,58,58,0,0
TOL LERMA SAN MATEO,2023-04-25,49,49,0,0
TOL LERMA SAN MATEO,2023-04-26,40,40,0,0
TOL LERMA SAN MATEO,2023-04-27,37,37,0,0
TOL LERMA SAN MATEO,2023-04-28,50,50,0,0
TOL LERMA SAN MATEO,2023-04-29,60,60,0,0
TOL LERMA SAN MATEO,2023-04-30,43,43,0,0
TOL LERMA SAN MATEO,2023-05-01,58,58,0,0
TOL LERMA SAN MATEO,2023-05-02,43,43,0,0
TOL LERMA SAN MATEO,2023-05-03,46,46,0,0
TOL LERMA SAN MATEO,2023-05-04,35,35,0,0
TOL LERMA SAN MATEO,2023-05-05,42,42,0,0
TOL LERMA SAN MATEO,2023-05-06,45,45,0,0
TOL LERMA SAN MATEO,2023-05-07,23,23,0,0
TOL LERMA SAN MATEO,2023-05-08,27,27,0,0
TOL SAN CARLOS,2023-01-02,40,34,6,0.15
TOL SAN CARLOS,2023-01-03,48,43,5,0.104166666666667
TOL SAN CARLOS,2023-01-04,48,35,13,0.270833333333333
TOL SAN CARLOS,2023-01-05,45,36,9,0.2
TOL SAN CARLOS,2023-01-06,38,35,3,0.0789473684210526
TOL SAN CARLOS,2023-01-07,40,35,5,0.125
TOL SAN CARLOS,2023-01-08,36,33,3,0.0833333333333333
TOL SAN CARLOS,2023-01-09,46,39,7,0.152173913043478
TOL SAN CARLOS,2023-01-10,50,40,10,0.2
TOL SAN CARLOS,2023-01-11,44,39,5,0.113636363636364
TOL SAN CARLOS,2023-01-12,36,35,1,0.0277777777777778
TOL SAN CARLOS,2023-01-13,34,31,3,0.0882352941176471
TOL SAN CARLOS,2023-01-14,51,43,8,0.156862745098039
TOL SAN CARLOS,2023-01-15,37,32,5,0.135135135135135
TOL SAN CARLOS,2023-01-16,23,16,7,0.304347826086957
TOL SAN CARLOS,2023-01-17,41,31,10,0.24390243902439
TOL SAN CARLOS,2023-01-18,40,29,11,0.275
TOL SAN CARLOS,2023-01-19,36,28,8,0.222222222222222
TOL SAN CARLOS,2023-01-20,48,45,3,0.0625
TOL SAN CARLOS,2023-01-21,42,32,10,0.238095238095238
TOL SAN CARLOS,2023-01-22,28,23,5,0.178571428571429
TOL SAN CARLOS,2023-01-23,37,29,8,0.216216216216216
TOL SAN CARLOS,2023-01-24,33,23,10,0.303030303030303
TOL SAN CARLOS,2023-01-25,51,36,15,0.294117647058824
TOL SAN CARLOS,2023-01-26,37,28,9,0.243243243243243
TOL SAN CARLOS,2023-01-27,53,44,9,0.169811320754717
TOL SAN CARLOS,2023-01-28,37,27,10,0.27027027027027
TOL SAN CARLOS,2023-01-29,31,18,13,0.419354838709677
TOL SAN CARLOS,2023-01-30,35,24,11,0.314285714285714
TOL SAN CARLOS,2023-01-31,41,28,13,0.317073170731707
TOL SAN CARLOS,2023-02-01,44,36,8,0.181818181818182
TOL SAN CARLOS,2023-02-02,42,36,6,0.142857142857143
TOL SAN CARLOS,2023-02-03,42,28,14,0.333333333333333
TOL SAN CARLOS,2023-02-04,49,31,18,0.36734693877551
TOL SAN CARLOS,2023-02-05,18,11,7,0.388888888888889
TOL SAN CARLOS,2023-02-06,34,22,12,0.352941176470588
TOL SAN CARLOS,2023-02-07,33,21,12,0.363636363636364
TOL SAN CARLOS,2023-02-08,25,14,11,0.44
TOL SAN CARLOS,2023-02-09,33,26,7,0.212121212121212
TOL SAN CARLOS,2023-02-10,34,18,16,0.470588235294118
TOL SAN CARLOS,2023-02-11,34,19,15,0.441176470588235
TOL SAN CARLOS,2023-02-12,29,20,9,0.310344827586207
TOL SAN CARLOS,2023-02-13,35,21,14,0.4
TOL SAN CARLOS,2023-02-14,28,20,8,0.285714285714286
TOL SAN CARLOS,2023-02-15,37,24,13,0.351351351351351
TOL SAN CARLOS,2023-02-16,30,20,10,0.333333333333333
TOL SAN CARLOS,2023-02-17,34,25,9,0.264705882352941
TOL SAN CARLOS,2023-02-18,35,19,16,0.457142857142857
TOL SAN CARLOS,2023-02-19,34,21,13,0.382352941176471
TOL SAN CARLOS,2023-02-20,43,30,13,0.302325581395349
TOL SAN CARLOS,2023-02-21,37,25,12,0.324324324324324
TOL SAN CARLOS,2023-02-22,28,21,7,0.25
TOL SAN CARLOS,2023-02-23,33,22,11,0.333333333333333
TOL SAN CARLOS,2023-02-24,44,33,11,0.25
TOL SAN CARLOS,2023-02-25,34,24,10,0.294117647058824
TOL SAN CARLOS,2023-02-26,24,15,9,0.375
TOL SAN CARLOS,2023-02-27,31,19,12,0.387096774193548
TOL SAN CARLOS,2023-02-28,49,33,16,0.326530612244898
TOL SAN CARLOS,2023-03-01,44,28,16,0.363636363636364
TOL SAN CARLOS,2023-03-02,36,23,13,0.361111111111111
TOL SAN CARLOS,2023-03-03,35,23,12,0.342857142857143
TOL SAN CARLOS,2023-03-04,40,21,19,0.475
TOL SAN CARLOS,2023-03-05,33,21,12,0.363636363636364
TOL SAN CARLOS,2023-03-06,49,32,17,0.346938775510204
TOL SAN CARLOS,2023-03-07,41,24,17,0.414634146341463
TOL SAN CARLOS,2023-03-08,39,28,11,0.282051282051282
TOL SAN CARLOS,2023-03-09,30,23,7,0.233333333333333
TOL SAN CARLOS,2023-03-10,29,23,6,0.206896551724138
TOL SAN CARLOS,2023-03-11,42,31,11,0.261904761904762
TOL SAN CARLOS,2023-03-12,25,21,4,0.16
TOL SAN CARLOS,2023-03-13,44,36,8,0.181818181818182
TOL SAN CARLOS,2023-03-14,34,25,9,0.264705882352941
TOL SAN CARLOS,2023-03-15,24,22,2,0.0833333333333333
TOL SAN CARLOS,2023-03-16,18,15,3,0.166666666666667
TOL SAN CARLOS,2023-03-17,57,55,2,0.0350877192982456
TOL SAN CARLOS,2023-03-18,46,46,0,0
TOL SAN CARLOS,2023-03-19,28,27,1,0.0357142857142857
TOL SAN CARLOS,2023-03-20,48,45,3,0.0625
TOL SAN CARLOS,2023-03-21,43,43,0,0
TOL SAN CARLOS,2023-03-22,39,39,0,0
TOL SAN CARLOS,2023-03-23,41,39,2,0.0487804878048781
TOL SAN CARLOS,2023-03-24,46,45,1,0.0217391304347826
TOL SAN CARLOS,2023-03-25,47,45,2,0.0425531914893617
TOL SAN CARLOS,2023-03-26,29,28,1,0.0344827586206897
TOL SAN CARLOS,2023-03-27,28,26,2,0.0714285714285714
TOL SAN CARLOS,2023-03-28,39,39,0,0
TOL SAN CARLOS,2023-03-29,32,32,0,0
TOL SAN CARLOS,2023-03-30,38,35,3,0.0789473684210526
TOL SAN CARLOS,2023-03-31,46,46,0,0
TOL SAN CARLOS,2023-04-01,44,42,2,0.0454545454545455
TOL SAN CARLOS,2023-04-02,26,26,0,0
TOL SAN CARLOS,2023-04-03,41,40,1,0.024390243902439
TOL SAN CARLOS,2023-04-04,39,39,0,0
TOL SAN CARLOS,2023-04-05,40,40,0,0
TOL SAN CARLOS,2023-04-06,39,39,0,0
TOL SAN CARLOS,2023-04-07,31,31,0,0
TOL SAN CARLOS,2023-04-08,28,28,0,0
TOL SAN CARLOS,2023-04-09,22,22,0,0
TOL SAN CARLOS,2023-04-10,28,28,0,0
TOL SAN CARLOS,2023-04-11,41,41,0,0
TOL SAN CARLOS,2023-04-12,41,41,0,0
TOL SAN CARLOS,2023-04-13,27,27,0,0
TOL SAN CARLOS,2023-04-14,44,44,0,0
TOL SAN CARLOS,2023-04-15,56,56,0,0
TOL SAN CARLOS,2023-04-16,39,39,0,0
TOL SAN CARLOS,2023-04-17,34,34,0,0
TOL SAN CARLOS,2023-04-18,36,36,0,0
TOL SAN CARLOS,2023-04-19,42,42,0,0
TOL SAN CARLOS,2023-04-20,38,38,0,0
TOL SAN CARLOS,2023-04-21,32,32,0,0
TOL SAN CARLOS,2023-04-22,33,33,0,0
TOL SAN CARLOS,2023-04-23,28,28,0,0
TOL SAN CARLOS,2023-04-24,48,48,0,0
TOL SAN CARLOS,2023-04-25,40,40,0,0
TOL SAN CARLOS,2023-04-26,40,40,0,0
TOL SAN CARLOS,2023-04-27,36,36,0,0
TOL SAN CARLOS,2023-04-28,34,34,0,0
TOL SAN CARLOS,2023-04-29,41,41,0,0
TOL SAN CARLOS,2023-04-30,29,29,0,0
TOL SAN CARLOS,2023-05-01,43,43,0,0
TOL SAN CARLOS,2023-05-02,28,28,0,0
TOL SAN CARLOS,2023-05-03,39,39,0,0
TOL SAN CARLOS,2023-05-04,32,32,0,0
TOL SAN CARLOS,2023-05-05,35,35,0,0
TOL SAN CARLOS,2023-05-06,36,36,0,0
TOL SAN CARLOS,2023-05-07,22,22,0,0
TOL SAN CARLOS,2023-05-08,28,28,0,0
TOL ZONA CONURBADA,2023-01-02,32,20,12,0.375
TOL ZONA CONURBADA,2023-01-03,35,23,12,0.342857142857143
TOL ZONA CONURBADA,2023-01-04,31,20,11,0.354838709677419
TOL ZONA CONURBADA,2023-01-05,36,16,20,0.555555555555556
TOL ZONA CONURBADA,2023-01-06,39,25,14,0.358974358974359
TOL ZONA CONURBADA,2023-01-07,36,25,11,0.305555555555556
TOL ZONA CONURBADA,2023-01-08,29,19,10,0.344827586206897
TOL ZONA CONURBADA,2023-01-09,32,19,13,0.40625
TOL ZONA CONURBADA,2023-01-10,28,20,8,0.285714285714286
TOL ZONA CONURBADA,2023-01-11,24,17,7,0.291666666666667
TOL ZONA CONURBADA,2023-01-12,33,23,10,0.303030303030303
TOL ZONA CONURBADA,2023-01-13,31,25,6,0.193548387096774
TOL ZONA CONURBADA,2023-01-14,37,26,11,0.297297297297297
TOL ZONA CONURBADA,2023-01-15,35,30,5,0.142857142857143
TOL ZONA CONURBADA,2023-01-16,37,25,12,0.324324324324324
TOL ZONA CONURBADA,2023-01-17,42,27,15,0.357142857142857
TOL ZONA CONURBADA,2023-01-18,22,12,10,0.454545454545455
TOL ZONA CONURBADA,2023-01-19,40,24,16,0.4
TOL ZONA CONURBADA,2023-01-20,33,17,16,0.484848484848485
TOL ZONA CONURBADA,2023-01-21,30,14,16,0.533333333333333
TOL ZONA CONURBADA,2023-01-22,25,17,8,0.32
TOL ZONA CONURBADA,2023-01-23,31,20,11,0.354838709677419
TOL ZONA CONURBADA,2023-01-24,32,21,11,0.34375
TOL ZONA CONURBADA,2023-01-25,36,20,16,0.444444444444444
TOL ZONA CONURBADA,2023-01-26,44,27,17,0.386363636363636
TOL ZONA CONURBADA,2023-01-27,52,22,30,0.576923076923077
TOL ZONA CONURBADA,2023-01-28,54,35,19,0.351851851851852
TOL ZONA CONURBADA,2023-01-29,27,15,12,0.444444444444444
TOL ZONA CONURBADA,2023-01-30,31,21,10,0.32258064516129
TOL ZONA CONURBADA,2023-01-31,40,19,21,0.525
TOL ZONA CONURBADA,2023-02-01,32,19,13,0.40625
TOL ZONA CONURBADA,2023-02-02,36,24,12,0.333333333333333
TOL ZONA CONURBADA,2023-02-03,24,15,9,0.375
TOL ZONA CONURBADA,2023-02-04,43,12,31,0.720930232558139
TOL ZONA CONURBADA,2023-02-05,35,22,13,0.371428571428571
TOL ZONA CONURBADA,2023-02-06,35,21,14,0.4
TOL ZONA CONURBADA,2023-02-07,45,27,18,0.4
TOL ZONA CONURBADA,2023-02-08,42,24,18,0.428571428571429
TOL ZONA CONURBADA,2023-02-09,41,23,18,0.439024390243902
TOL ZONA CONURBADA,2023-02-10,30,16,14,0.466666666666667
TOL ZONA CONURBADA,2023-02-11,34,19,15,0.441176470588235
TOL ZONA CONURBADA,2023-02-12,28,16,12,0.428571428571429
TOL ZONA CONURBADA,2023-02-13,31,16,15,0.483870967741935
TOL ZONA CONURBADA,2023-02-14,30,19,11,0.366666666666667
TOL ZONA CONURBADA,2023-02-15,38,24,14,0.368421052631579
TOL ZONA CONURBADA,2023-02-16,23,14,9,0.391304347826087
TOL ZONA CONURBADA,2023-02-17,30,15,15,0.5
TOL ZONA CONURBADA,2023-02-18,41,21,20,0.48780487804878
TOL ZONA CONURBADA,2023-02-19,26,9,17,0.653846153846154
TOL ZONA CONURBADA,2023-02-20,37,19,18,0.486486486486487
TOL ZONA CONURBADA,2023-02-21,37,22,15,0.405405405405405
TOL ZONA CONURBADA,2023-02-22,32,13,19,0.59375
TOL ZONA CONURBADA,2023-02-23,33,26,7,0.212121212121212
TOL ZONA CONURBADA,2023-02-24,35,21,14,0.4
TOL ZONA CONURBADA,2023-02-25,37,18,19,0.513513513513513
TOL ZONA CONURBADA,2023-02-26,21,13,8,0.380952380952381
TOL ZONA CONURBADA,2023-02-27,37,23,14,0.378378378378378
TOL ZONA CONURBADA,2023-02-28,39,23,16,0.41025641025641
TOL ZONA CONURBADA,2023-03-01,23,13,10,0.434782608695652
TOL ZONA CONURBADA,2023-03-02,31,20,11,0.354838709677419
TOL ZONA CONURBADA,2023-03-03,29,14,15,0.517241379310345
TOL ZONA CONURBADA,2023-03-04,36,22,14,0.388888888888889
TOL ZONA CONURBADA,2023-03-05,34,16,18,0.529411764705882
TOL ZONA CONURBADA,2023-03-06,35,23,12,0.342857142857143
TOL ZONA CONURBADA,2023-03-07,37,26,11,0.297297297297297
TOL ZONA CONURBADA,2023-03-08,41,23,18,0.439024390243902
TOL ZONA CONURBADA,2023-03-09,39,22,17,0.435897435897436
TOL ZONA CONURBADA,2023-03-10,32,20,12,0.375
TOL ZONA CONURBADA,2023-03-11,45,26,19,0.422222222222222
TOL ZONA CONURBADA,2023-03-12,12,9,3,0.25
TOL ZONA CONURBADA,2023-03-13,41,22,19,0.463414634146341
TOL ZONA CONURBADA,2023-03-14,32,19,13,0.40625
TOL ZONA CONURBADA,2023-03-15,25,21,4,0.16
TOL ZONA CONURBADA,2023-03-16,35,35,0,0
TOL ZONA CONURBADA,2023-03-17,64,63,1,0.015625
TOL ZONA CONURBADA,2023-03-18,65,64,1,0.0153846153846154
TOL ZONA CONURBADA,2023-03-19,46,45,1,0.0217391304347826
TOL ZONA CONURBADA,2023-03-20,60,60,0,0
TOL ZONA CONURBADA,2023-03-21,46,46,0,0
TOL ZONA CONURBADA,2023-03-22,41,41,0,0
TOL ZONA CONURBADA,2023-03-23,42,42,0,0
TOL ZONA CONURBADA,2023-03-24,48,48,0,0
TOL ZONA CONURBADA,2023-03-25,38,38,0,0
TOL ZONA CONURBADA,2023-03-26,55,55,0,0
TOL ZONA CONURBADA,2023-03-27,44,44,0,0
TOL ZONA CONURBADA,2023-03-28,31,31,0,0
TOL ZONA CONURBADA,2023-03-29,33,33,0,0
TOL ZONA CONURBADA,2023-03-30,45,45,0,0
TOL ZONA CONURBADA,2023-03-31,65,65,0,0
TOL ZONA CONURBADA,2023-04-01,30,30,0,0
TOL ZONA CONURBADA,2023-04-02,28,28,0,0
TOL ZONA CONURBADA,2023-04-03,41,41,0,0
TOL ZONA CONURBADA,2023-04-04,32,32,0,0
TOL ZONA CONURBADA,2023-04-05,31,31,0,0
TOL ZONA CONURBADA,2023-04-06,38,38,0,0
TOL ZONA CONURBADA,2023-04-07,22,22,0,0
TOL ZONA CONURBADA,2023-04-08,13,13,0,0
TOL ZONA CONURBADA,2023-04-09,14,14,0,0
TOL ZONA CONURBADA,2023-04-10,21,21,0,0
TOL ZONA CONURBADA,2023-04-11,36,36,0,0
TOL ZONA CONURBADA,2023-04-12,37,37,0,0
TOL ZONA CONURBADA,2023-04-13,26,26,0,0
TOL ZONA CONURBADA,2023-04-14,47,47,0,0
TOL ZONA CONURBADA,2023-04-15,55,55,0,0
TOL ZONA CONURBADA,2023-04-16,57,57,0,0
TOL ZONA CONURBADA,2023-04-17,41,41,0,0
TOL ZONA CONURBADA,2023-04-18,35,35,0,0
TOL ZONA CONURBADA,2023-04-19,34,34,0,0
TOL ZONA CONURBADA,2023-04-20,41,41,0,0
TOL ZONA CONURBADA,2023-04-21,39,39,0,0
TOL ZONA CONURBADA,2023-04-22,41,41,0,0
TOL ZONA CONURBADA,2023-04-23,22,22,0,0
TOL ZONA CONURBADA,2023-04-24,43,43,0,0
TOL ZONA CONURBADA,2023-04-25,44,44,0,0
TOL ZONA CONURBADA,2023-04-26,41,41,0,0
TOL ZONA CONURBADA,2023-04-27,27,27,0,0
TOL ZONA CONURBADA,2023-04-28,50,50,0,0
TOL ZONA CONURBADA,2023-04-29,48,48,0,0
TOL ZONA CONURBADA,2023-04-30,47,47,0,0
TOL ZONA CONURBADA,2023-05-01,43,43,0,0
TOL ZONA CONURBADA,2023-05-02,30,30,0,0
TOL ZONA CONURBADA,2023-05-03,29,29,0,0
TOL ZONA CONURBADA,2023-05-04,26,26,0,0
TOL ZONA CONURBADA,2023-05-05,27,27,0,0
TOL ZONA CONURBADA,2023-05-06,34,34,0,0
TOL ZONA CONURBADA,2023-05-07,26,26,0,0
TOL ZONA CONURBADA,2023-05-08,41,41,0,0
TULTEPEC,2023-01-02,25,11,14,0.56
TULTEPEC,2023-01-03,29,14,15,0.517241379310345
TULTEPEC,2023-01-04,24,13,11,0.458333333333333
TULTEPEC,2023-01-05,30,10,20,0.666666666666667
TULTEPEC,2023-01-06,30,9,21,0.7
TULTEPEC,2023-01-07,46,12,34,0.739130434782609
TULTEPEC,2023-01-08,30,9,21,0.7
TULTEPEC,2023-01-09,28,9,19,0.678571428571429
TULTEPEC,2023-01-10,31,9,22,0.709677419354839
TULTEPEC,2023-01-11,29,11,18,0.620689655172414
TULTEPEC,2023-01-12,40,15,25,0.625
TULTEPEC,2023-01-13,32,12,20,0.625
TULTEPEC,2023-01-14,36,16,20,0.555555555555556
TULTEPEC,2023-01-15,38,14,24,0.631578947368421
TULTEPEC,2023-01-16,37,15,22,0.594594594594595
TULTEPEC,2023-01-17,32,12,20,0.625
TULTEPEC,2023-01-18,30,8,22,0.733333333333333
TULTEPEC,2023-01-19,26,15,11,0.423076923076923
TULTEPEC,2023-01-20,32,16,16,0.5
TULTEPEC,2023-01-21,31,14,17,0.548387096774194
TULTEPEC,2023-01-22,28,10,18,0.642857142857143
TULTEPEC,2023-01-23,24,10,14,0.583333333333333
TULTEPEC,2023-01-24,22,7,15,0.681818181818182
TULTEPEC,2023-01-25,25,10,15,0.6
TULTEPEC,2023-01-26,20,10,10,0.5
TULTEPEC,2023-01-27,34,18,16,0.470588235294118
TULTEPEC,2023-01-28,56,25,31,0.553571428571429
TULTEPEC,2023-01-29,37,15,22,0.594594594594595
TULTEPEC,2023-01-30,44,26,18,0.409090909090909
TULTEPEC,2023-01-31,43,25,18,0.418604651162791
TULTEPEC,2023-02-01,49,27,22,0.448979591836735
TULTEPEC,2023-02-02,43,24,19,0.441860465116279
TULTEPEC,2023-02-03,32,17,15,0.46875
TULTEPEC,2023-02-04,44,33,11,0.25
TULTEPEC,2023-02-05,39,21,18,0.461538461538462
TULTEPEC,2023-02-06,49,29,20,0.408163265306122
TULTEPEC,2023-02-07,34,17,17,0.5
TULTEPEC,2023-02-08,31,13,18,0.580645161290323
TULTEPEC,2023-02-09,26,12,14,0.538461538461538
TULTEPEC,2023-02-10,34,20,14,0.411764705882353
TULTEPEC,2023-02-11,44,17,27,0.613636363636364
TULTEPEC,2023-02-12,29,17,12,0.413793103448276
TULTEPEC,2023-02-13,26,15,11,0.423076923076923
TULTEPEC,2023-02-14,22,11,11,0.5
TULTEPEC,2023-02-15,31,13,18,0.580645161290323
TULTEPEC,2023-02-16,34,19,15,0.441176470588235
TULTEPEC,2023-02-17,30,14,16,0.533333333333333
TULTEPEC,2023-02-18,39,20,19,0.487179487179487
TULTEPEC,2023-02-19,34,17,17,0.5
TULTEPEC,2023-02-20,23,10,13,0.565217391304348
TULTEPEC,2023-02-21,44,31,13,0.295454545454545
TULTEPEC,2023-02-22,53,43,10,0.188679245283019
TULTEPEC,2023-02-23,45,37,8,0.177777777777778
TULTEPEC,2023-02-24,39,34,5,0.128205128205128
TULTEPEC,2023-02-25,43,37,6,0.13953488372093
TULTEPEC,2023-02-26,36,28,8,0.222222222222222
TULTEPEC,2023-02-27,35,28,7,0.2
TULTEPEC,2023-02-28,34,29,5,0.147058823529412
TULTEPEC,2023-03-01,37,32,5,0.135135135135135
TULTEPEC,2023-03-02,28,25,3,0.107142857142857
TULTEPEC,2023-03-03,36,28,8,0.222222222222222
TULTEPEC,2023-03-04,50,47,3,0.06
TULTEPEC,2023-03-05,47,43,4,0.0851063829787234
TULTEPEC,2023-03-06,26,22,4,0.153846153846154
TULTEPEC,2023-03-07,28,28,0,0
TULTEPEC,2023-03-08,22,18,4,0.181818181818182
TULTEPEC,2023-03-09,23,23,0,0
TULTEPEC,2023-03-10,23,22,1,0.0434782608695652
TULTEPEC,2023-03-11,34,33,1,0.0294117647058824
TULTEPEC,2023-03-12,27,26,1,0.037037037037037
TULTEPEC,2023-03-13,24,24,0,0
TULTEPEC,2023-03-14,26,26,0,0
TULTEPEC,2023-03-15,41,40,1,0.024390243902439
TULTEPEC,2023-03-16,47,47,0,0
TULTEPEC,2023-03-17,67,66,1,0.0149253731343284
TULTEPEC,2023-03-18,60,60,0,0
TULTEPEC,2023-03-19,58,58,0,0
TULTEPEC,2023-03-20,70,70,0,0
TULTEPEC,2023-03-21,44,44,0,0
TULTEPEC,2023-03-22,50,50,0,0
TULTEPEC,2023-03-23,32,32,0,0
TULTEPEC,2023-03-24,53,53,0,0
TULTEPEC,2023-03-25,52,52,0,0
TULTEPEC,2023-03-26,40,40,0,0
TULTEPEC,2023-03-27,36,36,0,0
TULTEPEC,2023-03-28,27,27,0,0
TULTEPEC,2023-03-29,22,22,0,0
TULTEPEC,2023-03-30,22,22,0,0
TULTEPEC,2023-03-31,59,59,0,0
TULTEPEC,2023-04-01,39,39,0,0
TULTEPEC,2023-04-02,42,42,0,0
TULTEPEC,2023-04-03,46,46,0,0
TULTEPEC,2023-04-04,34,34,0,0
TULTEPEC,2023-04-05,34,34,0,0
TULTEPEC,2023-04-06,55,55,0,0
TULTEPEC,2023-04-07,28,28,0,0
TULTEPEC,2023-04-08,31,31,0,0
TULTEPEC,2023-04-09,26,26,0,0
TULTEPEC,2023-04-10,13,13,0,0
TULTEPEC,2023-04-11,23,23,0,0
TULTEPEC,2023-04-12,26,26,0,0
TULTEPEC,2023-04-13,53,53,0,0
TULTEPEC,2023-04-14,39,39,0,0
TULTEPEC,2023-04-15,55,55,0,0
TULTEPEC,2023-04-16,73,73,0,0
TULTEPEC,2023-04-17,37,37,0,0
TULTEPEC,2023-04-18,20,20,0,0
TULTEPEC,2023-04-19,23,23,0,0
TULTEPEC,2023-04-20,39,39,0,0
TULTEPEC,2023-04-21,40,40,0,0
TULTEPEC,2023-04-22,52,52,0,0
TULTEPEC,2023-04-23,38,38,0,0
TULTEPEC,2023-04-24,37,37,0,0
TULTEPEC,2023-04-25,45,45,0,0
TULTEPEC,2023-04-26,26,26,0,0
TULTEPEC,2023-04-27,43,43,0,0
TULTEPEC,2023-04-28,34,34,0,0
TULTEPEC,2023-04-29,54,54,0,0
TULTEPEC,2023-04-30,36,36,0,0
TULTEPEC,2023-05-01,37,37,0,0
TULTEPEC,2023-05-02,23,23,0,0
TULTEPEC,2023-05-03,32,32,0,0
TULTEPEC,2023-05-04,25,25,0,0
TULTEPEC,2023-05-05,19,19,0,0
TULTEPEC,2023-05-06,46,46,0,0
TULTEPEC,2023-05-07,35,35,0,0
TULTEPEC,2023-05-08,34,34,0,0
TULTITLAN,2023-01-02,24,14,10,0.416666666666667
TULTITLAN,2023-01-03,36,24,12,0.333333333333333
TULTITLAN,2023-01-04,24,15,9,0.375
TULTITLAN,2023-01-05,32,19,13,0.40625
TULTITLAN,2023-01-06,26,18,8,0.307692307692308
TULTITLAN,2023-01-07,39,27,12,0.307692307692308
TULTITLAN,2023-01-08,22,15,7,0.318181818181818
TULTITLAN,2023-01-09,30,20,10,0.333333333333333
TULTITLAN,2023-01-10,32,17,15,0.46875
TULTITLAN,2023-01-11,41,27,14,0.341463414634146
TULTITLAN,2023-01-12,35,24,11,0.314285714285714
TULTITLAN,2023-01-13,24,9,15,0.625
TULTITLAN,2023-01-14,49,22,27,0.551020408163265
TULTITLAN,2023-01-15,40,21,19,0.475
TULTITLAN,2023-01-16,45,15,30,0.666666666666667
TULTITLAN,2023-01-17,42,14,28,0.666666666666667
TULTITLAN,2023-01-18,31,15,16,0.516129032258065
TULTITLAN,2023-01-19,20,12,8,0.4
TULTITLAN,2023-01-20,35,16,19,0.542857142857143
TULTITLAN,2023-01-21,45,19,26,0.577777777777778
TULTITLAN,2023-01-22,38,24,14,0.368421052631579
TULTITLAN,2023-01-23,37,19,18,0.486486486486487
TULTITLAN,2023-01-24,36,14,22,0.611111111111111
TULTITLAN,2023-01-25,35,19,16,0.457142857142857
TULTITLAN,2023-01-26,35,22,13,0.371428571428571
TULTITLAN,2023-01-27,24,13,11,0.458333333333333
TULTITLAN,2023-01-28,45,24,21,0.466666666666667
TULTITLAN,2023-01-29,29,15,14,0.482758620689655
TULTITLAN,2023-01-30,36,21,15,0.416666666666667
TULTITLAN,2023-01-31,40,24,16,0.4
TULTITLAN,2023-02-01,31,21,10,0.32258064516129
TULTITLAN,2023-02-02,33,17,16,0.484848484848485
TULTITLAN,2023-02-03,38,18,20,0.526315789473684
TULTITLAN,2023-02-04,47,28,19,0.404255319148936
TULTITLAN,2023-02-05,28,17,11,0.392857142857143
TULTITLAN,2023-02-06,40,23,17,0.425
TULTITLAN,2023-02-07,29,19,10,0.344827586206897
TULTITLAN,2023-02-08,35,26,9,0.257142857142857
TULTITLAN,2023-02-09,26,16,10,0.384615384615385
TULTITLAN,2023-02-10,31,20,11,0.354838709677419
TULTITLAN,2023-02-11,43,24,19,0.441860465116279
TULTITLAN,2023-02-12,31,17,14,0.451612903225806
TULTITLAN,2023-02-13,33,20,13,0.393939393939394
TULTITLAN,2023-02-14,32,18,14,0.4375
TULTITLAN,2023-02-15,36,23,13,0.361111111111111
TULTITLAN,2023-02-16,37,24,13,0.351351351351351
TULTITLAN,2023-02-17,41,19,22,0.536585365853659
TULTITLAN,2023-02-18,33,14,19,0.575757575757576
TULTITLAN,2023-02-19,24,12,12,0.5
TULTITLAN,2023-02-20,29,17,12,0.413793103448276
TULTITLAN,2023-02-21,30,17,13,0.433333333333333
TULTITLAN,2023-02-22,24,13,11,0.458333333333333
TULTITLAN,2023-02-23,29,17,12,0.413793103448276
TULTITLAN,2023-02-24,40,25,15,0.375
TULTITLAN,2023-02-25,33,20,13,0.393939393939394
TULTITLAN,2023-02-26,38,24,14,0.368421052631579
TULTITLAN,2023-02-27,22,15,7,0.318181818181818
TULTITLAN,2023-02-28,29,16,13,0.448275862068966
TULTITLAN,2023-03-01,39,28,11,0.282051282051282
TULTITLAN,2023-03-02,34,19,15,0.441176470588235
TULTITLAN,2023-03-03,43,24,19,0.441860465116279
TULTITLAN,2023-03-04,50,33,17,0.34
TULTITLAN,2023-03-05,43,27,16,0.372093023255814
TULTITLAN,2023-03-06,41,31,10,0.24390243902439
TULTITLAN,2023-03-07,36,23,13,0.361111111111111
TULTITLAN,2023-03-08,28,15,13,0.464285714285714
TULTITLAN,2023-03-09,29,15,14,0.482758620689655
TULTITLAN,2023-03-10,27,16,11,0.407407407407407
TULTITLAN,2023-03-11,45,32,13,0.288888888888889
TULTITLAN,2023-03-12,44,33,11,0.25
TULTITLAN,2023-03-13,36,24,12,0.333333333333333
TULTITLAN,2023-03-14,45,30,15,0.333333333333333
TULTITLAN,2023-03-15,35,28,7,0.2
TULTITLAN,2023-03-16,53,46,7,0.132075471698113
TULTITLAN,2023-03-17,51,47,4,0.0784313725490196
TULTITLAN,2023-03-18,59,53,6,0.101694915254237
TULTITLAN,2023-03-19,64,60,4,0.0625
TULTITLAN,2023-03-20,63,60,3,0.0476190476190476
TULTITLAN,2023-03-21,40,38,2,0.05
TULTITLAN,2023-03-22,32,32,0,0
TULTITLAN,2023-03-23,42,40,2,0.0476190476190476
TULTITLAN,2023-03-24,42,42,0,0
TULTITLAN,2023-03-25,58,58,0,0
TULTITLAN,2023-03-26,51,50,1,0.0196078431372549
TULTITLAN,2023-03-27,36,35,1,0.0277777777777778
TULTITLAN,2023-03-28,28,28,0,0
TULTITLAN,2023-03-29,32,32,0,0
TULTITLAN,2023-03-30,44,43,1,0.0227272727272727
TULTITLAN,2023-03-31,62,59,3,0.0483870967741935
TULTITLAN,2023-04-01,40,39,1,0.025
TULTITLAN,2023-04-02,34,33,1,0.0294117647058824
TULTITLAN,2023-04-03,53,52,1,0.0188679245283019
TULTITLAN,2023-04-04,40,40,0,0
TULTITLAN,2023-04-05,24,23,1,0.0416666666666667
TULTITLAN,2023-04-06,36,36,0,0
TULTITLAN,2023-04-07,32,32,0,0
TULTITLAN,2023-04-08,18,18,0,0
TULTITLAN,2023-04-09,27,27,0,0
TULTITLAN,2023-04-10,25,24,1,0.04
TULTITLAN,2023-04-11,25,25,0,0
TULTITLAN,2023-04-12,32,32,0,0
TULTITLAN,2023-04-13,25,25,0,0
TULTITLAN,2023-04-14,42,42,0,0
TULTITLAN,2023-04-15,53,53,0,0
TULTITLAN,2023-04-16,53,53,0,0
TULTITLAN,2023-04-17,47,45,2,0.0425531914893617
TULTITLAN,2023-04-18,34,34,0,0
TULTITLAN,2023-04-19,30,30,0,0
TULTITLAN,2023-04-20,33,33,0,0
TULTITLAN,2023-04-21,46,46,0,0
TULTITLAN,2023-04-22,49,49,0,0
TULTITLAN,2023-04-23,35,35,0,0
TULTITLAN,2023-04-24,36,36,0,0
TULTITLAN,2023-04-25,47,45,2,0.0425531914893617
TULTITLAN,2023-04-26,46,46,0,0
TULTITLAN,2023-04-27,30,30,0,0
TULTITLAN,2023-04-28,46,46,0,0
TULTITLAN,2023-04-29,63,62,1,0.0158730158730159
TULTITLAN,2023-04-30,56,56,0,0
TULTITLAN,2023-05-01,27,26,1,0.037037037037037
TULTITLAN,2023-05-02,48,48,0,0
TULTITLAN,2023-05-03,39,38,1,0.0256410256410256
TULTITLAN,2023-05-04,36,36,0,0
TULTITLAN,2023-05-05,22,22,0,0
TULTITLAN,2023-05-06,45,44,1,0.0222222222222222
TULTITLAN,2023-05-07,26,26,0,0
TULTITLAN,2023-05-08,38,38,0,0
TUXTLA,2023-01-02,27,25,2,0.0740740740740741
TUXTLA,2023-01-03,50,38,12,0.24
TUXTLA,2023-01-04,44,33,11,0.25
TUXTLA,2023-01-05,60,44,16,0.266666666666667
TUXTLA,2023-01-06,43,32,11,0.255813953488372
TUXTLA,2023-01-07,49,43,6,0.122448979591837
TUXTLA,2023-01-08,35,25,10,0.285714285714286
TUXTLA,2023-01-09,22,18,4,0.181818181818182
TUXTLA,2023-01-10,49,40,9,0.183673469387755
TUXTLA,2023-01-11,47,39,8,0.170212765957447
TUXTLA,2023-01-12,45,38,7,0.155555555555556
TUXTLA,2023-01-13,27,20,7,0.259259259259259
TUXTLA,2023-01-14,45,37,8,0.177777777777778
TUXTLA,2023-01-15,41,29,12,0.292682926829268
TUXTLA,2023-01-16,40,17,23,0.575
TUXTLA,2023-01-17,45,23,22,0.488888888888889
TUXTLA,2023-01-18,32,23,9,0.28125
TUXTLA,2023-01-19,34,22,12,0.352941176470588
TUXTLA,2023-01-20,35,24,11,0.314285714285714
TUXTLA,2023-01-21,39,21,18,0.461538461538462
TUXTLA,2023-01-22,31,16,15,0.483870967741935
TUXTLA,2023-01-23,49,26,23,0.469387755102041
TUXTLA,2023-01-24,40,23,17,0.425
TUXTLA,2023-01-25,48,29,19,0.395833333333333
TUXTLA,2023-01-26,41,21,20,0.48780487804878
TUXTLA,2023-01-27,44,19,25,0.568181818181818
TUXTLA,2023-01-28,35,15,20,0.571428571428571
TUXTLA,2023-01-29,36,23,13,0.361111111111111
TUXTLA,2023-01-30,41,20,21,0.51219512195122
TUXTLA,2023-01-31,42,20,22,0.523809523809524
TUXTLA,2023-02-01,31,11,20,0.645161290322581
TUXTLA,2023-02-02,35,23,12,0.342857142857143
TUXTLA,2023-02-03,43,14,29,0.674418604651163
TUXTLA,2023-02-04,40,17,23,0.575
TUXTLA,2023-02-05,47,23,24,0.51063829787234
TUXTLA,2023-02-06,31,13,18,0.580645161290323
TUXTLA,2023-02-07,28,18,10,0.357142857142857
TUXTLA,2023-02-08,35,11,24,0.685714285714286
TUXTLA,2023-02-09,37,15,22,0.594594594594595
TUXTLA,2023-02-10,31,14,17,0.548387096774194
TUXTLA,2023-02-11,45,22,23,0.511111111111111
TUXTLA,2023-02-12,46,28,18,0.391304347826087
TUXTLA,2023-02-13,38,23,15,0.394736842105263
TUXTLA,2023-02-14,45,23,22,0.488888888888889
TUXTLA,2023-02-15,36,19,17,0.472222222222222
TUXTLA,2023-02-16,42,19,23,0.547619047619048
TUXTLA,2023-02-17,29,14,15,0.517241379310345
TUXTLA,2023-02-18,30,21,9,0.3
TUXTLA,2023-02-19,29,13,16,0.551724137931034
TUXTLA,2023-02-20,29,17,12,0.413793103448276
TUXTLA,2023-02-21,45,23,22,0.488888888888889
TUXTLA,2023-02-22,33,15,18,0.545454545454545
TUXTLA,2023-02-23,40,21,19,0.475
TUXTLA,2023-02-24,31,21,10,0.32258064516129
TUXTLA,2023-02-25,49,20,29,0.591836734693878
TUXTLA,2023-02-26,43,19,24,0.558139534883721
TUXTLA,2023-02-27,44,28,16,0.363636363636364
TUXTLA,2023-02-28,33,21,12,0.363636363636364
TUXTLA,2023-03-01,35,23,12,0.342857142857143
TUXTLA,2023-03-02,36,23,13,0.361111111111111
TUXTLA,2023-03-03,40,20,20,0.5
TUXTLA,2023-03-04,53,26,27,0.509433962264151
TUXTLA,2023-03-05,42,23,19,0.452380952380952
TUXTLA,2023-03-06,23,16,7,0.304347826086957
TUXTLA,2023-03-07,32,19,13,0.40625
TUXTLA,2023-03-08,34,23,11,0.323529411764706
TUXTLA,2023-03-09,30,23,7,0.233333333333333
TUXTLA,2023-03-10,32,21,11,0.34375
TUXTLA,2023-03-11,45,36,9,0.2
TUXTLA,2023-03-12,46,32,14,0.304347826086957
TUXTLA,2023-03-13,24,18,6,0.25
TUXTLA,2023-03-14,37,28,9,0.243243243243243
TUXTLA,2023-03-15,43,32,11,0.255813953488372
TUXTLA,2023-03-16,32,27,5,0.15625
TUXTLA,2023-03-17,50,34,16,0.32
TUXTLA,2023-03-18,60,48,12,0.2
TUXTLA,2023-03-19,53,42,11,0.207547169811321
TUXTLA,2023-03-20,43,31,12,0.27906976744186
TUXTLA,2023-03-21,44,37,7,0.159090909090909
TUXTLA,2023-03-22,50,46,4,0.08
TUXTLA,2023-03-23,39,35,4,0.102564102564103
TUXTLA,2023-03-24,60,55,5,0.0833333333333333
TUXTLA,2023-03-25,60,57,3,0.05
TUXTLA,2023-03-26,43,40,3,0.0697674418604651
TUXTLA,2023-03-27,36,34,2,0.0555555555555556
TUXTLA,2023-03-28,37,36,1,0.027027027027027
TUXTLA,2023-03-29,52,49,3,0.0576923076923077
TUXTLA,2023-03-30,63,63,0,0
TUXTLA,2023-03-31,69,66,3,0.0434782608695652
TUXTLA,2023-04-01,41,41,0,0
TUXTLA,2023-04-02,26,26,0,0
TUXTLA,2023-04-03,34,33,1,0.0294117647058824
TUXTLA,2023-04-04,39,39,0,0
TUXTLA,2023-04-05,34,30,4,0.117647058823529
TUXTLA,2023-04-06,34,33,1,0.0294117647058824
TUXTLA,2023-04-07,28,28,0,0
TUXTLA,2023-04-08,22,21,1,0.0454545454545455
TUXTLA,2023-04-09,10,10,0,0
TUXTLA,2023-04-10,38,36,2,0.0526315789473684
TUXTLA,2023-04-11,38,35,3,0.0789473684210526
TUXTLA,2023-04-12,44,39,5,0.113636363636364
TUXTLA,2023-04-13,46,44,2,0.0434782608695652
TUXTLA,2023-04-14,52,52,0,0
TUXTLA,2023-04-15,80,76,4,0.05
TUXTLA,2023-04-16,72,72,0,0
TUXTLA,2023-04-17,72,69,3,0.0416666666666667
TUXTLA,2023-04-18,47,46,1,0.0212765957446809
TUXTLA,2023-04-19,58,53,5,0.0862068965517241
TUXTLA,2023-04-20,59,57,2,0.0338983050847458
TUXTLA,2023-04-21,57,56,1,0.0175438596491228
TUXTLA,2023-04-22,47,46,1,0.0212765957446809
TUXTLA,2023-04-23,39,36,3,0.0769230769230769
TUXTLA,2023-04-24,60,59,1,0.0166666666666667
TUXTLA,2023-04-25,80,79,1,0.0125
TUXTLA,2023-04-26,62,58,4,0.0645161290322581
TUXTLA,2023-04-27,60,58,2,0.0333333333333333
TUXTLA,2023-04-28,57,57,0,0
TUXTLA,2023-04-29,76,73,3,0.0394736842105263
TUXTLA,2023-04-30,50,49,1,0.02
TUXTLA,2023-05-01,45,45,0,0
TUXTLA,2023-05-02,50,49,1,0.02
TUXTLA,2023-05-03,45,44,1,0.0222222222222222
TUXTLA,2023-05-04,32,32,0,0
TUXTLA,2023-05-05,35,35,0,0
TUXTLA,2023-05-06,54,54,0,0
TUXTLA,2023-05-07,32,31,1,0.03125
TUXTLA,2023-05-08,38,38,0,0
VERACRUZ,2023-01-02,26,20,6,0.230769230769231
VERACRUZ,2023-01-03,32,27,5,0.15625
VERACRUZ,2023-01-04,53,41,12,0.226415094339623
VERACRUZ,2023-01-05,39,29,10,0.256410256410256
VERACRUZ,2023-01-06,41,32,9,0.219512195121951
VERACRUZ,2023-01-07,38,30,8,0.210526315789474
VERACRUZ,2023-01-08,23,13,10,0.434782608695652
VERACRUZ,2023-01-09,50,38,12,0.24
VERACRUZ,2023-01-10,39,28,11,0.282051282051282
VERACRUZ,2023-01-11,54,41,13,0.240740740740741
VERACRUZ,2023-01-12,39,31,8,0.205128205128205
VERACRUZ,2023-01-13,32,26,6,0.1875
VERACRUZ,2023-01-14,54,45,9,0.166666666666667
VERACRUZ,2023-01-15,37,32,5,0.135135135135135
VERACRUZ,2023-01-16,35,23,12,0.342857142857143
VERACRUZ,2023-01-17,37,21,16,0.432432432432432
VERACRUZ,2023-01-18,38,26,12,0.315789473684211
VERACRUZ,2023-01-19,38,27,11,0.289473684210526
VERACRUZ,2023-01-20,40,25,15,0.375
VERACRUZ,2023-01-21,49,31,18,0.36734693877551
VERACRUZ,2023-01-22,26,19,7,0.269230769230769
VERACRUZ,2023-01-23,34,20,14,0.411764705882353
VERACRUZ,2023-01-24,41,17,24,0.585365853658537
VERACRUZ,2023-01-25,34,20,14,0.411764705882353
VERACRUZ,2023-01-26,33,20,13,0.393939393939394
VERACRUZ,2023-01-27,40,31,9,0.225
VERACRUZ,2023-01-28,30,18,12,0.4
VERACRUZ,2023-01-29,28,18,10,0.357142857142857
VERACRUZ,2023-01-30,37,24,13,0.351351351351351
VERACRUZ,2023-01-31,33,21,12,0.363636363636364
VERACRUZ,2023-02-01,39,20,19,0.487179487179487
VERACRUZ,2023-02-02,45,27,18,0.4
VERACRUZ,2023-02-03,24,8,16,0.666666666666667
VERACRUZ,2023-02-04,43,22,21,0.488372093023256
VERACRUZ,2023-02-05,32,16,16,0.5
VERACRUZ,2023-02-06,30,18,12,0.4
VERACRUZ,2023-02-07,30,21,9,0.3
VERACRUZ,2023-02-08,27,14,13,0.481481481481481
VERACRUZ,2023-02-09,35,21,14,0.4
VERACRUZ,2023-02-10,22,11,11,0.5
VERACRUZ,2023-02-11,42,21,21,0.5
VERACRUZ,2023-02-12,35,16,19,0.542857142857143
VERACRUZ,2023-02-13,34,20,14,0.411764705882353
VERACRUZ,2023-02-14,37,17,20,0.540540540540541
VERACRUZ,2023-02-15,47,18,29,0.617021276595745
VERACRUZ,2023-02-16,46,29,17,0.369565217391304
VERACRUZ,2023-02-17,33,15,18,0.545454545454545
VERACRUZ,2023-02-18,36,21,15,0.416666666666667
VERACRUZ,2023-02-19,39,17,22,0.564102564102564
VERACRUZ,2023-02-20,53,28,25,0.471698113207547
VERACRUZ,2023-02-21,44,22,22,0.5
VERACRUZ,2023-02-22,33,14,19,0.575757575757576
VERACRUZ,2023-02-23,54,28,26,0.481481481481481
VERACRUZ,2023-02-24,50,23,27,0.54
VERACRUZ,2023-02-25,58,28,30,0.517241379310345
VERACRUZ,2023-02-26,36,20,16,0.444444444444444
VERACRUZ,2023-02-27,45,20,25,0.555555555555556
VERACRUZ,2023-02-28,48,28,20,0.416666666666667
VERACRUZ,2023-03-01,31,12,19,0.612903225806452
VERACRUZ,2023-03-02,27,13,14,0.518518518518518
VERACRUZ,2023-03-03,38,17,21,0.552631578947368
VERACRUZ,2023-03-04,47,20,27,0.574468085106383
VERACRUZ,2023-03-05,26,14,12,0.461538461538462
VERACRUZ,2023-03-06,42,17,25,0.595238095238095
VERACRUZ,2023-03-07,48,25,23,0.479166666666667
VERACRUZ,2023-03-08,40,18,22,0.55
VERACRUZ,2023-03-09,48,36,12,0.25
VERACRUZ,2023-03-10,40,36,4,0.1
VERACRUZ,2023-03-11,42,39,3,0.0714285714285714
VERACRUZ,2023-03-12,27,27,0,0
VERACRUZ,2023-03-13,36,32,4,0.111111111111111
VERACRUZ,2023-03-14,36,32,4,0.111111111111111
VERACRUZ,2023-03-15,42,36,6,0.142857142857143
VERACRUZ,2023-03-16,53,50,3,0.0566037735849057
VERACRUZ,2023-03-17,54,52,2,0.037037037037037
VERACRUZ,2023-03-18,56,55,1,0.0178571428571429
VERACRUZ,2023-03-19,39,36,3,0.0769230769230769
VERACRUZ,2023-03-20,42,39,3,0.0714285714285714
VERACRUZ,2023-03-21,41,41,0,0
VERACRUZ,2023-03-22,43,42,1,0.0232558139534884
VERACRUZ,2023-03-23,41,40,1,0.024390243902439
VERACRUZ,2023-03-24,46,46,0,0
VERACRUZ,2023-03-25,45,44,1,0.0222222222222222
VERACRUZ,2023-03-26,40,40,0,0
VERACRUZ,2023-03-27,21,21,0,0
VERACRUZ,2023-03-28,30,30,0,0
VERACRUZ,2023-03-29,31,31,0,0
VERACRUZ,2023-03-30,32,30,2,0.0625
VERACRUZ,2023-03-31,60,57,3,0.05
VERACRUZ,2023-04-01,42,42,0,0
VERACRUZ,2023-04-02,27,26,1,0.037037037037037
VERACRUZ,2023-04-03,41,40,1,0.024390243902439
VERACRUZ,2023-04-04,44,42,2,0.0454545454545455
VERACRUZ,2023-04-05,30,28,2,0.0666666666666667
VERACRUZ,2023-04-06,35,32,3,0.0857142857142857
VERACRUZ,2023-04-07,27,27,0,0
VERACRUZ,2023-04-08,23,23,0,0
VERACRUZ,2023-04-09,12,12,0,0
VERACRUZ,2023-04-10,22,22,0,0
VERACRUZ,2023-04-11,46,44,2,0.0434782608695652
VERACRUZ,2023-04-12,30,28,2,0.0666666666666667
VERACRUZ,2023-04-13,29,28,1,0.0344827586206897
VERACRUZ,2023-04-14,42,38,4,0.0952380952380952
VERACRUZ,2023-04-15,74,66,8,0.108108108108108
VERACRUZ,2023-04-16,37,36,1,0.027027027027027
VERACRUZ,2023-04-17,33,32,1,0.0303030303030303
VERACRUZ,2023-04-18,32,30,2,0.0625
VERACRUZ,2023-04-19,30,27,3,0.1
VERACRUZ,2023-04-20,40,38,2,0.05
VERACRUZ,2023-04-21,35,31,4,0.114285714285714
VERACRUZ,2023-04-22,37,37,0,0
VERACRUZ,2023-04-23,29,28,1,0.0344827586206897
VERACRUZ,2023-04-24,38,35,3,0.0789473684210526
VERACRUZ,2023-04-25,43,40,3,0.0697674418604651
VERACRUZ,2023-04-26,39,38,1,0.0256410256410256
VERACRUZ,2023-04-27,32,23,9,0.28125
VERACRUZ,2023-04-28,47,40,7,0.148936170212766
VERACRUZ,2023-04-29,35,31,4,0.114285714285714
VERACRUZ,2023-04-30,32,29,3,0.09375
VERACRUZ,2023-05-01,29,26,3,0.103448275862069
VERACRUZ,2023-05-02,25,23,2,0.08
VERACRUZ,2023-05-03,38,38,0,0
VERACRUZ,2023-05-04,43,42,1,0.0232558139534884
VERACRUZ,2023-05-05,44,42,2,0.0454545454545455
VERACRUZ,2023-05-06,41,39,2,0.0487804878048781
VERACRUZ,2023-05-07,30,27,3,0.1
VERACRUZ,2023-05-08,40,34,6,0.15
XALAPA,2023-01-02,25,20,5,0.2
XALAPA,2023-01-03,27,15,12,0.444444444444444
XALAPA,2023-01-04,37,21,16,0.432432432432432
XALAPA,2023-01-05,34,27,7,0.205882352941176
XALAPA,2023-01-06,33,21,12,0.363636363636364
XALAPA,2023-01-07,35,25,10,0.285714285714286
XALAPA,2023-01-08,28,19,9,0.321428571428571
XALAPA,2023-01-09,32,24,8,0.25
XALAPA,2023-01-10,28,22,6,0.214285714285714
XALAPA,2023-01-11,31,18,13,0.419354838709677
XALAPA,2023-01-12,31,16,15,0.483870967741935
XALAPA,2023-01-13,27,21,6,0.222222222222222
XALAPA,2023-01-14,36,27,9,0.25
XALAPA,2023-01-15,28,18,10,0.357142857142857
XALAPA,2023-01-16,30,10,20,0.666666666666667
XALAPA,2023-01-17,28,10,18,0.642857142857143
XALAPA,2023-01-18,36,12,24,0.666666666666667
XALAPA,2023-01-19,30,14,16,0.533333333333333
XALAPA,2023-01-20,39,18,21,0.538461538461538
XALAPA,2023-01-21,40,20,20,0.5
XALAPA,2023-01-22,17,9,8,0.470588235294118
XALAPA,2023-01-23,31,16,15,0.483870967741935
XALAPA,2023-01-24,32,12,20,0.625
XALAPA,2023-01-25,42,15,27,0.642857142857143
XALAPA,2023-01-26,30,5,25,0.833333333333333
XALAPA,2023-01-27,34,15,19,0.558823529411765
XALAPA,2023-01-28,24,3,21,0.875
XALAPA,2023-01-29,27,5,22,0.814814814814815
XALAPA,2023-01-30,31,7,24,0.774193548387097
XALAPA,2023-01-31,50,16,34,0.68
XALAPA,2023-02-01,36,4,32,0.888888888888889
XALAPA,2023-02-02,34,8,26,0.764705882352941
XALAPA,2023-02-03,47,17,30,0.638297872340426
XALAPA,2023-02-04,65,17,48,0.738461538461539
XALAPA,2023-02-05,39,12,27,0.692307692307692
XALAPA,2023-02-06,47,10,37,0.787234042553192
XALAPA,2023-02-07,32,6,26,0.8125
XALAPA,2023-02-08,41,13,28,0.682926829268293
XALAPA,2023-02-09,33,9,24,0.727272727272727
XALAPA,2023-02-10,29,6,23,0.793103448275862
XALAPA,2023-02-11,38,10,28,0.736842105263158
XALAPA,2023-02-12,22,7,15,0.681818181818182
XALAPA,2023-02-13,32,6,26,0.8125
XALAPA,2023-02-14,50,12,38,0.76
XALAPA,2023-02-15,44,5,39,0.886363636363636
XALAPA,2023-02-16,49,7,42,0.857142857142857
XALAPA,2023-02-17,34,13,21,0.617647058823529
XALAPA,2023-02-18,39,11,28,0.717948717948718
XALAPA,2023-02-19,23,4,19,0.826086956521739
XALAPA,2023-02-20,36,10,26,0.722222222222222
XALAPA,2023-02-21,25,7,18,0.72
XALAPA,2023-02-22,33,9,24,0.727272727272727
XALAPA,2023-02-23,29,7,22,0.758620689655172
XALAPA,2023-02-24,41,15,26,0.634146341463415
XALAPA,2023-02-25,37,14,23,0.621621621621622
XALAPA,2023-02-26,20,8,12,0.6
XALAPA,2023-02-27,36,7,29,0.805555555555556
XALAPA,2023-02-28,46,13,33,0.717391304347826
XALAPA,2023-03-01,39,9,30,0.769230769230769
XALAPA,2023-03-02,28,6,22,0.785714285714286
XALAPA,2023-03-03,33,17,16,0.484848484848485
XALAPA,2023-03-04,38,11,27,0.710526315789474
XALAPA,2023-03-05,12,4,8,0.666666666666667
XALAPA,2023-03-06,35,10,25,0.714285714285714
XALAPA,2023-03-07,31,10,21,0.67741935483871
XALAPA,2023-03-08,34,19,15,0.441176470588235
XALAPA,2023-03-09,34,28,6,0.176470588235294
XALAPA,2023-03-10,28,27,1,0.0357142857142857
XALAPA,2023-03-11,35,34,1,0.0285714285714286
XALAPA,2023-03-12,22,21,1,0.0454545454545455
XALAPA,2023-03-13,34,33,1,0.0294117647058824
XALAPA,2023-03-14,26,26,0,0
XALAPA,2023-03-15,46,46,0,0
XALAPA,2023-03-16,53,52,1,0.0188679245283019
XALAPA,2023-03-17,40,40,0,0
XALAPA,2023-03-18,40,38,2,0.05
XALAPA,2023-03-19,31,29,2,0.0645161290322581
XALAPA,2023-03-20,49,48,1,0.0204081632653061
XALAPA,2023-03-21,33,32,1,0.0303030303030303
XALAPA,2023-03-22,31,31,0,0
XALAPA,2023-03-23,40,40,0,0
XALAPA,2023-03-24,31,30,1,0.032258064516129
XALAPA,2023-03-25,45,45,0,0
XALAPA,2023-03-26,38,37,1,0.0263157894736842
XALAPA,2023-03-27,25,25,0,0
XALAPA,2023-03-28,32,30,2,0.0625
XALAPA,2023-03-29,32,32,0,0
XALAPA,2023-03-30,42,42,0,0
XALAPA,2023-03-31,65,65,0,0
XALAPA,2023-04-01,31,30,1,0.032258064516129
XALAPA,2023-04-02,11,11,0,0
XALAPA,2023-04-03,42,42,0,0
XALAPA,2023-04-04,41,41,0,0
XALAPA,2023-04-05,25,24,1,0.04
XALAPA,2023-04-06,30,27,3,0.1
XALAPA,2023-04-07,14,13,1,0.0714285714285714
XALAPA,2023-04-08,14,14,0,0
XALAPA,2023-04-09,20,20,0,0
XALAPA,2023-04-10,35,34,1,0.0285714285714286
XALAPA,2023-04-11,24,22,2,0.0833333333333333
XALAPA,2023-04-12,38,35,3,0.0789473684210526
XALAPA,2023-04-13,32,31,1,0.03125
XALAPA,2023-04-14,42,37,5,0.119047619047619
XALAPA,2023-04-15,54,51,3,0.0555555555555556
XALAPA,2023-04-16,38,35,3,0.0789473684210526
XALAPA,2023-04-17,28,26,2,0.0714285714285714
XALAPA,2023-04-18,36,33,3,0.0833333333333333
XALAPA,2023-04-19,30,26,4,0.133333333333333
XALAPA,2023-04-20,28,26,2,0.0714285714285714
XALAPA,2023-04-21,38,34,4,0.105263157894737
XALAPA,2023-04-22,39,39,0,0
XALAPA,2023-04-23,27,27,0,0
XALAPA,2023-04-24,30,29,1,0.0333333333333333
XALAPA,2023-04-25,53,46,7,0.132075471698113
XALAPA,2023-04-26,33,32,1,0.0303030303030303
XALAPA,2023-04-27,31,30,1,0.032258064516129
XALAPA,2023-04-28,37,35,2,0.0540540540540541
XALAPA,2023-04-29,47,44,3,0.0638297872340425
XALAPA,2023-04-30,42,41,1,0.0238095238095238
XALAPA,2023-05-01,48,45,3,0.0625
XALAPA,2023-05-02,36,33,3,0.0833333333333333
XALAPA,2023-05-03,24,22,2,0.0833333333333333
XALAPA,2023-05-04,27,26,1,0.037037037037037
XALAPA,2023-05-05,41,39,2,0.0487804878048781
XALAPA,2023-05-06,41,39,2,0.0487804878048781
XALAPA,2023-05-07,21,20,1,0.0476190476190476
XALAPA,2023-05-08,27,27,0,0
XOCHIMILCO,2023-01-02,20,9,11,0.55
XOCHIMILCO,2023-01-03,20,13,7,0.35
XOCHIMILCO,2023-01-04,19,9,10,0.526315789473684
XOCHIMILCO,2023-01-05,10,8,2,0.2
XOCHIMILCO,2023-01-06,20,12,8,0.4
XOCHIMILCO,2023-01-07,17,10,7,0.411764705882353
XOCHIMILCO,2023-01-08,16,11,5,0.3125
XOCHIMILCO,2023-01-09,18,13,5,0.277777777777778
XOCHIMILCO,2023-01-10,22,14,8,0.363636363636364
XOCHIMILCO,2023-01-11,17,3,14,0.823529411764706
XOCHIMILCO,2023-01-12,15,7,8,0.533333333333333
XOCHIMILCO,2023-01-13,23,10,13,0.565217391304348
XOCHIMILCO,2023-01-14,16,6,10,0.625
XOCHIMILCO,2023-01-15,20,7,13,0.65
XOCHIMILCO,2023-01-16,15,8,7,0.466666666666667
XOCHIMILCO,2023-01-17,16,7,9,0.5625
XOCHIMILCO,2023-01-18,17,8,9,0.529411764705882
XOCHIMILCO,2023-01-19,20,14,6,0.3
XOCHIMILCO,2023-01-20,18,12,6,0.333333333333333
XOCHIMILCO,2023-01-21,23,12,11,0.478260869565217
XOCHIMILCO,2023-01-22,17,5,12,0.705882352941177
XOCHIMILCO,2023-01-23,14,6,8,0.571428571428571
XOCHIMILCO,2023-01-24,22,7,15,0.681818181818182
XOCHIMILCO,2023-01-25,20,11,9,0.45
XOCHIMILCO,2023-01-26,23,12,11,0.478260869565217
XOCHIMILCO,2023-01-27,22,12,10,0.454545454545455
XOCHIMILCO,2023-01-28,19,10,9,0.473684210526316
XOCHIMILCO,2023-01-29,11,9,2,0.181818181818182
XOCHIMILCO,2023-01-30,24,10,14,0.583333333333333
XOCHIMILCO,2023-01-31,24,9,15,0.625
XOCHIMILCO,2023-02-01,24,8,16,0.666666666666667
XOCHIMILCO,2023-02-02,25,15,10,0.4
XOCHIMILCO,2023-02-03,27,11,16,0.592592592592593
XOCHIMILCO,2023-02-04,21,11,10,0.476190476190476
XOCHIMILCO,2023-02-05,16,8,8,0.5
XOCHIMILCO,2023-02-06,15,10,5,0.333333333333333
XOCHIMILCO,2023-02-07,20,13,7,0.35
XOCHIMILCO,2023-02-08,23,9,14,0.608695652173913
XOCHIMILCO,2023-02-09,17,13,4,0.235294117647059
XOCHIMILCO,2023-02-10,24,13,11,0.458333333333333
XOCHIMILCO,2023-02-11,17,9,8,0.470588235294118
XOCHIMILCO,2023-02-12,9,6,3,0.333333333333333
XOCHIMILCO,2023-02-13,32,20,12,0.375
XOCHIMILCO,2023-02-14,18,8,10,0.555555555555556
XOCHIMILCO,2023-02-15,17,11,6,0.352941176470588
XOCHIMILCO,2023-02-16,19,7,12,0.631578947368421
XOCHIMILCO,2023-02-17,18,9,9,0.5
XOCHIMILCO,2023-02-18,26,5,21,0.807692307692308
XOCHIMILCO,2023-02-19,17,9,8,0.470588235294118
XOCHIMILCO,2023-02-20,14,10,4,0.285714285714286
XOCHIMILCO,2023-02-21,14,6,8,0.571428571428571
XOCHIMILCO,2023-02-22,24,14,10,0.416666666666667
XOCHIMILCO,2023-02-23,15,4,11,0.733333333333333
XOCHIMILCO,2023-02-24,16,9,7,0.4375
XOCHIMILCO,2023-02-25,22,14,8,0.363636363636364
XOCHIMILCO,2023-02-26,22,10,12,0.545454545454545
XOCHIMILCO,2023-02-27,21,8,13,0.619047619047619
XOCHIMILCO,2023-02-28,23,12,11,0.478260869565217
XOCHIMILCO,2023-03-01,18,8,10,0.555555555555556
XOCHIMILCO,2023-03-02,17,9,8,0.470588235294118
XOCHIMILCO,2023-03-03,29,20,9,0.310344827586207
XOCHIMILCO,2023-03-04,22,15,7,0.318181818181818
XOCHIMILCO,2023-03-05,19,10,9,0.473684210526316
XOCHIMILCO,2023-03-06,19,12,7,0.368421052631579
XOCHIMILCO,2023-03-07,23,11,12,0.521739130434783
XOCHIMILCO,2023-03-08,21,13,8,0.380952380952381
XOCHIMILCO,2023-03-09,19,14,5,0.263157894736842
XOCHIMILCO,2023-03-10,11,8,3,0.272727272727273
XOCHIMILCO,2023-03-11,16,10,6,0.375
XOCHIMILCO,2023-03-12,15,8,7,0.466666666666667
XOCHIMILCO,2023-03-13,26,18,8,0.307692307692308
XOCHIMILCO,2023-03-14,25,19,6,0.24
XOCHIMILCO,2023-03-15,20,17,3,0.15
XOCHIMILCO,2023-03-16,19,12,7,0.368421052631579
XOCHIMILCO,2023-03-17,19,13,6,0.315789473684211
XOCHIMILCO,2023-03-18,32,18,14,0.4375
XOCHIMILCO,2023-03-19,21,17,4,0.19047619047619
XOCHIMILCO,2023-03-20,29,22,7,0.241379310344828
XOCHIMILCO,2023-03-21,12,11,1,0.0833333333333333
XOCHIMILCO,2023-03-22,22,19,3,0.136363636363636
XOCHIMILCO,2023-03-23,22,17,5,0.227272727272727
XOCHIMILCO,2023-03-24,14,12,2,0.142857142857143
XOCHIMILCO,2023-03-25,26,23,3,0.115384615384615
XOCHIMILCO,2023-03-26,10,7,3,0.3
XOCHIMILCO,2023-03-27,24,20,4,0.166666666666667
XOCHIMILCO,2023-03-28,22,19,3,0.136363636363636
XOCHIMILCO,2023-03-29,21,21,0,0
XOCHIMILCO,2023-03-30,20,15,5,0.25
XOCHIMILCO,2023-03-31,36,34,2,0.0555555555555556
XOCHIMILCO,2023-04-01,11,10,1,0.0909090909090909
XOCHIMILCO,2023-04-02,11,9,2,0.181818181818182
XOCHIMILCO,2023-04-03,16,15,1,0.0625
XOCHIMILCO,2023-04-04,19,17,2,0.105263157894737
XOCHIMILCO,2023-04-05,22,15,7,0.318181818181818
XOCHIMILCO,2023-04-06,26,24,2,0.0769230769230769
XOCHIMILCO,2023-04-07,13,13,0,0
XOCHIMILCO,2023-04-08,14,13,1,0.0714285714285714
XOCHIMILCO,2023-04-09,13,12,1,0.0769230769230769
XOCHIMILCO,2023-04-10,10,9,1,0.1
XOCHIMILCO,2023-04-11,16,16,0,0
XOCHIMILCO,2023-04-12,13,11,2,0.153846153846154
XOCHIMILCO,2023-04-13,26,21,5,0.192307692307692
XOCHIMILCO,2023-04-14,23,22,1,0.0434782608695652
XOCHIMILCO,2023-04-15,17,16,1,0.0588235294117647
XOCHIMILCO,2023-04-16,17,16,1,0.0588235294117647
XOCHIMILCO,2023-04-17,16,15,1,0.0625
XOCHIMILCO,2023-04-18,24,19,5,0.208333333333333
XOCHIMILCO,2023-04-19,22,20,2,0.0909090909090909
XOCHIMILCO,2023-04-20,15,14,1,0.0666666666666667
XOCHIMILCO,2023-04-21,21,16,5,0.238095238095238
XOCHIMILCO,2023-04-22,27,24,3,0.111111111111111
XOCHIMILCO,2023-04-23,16,12,4,0.25
XOCHIMILCO,2023-04-24,25,21,4,0.16
XOCHIMILCO,2023-04-25,20,18,2,0.1
XOCHIMILCO,2023-04-26,20,20,0,0
XOCHIMILCO,2023-04-27,27,23,4,0.148148148148148
XOCHIMILCO,2023-04-28,23,20,3,0.130434782608696
XOCHIMILCO,2023-04-29,28,23,5,0.178571428571429
XOCHIMILCO,2023-04-30,23,21,2,0.0869565217391304
XOCHIMILCO,2023-05-01,12,10,2,0.166666666666667
XOCHIMILCO,2023-05-02,24,22,2,0.0833333333333333
XOCHIMILCO,2023-05-03,23,23,0,0
XOCHIMILCO,2023-05-04,17,15,2,0.117647058823529
XOCHIMILCO,2023-05-05,23,21,2,0.0869565217391304
XOCHIMILCO,2023-05-06,17,17,0,0
XOCHIMILCO,2023-05-07,11,11,0,0
XOCHIMILCO,2023-05-08,14,14,0,0