DIRECCION,Fecha,Instalaciones,Activaciones_automaticas,Activaciones_manuales,PorcAM
CENTRO 1,2023-08-19,829,811,18,0.0217129071170084
CENTRO 1,2023-08-20,766,747,19,0.0248041775456919
CENTRO 1,2023-08-21,710,709,1,0.00140845070422535
CENTRO 1,2023-08-22,746,745,1,0.00134048257372654
CENTRO 1,2023-08-23,751,749,2,0.00266311584553928
CENTRO 1,2023-08-24,762,760,2,0.0026246719160105
CENTRO 1,2023-08-25,829,829,0,0
CENTRO 1,2023-08-26,1009,1007,2,0.00198216055500496
CENTRO 1,2023-08-27,952,951,1,0.00105042016806723
CENTRO 1,2023-08-28,894,892,2,0.00223713646532438
CENTRO 1,2023-08-29,913,911,2,0.00219058050383352
CENTRO 1,2023-08-30,862,860,2,0.00232018561484919
CENTRO 1,2023-08-31,775,768,7,0.00903225806451613
CENTRO 1,2023-09-01,736,734,2,0.00271739130434783
CENTRO 1,2023-09-02,795,792,3,0.00377358490566038
CENTRO 1,2023-09-03,743,740,3,0.00403768506056528
CENTRO 1,2023-09-04,726,725,1,0.00137741046831956
CENTRO 1,2023-09-05,704,702,2,0.00284090909090909
CENTRO 1,2023-09-06,716,715,1,0.00139664804469274
CENTRO 1,2023-09-07,793,789,4,0.00504413619167718
CENTRO 1,2023-09-08,650,649,1,0.00153846153846154
CENTRO 1,2023-09-09,804,804,0,0
CENTRO 1,2023-09-10,768,766,2,0.00260416666666667
CENTRO 1,2023-09-11,670,669,1,0.00149253731343284
CENTRO 1,2023-09-12,619,616,3,0.00484652665589661
CENTRO 1,2023-09-13,625,624,1,0.0016
CENTRO 1,2023-09-14,647,645,2,0.00309119010819165
CENTRO 1,2023-09-15,575,569,6,0.0104347826086957
CENTRO 1,2023-09-16,622,618,4,0.00643086816720257
CENTRO 1,2023-09-17,695,693,2,0.00287769784172662
CENTRO 1,2023-09-18,686,685,1,0.00145772594752187
CENTRO 1,2023-09-19,647,643,4,0.00618238021638331
CENTRO 1,2023-09-20,518,516,2,0.00386100386100386
CENTRO 1,2023-09-21,702,698,4,0.0056980056980057
CENTRO 1,2023-09-22,866,864,2,0.0023094688221709
CENTRO 1,2023-09-23,851,850,1,0.00117508813160987
CENTRO 1,2023-09-24,875,873,2,0.00228571428571429
CENTRO 1,2023-09-25,743,741,2,0.00269179004037685
CENTRO 1,2023-09-26,731,728,3,0.00410396716826265
CENTRO 1,2023-09-27,694,691,3,0.00432276657060519
CENTRO 1,2023-09-28,817,811,6,0.00734394124847001
CENTRO 1,2023-09-29,896,893,3,0.00334821428571429
CENTRO 1,2023-09-30,1088,1081,7,0.00643382352941176
CENTRO 1,2023-10-01,745,741,4,0.00536912751677852
CENTRO 1,2023-10-02,718,716,2,0.00278551532033426
CENTRO 1,2023-10-03,663,643,20,0.0301659125188537
CENTRO 1,2023-10-04,660,645,15,0.0227272727272727
CENTRO 1,2023-10-05,656,634,22,0.0335365853658537
CENTRO 1,2023-10-06,731,702,29,0.039671682626539
CENTRO 1,2023-10-07,848,823,25,0.0294811320754717
CENTRO 1,2023-10-08,764,742,22,0.0287958115183246
CENTRO 1,2023-10-09,727,704,23,0.031636863823934
CENTRO 1,2023-10-10,603,586,17,0.0281923714759536
CENTRO 1,2023-10-11,619,604,15,0.024232633279483
CENTRO 1,2023-10-12,583,568,15,0.0257289879931389
CENTRO 1,2023-10-13,675,657,18,0.0266666666666667
CENTRO 1,2023-10-14,864,845,19,0.0219907407407407
CENTRO 1,2023-10-15,862,836,26,0.0301624129930394
CENTRO 1,2023-10-16,820,802,18,0.0219512195121951
CENTRO 1,2023-10-17,762,737,25,0.0328083989501312
CENTRO 1,2023-10-18,678,655,23,0.0339233038348083
CENTRO 1,2023-10-19,709,690,19,0.0267983074753173
CENTRO 1,2023-10-20,734,718,16,0.0217983651226158
CENTRO 1,2023-10-21,916,893,23,0.0251091703056769
CENTRO 1,2023-10-22,806,777,29,0.0359801488833747
CENTRO 1,2023-10-23,785,764,21,0.0267515923566879
CENTRO 1,2023-10-24,726,702,24,0.0330578512396694
CENTRO 1,2023-10-25,626,605,21,0.0335463258785942
CENTRO 1,2023-10-26,599,582,17,0.0283806343906511
CENTRO 1,2023-10-27,650,630,20,0.0307692307692308
CENTRO 1,2023-10-28,796,777,19,0.0238693467336683
CENTRO 1,2023-10-29,756,737,19,0.0251322751322751
CENTRO 1,2023-10-30,729,692,37,0.0507544581618656
CENTRO 1,2023-10-31,958,931,27,0.0281837160751566
CENTRO 1,2023-11-01,725,700,25,0.0344827586206897
CENTRO 1,2023-11-02,676,659,17,0.0251479289940828
CENTRO 1,2023-11-03,650,629,21,0.0323076923076923
CENTRO 1,2023-11-04,898,876,22,0.0244988864142539
CENTRO 1,2023-11-05,937,905,32,0.0341515474919957
CENTRO 1,2023-11-06,897,875,22,0.0245261984392419
CENTRO 1,2023-11-07,929,901,28,0.0301399354144241
CENTRO 1,2023-11-08,875,852,23,0.0262857142857143
CENTRO 1,2023-11-09,786,760,26,0.0330788804071247
CENTRO 1,2023-11-10,807,793,14,0.0173482032218092
CENTRO 1,2023-11-11,1003,981,22,0.0219341974077767
CENTRO 1,2023-11-12,893,875,18,0.0201567749160134
CENTRO 1,2023-11-13,902,859,43,0.0476718403547672
CENTRO 1,2023-11-14,935,906,29,0.0310160427807487
CENTRO 1,2023-11-15,985,961,24,0.0243654822335025
CENTRO 1,2023-11-16,1085,1055,30,0.0276497695852535
CENTRO 1,2023-11-17,1139,1121,18,0.0158033362598771
CENTRO 1,2023-11-18,1287,1252,35,0.0271950271950272
CENTRO 1,2023-11-19,1301,1267,34,0.0261337432744043
CENTRO 1,2023-11-20,1290,1263,27,0.0209302325581395
CENTRO 1,2023-11-21,1078,1050,28,0.025974025974026
CENTRO 1,2023-11-22,919,893,26,0.0282916213275299
CENTRO 1,2023-11-23,883,859,24,0.0271800679501699
CENTRO 1,2023-11-24,916,886,30,0.0327510917030568
CENTRO 1,2023-11-25,1046,1027,19,0.0181644359464627
CENTRO 1,2023-11-26,943,917,26,0.0275715800636267
CENTRO 1,2023-11-27,978,942,36,0.0368098159509202
CENTRO 1,2023-11-28,1007,982,25,0.0248262164846077
CENTRO 1,2023-11-29,998,964,34,0.0340681362725451
CENTRO 1,2023-11-30,1201,1151,50,0.0416319733555371
CENTRO 1,2023-12-01,907,867,40,0.0441014332965821
CENTRO 1,2023-12-02,1044,997,47,0.0450191570881226
CENTRO 1,2023-12-03,1039,1002,37,0.0356111645813282
CENTRO 1,2023-12-04,947,913,34,0.0359028511087645
CENTRO 1,2023-12-05,853,816,37,0.0433763188745604
CENTRO 1,2023-12-06,856,825,31,0.036214953271028
CENTRO 1,2023-12-07,901,872,29,0.0321864594894562
CENTRO 1,2023-12-08,790,773,17,0.0215189873417722
CENTRO 1,2023-12-09,996,964,32,0.0321285140562249
CENTRO 1,2023-12-10,980,945,35,0.0357142857142857
CENTRO 1,2023-12-11,841,820,21,0.0249702734839477
CENTRO 1,2023-12-12,896,873,23,0.0256696428571429
CENTRO 1,2023-12-13,804,773,31,0.0385572139303483
CENTRO 1,2023-12-14,709,685,24,0.0338504936530324
CENTRO 1,2023-12-15,945,916,29,0.0306878306878307
CENTRO 1,2023-12-16,1075,1044,31,0.0288372093023256
CENTRO 1,2023-12-17,924,888,36,0.038961038961039
CENTRO 1,2023-12-18,954,925,29,0.030398322851153
CENTRO 1,2023-12-19,931,899,32,0.0343716433941998
CENTRO 1,2023-12-20,951,918,33,0.0347003154574132
CENTRO 1,2023-12-21,951,925,26,0.0273396424815983
CENTRO 1,2023-12-22,836,808,28,0.0334928229665072
CENTRO 1,2023-12-23,911,882,29,0.0318331503841932
CENTRO 1,2023-12-24,667,641,26,0.0389805097451274
CENTRO 1,2023-12-25,260,249,11,0.0423076923076923
CENTRO 1,2023-12-26,760,734,26,0.0342105263157895
CENTRO 1,2023-12-27,964,942,22,0.0228215767634855
CENTRO 1,2023-12-28,955,933,22,0.0230366492146597
CENTRO 1,2023-12-29,937,903,34,0.0362860192102455
CENTRO 1,2023-12-30,939,915,24,0.0255591054313099
CENTRO 1,2023-12-31,586,572,14,0.0238907849829352
CENTRO 1,2024-01-01,174,166,8,0.0459770114942529
CENTRO 1,2024-01-02,712,690,22,0.0308988764044944
CENTRO 1,2024-01-03,911,896,15,0.0164654226125137
CENTRO 1,2024-01-04,871,844,27,0.0309988518943743
CENTRO 1,2024-01-05,885,869,16,0.0180790960451977
CENTRO 1,2024-01-06,829,803,26,0.0313630880579011
CENTRO 1,2024-01-07,868,852,16,0.0184331797235023
CENTRO 1,2024-01-08,887,854,33,0.0372040586245772
CENTRO 1,2024-01-09,943,920,23,0.024390243902439
CENTRO 1,2024-01-10,889,861,28,0.031496062992126
CENTRO 1,2024-01-11,947,926,21,0.0221752903907075
CENTRO 1,2024-01-12,941,918,23,0.024442082890542
CENTRO 1,2024-01-13,1058,1031,27,0.0255198487712665
CENTRO 1,2024-01-14,1039,1012,27,0.0259865255052935
CENTRO 1,2024-01-15,977,951,26,0.0266120777891505
CENTRO 1,2024-01-16,998,973,25,0.0250501002004008
CENTRO 1,2024-01-17,859,830,29,0.0337601862630966
CENTRO 1,2024-01-18,948,931,17,0.0179324894514768
CENTRO 1,2024-01-19,855,835,20,0.0233918128654971
CENTRO 1,2024-01-20,971,943,28,0.0288362512873326
CENTRO 1,2024-01-21,868,850,18,0.0207373271889401
CENTRO 1,2024-01-22,846,823,23,0.0271867612293144
CENTRO 1,2024-01-23,886,856,30,0.0338600451467269
CENTRO 1,2024-01-24,905,871,34,0.0375690607734807
CENTRO 1,2024-01-25,813,789,24,0.029520295202952
CENTRO 1,2024-01-26,788,760,28,0.0355329949238579
CENTRO 1,2024-01-27,994,972,22,0.0221327967806841
CENTRO 1,2024-01-28,850,823,27,0.0317647058823529
CENTRO 1,2024-01-29,853,831,22,0.0257913247362251
CENTRO 1,2024-01-30,858,819,39,0.0454545454545455
CENTRO 1,2024-01-31,1018,992,26,0.0255402750491159
CENTRO 1,2024-02-01,884,850,34,0.0384615384615385
CENTRO 1,2024-02-02,799,784,15,0.0187734668335419
CENTRO 1,2024-02-03,937,916,21,0.0224119530416222
CENTRO 1,2024-02-04,874,854,20,0.022883295194508
CENTRO 1,2024-02-05,893,872,21,0.0235162374020157
CENTRO 1,2024-02-06,912,886,26,0.0285087719298246
CENTRO 1,2024-02-07,818,791,27,0.0330073349633252
CENTRO 1,2024-02-08,791,767,24,0.0303413400758533
CENTRO 1,2024-02-09,792,768,24,0.0303030303030303
CENTRO 1,2024-02-10,946,922,24,0.025369978858351
CENTRO 1,2024-02-11,774,745,29,0.0374677002583979
CENTRO 1,2024-02-12,697,675,22,0.0315638450502152
CENTRO 1,2024-02-13,809,789,20,0.0247218788627936
CENTRO 1,2024-02-14,690,668,22,0.0318840579710145
CENTRO 1,2024-02-15,781,762,19,0.0243277848911652
CENTRO 1,2024-02-16,897,876,21,0.0234113712374582
CENTRO 1,2024-02-17,996,975,21,0.0210843373493976
CENTRO 1,2024-02-18,1023,1003,20,0.0195503421309873
CENTRO 1,2024-02-19,920,898,22,0.0239130434782609
CENTRO 1,2024-02-20,862,844,18,0.0208816705336427
CENTRO 1,2024-02-21,882,860,22,0.0249433106575964
CENTRO 1,2024-02-22,857,838,19,0.0221703617269545
CENTRO 1,2024-02-23,633,579,54,0.0853080568720379
CENTRO 1,2024-02-24,1089,1064,25,0.0229568411386593
CENTRO 1,2024-02-25,918,901,17,0.0185185185185185
CENTRO 1,2024-02-26,930,901,29,0.0311827956989247
CENTRO 1,2024-02-27,940,918,22,0.0234042553191489
CENTRO 1,2024-02-28,892,865,27,0.0302690582959641
CENTRO 1,2024-02-29,985,966,19,0.0192893401015228
CENTRO 1,2024-03-01,882,866,16,0.018140589569161
CENTRO 1,2024-03-02,1027,1006,21,0.0204479065238559
CENTRO 1,2024-03-03,914,897,17,0.0185995623632385
CENTRO 1,2024-03-04,863,844,19,0.0220162224797219
CENTRO 1,2024-03-05,837,813,24,0.028673835125448
CENTRO 1,2024-03-06,845,820,25,0.029585798816568
CENTRO 1,2024-03-07,830,816,14,0.0168674698795181
CENTRO 1,2024-03-08,841,819,22,0.0261593341260404
CENTRO 1,2024-03-09,996,981,15,0.0150602409638554
CENTRO 1,2024-03-10,892,874,18,0.0201793721973094
CENTRO 1,2024-03-11,919,898,21,0.0228509249183896
CENTRO 1,2024-03-12,799,779,20,0.0250312891113892
CENTRO 1,2024-03-13,744,713,31,0.0416666666666667
CENTRO 1,2024-03-14,690,678,12,0.0173913043478261
CENTRO 1,2024-03-15,896,870,26,0.0290178571428571
CENTRO 1,2024-03-16,1060,1033,27,0.0254716981132075
CENTRO 1,2024-03-17,919,896,23,0.0250272034820457
CENTRO 1,2024-03-18,1007,972,35,0.0347567030784508
CENTRO 1,2024-03-19,721,710,11,0.0152565880721221
CENTRO 1,2024-03-20,739,725,14,0.0189445196211096
CENTRO 1,2024-03-21,694,676,18,0.0259365994236311
CENTRO 1,2024-03-22,716,698,18,0.0251396648044693
CENTRO 1,2024-03-23,933,922,11,0.0117899249732047
CENTRO 1,2024-03-24,697,679,18,0.0258249641319943
CENTRO 1,2024-03-25,759,736,23,0.0303030303030303
CENTRO 1,2024-03-26,871,851,20,0.0229621125143513
CENTRO 1,2024-03-27,885,859,26,0.0293785310734463
CENTRO 1,2024-03-28,1017,995,22,0.0216322517207473
CENTRO 1,2024-03-29,855,819,36,0.0421052631578947
CENTRO 1,2024-03-30,851,824,27,0.0317273795534665
CENTRO 1,2024-03-31,815,790,25,0.0306748466257669
CENTRO 1,2024-04-01,865,835,30,0.0346820809248555
CENTRO 1,2024-04-02,767,743,24,0.0312907431551499
CENTRO 1,2024-04-03,792,792,0,0
CENTRO 1,2024-04-04,760,760,0,0
CENTRO 1,2024-04-05,762,733,29,0.0380577427821522
CENTRO 1,2024-04-06,866,850,16,0.0184757505773672
CENTRO 1,2024-04-07,675,648,27,0.04
CENTRO 1,2024-04-08,676,658,18,0.0266272189349112
CENTRO 1,2024-04-09,727,702,25,0.0343878954607978
CENTRO 1,2024-04-10,751,723,28,0.0372836218375499
CENTRO 1,2024-04-11,682,670,12,0.0175953079178886
CENTRO 1,2024-04-12,769,747,22,0.0286085825747724
CENTRO 1,2024-04-13,836,816,20,0.0239234449760766
CENTRO 1,2024-04-14,835,818,17,0.0203592814371257
CENTRO 1,2024-04-15,897,879,18,0.020066889632107
CENTRO 1,2024-04-16,950,879,71,0.0747368421052632
CENTRO 1,2024-04-17,802,759,43,0.0536159600997506
CENTRO 1,2024-04-18,698,675,23,0.0329512893982808
CENTRO 1,2024-04-19,671,630,41,0.0611028315946349
CENTRO 1,2024-04-20,870,839,31,0.035632183908046
CENTRO 1,2024-04-21,769,746,23,0.0299089726918075
CENTRO 1,2024-04-22,470,452,18,0.0382978723404255
CENTRO 1,2024-04-23,941,875,66,0.0701381509032944
CENTRO 1,2024-04-24,792,765,27,0.0340909090909091
CENTRO 1,2024-04-25,707,683,24,0.0339462517680339
CENTRO 1,2024-04-26,769,743,26,0.0338101430429129
CENTRO 1,2024-04-27,879,821,58,0.0659840728100114
CENTRO 1,2024-04-28,767,738,29,0.0378096479791395
CENTRO 1,2024-04-29,849,824,25,0.0294464075382803
CENTRO 1,2024-04-30,933,899,34,0.0364415862808146
CENTRO 1,2024-05-01,800,780,20,0.025
CENTRO 1,2024-05-02,774,743,31,0.0400516795865633
CENTRO 1,2024-05-03,726,692,34,0.046831955922865
CENTRO 1,2024-05-04,817,790,27,0.0330477356181151
CENTRO 1,2024-05-05,696,681,15,0.021551724137931
CENTRO 1,2024-05-06,765,765,0,0
CENTRO 1,2024-05-07,745,727,18,0.0241610738255034
CENTRO 1,2024-05-08,674,635,39,0.0578635014836795
CENTRO 1,2024-05-09,642,616,26,0.0404984423676012
CENTRO 1,2024-05-10,592,568,24,0.0405405405405405
CENTRO 1,2024-05-11,747,718,29,0.0388219544846051
CENTRO 1,2024-05-12,659,633,26,0.039453717754173
CENTRO 1,2024-05-13,803,761,42,0.0523038605230386
CENTRO 1,2024-05-14,818,778,40,0.0488997555012225
CENTRO 1,2024-05-15,913,880,33,0.036144578313253
CENTRO 1,2024-05-16,821,709,112,0.136419001218027
CENTRO 1,2024-05-17,826,798,28,0.0338983050847458
CENTRO 1,2024-05-18,927,897,30,0.0323624595469256
CENTRO 1,2024-05-19,867,832,35,0.0403690888119954
CENTRO 1,2024-05-20,887,860,27,0.0304396843291995
CENTRO 1,2024-05-21,798,773,25,0.031328320802005
CENTRO 1,2024-05-22,780,747,33,0.0423076923076923
CENTRO 1,2024-05-23,760,733,27,0.0355263157894737
CENTRO 1,2024-05-24,737,711,26,0.0352781546811398
CENTRO 1,2024-05-25,979,955,24,0.024514811031665
CENTRO 1,2024-05-26,763,746,17,0.0222804718217562
CENTRO 1,2024-05-27,783,758,25,0.0319284802043423
CENTRO 1,2024-05-28,756,744,12,0.0158730158730159
CENTRO 1,2024-05-29,797,765,32,0.0401505646173149
CENTRO 1,2024-05-30,862,829,33,0.0382830626450116
CENTRO 1,2024-05-31,985,954,31,0.0314720812182741
CENTRO 1,2024-06-01,953,921,32,0.0335781741867786
CENTRO 1,2024-06-02,758,738,20,0.0263852242744063
CENTRO 1,2024-06-03,798,785,13,0.0162907268170426
CENTRO 1,2024-06-04,860,815,45,0.0523255813953488
CENTRO 1,2024-06-05,744,703,41,0.0551075268817204
CENTRO 1,2024-06-06,708,669,39,0.0550847457627119
CENTRO 1,2024-06-07,737,714,23,0.0312075983717775
CENTRO 1,2024-06-08,935,904,31,0.0331550802139037
CENTRO 1,2024-06-09,824,799,25,0.0303398058252427
CENTRO 1,2024-06-10,756,729,27,0.0357142857142857
CENTRO 1,2024-06-11,790,759,31,0.0392405063291139
CENTRO 1,2024-06-12,728,711,17,0.0233516483516484
CENTRO 1,2024-06-13,727,693,34,0.046767537826685
CENTRO 1,2024-06-14,783,746,37,0.0472541507024266
CENTRO 1,2024-06-15,1007,972,35,0.0347567030784508
CENTRO 1,2024-06-16,788,762,26,0.032994923857868
CENTRO 1,2024-06-17,834,795,39,0.0467625899280576
CENTRO 1,2024-06-18,926,883,43,0.0464362850971922
CENTRO 1,2024-06-19,810,780,30,0.037037037037037
CENTRO 1,2024-06-20,820,792,28,0.0341463414634146
CENTRO 1,2024-06-21,886,866,20,0.0225733634311512
CENTRO 1,2024-06-22,963,926,37,0.0384215991692627
CENTRO 1,2024-06-23,908,877,31,0.0341409691629956
CENTRO 1,2024-06-24,863,828,35,0.0405561993047509
CENTRO 1,2024-06-25,791,767,24,0.0303413400758533
CENTRO 1,2024-06-26,774,737,37,0.0478036175710594
CENTRO 1,2024-06-27,734,706,28,0.0381471389645777
CENTRO 1,2024-06-28,886,868,18,0.0203160270880361
CENTRO 1,2024-06-29,1120,1076,44,0.0392857142857143
CENTRO 1,2024-06-30,1119,1080,39,0.0348525469168901
CENTRO 1,2024-07-01,768,736,32,0.0416666666666667
CENTRO 1,2024-07-02,844,809,35,0.0414691943127962
CENTRO 1,2024-07-03,677,654,23,0.03397341211226
CENTRO 1,2024-07-04,738,702,36,0.0487804878048781
CENTRO 1,2024-07-05,770,748,22,0.0285714285714286
CENTRO 1,2024-07-06,928,891,37,0.0398706896551724
CENTRO 1,2024-07-07,784,761,23,0.0293367346938776
CENTRO 1,2024-07-08,743,708,35,0.0471063257065949
CENTRO 1,2024-07-09,690,657,33,0.0478260869565217
CENTRO 1,2024-07-10,744,744,0,0
CENTRO 1,2024-07-11,739,717,22,0.0297699594046008
CENTRO 1,2024-07-12,765,740,25,0.0326797385620915
CENTRO 1,2024-07-13,1013,974,39,0.0384995064165844
CENTRO 1,2024-07-14,912,882,30,0.0328947368421053
CENTRO 1,2024-07-15,973,935,38,0.039054470709147
CENTRO 1,2024-07-16,954,912,42,0.0440251572327044
CENTRO 1,2024-07-17,834,801,33,0.039568345323741
CENTRO 1,2024-07-18,779,751,28,0.0359435173299101
CENTRO 1,2024-07-19,879,850,29,0.0329920364050057
CENTRO 1,2024-07-20,948,915,33,0.0348101265822785
CENTRO 1,2024-07-21,937,901,36,0.0384204909284952
CENTRO 1,2024-07-22,864,838,26,0.0300925925925926
CENTRO 1,2024-07-23,892,866,26,0.0291479820627803
CENTRO 1,2024-07-24,966,929,37,0.0383022774327122
CENTRO 1,2024-07-25,845,812,33,0.0390532544378698
CENTRO 1,2024-07-26,860,827,33,0.0383720930232558
CENTRO 1,2024-07-27,964,933,31,0.0321576763485477
CENTRO 1,2024-07-28,847,825,22,0.025974025974026
CENTRO 1,2024-07-29,884,848,36,0.0407239819004525
CENTRO 1,2024-07-30,912,888,24,0.0263157894736842
CENTRO 1,2024-07-31,991,951,40,0.0403632694248234
CENTRO 1,2024-08-01,801,776,25,0.031210986267166
CENTRO 1,2024-08-02,777,737,40,0.0514800514800515
CENTRO 1,2024-08-03,906,873,33,0.0364238410596026
CENTRO 1,2024-08-04,804,785,19,0.0236318407960199
CENTRO 1,2024-08-05,876,850,26,0.0296803652968037
CENTRO 1,2024-08-06,829,782,47,0.0566948130277443
CENTRO 1,2024-08-07,862,831,31,0.0359628770301624
CENTRO 1,2024-08-08,825,795,30,0.0363636363636364
CENTRO 1,2024-08-09,762,746,16,0.020997375328084
CENTRO 1,2024-08-10,916,889,27,0.0294759825327511
CENTRO 1,2024-08-11,848,826,22,0.0259433962264151
CENTRO 1,2024-08-12,919,894,25,0.0272034820457018
CENTRO 1,2024-08-13,840,817,23,0.0273809523809524
CENTRO 1,2024-08-14,881,848,33,0.0374574347332577
CENTRO 1,2024-08-15,889,869,20,0.0224971878515186
CENTRO 1,2024-08-16,786,760,26,0.0330788804071247
CENTRO 1,2024-08-17,941,919,22,0.0233793836344315
CENTRO 1,2024-08-18,825,800,25,0.0303030303030303
CENTRO 2,2023-08-19,773,746,27,0.0349288486416559
CENTRO 2,2023-08-20,578,556,22,0.0380622837370242
CENTRO 2,2023-08-21,626,621,5,0.00798722044728434
CENTRO 2,2023-08-22,608,606,2,0.00328947368421053
CENTRO 2,2023-08-23,628,618,10,0.0159235668789809
CENTRO 2,2023-08-24,669,656,13,0.0194319880418535
CENTRO 2,2023-08-25,704,694,10,0.0142045454545455
CENTRO 2,2023-08-26,798,792,6,0.0075187969924812
CENTRO 2,2023-08-27,686,682,4,0.00583090379008746
CENTRO 2,2023-08-28,687,679,8,0.0116448326055313
CENTRO 2,2023-08-29,659,649,10,0.0151745068285281
CENTRO 2,2023-08-30,694,687,7,0.0100864553314121
CENTRO 2,2023-08-31,635,626,9,0.0141732283464567
CENTRO 2,2023-09-01,649,644,5,0.00770416024653313
CENTRO 2,2023-09-02,754,748,6,0.00795755968169761
CENTRO 2,2023-09-03,590,588,2,0.00338983050847458
CENTRO 2,2023-09-04,594,591,3,0.00505050505050505
CENTRO 2,2023-09-05,663,661,2,0.00301659125188537
CENTRO 2,2023-09-06,585,578,7,0.011965811965812
CENTRO 2,2023-09-07,543,541,2,0.00368324125230203
CENTRO 2,2023-09-08,521,516,5,0.00959692898272553
CENTRO 2,2023-09-09,722,720,2,0.00277008310249307
CENTRO 2,2023-09-10,567,566,1,0.0017636684303351
CENTRO 2,2023-09-11,581,572,9,0.0154905335628227
CENTRO 2,2023-09-12,614,608,6,0.00977198697068404
CENTRO 2,2023-09-13,485,473,12,0.0247422680412371
CENTRO 2,2023-09-14,519,507,12,0.023121387283237
CENTRO 2,2023-09-15,643,632,11,0.0171073094867807
CENTRO 2,2023-09-16,484,478,6,0.012396694214876
CENTRO 2,2023-09-17,552,544,8,0.0144927536231884
CENTRO 2,2023-09-18,622,618,4,0.00643086816720257
CENTRO 2,2023-09-19,604,596,8,0.0132450331125828
CENTRO 2,2023-09-20,584,575,9,0.0154109589041096
CENTRO 2,2023-09-21,657,642,15,0.0228310502283105
CENTRO 2,2023-09-22,667,652,15,0.0224887556221889
CENTRO 2,2023-09-23,772,763,9,0.0116580310880829
CENTRO 2,2023-09-24,573,565,8,0.0139616055846422
CENTRO 2,2023-09-25,609,597,12,0.0197044334975369
CENTRO 2,2023-09-26,636,630,6,0.00943396226415094
CENTRO 2,2023-09-27,580,576,4,0.00689655172413793
CENTRO 2,2023-09-28,660,651,9,0.0136363636363636
CENTRO 2,2023-09-29,717,701,16,0.0223152022315202
CENTRO 2,2023-09-30,881,858,23,0.0261066969353008
CENTRO 2,2023-10-01,541,531,10,0.0184842883548983
CENTRO 2,2023-10-02,583,575,8,0.0137221269296741
CENTRO 2,2023-10-03,600,581,19,0.0316666666666667
CENTRO 2,2023-10-04,545,524,21,0.0385321100917431
CENTRO 2,2023-10-05,526,504,22,0.0418250950570342
CENTRO 2,2023-10-06,590,567,23,0.0389830508474576
CENTRO 2,2023-10-07,635,623,12,0.0188976377952756
CENTRO 2,2023-10-08,497,472,25,0.0503018108651912
CENTRO 2,2023-10-09,541,520,21,0.0388170055452865
CENTRO 2,2023-10-10,538,524,14,0.0260223048327138
CENTRO 2,2023-10-11,532,500,32,0.0601503759398496
CENTRO 2,2023-10-12,472,453,19,0.0402542372881356
CENTRO 2,2023-10-13,467,445,22,0.0471092077087794
CENTRO 2,2023-10-14,698,672,26,0.0372492836676218
CENTRO 2,2023-10-15,562,549,13,0.0231316725978648
CENTRO 2,2023-10-16,640,621,19,0.0296875
CENTRO 2,2023-10-17,592,579,13,0.0219594594594595
CENTRO 2,2023-10-18,578,556,22,0.0380622837370242
CENTRO 2,2023-10-19,570,548,22,0.0385964912280702
CENTRO 2,2023-10-20,552,537,15,0.0271739130434783
CENTRO 2,2023-10-21,635,616,19,0.0299212598425197
CENTRO 2,2023-10-22,505,492,13,0.0257425742574257
CENTRO 2,2023-10-23,531,507,24,0.0451977401129944
CENTRO 2,2023-10-24,542,527,15,0.0276752767527675
CENTRO 2,2023-10-25,531,516,15,0.0282485875706215
CENTRO 2,2023-10-26,569,555,14,0.0246045694200351
CENTRO 2,2023-10-27,567,556,11,0.0194003527336861
CENTRO 2,2023-10-28,670,651,19,0.0283582089552239
CENTRO 2,2023-10-29,536,522,14,0.0261194029850746
CENTRO 2,2023-10-30,568,549,19,0.0334507042253521
CENTRO 2,2023-10-31,676,653,23,0.0340236686390533
CENTRO 2,2023-11-01,617,601,16,0.0259319286871961
CENTRO 2,2023-11-02,546,531,15,0.0274725274725275
CENTRO 2,2023-11-03,569,555,14,0.0246045694200351
CENTRO 2,2023-11-04,644,629,15,0.0232919254658385
CENTRO 2,2023-11-05,575,561,14,0.0243478260869565
CENTRO 2,2023-11-06,606,592,14,0.0231023102310231
CENTRO 2,2023-11-07,629,602,27,0.0429252782193959
CENTRO 2,2023-11-08,639,622,17,0.02660406885759
CENTRO 2,2023-11-09,593,579,14,0.0236087689713322
CENTRO 2,2023-11-10,603,580,23,0.0381426202321725
CENTRO 2,2023-11-11,713,693,20,0.0280504908835905
CENTRO 2,2023-11-12,571,556,15,0.0262697022767075
CENTRO 2,2023-11-13,633,609,24,0.037914691943128
CENTRO 2,2023-11-14,662,640,22,0.0332326283987915
CENTRO 2,2023-11-15,682,666,16,0.0234604105571848
CENTRO 2,2023-11-16,670,648,22,0.0328358208955224
CENTRO 2,2023-11-17,768,741,27,0.03515625
CENTRO 2,2023-11-18,915,889,26,0.0284153005464481
CENTRO 2,2023-11-19,643,628,15,0.0233281493001555
CENTRO 2,2023-11-20,771,751,20,0.0259403372243839
CENTRO 2,2023-11-21,737,714,23,0.0312075983717775
CENTRO 2,2023-11-22,706,685,21,0.0297450424929178
CENTRO 2,2023-11-23,695,677,18,0.0258992805755396
CENTRO 2,2023-11-24,653,634,19,0.0290964777947933
CENTRO 2,2023-11-25,775,759,16,0.0206451612903226
CENTRO 2,2023-11-26,631,612,19,0.0301109350237718
CENTRO 2,2023-11-27,696,677,19,0.0272988505747126
CENTRO 2,2023-11-28,727,705,22,0.0302613480055021
CENTRO 2,2023-11-29,668,618,50,0.0748502994011976
CENTRO 2,2023-11-30,838,790,48,0.0572792362768496
CENTRO 2,2023-12-01,720,692,28,0.0388888888888889
CENTRO 2,2023-12-02,721,688,33,0.0457697642163662
CENTRO 2,2023-12-03,658,627,31,0.047112462006079
CENTRO 2,2023-12-04,635,613,22,0.0346456692913386
CENTRO 2,2023-12-05,654,615,39,0.0596330275229358
CENTRO 2,2023-12-06,614,590,24,0.0390879478827362
CENTRO 2,2023-12-07,563,542,21,0.0373001776198934
CENTRO 2,2023-12-08,632,603,29,0.0458860759493671
CENTRO 2,2023-12-09,717,693,24,0.0334728033472803
CENTRO 2,2023-12-10,538,529,9,0.016728624535316
CENTRO 2,2023-12-11,609,588,21,0.0344827586206897
CENTRO 2,2023-12-12,707,673,34,0.0480905233380481
CENTRO 2,2023-12-13,547,531,16,0.0292504570383912
CENTRO 2,2023-12-14,567,541,26,0.0458553791887125
CENTRO 2,2023-12-15,615,601,14,0.0227642276422764
CENTRO 2,2023-12-16,693,679,14,0.0202020202020202
CENTRO 2,2023-12-17,544,533,11,0.0202205882352941
CENTRO 2,2023-12-18,670,654,16,0.0238805970149254
CENTRO 2,2023-12-19,717,698,19,0.0264993026499303
CENTRO 2,2023-12-20,724,698,26,0.0359116022099447
CENTRO 2,2023-12-21,682,664,18,0.0263929618768328
CENTRO 2,2023-12-22,648,632,16,0.0246913580246914
CENTRO 2,2023-12-23,705,680,25,0.0354609929078014
CENTRO 2,2023-12-24,380,371,9,0.0236842105263158
CENTRO 2,2023-12-25,174,167,7,0.0402298850574713
CENTRO 2,2023-12-26,567,548,19,0.0335097001763668
CENTRO 2,2023-12-27,753,733,20,0.0265604249667995
CENTRO 2,2023-12-28,750,729,21,0.028
CENTRO 2,2023-12-29,703,686,17,0.0241820768136558
CENTRO 2,2023-12-30,699,683,16,0.0228898426323319
CENTRO 2,2023-12-31,334,327,7,0.0209580838323353
CENTRO 2,2024-01-01,134,132,2,0.0149253731343284
CENTRO 2,2024-01-02,587,572,15,0.0255536626916525
CENTRO 2,2024-01-03,773,757,16,0.0206985769728331
CENTRO 2,2024-01-04,707,689,18,0.0254596888260255
CENTRO 2,2024-01-05,649,627,22,0.0338983050847458
CENTRO 2,2024-01-06,689,673,16,0.02322206095791
CENTRO 2,2024-01-07,525,515,10,0.019047619047619
CENTRO 2,2024-01-08,665,646,19,0.0285714285714286
CENTRO 2,2024-01-09,645,626,19,0.0294573643410853
CENTRO 2,2024-01-10,673,657,16,0.0237741456166419
CENTRO 2,2024-01-11,642,625,17,0.0264797507788162
CENTRO 2,2024-01-12,671,649,22,0.0327868852459016
CENTRO 2,2024-01-13,799,775,24,0.0300375469336671
CENTRO 2,2024-01-14,659,644,15,0.0227617602427921
CENTRO 2,2024-01-15,761,736,25,0.0328515111695138
CENTRO 2,2024-01-16,755,728,27,0.0357615894039735
CENTRO 2,2024-01-17,705,683,22,0.0312056737588652
CENTRO 2,2024-01-18,702,685,17,0.0242165242165242
CENTRO 2,2024-01-19,640,618,22,0.034375
CENTRO 2,2024-01-20,716,690,26,0.0363128491620112
CENTRO 2,2024-01-21,587,574,13,0.0221465076660988
CENTRO 2,2024-01-22,679,656,23,0.0338733431516937
CENTRO 2,2024-01-23,643,633,10,0.015552099533437
CENTRO 2,2024-01-24,650,629,21,0.0323076923076923
CENTRO 2,2024-01-25,651,629,22,0.0337941628264209
CENTRO 2,2024-01-26,677,656,21,0.0310192023633678
CENTRO 2,2024-01-27,785,770,15,0.0191082802547771
CENTRO 2,2024-01-28,605,590,15,0.0247933884297521
CENTRO 2,2024-01-29,706,681,25,0.0354107648725212
CENTRO 2,2024-01-30,661,636,25,0.037821482602118
CENTRO 2,2024-01-31,737,717,20,0.0271370420624152
CENTRO 2,2024-02-01,645,624,21,0.0325581395348837
CENTRO 2,2024-02-02,661,650,11,0.0166414523449319
CENTRO 2,2024-02-03,752,730,22,0.0292553191489362
CENTRO 2,2024-02-04,587,574,13,0.0221465076660988
CENTRO 2,2024-02-05,639,627,12,0.0187793427230047
CENTRO 2,2024-02-06,669,640,29,0.0433482810164425
CENTRO 2,2024-02-07,679,655,24,0.0353460972017673
CENTRO 2,2024-02-08,633,611,22,0.0347551342812006
CENTRO 2,2024-02-09,641,620,21,0.0327613104524181
CENTRO 2,2024-02-10,788,778,10,0.0126903553299492
CENTRO 2,2024-02-11,515,501,14,0.0271844660194175
CENTRO 2,2024-02-12,512,479,33,0.064453125
CENTRO 2,2024-02-13,636,623,13,0.020440251572327
CENTRO 2,2024-02-14,573,558,15,0.0261780104712042
CENTRO 2,2024-02-15,605,588,17,0.028099173553719
CENTRO 2,2024-02-16,651,628,23,0.0353302611367127
CENTRO 2,2024-02-17,761,746,15,0.0197109067017083
CENTRO 2,2024-02-18,622,607,15,0.0241157556270096
CENTRO 2,2024-02-19,636,611,25,0.0393081761006289
CENTRO 2,2024-02-20,634,622,12,0.0189274447949527
CENTRO 2,2024-02-21,617,600,17,0.0275526742301459
CENTRO 2,2024-02-22,666,655,11,0.0165165165165165
CENTRO 2,2024-02-23,482,431,51,0.105809128630705
CENTRO 2,2024-02-24,786,773,13,0.0165394402035623
CENTRO 2,2024-02-25,565,556,9,0.015929203539823
CENTRO 2,2024-02-26,694,676,18,0.0259365994236311
CENTRO 2,2024-02-27,707,691,16,0.0226308345120226
CENTRO 2,2024-02-28,733,708,25,0.034106412005457
CENTRO 2,2024-02-29,762,743,19,0.0249343832020997
CENTRO 2,2024-03-01,660,643,17,0.0257575757575758
CENTRO 2,2024-03-02,806,795,11,0.0136476426799007
CENTRO 2,2024-03-03,649,640,9,0.0138674884437596
CENTRO 2,2024-03-04,690,674,16,0.0231884057971014
CENTRO 2,2024-03-05,721,699,22,0.0305131761442441
CENTRO 2,2024-03-06,678,660,18,0.0265486725663717
CENTRO 2,2024-03-07,645,628,17,0.0263565891472868
CENTRO 2,2024-03-08,657,637,20,0.030441400304414
CENTRO 2,2024-03-09,766,752,14,0.0182767624020888
CENTRO 2,2024-03-10,594,585,9,0.0151515151515152
CENTRO 2,2024-03-11,648,638,10,0.0154320987654321
CENTRO 2,2024-03-12,623,611,12,0.0192616372391653
CENTRO 2,2024-03-13,612,602,10,0.0163398692810458
CENTRO 2,2024-03-14,616,600,16,0.025974025974026
CENTRO 2,2024-03-15,663,650,13,0.0196078431372549
CENTRO 2,2024-03-16,816,793,23,0.0281862745098039
CENTRO 2,2024-03-17,584,566,18,0.0308219178082192
CENTRO 2,2024-03-18,610,598,12,0.019672131147541
CENTRO 2,2024-03-19,604,590,14,0.0231788079470199
CENTRO 2,2024-03-20,605,589,16,0.0264462809917355
CENTRO 2,2024-03-21,572,560,12,0.020979020979021
CENTRO 2,2024-03-22,567,542,25,0.0440917107583774
CENTRO 2,2024-03-23,696,681,15,0.021551724137931
CENTRO 2,2024-03-24,491,472,19,0.0386965376782077
CENTRO 2,2024-03-25,600,579,21,0.035
CENTRO 2,2024-03-26,650,626,24,0.0369230769230769
CENTRO 2,2024-03-27,682,665,17,0.0249266862170088
CENTRO 2,2024-03-28,795,778,17,0.0213836477987421
CENTRO 2,2024-03-29,641,629,12,0.0187207488299532
CENTRO 2,2024-03-30,565,550,15,0.0265486725663717
CENTRO 2,2024-03-31,461,452,9,0.0195227765726681
CENTRO 2,2024-04-01,618,597,21,0.0339805825242718
CENTRO 2,2024-04-02,679,660,19,0.0279823269513991
CENTRO 2,2024-04-03,617,617,0,0
CENTRO 2,2024-04-04,616,616,0,0
CENTRO 2,2024-04-05,600,580,20,0.0333333333333333
CENTRO 2,2024-04-06,691,680,11,0.0159189580318379
CENTRO 2,2024-04-07,466,453,13,0.0278969957081545
CENTRO 2,2024-04-08,538,524,14,0.0260223048327138
CENTRO 2,2024-04-09,576,568,8,0.0138888888888889
CENTRO 2,2024-04-10,552,536,16,0.0289855072463768
CENTRO 2,2024-04-11,582,561,21,0.0360824742268041
CENTRO 2,2024-04-12,564,545,19,0.0336879432624113
CENTRO 2,2024-04-13,649,633,16,0.024653312788906
CENTRO 2,2024-04-14,517,506,11,0.0212765957446809
CENTRO 2,2024-04-15,635,620,15,0.0236220472440945
CENTRO 2,2024-04-16,727,679,48,0.0660247592847318
CENTRO 2,2024-04-17,653,620,33,0.0505359877488515
CENTRO 2,2024-04-18,597,573,24,0.0402010050251256
CENTRO 2,2024-04-19,552,526,26,0.0471014492753623
CENTRO 2,2024-04-20,674,648,26,0.0385756676557863
CENTRO 2,2024-04-21,493,488,5,0.0101419878296146
CENTRO 2,2024-04-22,310,296,14,0.0451612903225806
CENTRO 2,2024-04-23,718,677,41,0.0571030640668524
CENTRO 2,2024-04-24,547,534,13,0.0237659963436929
CENTRO 2,2024-04-25,530,512,18,0.0339622641509434
CENTRO 2,2024-04-26,550,531,19,0.0345454545454545
CENTRO 2,2024-04-27,633,614,19,0.0300157977883096
CENTRO 2,2024-04-28,554,540,14,0.0252707581227437
CENTRO 2,2024-04-29,550,534,16,0.0290909090909091
CENTRO 2,2024-04-30,610,584,26,0.0426229508196721
CENTRO 2,2024-05-01,620,610,10,0.0161290322580645
CENTRO 2,2024-05-02,587,561,26,0.0442930153321976
CENTRO 2,2024-05-03,608,587,21,0.0345394736842105
CENTRO 2,2024-05-04,671,654,17,0.0253353204172876
CENTRO 2,2024-05-05,473,462,11,0.0232558139534884
CENTRO 2,2024-05-06,583,583,0,0
CENTRO 2,2024-05-07,608,584,24,0.0394736842105263
CENTRO 2,2024-05-08,521,498,23,0.0441458733205374
CENTRO 2,2024-05-09,504,488,16,0.0317460317460317
CENTRO 2,2024-05-10,489,465,24,0.049079754601227
CENTRO 2,2024-05-11,589,576,13,0.0220713073005093
CENTRO 2,2024-05-12,415,408,7,0.0168674698795181
CENTRO 2,2024-05-13,548,534,14,0.0255474452554745
CENTRO 2,2024-05-14,572,549,23,0.0402097902097902
CENTRO 2,2024-05-15,643,622,21,0.0326594090202177
CENTRO 2,2024-05-16,598,527,71,0.118729096989967
CENTRO 2,2024-05-17,663,645,18,0.0271493212669683
CENTRO 2,2024-05-18,744,729,15,0.0201612903225806
CENTRO 2,2024-05-19,522,510,12,0.0229885057471264
CENTRO 2,2024-05-20,646,625,21,0.0325077399380805
CENTRO 2,2024-05-21,653,629,24,0.0367534456355283
CENTRO 2,2024-05-22,618,599,19,0.0307443365695793
CENTRO 2,2024-05-23,585,569,16,0.0273504273504274
CENTRO 2,2024-05-24,566,545,21,0.0371024734982332
CENTRO 2,2024-05-25,741,723,18,0.0242914979757085
CENTRO 2,2024-05-26,470,459,11,0.0234042553191489
CENTRO 2,2024-05-27,569,555,14,0.0246045694200351
CENTRO 2,2024-05-28,623,612,11,0.0176565008025682
CENTRO 2,2024-05-29,587,572,15,0.0255536626916525
CENTRO 2,2024-05-30,609,595,14,0.0229885057471264
CENTRO 2,2024-05-31,657,644,13,0.0197869101978691
CENTRO 2,2024-06-01,713,690,23,0.032258064516129
CENTRO 2,2024-06-02,496,480,16,0.032258064516129
CENTRO 2,2024-06-03,602,587,15,0.0249169435215947
CENTRO 2,2024-06-04,660,636,24,0.0363636363636364
CENTRO 2,2024-06-05,596,572,24,0.0402684563758389
CENTRO 2,2024-06-06,631,598,33,0.05229793977813
CENTRO 2,2024-06-07,619,596,23,0.037156704361874
CENTRO 2,2024-06-08,676,652,24,0.0355029585798817
CENTRO 2,2024-06-09,531,523,8,0.0150659133709981
CENTRO 2,2024-06-10,550,527,23,0.0418181818181818
CENTRO 2,2024-06-11,597,576,21,0.0351758793969849
CENTRO 2,2024-06-12,567,558,9,0.0158730158730159
CENTRO 2,2024-06-13,605,577,28,0.0462809917355372
CENTRO 2,2024-06-14,599,575,24,0.0400667779632721
CENTRO 2,2024-06-15,745,719,26,0.0348993288590604
CENTRO 2,2024-06-16,545,527,18,0.0330275229357798
CENTRO 2,2024-06-17,613,593,20,0.032626427406199
CENTRO 2,2024-06-18,709,689,20,0.0282087447108604
CENTRO 2,2024-06-19,635,619,16,0.0251968503937008
CENTRO 2,2024-06-20,625,603,22,0.0352
CENTRO 2,2024-06-21,662,643,19,0.0287009063444109
CENTRO 2,2024-06-22,737,717,20,0.0271370420624152
CENTRO 2,2024-06-23,556,541,15,0.026978417266187
CENTRO 2,2024-06-24,616,601,15,0.0243506493506494
CENTRO 2,2024-06-25,649,631,18,0.0277349768875193
CENTRO 2,2024-06-26,682,661,21,0.030791788856305
CENTRO 2,2024-06-27,611,593,18,0.0294599018003273
CENTRO 2,2024-06-28,673,660,13,0.0193164933135215
CENTRO 2,2024-06-29,779,756,23,0.0295250320924262
CENTRO 2,2024-06-30,646,634,12,0.0185758513931889
CENTRO 2,2024-07-01,564,550,14,0.024822695035461
CENTRO 2,2024-07-02,659,641,18,0.0273141122913505
CENTRO 2,2024-07-03,497,489,8,0.0160965794768612
CENTRO 2,2024-07-04,613,597,16,0.0261011419249592
CENTRO 2,2024-07-05,601,583,18,0.0299500831946755
CENTRO 2,2024-07-06,712,699,13,0.0182584269662921
CENTRO 2,2024-07-07,539,526,13,0.0241187384044527
CENTRO 2,2024-07-08,570,557,13,0.0228070175438597
CENTRO 2,2024-07-09,589,560,29,0.0492359932088285
CENTRO 2,2024-07-10,612,612,0,0
CENTRO 2,2024-07-11,608,593,15,0.0246710526315789
CENTRO 2,2024-07-12,626,608,18,0.0287539936102236
CENTRO 2,2024-07-13,750,739,11,0.0146666666666667
CENTRO 2,2024-07-14,545,541,4,0.0073394495412844
CENTRO 2,2024-07-15,750,722,28,0.0373333333333333
CENTRO 2,2024-07-16,688,672,16,0.0232558139534884
CENTRO 2,2024-07-17,669,649,20,0.0298953662182362
CENTRO 2,2024-07-18,616,608,8,0.012987012987013
CENTRO 2,2024-07-19,614,607,7,0.011400651465798
CENTRO 2,2024-07-20,768,755,13,0.0169270833333333
CENTRO 2,2024-07-21,567,559,8,0.0141093474426808
CENTRO 2,2024-07-22,650,641,9,0.0138461538461538
CENTRO 2,2024-07-23,671,651,20,0.029806259314456
CENTRO 2,2024-07-24,620,599,21,0.0338709677419355
CENTRO 2,2024-07-25,664,645,19,0.0286144578313253
CENTRO 2,2024-07-26,617,599,18,0.0291734197730956
CENTRO 2,2024-07-27,714,696,18,0.0252100840336134
CENTRO 2,2024-07-28,600,592,8,0.0133333333333333
CENTRO 2,2024-07-29,713,696,17,0.0238429172510519
CENTRO 2,2024-07-30,789,766,23,0.0291508238276299
CENTRO 2,2024-07-31,777,752,25,0.0321750321750322
CENTRO 2,2024-08-01,681,659,22,0.0323054331864905
CENTRO 2,2024-08-02,647,632,15,0.0231839258114374
CENTRO 2,2024-08-03,756,741,15,0.0198412698412698
CENTRO 2,2024-08-04,612,606,6,0.00980392156862745
CENTRO 2,2024-08-05,668,652,16,0.0239520958083832
CENTRO 2,2024-08-06,613,585,28,0.0456769983686786
CENTRO 2,2024-08-07,624,608,16,0.0256410256410256
CENTRO 2,2024-08-08,726,704,22,0.0303030303030303
CENTRO 2,2024-08-09,630,616,14,0.0222222222222222
CENTRO 2,2024-08-10,760,749,11,0.0144736842105263
CENTRO 2,2024-08-11,562,552,10,0.0177935943060498
CENTRO 2,2024-08-12,770,753,17,0.0220779220779221
CENTRO 2,2024-08-13,661,647,14,0.0211800302571861
CENTRO 2,2024-08-14,688,666,22,0.0319767441860465
CENTRO 2,2024-08-15,647,633,14,0.0216383307573416
CENTRO 2,2024-08-16,704,681,23,0.0326704545454545
CENTRO 2,2024-08-17,794,777,17,0.0214105793450882
CENTRO 2,2024-08-18,590,575,15,0.0254237288135593
NORESTE-FRONTERA,2023-08-19,886,833,53,0.0598194130925508
NORESTE-FRONTERA,2023-08-20,589,566,23,0.0390492359932088
NORESTE-FRONTERA,2023-08-21,570,551,19,0.0333333333333333
NORESTE-FRONTERA,2023-08-22,572,551,21,0.0367132867132867
NORESTE-FRONTERA,2023-08-23,686,647,39,0.0568513119533528
NORESTE-FRONTERA,2023-08-24,646,612,34,0.0526315789473684
NORESTE-FRONTERA,2023-08-25,792,750,42,0.053030303030303
NORESTE-FRONTERA,2023-08-26,894,859,35,0.0391498881431767
NORESTE-FRONTERA,2023-08-27,667,634,33,0.0494752623688156
NORESTE-FRONTERA,2023-08-28,640,611,29,0.0453125
NORESTE-FRONTERA,2023-08-29,629,606,23,0.0365659777424483
NORESTE-FRONTERA,2023-08-30,578,567,11,0.0190311418685121
NORESTE-FRONTERA,2023-08-31,622,609,13,0.0209003215434084
NORESTE-FRONTERA,2023-09-01,585,577,8,0.0136752136752137
NORESTE-FRONTERA,2023-09-02,641,634,7,0.0109204368174727
NORESTE-FRONTERA,2023-09-03,549,540,9,0.0163934426229508
NORESTE-FRONTERA,2023-09-04,583,577,6,0.0102915951972556
NORESTE-FRONTERA,2023-09-05,668,659,9,0.0134730538922156
NORESTE-FRONTERA,2023-09-06,663,658,5,0.00754147812971342
NORESTE-FRONTERA,2023-09-07,569,565,4,0.0070298769771529
NORESTE-FRONTERA,2023-09-08,599,594,5,0.00834724540901502
NORESTE-FRONTERA,2023-09-09,702,687,15,0.0213675213675214
NORESTE-FRONTERA,2023-09-10,510,507,3,0.00588235294117647
NORESTE-FRONTERA,2023-09-11,558,552,6,0.010752688172043
NORESTE-FRONTERA,2023-09-12,624,614,10,0.016025641025641
NORESTE-FRONTERA,2023-09-13,616,608,8,0.012987012987013
NORESTE-FRONTERA,2023-09-14,515,511,4,0.00776699029126214
NORESTE-FRONTERA,2023-09-15,665,650,15,0.0225563909774436
NORESTE-FRONTERA,2023-09-16,488,482,6,0.0122950819672131
NORESTE-FRONTERA,2023-09-17,498,491,7,0.0140562248995984
NORESTE-FRONTERA,2023-09-18,564,557,7,0.0124113475177305
NORESTE-FRONTERA,2023-09-19,441,439,2,0.00453514739229025
NORESTE-FRONTERA,2023-09-20,372,369,3,0.00806451612903226
NORESTE-FRONTERA,2023-09-21,390,374,16,0.041025641025641
NORESTE-FRONTERA,2023-09-22,624,613,11,0.0176282051282051
NORESTE-FRONTERA,2023-09-23,693,681,12,0.0173160173160173
NORESTE-FRONTERA,2023-09-24,522,515,7,0.0134099616858238
NORESTE-FRONTERA,2023-09-25,570,560,10,0.0175438596491228
NORESTE-FRONTERA,2023-09-26,581,566,15,0.0258175559380379
NORESTE-FRONTERA,2023-09-27,580,567,13,0.0224137931034483
NORESTE-FRONTERA,2023-09-28,638,622,16,0.0250783699059561
NORESTE-FRONTERA,2023-09-29,641,615,26,0.0405616224648986
NORESTE-FRONTERA,2023-09-30,717,697,20,0.0278940027894003
NORESTE-FRONTERA,2023-10-01,480,462,18,0.0375
NORESTE-FRONTERA,2023-10-02,530,518,12,0.0226415094339623
NORESTE-FRONTERA,2023-10-03,425,412,13,0.0305882352941176
NORESTE-FRONTERA,2023-10-04,634,606,28,0.0441640378548896
NORESTE-FRONTERA,2023-10-05,496,478,18,0.0362903225806452
NORESTE-FRONTERA,2023-10-06,570,553,17,0.0298245614035088
NORESTE-FRONTERA,2023-10-07,651,626,25,0.0384024577572965
NORESTE-FRONTERA,2023-10-08,473,454,19,0.040169133192389
NORESTE-FRONTERA,2023-10-09,538,517,21,0.0390334572490706
NORESTE-FRONTERA,2023-10-10,473,465,8,0.0169133192389006
NORESTE-FRONTERA,2023-10-11,535,520,15,0.0280373831775701
NORESTE-FRONTERA,2023-10-12,448,432,16,0.0357142857142857
NORESTE-FRONTERA,2023-10-13,421,410,11,0.0261282660332542
NORESTE-FRONTERA,2023-10-14,571,555,16,0.0280210157618214
NORESTE-FRONTERA,2023-10-15,476,464,12,0.0252100840336134
NORESTE-FRONTERA,2023-10-16,567,553,14,0.0246913580246914
NORESTE-FRONTERA,2023-10-17,582,571,11,0.0189003436426117
NORESTE-FRONTERA,2023-10-18,640,623,17,0.0265625
NORESTE-FRONTERA,2023-10-19,588,577,11,0.0187074829931973
NORESTE-FRONTERA,2023-10-20,581,564,17,0.0292598967297762
NORESTE-FRONTERA,2023-10-21,682,667,15,0.0219941348973607
NORESTE-FRONTERA,2023-10-22,478,470,8,0.0167364016736402
NORESTE-FRONTERA,2023-10-23,544,523,21,0.0386029411764706
NORESTE-FRONTERA,2023-10-24,540,523,17,0.0314814814814815
NORESTE-FRONTERA,2023-10-25,563,550,13,0.0230905861456483
NORESTE-FRONTERA,2023-10-26,600,582,18,0.03
NORESTE-FRONTERA,2023-10-27,571,556,15,0.0262697022767075
NORESTE-FRONTERA,2023-10-28,686,674,12,0.0174927113702624
NORESTE-FRONTERA,2023-10-29,458,446,12,0.0262008733624454
NORESTE-FRONTERA,2023-10-30,459,450,9,0.0196078431372549
NORESTE-FRONTERA,2023-10-31,488,479,9,0.0184426229508197
NORESTE-FRONTERA,2023-11-01,555,541,14,0.0252252252252252
NORESTE-FRONTERA,2023-11-02,574,562,12,0.0209059233449477
NORESTE-FRONTERA,2023-11-03,641,627,14,0.0218408736349454
NORESTE-FRONTERA,2023-11-04,694,675,19,0.0273775216138329
NORESTE-FRONTERA,2023-11-05,522,511,11,0.0210727969348659
NORESTE-FRONTERA,2023-11-06,592,580,12,0.0202702702702703
NORESTE-FRONTERA,2023-11-07,634,620,14,0.0220820189274448
NORESTE-FRONTERA,2023-11-08,641,631,10,0.015600624024961
NORESTE-FRONTERA,2023-11-09,654,641,13,0.0198776758409786
NORESTE-FRONTERA,2023-11-10,615,609,6,0.00975609756097561
NORESTE-FRONTERA,2023-11-11,766,748,18,0.0234986945169713
NORESTE-FRONTERA,2023-11-12,414,404,10,0.0241545893719807
NORESTE-FRONTERA,2023-11-13,621,603,18,0.0289855072463768
NORESTE-FRONTERA,2023-11-14,679,665,14,0.0206185567010309
NORESTE-FRONTERA,2023-11-15,607,593,14,0.0230642504118616
NORESTE-FRONTERA,2023-11-16,598,576,22,0.0367892976588629
NORESTE-FRONTERA,2023-11-17,768,752,16,0.0208333333333333
NORESTE-FRONTERA,2023-11-18,878,864,14,0.0159453302961276
NORESTE-FRONTERA,2023-11-19,623,612,11,0.0176565008025682
NORESTE-FRONTERA,2023-11-20,605,591,14,0.0231404958677686
NORESTE-FRONTERA,2023-11-21,630,616,14,0.0222222222222222
NORESTE-FRONTERA,2023-11-22,614,598,16,0.0260586319218241
NORESTE-FRONTERA,2023-11-23,727,711,16,0.0220082530949106
NORESTE-FRONTERA,2023-11-24,749,730,19,0.0253671562082777
NORESTE-FRONTERA,2023-11-25,796,780,16,0.0201005025125628
NORESTE-FRONTERA,2023-11-26,745,727,18,0.0241610738255034
NORESTE-FRONTERA,2023-11-27,605,596,9,0.0148760330578512
NORESTE-FRONTERA,2023-11-28,714,706,8,0.0112044817927171
NORESTE-FRONTERA,2023-11-29,729,690,39,0.0534979423868313
NORESTE-FRONTERA,2023-11-30,752,719,33,0.0438829787234043
NORESTE-FRONTERA,2023-12-01,631,612,19,0.0301109350237718
NORESTE-FRONTERA,2023-12-02,830,802,28,0.0337349397590361
NORESTE-FRONTERA,2023-12-03,691,673,18,0.0260492040520984
NORESTE-FRONTERA,2023-12-04,662,634,28,0.0422960725075529
NORESTE-FRONTERA,2023-12-05,696,671,25,0.0359195402298851
NORESTE-FRONTERA,2023-12-06,678,651,27,0.0398230088495575
NORESTE-FRONTERA,2023-12-07,724,702,22,0.0303867403314917
NORESTE-FRONTERA,2023-12-08,800,779,21,0.02625
NORESTE-FRONTERA,2023-12-09,826,801,25,0.0302663438256659
NORESTE-FRONTERA,2023-12-10,675,649,26,0.0385185185185185
NORESTE-FRONTERA,2023-12-11,531,514,17,0.032015065913371
NORESTE-FRONTERA,2023-12-12,674,647,27,0.0400593471810089
NORESTE-FRONTERA,2023-12-13,602,589,13,0.0215946843853821
NORESTE-FRONTERA,2023-12-14,600,582,18,0.03
NORESTE-FRONTERA,2023-12-15,607,586,21,0.0345963756177924
NORESTE-FRONTERA,2023-12-16,715,693,22,0.0307692307692308
NORESTE-FRONTERA,2023-12-17,552,537,15,0.0271739130434783
NORESTE-FRONTERA,2023-12-18,621,603,18,0.0289855072463768
NORESTE-FRONTERA,2023-12-19,720,702,18,0.025
NORESTE-FRONTERA,2023-12-20,779,756,23,0.0295250320924262
NORESTE-FRONTERA,2023-12-21,691,663,28,0.040520984081042
NORESTE-FRONTERA,2023-12-22,748,731,17,0.0227272727272727
NORESTE-FRONTERA,2023-12-23,783,764,19,0.0242656449553001
NORESTE-FRONTERA,2023-12-24,462,458,4,0.00865800865800866
NORESTE-FRONTERA,2023-12-25,170,170,0,0
NORESTE-FRONTERA,2023-12-26,588,577,11,0.0187074829931973
NORESTE-FRONTERA,2023-12-27,760,739,21,0.0276315789473684
NORESTE-FRONTERA,2023-12-28,749,731,18,0.0240320427236315
NORESTE-FRONTERA,2023-12-29,823,802,21,0.0255164034021871
NORESTE-FRONTERA,2023-12-30,771,760,11,0.0142671854734112
NORESTE-FRONTERA,2023-12-31,396,387,9,0.0227272727272727
NORESTE-FRONTERA,2024-01-01,83,82,1,0.0120481927710843
NORESTE-FRONTERA,2024-01-02,499,487,12,0.0240480961923848
NORESTE-FRONTERA,2024-01-03,770,753,17,0.0220779220779221
NORESTE-FRONTERA,2024-01-04,702,687,15,0.0213675213675214
NORESTE-FRONTERA,2024-01-05,769,748,21,0.0273081924577373
NORESTE-FRONTERA,2024-01-06,894,865,29,0.0324384787472036
NORESTE-FRONTERA,2024-01-07,586,576,10,0.0170648464163823
NORESTE-FRONTERA,2024-01-08,588,577,11,0.0187074829931973
NORESTE-FRONTERA,2024-01-09,639,619,20,0.0312989045383412
NORESTE-FRONTERA,2024-01-10,671,654,17,0.0253353204172876
NORESTE-FRONTERA,2024-01-11,655,647,8,0.0122137404580153
NORESTE-FRONTERA,2024-01-12,776,759,17,0.0219072164948454
NORESTE-FRONTERA,2024-01-13,806,795,11,0.0136476426799007
NORESTE-FRONTERA,2024-01-14,627,619,8,0.0127591706539075
NORESTE-FRONTERA,2024-01-15,668,646,22,0.0329341317365269
NORESTE-FRONTERA,2024-01-16,697,681,16,0.0229555236728838
NORESTE-FRONTERA,2024-01-17,729,705,24,0.0329218106995885
NORESTE-FRONTERA,2024-01-18,735,718,17,0.0231292517006803
NORESTE-FRONTERA,2024-01-19,682,665,17,0.0249266862170088
NORESTE-FRONTERA,2024-01-20,761,743,18,0.0236530880420499
NORESTE-FRONTERA,2024-01-21,613,597,16,0.0261011419249592
NORESTE-FRONTERA,2024-01-22,655,640,15,0.0229007633587786
NORESTE-FRONTERA,2024-01-23,703,676,27,0.0384068278805121
NORESTE-FRONTERA,2024-01-24,659,644,15,0.0227617602427921
NORESTE-FRONTERA,2024-01-25,733,717,16,0.0218281036834925
NORESTE-FRONTERA,2024-01-26,727,700,27,0.0371389270976616
NORESTE-FRONTERA,2024-01-27,795,777,18,0.0226415094339623
NORESTE-FRONTERA,2024-01-28,570,556,14,0.0245614035087719
NORESTE-FRONTERA,2024-01-29,653,632,21,0.0321592649310873
NORESTE-FRONTERA,2024-01-30,565,547,18,0.031858407079646
NORESTE-FRONTERA,2024-01-31,693,676,17,0.0245310245310245
NORESTE-FRONTERA,2024-02-01,639,621,18,0.028169014084507
NORESTE-FRONTERA,2024-02-02,657,637,20,0.030441400304414
NORESTE-FRONTERA,2024-02-03,729,706,23,0.0315500685871056
NORESTE-FRONTERA,2024-02-04,551,542,9,0.0163339382940109
NORESTE-FRONTERA,2024-02-05,488,481,7,0.014344262295082
NORESTE-FRONTERA,2024-02-06,616,604,12,0.0194805194805195
NORESTE-FRONTERA,2024-02-07,662,646,16,0.0241691842900302
NORESTE-FRONTERA,2024-02-08,724,721,3,0.00414364640883978
NORESTE-FRONTERA,2024-02-09,664,651,13,0.019578313253012
NORESTE-FRONTERA,2024-02-10,776,763,13,0.0167525773195876
NORESTE-FRONTERA,2024-02-11,534,528,6,0.0112359550561798
NORESTE-FRONTERA,2024-02-12,516,502,14,0.0271317829457364
NORESTE-FRONTERA,2024-02-13,678,668,10,0.0147492625368732
NORESTE-FRONTERA,2024-02-14,620,606,14,0.0225806451612903
NORESTE-FRONTERA,2024-02-15,607,596,11,0.0181219110378913
NORESTE-FRONTERA,2024-02-16,665,651,14,0.0210526315789474
NORESTE-FRONTERA,2024-02-17,599,587,12,0.0200333889816361
NORESTE-FRONTERA,2024-02-18,646,639,7,0.0108359133126935
NORESTE-FRONTERA,2024-02-19,595,583,12,0.0201680672268908
NORESTE-FRONTERA,2024-02-20,678,668,10,0.0147492625368732
NORESTE-FRONTERA,2024-02-21,673,662,11,0.0163447251114413
NORESTE-FRONTERA,2024-02-22,754,746,8,0.0106100795755968
NORESTE-FRONTERA,2024-02-23,549,488,61,0.111111111111111
NORESTE-FRONTERA,2024-02-24,833,821,12,0.014405762304922
NORESTE-FRONTERA,2024-02-25,589,582,7,0.0118845500848896
NORESTE-FRONTERA,2024-02-26,675,661,14,0.0207407407407407
NORESTE-FRONTERA,2024-02-27,676,665,11,0.0162721893491124
NORESTE-FRONTERA,2024-02-28,609,598,11,0.0180623973727422
NORESTE-FRONTERA,2024-02-29,697,680,17,0.024390243902439
NORESTE-FRONTERA,2024-03-01,658,640,18,0.027355623100304
NORESTE-FRONTERA,2024-03-02,714,704,10,0.0140056022408964
NORESTE-FRONTERA,2024-03-03,556,549,7,0.012589928057554
NORESTE-FRONTERA,2024-03-04,605,591,14,0.0231404958677686
NORESTE-FRONTERA,2024-03-05,601,588,13,0.021630615640599
NORESTE-FRONTERA,2024-03-06,677,664,13,0.0192023633677991
NORESTE-FRONTERA,2024-03-07,678,668,10,0.0147492625368732
NORESTE-FRONTERA,2024-03-08,644,630,14,0.0217391304347826
NORESTE-FRONTERA,2024-03-09,756,742,14,0.0185185185185185
NORESTE-FRONTERA,2024-03-10,569,559,10,0.0175746924428823
NORESTE-FRONTERA,2024-03-11,584,576,8,0.0136986301369863
NORESTE-FRONTERA,2024-03-12,566,563,3,0.00530035335689046
NORESTE-FRONTERA,2024-03-13,628,617,11,0.017515923566879
NORESTE-FRONTERA,2024-03-14,648,640,8,0.0123456790123457
NORESTE-FRONTERA,2024-03-15,669,659,10,0.0149476831091181
NORESTE-FRONTERA,2024-03-16,763,753,10,0.0131061598951507
NORESTE-FRONTERA,2024-03-17,575,563,12,0.0208695652173913
NORESTE-FRONTERA,2024-03-18,469,461,8,0.0170575692963753
NORESTE-FRONTERA,2024-03-19,593,580,13,0.0219224283305228
NORESTE-FRONTERA,2024-03-20,626,614,12,0.0191693290734824
NORESTE-FRONTERA,2024-03-21,580,571,9,0.0155172413793103
NORESTE-FRONTERA,2024-03-22,634,619,15,0.0236593059936909
NORESTE-FRONTERA,2024-03-23,712,695,17,0.023876404494382
NORESTE-FRONTERA,2024-03-24,491,483,8,0.0162932790224033
NORESTE-FRONTERA,2024-03-25,611,598,13,0.0212765957446809
NORESTE-FRONTERA,2024-03-26,677,664,13,0.0192023633677991
NORESTE-FRONTERA,2024-03-27,703,690,13,0.0184921763869132
NORESTE-FRONTERA,2024-03-28,809,790,19,0.0234857849196539
NORESTE-FRONTERA,2024-03-29,728,710,18,0.0247252747252747
NORESTE-FRONTERA,2024-03-30,653,638,15,0.0229709035222052
NORESTE-FRONTERA,2024-03-31,472,457,15,0.0317796610169492
NORESTE-FRONTERA,2024-04-01,607,595,12,0.0197693574958814
NORESTE-FRONTERA,2024-04-02,644,629,15,0.0232919254658385
NORESTE-FRONTERA,2024-04-03,631,631,0,0
NORESTE-FRONTERA,2024-04-04,622,622,0,0
NORESTE-FRONTERA,2024-04-05,687,673,14,0.0203784570596798
NORESTE-FRONTERA,2024-04-06,733,729,4,0.00545702592087312
NORESTE-FRONTERA,2024-04-07,527,518,9,0.0170777988614801
NORESTE-FRONTERA,2024-04-08,529,522,7,0.0132325141776938
NORESTE-FRONTERA,2024-04-09,594,582,12,0.0202020202020202
NORESTE-FRONTERA,2024-04-10,606,592,14,0.0231023102310231
NORESTE-FRONTERA,2024-04-11,609,603,6,0.00985221674876847
NORESTE-FRONTERA,2024-04-12,644,632,12,0.0186335403726708
NORESTE-FRONTERA,2024-04-13,789,775,14,0.017743979721166
NORESTE-FRONTERA,2024-04-14,581,575,6,0.0103270223752151
NORESTE-FRONTERA,2024-04-15,641,629,12,0.0187207488299532
NORESTE-FRONTERA,2024-04-16,643,601,42,0.0653188180404355
NORESTE-FRONTERA,2024-04-17,721,678,43,0.0596393897364771
NORESTE-FRONTERA,2024-04-18,609,596,13,0.0213464696223317
NORESTE-FRONTERA,2024-04-19,613,580,33,0.0538336052202284
NORESTE-FRONTERA,2024-04-20,706,682,24,0.0339943342776204
NORESTE-FRONTERA,2024-04-21,472,460,12,0.0254237288135593
NORESTE-FRONTERA,2024-04-22,306,292,14,0.0457516339869281
NORESTE-FRONTERA,2024-04-23,819,776,43,0.0525030525030525
NORESTE-FRONTERA,2024-04-24,617,596,21,0.0340356564019449
NORESTE-FRONTERA,2024-04-25,595,582,13,0.0218487394957983
NORESTE-FRONTERA,2024-04-26,677,664,13,0.0192023633677991
NORESTE-FRONTERA,2024-04-27,661,629,32,0.048411497730711
NORESTE-FRONTERA,2024-04-28,542,527,15,0.0276752767527675
NORESTE-FRONTERA,2024-04-29,620,604,16,0.0258064516129032
NORESTE-FRONTERA,2024-04-30,570,558,12,0.0210526315789474
NORESTE-FRONTERA,2024-05-01,420,410,10,0.0238095238095238
NORESTE-FRONTERA,2024-05-02,565,554,11,0.0194690265486726
NORESTE-FRONTERA,2024-05-03,651,633,18,0.0276497695852535
NORESTE-FRONTERA,2024-05-04,693,677,16,0.0230880230880231
NORESTE-FRONTERA,2024-05-05,515,502,13,0.0252427184466019
NORESTE-FRONTERA,2024-05-06,570,570,0,0
NORESTE-FRONTERA,2024-05-07,591,578,13,0.0219966159052453
NORESTE-FRONTERA,2024-05-08,554,541,13,0.0234657039711191
NORESTE-FRONTERA,2024-05-09,583,558,25,0.0428816466552316
NORESTE-FRONTERA,2024-05-10,533,517,16,0.0300187617260788
NORESTE-FRONTERA,2024-05-11,620,606,14,0.0225806451612903
NORESTE-FRONTERA,2024-05-12,384,374,10,0.0260416666666667
NORESTE-FRONTERA,2024-05-13,534,513,21,0.0393258426966292
NORESTE-FRONTERA,2024-05-14,585,562,23,0.0393162393162393
NORESTE-FRONTERA,2024-05-15,606,588,18,0.0297029702970297
NORESTE-FRONTERA,2024-05-16,632,591,41,0.064873417721519
NORESTE-FRONTERA,2024-05-17,700,678,22,0.0314285714285714
NORESTE-FRONTERA,2024-05-18,766,751,15,0.0195822454308094
NORESTE-FRONTERA,2024-05-19,585,571,14,0.0239316239316239
NORESTE-FRONTERA,2024-05-20,652,636,16,0.0245398773006135
NORESTE-FRONTERA,2024-05-21,580,569,11,0.0189655172413793
NORESTE-FRONTERA,2024-05-22,649,631,18,0.0277349768875193
NORESTE-FRONTERA,2024-05-23,584,570,14,0.023972602739726
NORESTE-FRONTERA,2024-05-24,578,564,14,0.0242214532871972
NORESTE-FRONTERA,2024-05-25,703,690,13,0.0184921763869132
NORESTE-FRONTERA,2024-05-26,459,449,10,0.0217864923747277
NORESTE-FRONTERA,2024-05-27,536,524,12,0.0223880597014925
NORESTE-FRONTERA,2024-05-28,576,567,9,0.015625
NORESTE-FRONTERA,2024-05-29,537,527,10,0.0186219739292365
NORESTE-FRONTERA,2024-05-30,536,523,13,0.0242537313432836
NORESTE-FRONTERA,2024-05-31,576,558,18,0.03125
NORESTE-FRONTERA,2024-06-01,512,500,12,0.0234375
NORESTE-FRONTERA,2024-06-02,198,197,1,0.00505050505050505
NORESTE-FRONTERA,2024-06-03,373,369,4,0.0107238605898123
NORESTE-FRONTERA,2024-06-04,621,602,19,0.0305958132045089
NORESTE-FRONTERA,2024-06-05,609,581,28,0.0459770114942529
NORESTE-FRONTERA,2024-06-06,519,499,20,0.0385356454720617
NORESTE-FRONTERA,2024-06-07,556,537,19,0.0341726618705036
NORESTE-FRONTERA,2024-06-08,631,608,23,0.0364500792393027
NORESTE-FRONTERA,2024-06-09,519,505,14,0.0269749518304432
NORESTE-FRONTERA,2024-06-10,540,518,22,0.0407407407407407
NORESTE-FRONTERA,2024-06-11,700,690,10,0.0142857142857143
NORESTE-FRONTERA,2024-06-12,651,642,9,0.0138248847926267
NORESTE-FRONTERA,2024-06-13,610,590,20,0.0327868852459016
NORESTE-FRONTERA,2024-06-14,382,373,9,0.0235602094240838
NORESTE-FRONTERA,2024-06-15,365,350,15,0.0410958904109589
NORESTE-FRONTERA,2024-06-16,258,255,3,0.0116279069767442
NORESTE-FRONTERA,2024-06-17,366,360,6,0.0163934426229508
NORESTE-FRONTERA,2024-06-18,607,596,11,0.0181219110378913
NORESTE-FRONTERA,2024-06-19,452,439,13,0.0287610619469027
NORESTE-FRONTERA,2024-06-20,312,304,8,0.0256410256410256
NORESTE-FRONTERA,2024-06-21,414,406,8,0.0193236714975845
NORESTE-FRONTERA,2024-06-22,428,415,13,0.0303738317757009
NORESTE-FRONTERA,2024-06-23,410,398,12,0.0292682926829268
NORESTE-FRONTERA,2024-06-24,359,353,6,0.0167130919220056
NORESTE-FRONTERA,2024-06-25,459,444,15,0.0326797385620915
NORESTE-FRONTERA,2024-06-26,450,438,12,0.0266666666666667
NORESTE-FRONTERA,2024-06-27,608,590,18,0.0296052631578947
NORESTE-FRONTERA,2024-06-28,544,526,18,0.0330882352941176
NORESTE-FRONTERA,2024-06-29,545,536,9,0.0165137614678899
NORESTE-FRONTERA,2024-06-30,403,396,7,0.0173697270471464
NORESTE-FRONTERA,2024-07-01,271,263,8,0.029520295202952
NORESTE-FRONTERA,2024-07-02,366,355,11,0.0300546448087432
NORESTE-FRONTERA,2024-07-03,563,552,11,0.019538188277087
NORESTE-FRONTERA,2024-07-04,519,502,17,0.0327552986512524
NORESTE-FRONTERA,2024-07-05,434,419,15,0.0345622119815668
NORESTE-FRONTERA,2024-07-06,499,485,14,0.0280561122244489
NORESTE-FRONTERA,2024-07-07,419,414,5,0.0119331742243437
NORESTE-FRONTERA,2024-07-08,529,522,7,0.0132325141776938
NORESTE-FRONTERA,2024-07-09,541,531,10,0.0184842883548983
NORESTE-FRONTERA,2024-07-10,558,558,0,0
NORESTE-FRONTERA,2024-07-11,555,546,9,0.0162162162162162
NORESTE-FRONTERA,2024-07-12,733,717,16,0.0218281036834925
NORESTE-FRONTERA,2024-07-13,707,703,4,0.00565770862800566
NORESTE-FRONTERA,2024-07-14,389,382,7,0.0179948586118252
NORESTE-FRONTERA,2024-07-15,643,628,15,0.0233281493001555
NORESTE-FRONTERA,2024-07-16,607,585,22,0.0362438220757825
NORESTE-FRONTERA,2024-07-17,674,663,11,0.0163204747774481
NORESTE-FRONTERA,2024-07-18,636,618,18,0.0283018867924528
NORESTE-FRONTERA,2024-07-19,702,682,20,0.0284900284900285
NORESTE-FRONTERA,2024-07-20,723,707,16,0.0221300138312586
NORESTE-FRONTERA,2024-07-21,530,518,12,0.0226415094339623
NORESTE-FRONTERA,2024-07-22,600,577,23,0.0383333333333333
NORESTE-FRONTERA,2024-07-23,672,649,23,0.0342261904761905
NORESTE-FRONTERA,2024-07-24,559,538,21,0.037567084078712
NORESTE-FRONTERA,2024-07-25,667,641,26,0.0389805097451274
NORESTE-FRONTERA,2024-07-26,707,684,23,0.0325318246110325
NORESTE-FRONTERA,2024-07-27,699,682,17,0.0243204577968526
NORESTE-FRONTERA,2024-07-28,568,555,13,0.022887323943662
NORESTE-FRONTERA,2024-07-29,653,636,17,0.0260336906584992
NORESTE-FRONTERA,2024-07-30,671,648,23,0.0342771982116244
NORESTE-FRONTERA,2024-07-31,667,648,19,0.0284857571214393
NORESTE-FRONTERA,2024-08-01,549,527,22,0.0400728597449909
NORESTE-FRONTERA,2024-08-02,597,574,23,0.0385259631490787
NORESTE-FRONTERA,2024-08-03,692,671,21,0.0303468208092486
NORESTE-FRONTERA,2024-08-04,567,559,8,0.0141093474426808
NORESTE-FRONTERA,2024-08-05,598,576,22,0.0367892976588629
NORESTE-FRONTERA,2024-08-06,570,543,27,0.0473684210526316
NORESTE-FRONTERA,2024-08-07,674,649,25,0.0370919881305638
NORESTE-FRONTERA,2024-08-08,685,659,26,0.037956204379562
NORESTE-FRONTERA,2024-08-09,714,696,18,0.0252100840336134
NORESTE-FRONTERA,2024-08-10,733,713,20,0.0272851296043656
NORESTE-FRONTERA,2024-08-11,513,505,8,0.0155945419103314
NORESTE-FRONTERA,2024-08-12,586,573,13,0.0221843003412969
NORESTE-FRONTERA,2024-08-13,678,657,21,0.0309734513274336
NORESTE-FRONTERA,2024-08-14,606,584,22,0.0363036303630363
NORESTE-FRONTERA,2024-08-15,573,553,20,0.0349040139616056
NORESTE-FRONTERA,2024-08-16,606,589,17,0.0280528052805281
NORESTE-FRONTERA,2024-08-17,686,662,24,0.0349854227405248
NORESTE-FRONTERA,2024-08-18,567,551,16,0.0282186948853616
NORTE,2023-08-19,361,351,10,0.0277008310249307
NORTE,2023-08-20,65,65,0,0
NORTE,2023-08-21,189,185,4,0.0211640211640212
NORTE,2023-08-22,293,284,9,0.0307167235494881
NORTE,2023-08-23,294,285,9,0.0306122448979592
NORTE,2023-08-24,300,297,3,0.01
NORTE,2023-08-25,309,297,12,0.0388349514563107
NORTE,2023-08-26,372,362,10,0.0268817204301075
NORTE,2023-08-27,301,297,4,0.0132890365448505
NORTE,2023-08-28,361,352,9,0.0249307479224377
NORTE,2023-08-29,332,332,0,0
NORTE,2023-08-30,359,359,0,0
NORTE,2023-08-31,364,363,1,0.00274725274725275
NORTE,2023-09-01,300,297,3,0.01
NORTE,2023-09-02,373,370,3,0.00804289544235925
NORTE,2023-09-03,280,278,2,0.00714285714285714
NORTE,2023-09-04,319,318,1,0.00313479623824451
NORTE,2023-09-05,327,325,2,0.00611620795107034
NORTE,2023-09-06,307,304,3,0.00977198697068404
NORTE,2023-09-07,304,304,0,0
NORTE,2023-09-08,375,373,2,0.00533333333333333
NORTE,2023-09-09,404,399,5,0.0123762376237624
NORTE,2023-09-10,292,289,3,0.0102739726027397
NORTE,2023-09-11,319,314,5,0.0156739811912226
NORTE,2023-09-12,309,309,0,0
NORTE,2023-09-13,305,303,2,0.00655737704918033
NORTE,2023-09-14,280,279,1,0.00357142857142857
NORTE,2023-09-15,321,320,1,0.00311526479750779
NORTE,2023-09-16,241,239,2,0.00829875518672199
NORTE,2023-09-17,302,301,1,0.0033112582781457
NORTE,2023-09-18,388,388,0,0
NORTE,2023-09-19,365,362,3,0.00821917808219178
NORTE,2023-09-20,316,313,3,0.00949367088607595
NORTE,2023-09-21,345,340,5,0.0144927536231884
NORTE,2023-09-22,364,356,8,0.021978021978022
NORTE,2023-09-23,424,415,9,0.0212264150943396
NORTE,2023-09-24,302,299,3,0.00993377483443709
NORTE,2023-09-25,295,293,2,0.00677966101694915
NORTE,2023-09-26,344,339,5,0.0145348837209302
NORTE,2023-09-27,322,319,3,0.0093167701863354
NORTE,2023-09-28,331,330,1,0.00302114803625378
NORTE,2023-09-29,348,343,5,0.014367816091954
NORTE,2023-09-30,396,393,3,0.00757575757575758
NORTE,2023-10-01,274,271,3,0.0109489051094891
NORTE,2023-10-02,272,270,2,0.00735294117647059
NORTE,2023-10-03,329,321,8,0.0243161094224924
NORTE,2023-10-04,311,304,7,0.022508038585209
NORTE,2023-10-05,338,334,4,0.0118343195266272
NORTE,2023-10-06,375,360,15,0.04
NORTE,2023-10-07,387,380,7,0.0180878552971576
NORTE,2023-10-08,312,306,6,0.0192307692307692
NORTE,2023-10-09,306,299,7,0.0228758169934641
NORTE,2023-10-10,322,314,8,0.0248447204968944
NORTE,2023-10-11,275,272,3,0.0109090909090909
NORTE,2023-10-12,319,313,6,0.0188087774294671
NORTE,2023-10-13,311,298,13,0.0418006430868167
NORTE,2023-10-14,358,350,8,0.0223463687150838
NORTE,2023-10-15,312,307,5,0.016025641025641
NORTE,2023-10-16,333,327,6,0.018018018018018
NORTE,2023-10-17,314,310,4,0.0127388535031847
NORTE,2023-10-18,284,274,10,0.0352112676056338
NORTE,2023-10-19,319,313,6,0.0188087774294671
NORTE,2023-10-20,356,350,6,0.0168539325842697
NORTE,2023-10-21,461,451,10,0.0216919739696312
NORTE,2023-10-22,290,281,9,0.0310344827586207
NORTE,2023-10-23,312,305,7,0.0224358974358974
NORTE,2023-10-24,318,309,9,0.0283018867924528
NORTE,2023-10-25,320,308,12,0.0375
NORTE,2023-10-26,319,313,6,0.0188087774294671
NORTE,2023-10-27,350,343,7,0.02
NORTE,2023-10-28,360,358,2,0.00555555555555556
NORTE,2023-10-29,265,259,6,0.0226415094339623
NORTE,2023-10-30,283,274,9,0.0318021201413428
NORTE,2023-10-31,274,269,5,0.0182481751824818
NORTE,2023-11-01,314,308,6,0.0191082802547771
NORTE,2023-11-02,359,352,7,0.0194986072423398
NORTE,2023-11-03,314,305,9,0.0286624203821656
NORTE,2023-11-04,428,417,11,0.0257009345794393
NORTE,2023-11-05,327,323,4,0.0122324159021407
NORTE,2023-11-06,337,329,8,0.0237388724035608
NORTE,2023-11-07,358,351,7,0.0195530726256983
NORTE,2023-11-08,377,367,10,0.026525198938992
NORTE,2023-11-09,362,355,7,0.0193370165745856
NORTE,2023-11-10,387,380,7,0.0180878552971576
NORTE,2023-11-11,457,449,8,0.0175054704595186
NORTE,2023-11-12,354,342,12,0.0338983050847458
NORTE,2023-11-13,318,311,7,0.0220125786163522
NORTE,2023-11-14,377,366,11,0.0291777188328912
NORTE,2023-11-15,326,322,4,0.0122699386503067
NORTE,2023-11-16,359,350,9,0.0250696378830084
NORTE,2023-11-17,380,375,5,0.0131578947368421
NORTE,2023-11-18,497,486,11,0.0221327967806841
NORTE,2023-11-19,377,368,9,0.0238726790450928
NORTE,2023-11-20,296,288,8,0.027027027027027
NORTE,2023-11-21,425,413,12,0.0282352941176471
NORTE,2023-11-22,350,343,7,0.02
NORTE,2023-11-23,402,391,11,0.027363184079602
NORTE,2023-11-24,426,419,7,0.0164319248826291
NORTE,2023-11-25,460,451,9,0.0195652173913043
NORTE,2023-11-26,344,342,2,0.00581395348837209
NORTE,2023-11-27,348,342,6,0.0172413793103448
NORTE,2023-11-28,394,388,6,0.0152284263959391
NORTE,2023-11-29,349,335,14,0.0401146131805158
NORTE,2023-11-30,320,316,4,0.0125
NORTE,2023-12-01,376,363,13,0.0345744680851064
NORTE,2023-12-02,461,452,9,0.0195227765726681
NORTE,2023-12-03,354,347,7,0.019774011299435
NORTE,2023-12-04,382,367,15,0.0392670157068063
NORTE,2023-12-05,387,375,12,0.0310077519379845
NORTE,2023-12-06,371,363,8,0.0215633423180593
NORTE,2023-12-07,366,353,13,0.0355191256830601
NORTE,2023-12-08,389,383,6,0.0154241645244216
NORTE,2023-12-09,410,404,6,0.0146341463414634
NORTE,2023-12-10,349,340,9,0.0257879656160458
NORTE,2023-12-11,342,337,5,0.0146198830409357
NORTE,2023-12-12,360,355,5,0.0138888888888889
NORTE,2023-12-13,360,350,10,0.0277777777777778
NORTE,2023-12-14,340,331,9,0.0264705882352941
NORTE,2023-12-15,340,332,8,0.0235294117647059
NORTE,2023-12-16,397,391,6,0.0151133501259446
NORTE,2023-12-17,341,336,5,0.0146627565982405
NORTE,2023-12-18,333,327,6,0.018018018018018
NORTE,2023-12-19,404,396,8,0.0198019801980198
NORTE,2023-12-20,392,375,17,0.0433673469387755
NORTE,2023-12-21,407,398,9,0.0221130221130221
NORTE,2023-12-22,360,352,8,0.0222222222222222
NORTE,2023-12-23,402,397,5,0.0124378109452736
NORTE,2023-12-24,155,150,5,0.032258064516129
NORTE,2023-12-25,16,15,1,0.0625
NORTE,2023-12-26,384,376,8,0.0208333333333333
NORTE,2023-12-27,376,365,11,0.0292553191489362
NORTE,2023-12-28,413,401,12,0.0290556900726392
NORTE,2023-12-29,406,402,4,0.00985221674876847
NORTE,2023-12-30,385,376,9,0.0233766233766234
NORTE,2023-12-31,160,157,3,0.01875
NORTE,2024-01-01,11,11,0,0
NORTE,2024-01-02,337,331,6,0.0178041543026706
NORTE,2024-01-03,336,329,7,0.0208333333333333
NORTE,2024-01-04,402,393,9,0.0223880597014925
NORTE,2024-01-05,434,424,10,0.0230414746543779
NORTE,2024-01-06,464,456,8,0.0172413793103448
NORTE,2024-01-07,368,363,5,0.0135869565217391
NORTE,2024-01-08,293,284,9,0.0307167235494881
NORTE,2024-01-09,432,422,10,0.0231481481481481
NORTE,2024-01-10,425,416,9,0.0211764705882353
NORTE,2024-01-11,319,309,10,0.0313479623824451
NORTE,2024-01-12,407,398,9,0.0221130221130221
NORTE,2024-01-13,488,479,9,0.0184426229508197
NORTE,2024-01-14,367,364,3,0.00817438692098093
NORTE,2024-01-15,267,255,12,0.0449438202247191
NORTE,2024-01-16,457,448,9,0.0196936542669584
NORTE,2024-01-17,394,388,6,0.0152284263959391
NORTE,2024-01-18,453,447,6,0.0132450331125828
NORTE,2024-01-19,381,371,10,0.026246719160105
NORTE,2024-01-20,373,365,8,0.0214477211796247
NORTE,2024-01-21,371,365,6,0.0161725067385445
NORTE,2024-01-22,211,205,6,0.028436018957346
NORTE,2024-01-23,372,367,5,0.0134408602150538
NORTE,2024-01-24,399,378,21,0.0526315789473684
NORTE,2024-01-25,346,341,5,0.0144508670520231
NORTE,2024-01-26,419,412,7,0.0167064439140811
NORTE,2024-01-27,497,487,10,0.0201207243460765
NORTE,2024-01-28,349,347,2,0.00573065902578797
NORTE,2024-01-29,306,298,8,0.0261437908496732
NORTE,2024-01-30,365,355,10,0.0273972602739726
NORTE,2024-01-31,385,379,6,0.0155844155844156
NORTE,2024-02-01,225,218,7,0.0311111111111111
NORTE,2024-02-02,413,403,10,0.0242130750605327
NORTE,2024-02-03,465,453,12,0.0258064516129032
NORTE,2024-02-04,420,409,11,0.0261904761904762
NORTE,2024-02-05,220,216,4,0.0181818181818182
NORTE,2024-02-06,341,332,9,0.0263929618768328
NORTE,2024-02-07,383,370,13,0.0339425587467363
NORTE,2024-02-08,381,376,5,0.0131233595800525
NORTE,2024-02-09,388,381,7,0.0180412371134021
NORTE,2024-02-10,504,494,10,0.0198412698412698
NORTE,2024-02-11,354,349,5,0.0141242937853107
NORTE,2024-02-12,277,268,9,0.0324909747292419
NORTE,2024-02-13,432,429,3,0.00694444444444444
NORTE,2024-02-14,387,385,2,0.00516795865633075
NORTE,2024-02-15,303,299,4,0.0132013201320132
NORTE,2024-02-16,448,440,8,0.0178571428571429
NORTE,2024-02-17,499,495,4,0.00801603206412826
NORTE,2024-02-18,380,376,4,0.0105263157894737
NORTE,2024-02-19,374,370,4,0.0106951871657754
NORTE,2024-02-20,393,384,9,0.0229007633587786
NORTE,2024-02-21,399,393,6,0.0150375939849624
NORTE,2024-02-22,384,374,10,0.0260416666666667
NORTE,2024-02-23,243,210,33,0.135802469135802
NORTE,2024-02-24,508,502,6,0.0118110236220472
NORTE,2024-02-25,341,337,4,0.0117302052785924
NORTE,2024-02-26,342,338,4,0.0116959064327485
NORTE,2024-02-27,376,363,13,0.0345744680851064
NORTE,2024-02-28,346,331,15,0.0433526011560694
NORTE,2024-02-29,362,355,7,0.0193370165745856
NORTE,2024-03-01,369,364,5,0.013550135501355
NORTE,2024-03-02,418,412,6,0.0143540669856459
NORTE,2024-03-03,345,341,4,0.0115942028985507
NORTE,2024-03-04,348,340,8,0.0229885057471264
NORTE,2024-03-05,352,347,5,0.0142045454545455
NORTE,2024-03-06,343,339,4,0.0116618075801749
NORTE,2024-03-07,372,367,5,0.0134408602150538
NORTE,2024-03-08,394,385,9,0.0228426395939086
NORTE,2024-03-09,442,437,5,0.0113122171945701
NORTE,2024-03-10,351,347,4,0.0113960113960114
NORTE,2024-03-11,331,323,8,0.0241691842900302
NORTE,2024-03-12,382,374,8,0.0209424083769634
NORTE,2024-03-13,325,314,11,0.0338461538461538
NORTE,2024-03-14,362,355,7,0.0193370165745856
NORTE,2024-03-15,360,354,6,0.0166666666666667
NORTE,2024-03-16,439,436,3,0.00683371298405467
NORTE,2024-03-17,338,334,4,0.0118343195266272
NORTE,2024-03-18,240,233,7,0.0291666666666667
NORTE,2024-03-19,361,354,7,0.0193905817174515
NORTE,2024-03-20,357,351,6,0.0168067226890756
NORTE,2024-03-21,351,347,4,0.0113960113960114
NORTE,2024-03-22,354,346,8,0.0225988700564972
NORTE,2024-03-23,436,428,8,0.018348623853211
NORTE,2024-03-24,230,226,4,0.0173913043478261
NORTE,2024-03-25,284,275,9,0.0316901408450704
NORTE,2024-03-26,405,395,10,0.0246913580246914
NORTE,2024-03-27,378,369,9,0.0238095238095238
NORTE,2024-03-28,437,431,6,0.0137299771167048
NORTE,2024-03-29,442,434,8,0.0180995475113122
NORTE,2024-03-30,281,277,4,0.0142348754448399
NORTE,2024-03-31,269,264,5,0.0185873605947955
NORTE,2024-04-01,356,346,10,0.0280898876404494
NORTE,2024-04-02,384,377,7,0.0182291666666667
NORTE,2024-04-03,311,311,0,0
NORTE,2024-04-04,323,323,0,0
NORTE,2024-04-05,377,373,4,0.0106100795755968
NORTE,2024-04-06,405,401,4,0.00987654320987654
NORTE,2024-04-07,290,281,9,0.0310344827586207
NORTE,2024-04-08,324,316,8,0.0246913580246914
NORTE,2024-04-09,351,341,10,0.0284900284900285
NORTE,2024-04-10,284,276,8,0.028169014084507
NORTE,2024-04-11,369,364,5,0.013550135501355
NORTE,2024-04-12,373,363,10,0.0268096514745308
NORTE,2024-04-13,424,414,10,0.0235849056603774
NORTE,2024-04-14,283,278,5,0.0176678445229682
NORTE,2024-04-15,321,317,4,0.0124610591900312
NORTE,2024-04-16,360,338,22,0.0611111111111111
NORTE,2024-04-17,320,303,17,0.053125
NORTE,2024-04-18,325,317,8,0.0246153846153846
NORTE,2024-04-19,370,355,15,0.0405405405405405
NORTE,2024-04-20,417,407,10,0.0239808153477218
NORTE,2024-04-21,298,294,4,0.0134228187919463
NORTE,2024-04-22,145,138,7,0.0482758620689655
NORTE,2024-04-23,449,410,39,0.0868596881959911
NORTE,2024-04-24,325,308,17,0.0523076923076923
NORTE,2024-04-25,316,310,6,0.0189873417721519
NORTE,2024-04-26,396,389,7,0.0176767676767677
NORTE,2024-04-27,411,396,15,0.0364963503649635
NORTE,2024-04-28,283,279,4,0.0141342756183746
NORTE,2024-04-29,330,322,8,0.0242424242424242
NORTE,2024-04-30,309,300,9,0.029126213592233
NORTE,2024-05-01,294,289,5,0.0170068027210884
NORTE,2024-05-02,346,336,10,0.0289017341040462
NORTE,2024-05-03,392,385,7,0.0178571428571429
NORTE,2024-05-04,452,440,12,0.0265486725663717
NORTE,2024-05-05,261,253,8,0.0306513409961686
NORTE,2024-05-06,331,331,0,0
NORTE,2024-05-07,303,288,15,0.0495049504950495
NORTE,2024-05-08,316,298,18,0.0569620253164557
NORTE,2024-05-09,348,336,12,0.0344827586206897
NORTE,2024-05-10,296,284,12,0.0405405405405405
NORTE,2024-05-11,377,368,9,0.0238726790450928
NORTE,2024-05-12,279,270,9,0.032258064516129
NORTE,2024-05-13,319,305,14,0.0438871473354232
NORTE,2024-05-14,338,333,5,0.014792899408284
NORTE,2024-05-15,346,335,11,0.0317919075144509
NORTE,2024-05-16,346,301,45,0.130057803468208
NORTE,2024-05-17,378,365,13,0.0343915343915344
NORTE,2024-05-18,466,449,17,0.036480686695279
NORTE,2024-05-19,338,324,14,0.0414201183431953
NORTE,2024-05-20,298,291,7,0.023489932885906
NORTE,2024-05-21,368,362,6,0.016304347826087
NORTE,2024-05-22,321,311,10,0.0311526479750779
NORTE,2024-05-23,333,329,4,0.012012012012012
NORTE,2024-05-24,355,348,7,0.0197183098591549
NORTE,2024-05-25,471,461,10,0.0212314225053079
NORTE,2024-05-26,299,293,6,0.020066889632107
NORTE,2024-05-27,326,317,9,0.0276073619631902
NORTE,2024-05-28,356,351,5,0.0140449438202247
NORTE,2024-05-29,301,289,12,0.0398671096345515
NORTE,2024-05-30,294,287,7,0.0238095238095238
NORTE,2024-05-31,343,336,7,0.0204081632653061
NORTE,2024-06-01,404,398,6,0.0148514851485149
NORTE,2024-06-02,271,266,5,0.018450184501845
NORTE,2024-06-03,331,320,11,0.0332326283987915
NORTE,2024-06-04,384,374,10,0.0260416666666667
NORTE,2024-06-05,373,366,7,0.0187667560321716
NORTE,2024-06-06,331,322,9,0.027190332326284
NORTE,2024-06-07,344,334,10,0.0290697674418605
NORTE,2024-06-08,387,370,17,0.0439276485788114
NORTE,2024-06-09,282,272,10,0.0354609929078014
NORTE,2024-06-10,314,303,11,0.035031847133758
NORTE,2024-06-11,372,360,12,0.032258064516129
NORTE,2024-06-12,337,329,8,0.0237388724035608
NORTE,2024-06-13,335,333,2,0.00597014925373134
NORTE,2024-06-14,340,331,9,0.0264705882352941
NORTE,2024-06-15,392,383,9,0.0229591836734694
NORTE,2024-06-16,248,241,7,0.0282258064516129
NORTE,2024-06-17,304,295,9,0.0296052631578947
NORTE,2024-06-18,368,355,13,0.0353260869565217
NORTE,2024-06-19,289,281,8,0.027681660899654
NORTE,2024-06-20,255,250,5,0.0196078431372549
NORTE,2024-06-21,357,344,13,0.0364145658263305
NORTE,2024-06-22,504,490,14,0.0277777777777778
NORTE,2024-06-23,308,297,11,0.0357142857142857
NORTE,2024-06-24,397,382,15,0.0377833753148615
NORTE,2024-06-25,379,364,15,0.0395778364116095
NORTE,2024-06-26,344,330,14,0.0406976744186047
NORTE,2024-06-27,332,317,15,0.0451807228915663
NORTE,2024-06-28,341,332,9,0.0263929618768328
NORTE,2024-06-29,434,419,15,0.0345622119815668
NORTE,2024-06-30,295,286,9,0.0305084745762712
NORTE,2024-07-01,258,252,6,0.0232558139534884
NORTE,2024-07-02,347,340,7,0.0201729106628242
NORTE,2024-07-03,309,299,10,0.0323624595469256
NORTE,2024-07-04,262,253,9,0.0343511450381679
NORTE,2024-07-05,296,290,6,0.0202702702702703
NORTE,2024-07-06,362,355,7,0.0193370165745856
NORTE,2024-07-07,272,264,8,0.0294117647058824
NORTE,2024-07-08,284,277,7,0.0246478873239437
NORTE,2024-07-09,302,287,15,0.0496688741721854
NORTE,2024-07-10,353,353,0,0
NORTE,2024-07-11,333,321,12,0.036036036036036
NORTE,2024-07-12,362,346,16,0.0441988950276243
NORTE,2024-07-13,419,408,11,0.0262529832935561
NORTE,2024-07-14,314,305,9,0.0286624203821656
NORTE,2024-07-15,362,347,15,0.0414364640883978
NORTE,2024-07-16,403,397,6,0.0148883374689826
NORTE,2024-07-17,373,365,8,0.0214477211796247
NORTE,2024-07-18,344,333,11,0.0319767441860465
NORTE,2024-07-19,409,394,15,0.0366748166259169
NORTE,2024-07-20,422,410,12,0.028436018957346
NORTE,2024-07-21,301,288,13,0.0431893687707641
NORTE,2024-07-22,355,344,11,0.0309859154929577
NORTE,2024-07-23,386,372,14,0.0362694300518135
NORTE,2024-07-24,375,365,10,0.0266666666666667
NORTE,2024-07-25,353,346,7,0.0198300283286119
NORTE,2024-07-26,393,377,16,0.0407124681933842
NORTE,2024-07-27,394,377,17,0.0431472081218274
NORTE,2024-07-28,312,307,5,0.016025641025641
NORTE,2024-07-29,333,321,12,0.036036036036036
NORTE,2024-07-30,391,380,11,0.0281329923273657
NORTE,2024-07-31,356,349,7,0.0196629213483146
NORTE,2024-08-01,278,272,6,0.0215827338129496
NORTE,2024-08-02,334,323,11,0.0329341317365269
NORTE,2024-08-03,383,371,12,0.031331592689295
NORTE,2024-08-04,290,283,7,0.0241379310344828
NORTE,2024-08-05,335,319,16,0.0477611940298507
NORTE,2024-08-06,314,300,14,0.0445859872611465
NORTE,2024-08-07,378,365,13,0.0343915343915344
NORTE,2024-08-08,334,326,8,0.0239520958083832
NORTE,2024-08-09,371,359,12,0.032345013477089
NORTE,2024-08-10,466,444,22,0.0472103004291846
NORTE,2024-08-11,282,277,5,0.0177304964539007
NORTE,2024-08-12,316,307,9,0.0284810126582278
NORTE,2024-08-13,394,381,13,0.032994923857868
NORTE,2024-08-14,362,352,10,0.0276243093922652
NORTE,2024-08-15,373,361,12,0.032171581769437
NORTE,2024-08-16,372,350,22,0.0591397849462366
NORTE,2024-08-17,471,455,16,0.0339702760084926
NORTE,2024-08-18,315,301,14,0.0444444444444444
OCCIDENTE-BAJIO,2023-08-19,696,657,39,0.0560344827586207
OCCIDENTE-BAJIO,2023-08-20,443,421,22,0.0496613995485327
OCCIDENTE-BAJIO,2023-08-21,549,529,20,0.0364298724954463
OCCIDENTE-BAJIO,2023-08-22,584,566,18,0.0308219178082192
OCCIDENTE-BAJIO,2023-08-23,566,541,25,0.0441696113074205
OCCIDENTE-BAJIO,2023-08-24,591,568,23,0.038917089678511
OCCIDENTE-BAJIO,2023-08-25,637,623,14,0.021978021978022
OCCIDENTE-BAJIO,2023-08-26,733,708,25,0.034106412005457
OCCIDENTE-BAJIO,2023-08-27,478,462,16,0.0334728033472803
OCCIDENTE-BAJIO,2023-08-28,550,532,18,0.0327272727272727
OCCIDENTE-BAJIO,2023-08-29,646,627,19,0.0294117647058824
OCCIDENTE-BAJIO,2023-08-30,554,543,11,0.01985559566787
OCCIDENTE-BAJIO,2023-08-31,596,576,20,0.0335570469798658
OCCIDENTE-BAJIO,2023-09-01,541,526,15,0.0277264325323475
OCCIDENTE-BAJIO,2023-09-02,594,584,10,0.0168350168350168
OCCIDENTE-BAJIO,2023-09-03,414,406,8,0.0193236714975845
OCCIDENTE-BAJIO,2023-09-04,481,471,10,0.0207900207900208
OCCIDENTE-BAJIO,2023-09-05,584,575,9,0.0154109589041096
OCCIDENTE-BAJIO,2023-09-06,544,528,16,0.0294117647058824
OCCIDENTE-BAJIO,2023-09-07,570,553,17,0.0298245614035088
OCCIDENTE-BAJIO,2023-09-08,531,523,8,0.0150659133709981
OCCIDENTE-BAJIO,2023-09-09,598,586,12,0.020066889632107
OCCIDENTE-BAJIO,2023-09-10,386,378,8,0.0207253886010363
OCCIDENTE-BAJIO,2023-09-11,510,497,13,0.0254901960784314
OCCIDENTE-BAJIO,2023-09-12,543,535,8,0.0147329650092081
OCCIDENTE-BAJIO,2023-09-13,542,531,11,0.0202952029520295
OCCIDENTE-BAJIO,2023-09-14,534,519,15,0.0280898876404494
OCCIDENTE-BAJIO,2023-09-15,614,602,12,0.0195439739413681
OCCIDENTE-BAJIO,2023-09-16,537,527,10,0.0186219739292365
OCCIDENTE-BAJIO,2023-09-17,410,403,7,0.0170731707317073
OCCIDENTE-BAJIO,2023-09-18,525,515,10,0.019047619047619
OCCIDENTE-BAJIO,2023-09-19,543,525,18,0.0331491712707182
OCCIDENTE-BAJIO,2023-09-20,446,437,9,0.0201793721973094
OCCIDENTE-BAJIO,2023-09-21,492,479,13,0.0264227642276423
OCCIDENTE-BAJIO,2023-09-22,540,523,17,0.0314814814814815
OCCIDENTE-BAJIO,2023-09-23,641,624,17,0.0265210608424337
OCCIDENTE-BAJIO,2023-09-24,376,369,7,0.0186170212765957
OCCIDENTE-BAJIO,2023-09-25,486,475,11,0.0226337448559671
OCCIDENTE-BAJIO,2023-09-26,525,511,14,0.0266666666666667
OCCIDENTE-BAJIO,2023-09-27,518,506,12,0.0231660231660232
OCCIDENTE-BAJIO,2023-09-28,564,546,18,0.0319148936170213
OCCIDENTE-BAJIO,2023-09-29,603,583,20,0.033167495854063
OCCIDENTE-BAJIO,2023-09-30,736,708,28,0.0380434782608696
OCCIDENTE-BAJIO,2023-10-01,432,420,12,0.0277777777777778
OCCIDENTE-BAJIO,2023-10-02,500,486,14,0.028
OCCIDENTE-BAJIO,2023-10-03,499,478,21,0.0420841683366733
OCCIDENTE-BAJIO,2023-10-04,461,438,23,0.0498915401301518
OCCIDENTE-BAJIO,2023-10-05,471,445,26,0.0552016985138004
OCCIDENTE-BAJIO,2023-10-06,490,463,27,0.0551020408163265
OCCIDENTE-BAJIO,2023-10-07,616,593,23,0.0373376623376623
OCCIDENTE-BAJIO,2023-10-08,386,369,17,0.0440414507772021
OCCIDENTE-BAJIO,2023-10-09,515,491,24,0.0466019417475728
OCCIDENTE-BAJIO,2023-10-10,432,408,24,0.0555555555555556
OCCIDENTE-BAJIO,2023-10-11,414,386,28,0.0676328502415459
OCCIDENTE-BAJIO,2023-10-12,449,425,24,0.0534521158129176
OCCIDENTE-BAJIO,2023-10-13,415,388,27,0.0650602409638554
OCCIDENTE-BAJIO,2023-10-14,516,492,24,0.0465116279069767
OCCIDENTE-BAJIO,2023-10-15,404,385,19,0.047029702970297
OCCIDENTE-BAJIO,2023-10-16,517,496,21,0.0406189555125725
OCCIDENTE-BAJIO,2023-10-17,444,434,10,0.0225225225225225
OCCIDENTE-BAJIO,2023-10-18,480,456,24,0.05
OCCIDENTE-BAJIO,2023-10-19,454,434,20,0.0440528634361234
OCCIDENTE-BAJIO,2023-10-20,523,501,22,0.0420650095602294
OCCIDENTE-BAJIO,2023-10-21,605,586,19,0.031404958677686
OCCIDENTE-BAJIO,2023-10-22,402,395,7,0.0174129353233831
OCCIDENTE-BAJIO,2023-10-23,468,454,14,0.0299145299145299
OCCIDENTE-BAJIO,2023-10-24,491,476,15,0.0305498981670061
OCCIDENTE-BAJIO,2023-10-25,498,484,14,0.0281124497991968
OCCIDENTE-BAJIO,2023-10-26,474,450,24,0.0506329113924051
OCCIDENTE-BAJIO,2023-10-27,484,470,14,0.0289256198347107
OCCIDENTE-BAJIO,2023-10-28,533,518,15,0.0281425891181989
OCCIDENTE-BAJIO,2023-10-29,328,322,6,0.0182926829268293
OCCIDENTE-BAJIO,2023-10-30,480,462,18,0.0375
OCCIDENTE-BAJIO,2023-10-31,600,578,22,0.0366666666666667
OCCIDENTE-BAJIO,2023-11-01,545,529,16,0.0293577981651376
OCCIDENTE-BAJIO,2023-11-02,538,524,14,0.0260223048327138
OCCIDENTE-BAJIO,2023-11-03,491,474,17,0.0346232179226069
OCCIDENTE-BAJIO,2023-11-04,588,572,16,0.0272108843537415
OCCIDENTE-BAJIO,2023-11-05,418,409,9,0.0215311004784689
OCCIDENTE-BAJIO,2023-11-06,513,491,22,0.0428849902534113
OCCIDENTE-BAJIO,2023-11-07,595,587,8,0.0134453781512605
OCCIDENTE-BAJIO,2023-11-08,532,506,26,0.0488721804511278
OCCIDENTE-BAJIO,2023-11-09,494,473,21,0.0425101214574899
OCCIDENTE-BAJIO,2023-11-10,499,481,18,0.0360721442885772
OCCIDENTE-BAJIO,2023-11-11,660,636,24,0.0363636363636364
OCCIDENTE-BAJIO,2023-11-12,415,405,10,0.0240963855421687
OCCIDENTE-BAJIO,2023-11-13,550,532,18,0.0327272727272727
OCCIDENTE-BAJIO,2023-11-14,594,572,22,0.037037037037037
OCCIDENTE-BAJIO,2023-11-15,594,579,15,0.0252525252525253
OCCIDENTE-BAJIO,2023-11-16,553,529,24,0.0433996383363472
OCCIDENTE-BAJIO,2023-11-17,581,563,18,0.0309810671256454
OCCIDENTE-BAJIO,2023-11-18,732,716,16,0.0218579234972678
OCCIDENTE-BAJIO,2023-11-19,472,461,11,0.0233050847457627
OCCIDENTE-BAJIO,2023-11-20,587,567,20,0.0340715502555366
OCCIDENTE-BAJIO,2023-11-21,616,593,23,0.0373376623376623
OCCIDENTE-BAJIO,2023-11-22,548,532,16,0.0291970802919708
OCCIDENTE-BAJIO,2023-11-23,562,542,20,0.0355871886120996
OCCIDENTE-BAJIO,2023-11-24,613,594,19,0.0309951060358891
OCCIDENTE-BAJIO,2023-11-25,652,637,15,0.0230061349693252
OCCIDENTE-BAJIO,2023-11-26,441,427,14,0.0317460317460317
OCCIDENTE-BAJIO,2023-11-27,522,503,19,0.0363984674329502
OCCIDENTE-BAJIO,2023-11-28,605,579,26,0.0429752066115702
OCCIDENTE-BAJIO,2023-11-29,607,570,37,0.0609555189456343
OCCIDENTE-BAJIO,2023-11-30,638,616,22,0.0344827586206897
OCCIDENTE-BAJIO,2023-12-01,557,529,28,0.0502692998204668
OCCIDENTE-BAJIO,2023-12-02,619,590,29,0.0468497576736672
OCCIDENTE-BAJIO,2023-12-03,443,420,23,0.0519187358916479
OCCIDENTE-BAJIO,2023-12-04,543,520,23,0.0423572744014733
OCCIDENTE-BAJIO,2023-12-05,595,566,29,0.0487394957983193
OCCIDENTE-BAJIO,2023-12-06,605,579,26,0.0429752066115702
OCCIDENTE-BAJIO,2023-12-07,510,492,18,0.0352941176470588
OCCIDENTE-BAJIO,2023-12-08,568,547,21,0.0369718309859155
OCCIDENTE-BAJIO,2023-12-09,620,587,33,0.0532258064516129
OCCIDENTE-BAJIO,2023-12-10,441,428,13,0.0294784580498866
OCCIDENTE-BAJIO,2023-12-11,476,454,22,0.046218487394958
OCCIDENTE-BAJIO,2023-12-12,572,546,26,0.0454545454545455
OCCIDENTE-BAJIO,2023-12-13,513,491,22,0.0428849902534113
OCCIDENTE-BAJIO,2023-12-14,527,504,23,0.0436432637571157
OCCIDENTE-BAJIO,2023-12-15,484,464,20,0.0413223140495868
OCCIDENTE-BAJIO,2023-12-16,658,637,21,0.0319148936170213
OCCIDENTE-BAJIO,2023-12-17,449,439,10,0.022271714922049
OCCIDENTE-BAJIO,2023-12-18,594,572,22,0.037037037037037
OCCIDENTE-BAJIO,2023-12-19,579,553,26,0.0449050086355786
OCCIDENTE-BAJIO,2023-12-20,614,584,30,0.0488599348534202
OCCIDENTE-BAJIO,2023-12-21,567,543,24,0.0423280423280423
OCCIDENTE-BAJIO,2023-12-22,580,562,18,0.0310344827586207
OCCIDENTE-BAJIO,2023-12-23,606,590,16,0.0264026402640264
OCCIDENTE-BAJIO,2023-12-24,324,314,10,0.0308641975308642
OCCIDENTE-BAJIO,2023-12-25,112,108,4,0.0357142857142857
OCCIDENTE-BAJIO,2023-12-26,470,457,13,0.0276595744680851
OCCIDENTE-BAJIO,2023-12-27,606,587,19,0.0313531353135314
OCCIDENTE-BAJIO,2023-12-28,649,628,21,0.0323574730354391
OCCIDENTE-BAJIO,2023-12-29,639,618,21,0.0328638497652582
OCCIDENTE-BAJIO,2023-12-30,668,654,14,0.0209580838323353
OCCIDENTE-BAJIO,2023-12-31,347,344,3,0.00864553314121038
OCCIDENTE-BAJIO,2024-01-01,116,111,5,0.0431034482758621
OCCIDENTE-BAJIO,2024-01-02,483,472,11,0.0227743271221532
OCCIDENTE-BAJIO,2024-01-03,684,668,16,0.0233918128654971
OCCIDENTE-BAJIO,2024-01-04,608,588,20,0.0328947368421053
OCCIDENTE-BAJIO,2024-01-05,610,588,22,0.0360655737704918
OCCIDENTE-BAJIO,2024-01-06,641,626,15,0.0234009360374415
OCCIDENTE-BAJIO,2024-01-07,412,398,14,0.0339805825242718
OCCIDENTE-BAJIO,2024-01-08,616,588,28,0.0454545454545455
OCCIDENTE-BAJIO,2024-01-09,678,654,24,0.0353982300884956
OCCIDENTE-BAJIO,2024-01-10,605,586,19,0.031404958677686
OCCIDENTE-BAJIO,2024-01-11,633,615,18,0.028436018957346
OCCIDENTE-BAJIO,2024-01-12,607,595,12,0.0197693574958814
OCCIDENTE-BAJIO,2024-01-13,693,664,29,0.0418470418470418
OCCIDENTE-BAJIO,2024-01-14,482,465,17,0.0352697095435685
OCCIDENTE-BAJIO,2024-01-15,587,566,21,0.0357751277683135
OCCIDENTE-BAJIO,2024-01-16,648,630,18,0.0277777777777778
OCCIDENTE-BAJIO,2024-01-17,627,607,20,0.0318979266347687
OCCIDENTE-BAJIO,2024-01-18,578,562,16,0.027681660899654
OCCIDENTE-BAJIO,2024-01-19,580,554,26,0.0448275862068966
OCCIDENTE-BAJIO,2024-01-20,654,642,12,0.018348623853211
OCCIDENTE-BAJIO,2024-01-21,412,398,14,0.0339805825242718
OCCIDENTE-BAJIO,2024-01-22,474,455,19,0.040084388185654
OCCIDENTE-BAJIO,2024-01-23,561,541,20,0.035650623885918
OCCIDENTE-BAJIO,2024-01-24,592,565,27,0.0456081081081081
OCCIDENTE-BAJIO,2024-01-25,550,534,16,0.0290909090909091
OCCIDENTE-BAJIO,2024-01-26,590,571,19,0.0322033898305085
OCCIDENTE-BAJIO,2024-01-27,652,634,18,0.0276073619631902
OCCIDENTE-BAJIO,2024-01-28,423,411,12,0.0283687943262411
OCCIDENTE-BAJIO,2024-01-29,534,515,19,0.0355805243445693
OCCIDENTE-BAJIO,2024-01-30,593,566,27,0.045531197301855
OCCIDENTE-BAJIO,2024-01-31,612,589,23,0.0375816993464052
OCCIDENTE-BAJIO,2024-02-01,518,502,16,0.0308880308880309
OCCIDENTE-BAJIO,2024-02-02,554,526,28,0.0505415162454874
OCCIDENTE-BAJIO,2024-02-03,657,633,24,0.0365296803652968
OCCIDENTE-BAJIO,2024-02-04,430,423,7,0.0162790697674419
OCCIDENTE-BAJIO,2024-02-05,449,434,15,0.0334075723830735
OCCIDENTE-BAJIO,2024-02-06,588,570,18,0.0306122448979592
OCCIDENTE-BAJIO,2024-02-07,604,587,17,0.0281456953642384
OCCIDENTE-BAJIO,2024-02-08,541,535,6,0.011090573012939
OCCIDENTE-BAJIO,2024-02-09,564,554,10,0.0177304964539007
OCCIDENTE-BAJIO,2024-02-10,628,615,13,0.0207006369426752
OCCIDENTE-BAJIO,2024-02-11,379,369,10,0.0263852242744063
OCCIDENTE-BAJIO,2024-02-12,408,389,19,0.0465686274509804
OCCIDENTE-BAJIO,2024-02-13,564,539,25,0.0443262411347518
OCCIDENTE-BAJIO,2024-02-14,490,477,13,0.026530612244898
OCCIDENTE-BAJIO,2024-02-15,525,515,10,0.019047619047619
OCCIDENTE-BAJIO,2024-02-16,479,470,9,0.0187891440501044
OCCIDENTE-BAJIO,2024-02-17,653,631,22,0.0336906584992343
OCCIDENTE-BAJIO,2024-02-18,467,459,8,0.0171306209850107
OCCIDENTE-BAJIO,2024-02-19,568,553,15,0.0264084507042254
OCCIDENTE-BAJIO,2024-02-20,565,549,16,0.0283185840707965
OCCIDENTE-BAJIO,2024-02-21,590,570,20,0.0338983050847458
OCCIDENTE-BAJIO,2024-02-22,583,572,11,0.0188679245283019
OCCIDENTE-BAJIO,2024-02-23,422,346,76,0.180094786729858
OCCIDENTE-BAJIO,2024-02-24,741,716,25,0.0337381916329285
OCCIDENTE-BAJIO,2024-02-25,449,441,8,0.0178173719376392
OCCIDENTE-BAJIO,2024-02-26,535,520,15,0.0280373831775701
OCCIDENTE-BAJIO,2024-02-27,659,635,24,0.0364188163884674
OCCIDENTE-BAJIO,2024-02-28,549,530,19,0.034608378870674
OCCIDENTE-BAJIO,2024-02-29,643,619,24,0.0373250388802488
OCCIDENTE-BAJIO,2024-03-01,617,601,16,0.0259319286871961
OCCIDENTE-BAJIO,2024-03-02,743,722,21,0.0282637954239569
OCCIDENTE-BAJIO,2024-03-03,451,442,9,0.0199556541019956
OCCIDENTE-BAJIO,2024-03-04,570,560,10,0.0175438596491228
OCCIDENTE-BAJIO,2024-03-05,612,591,21,0.0343137254901961
OCCIDENTE-BAJIO,2024-03-06,610,593,17,0.0278688524590164
OCCIDENTE-BAJIO,2024-03-07,576,567,9,0.015625
OCCIDENTE-BAJIO,2024-03-08,624,605,19,0.0304487179487179
OCCIDENTE-BAJIO,2024-03-09,655,642,13,0.0198473282442748
OCCIDENTE-BAJIO,2024-03-10,435,425,10,0.0229885057471264
OCCIDENTE-BAJIO,2024-03-11,547,527,20,0.036563071297989
OCCIDENTE-BAJIO,2024-03-12,573,560,13,0.0226876090750436
OCCIDENTE-BAJIO,2024-03-13,529,511,18,0.0340264650283554
OCCIDENTE-BAJIO,2024-03-14,486,471,15,0.0308641975308642
OCCIDENTE-BAJIO,2024-03-15,635,619,16,0.0251968503937008
OCCIDENTE-BAJIO,2024-03-16,674,657,17,0.0252225519287834
OCCIDENTE-BAJIO,2024-03-17,450,441,9,0.02
OCCIDENTE-BAJIO,2024-03-18,476,464,12,0.0252100840336134
OCCIDENTE-BAJIO,2024-03-19,543,526,17,0.0313075506445672
OCCIDENTE-BAJIO,2024-03-20,592,573,19,0.0320945945945946
OCCIDENTE-BAJIO,2024-03-21,500,478,22,0.044
OCCIDENTE-BAJIO,2024-03-22,534,514,20,0.0374531835205993
OCCIDENTE-BAJIO,2024-03-23,595,582,13,0.0218487394957983
OCCIDENTE-BAJIO,2024-03-24,419,410,9,0.0214797136038186
OCCIDENTE-BAJIO,2024-03-25,525,502,23,0.0438095238095238
OCCIDENTE-BAJIO,2024-03-26,645,618,27,0.0418604651162791
OCCIDENTE-BAJIO,2024-03-27,615,602,13,0.0211382113821138
OCCIDENTE-BAJIO,2024-03-28,662,647,15,0.0226586102719033
OCCIDENTE-BAJIO,2024-03-29,450,435,15,0.0333333333333333
OCCIDENTE-BAJIO,2024-03-30,533,518,15,0.0281425891181989
OCCIDENTE-BAJIO,2024-03-31,403,393,10,0.0248138957816377
OCCIDENTE-BAJIO,2024-04-01,564,553,11,0.0195035460992908
OCCIDENTE-BAJIO,2024-04-02,584,568,16,0.0273972602739726
OCCIDENTE-BAJIO,2024-04-03,530,530,0,0
OCCIDENTE-BAJIO,2024-04-04,537,537,0,0
OCCIDENTE-BAJIO,2024-04-05,546,527,19,0.0347985347985348
OCCIDENTE-BAJIO,2024-04-06,616,598,18,0.0292207792207792
OCCIDENTE-BAJIO,2024-04-07,347,335,12,0.0345821325648415
OCCIDENTE-BAJIO,2024-04-08,486,472,14,0.0288065843621399
OCCIDENTE-BAJIO,2024-04-09,539,513,26,0.0482374768089054
OCCIDENTE-BAJIO,2024-04-10,555,530,25,0.045045045045045
OCCIDENTE-BAJIO,2024-04-11,497,485,12,0.0241448692152917
OCCIDENTE-BAJIO,2024-04-12,581,563,18,0.0309810671256454
OCCIDENTE-BAJIO,2024-04-13,680,667,13,0.0191176470588235
OCCIDENTE-BAJIO,2024-04-14,400,393,7,0.0175
OCCIDENTE-BAJIO,2024-04-15,580,565,15,0.0258620689655172
OCCIDENTE-BAJIO,2024-04-16,619,571,48,0.0775444264943457
OCCIDENTE-BAJIO,2024-04-17,555,523,32,0.0576576576576577
OCCIDENTE-BAJIO,2024-04-18,538,515,23,0.0427509293680297
OCCIDENTE-BAJIO,2024-04-19,492,460,32,0.0650406504065041
OCCIDENTE-BAJIO,2024-04-20,613,591,22,0.0358890701468189
OCCIDENTE-BAJIO,2024-04-21,360,353,7,0.0194444444444444
OCCIDENTE-BAJIO,2024-04-22,271,255,16,0.0590405904059041
OCCIDENTE-BAJIO,2024-04-23,734,674,60,0.0817438692098093
OCCIDENTE-BAJIO,2024-04-24,511,486,25,0.0489236790606654
OCCIDENTE-BAJIO,2024-04-25,504,483,21,0.0416666666666667
OCCIDENTE-BAJIO,2024-04-26,511,491,20,0.0391389432485323
OCCIDENTE-BAJIO,2024-04-27,545,519,26,0.0477064220183486
OCCIDENTE-BAJIO,2024-04-28,377,370,7,0.0185676392572944
OCCIDENTE-BAJIO,2024-04-29,505,479,26,0.0514851485148515
OCCIDENTE-BAJIO,2024-04-30,604,584,20,0.033112582781457
OCCIDENTE-BAJIO,2024-05-01,581,567,14,0.0240963855421687
OCCIDENTE-BAJIO,2024-05-02,511,498,13,0.025440313111546
OCCIDENTE-BAJIO,2024-05-03,513,501,12,0.0233918128654971
OCCIDENTE-BAJIO,2024-05-04,568,545,23,0.0404929577464789
OCCIDENTE-BAJIO,2024-05-05,344,332,12,0.0348837209302326
OCCIDENTE-BAJIO,2024-05-06,497,497,0,0
OCCIDENTE-BAJIO,2024-05-07,521,504,17,0.0326295585412668
OCCIDENTE-BAJIO,2024-05-08,524,500,24,0.0458015267175573
OCCIDENTE-BAJIO,2024-05-09,461,443,18,0.0390455531453362
OCCIDENTE-BAJIO,2024-05-10,445,422,23,0.051685393258427
OCCIDENTE-BAJIO,2024-05-11,527,500,27,0.0512333965844402
OCCIDENTE-BAJIO,2024-05-12,315,307,8,0.0253968253968254
OCCIDENTE-BAJIO,2024-05-13,537,518,19,0.0353817504655493
OCCIDENTE-BAJIO,2024-05-14,586,556,30,0.0511945392491468
OCCIDENTE-BAJIO,2024-05-15,600,580,20,0.0333333333333333
OCCIDENTE-BAJIO,2024-05-16,564,500,64,0.113475177304965
OCCIDENTE-BAJIO,2024-05-17,538,520,18,0.033457249070632
OCCIDENTE-BAJIO,2024-05-18,632,611,21,0.0332278481012658
OCCIDENTE-BAJIO,2024-05-19,365,353,12,0.0328767123287671
OCCIDENTE-BAJIO,2024-05-20,553,539,14,0.0253164556962025
OCCIDENTE-BAJIO,2024-05-21,548,526,22,0.0401459854014599
OCCIDENTE-BAJIO,2024-05-22,522,510,12,0.0229885057471264
OCCIDENTE-BAJIO,2024-05-23,513,497,16,0.0311890838206628
OCCIDENTE-BAJIO,2024-05-24,504,491,13,0.0257936507936508
OCCIDENTE-BAJIO,2024-05-25,616,599,17,0.0275974025974026
OCCIDENTE-BAJIO,2024-05-26,372,367,5,0.0134408602150538
OCCIDENTE-BAJIO,2024-05-27,465,448,17,0.0365591397849462
OCCIDENTE-BAJIO,2024-05-28,539,526,13,0.0241187384044527
OCCIDENTE-BAJIO,2024-05-29,565,550,15,0.0265486725663717
OCCIDENTE-BAJIO,2024-05-30,577,557,20,0.0346620450606586
OCCIDENTE-BAJIO,2024-05-31,598,580,18,0.0301003344481605
OCCIDENTE-BAJIO,2024-06-01,585,562,23,0.0393162393162393
OCCIDENTE-BAJIO,2024-06-02,301,294,7,0.0232558139534884
OCCIDENTE-BAJIO,2024-06-03,505,488,17,0.0336633663366337
OCCIDENTE-BAJIO,2024-06-04,571,538,33,0.0577933450087566
OCCIDENTE-BAJIO,2024-06-05,545,525,20,0.036697247706422
OCCIDENTE-BAJIO,2024-06-06,555,529,26,0.0468468468468468
OCCIDENTE-BAJIO,2024-06-07,540,514,26,0.0481481481481481
OCCIDENTE-BAJIO,2024-06-08,615,594,21,0.0341463414634146
OCCIDENTE-BAJIO,2024-06-09,396,385,11,0.0277777777777778
OCCIDENTE-BAJIO,2024-06-10,516,501,15,0.0290697674418605
OCCIDENTE-BAJIO,2024-06-11,553,537,16,0.0289330922242315
OCCIDENTE-BAJIO,2024-06-12,519,501,18,0.0346820809248555
OCCIDENTE-BAJIO,2024-06-13,537,520,17,0.031657355679702
OCCIDENTE-BAJIO,2024-06-14,494,478,16,0.0323886639676113
OCCIDENTE-BAJIO,2024-06-15,629,617,12,0.0190779014308426
OCCIDENTE-BAJIO,2024-06-16,312,307,5,0.016025641025641
OCCIDENTE-BAJIO,2024-06-17,508,494,14,0.0275590551181102
OCCIDENTE-BAJIO,2024-06-18,564,547,17,0.0301418439716312
OCCIDENTE-BAJIO,2024-06-19,560,550,10,0.0178571428571429
OCCIDENTE-BAJIO,2024-06-20,487,475,12,0.0246406570841889
OCCIDENTE-BAJIO,2024-06-21,577,553,24,0.0415944540727903
OCCIDENTE-BAJIO,2024-06-22,646,628,18,0.0278637770897833
OCCIDENTE-BAJIO,2024-06-23,425,415,10,0.0235294117647059
OCCIDENTE-BAJIO,2024-06-24,458,439,19,0.0414847161572052
OCCIDENTE-BAJIO,2024-06-25,541,521,20,0.0369685767097967
OCCIDENTE-BAJIO,2024-06-26,498,483,15,0.0301204819277108
OCCIDENTE-BAJIO,2024-06-27,522,507,15,0.028735632183908
OCCIDENTE-BAJIO,2024-06-28,541,531,10,0.0184842883548983
OCCIDENTE-BAJIO,2024-06-29,710,683,27,0.0380281690140845
OCCIDENTE-BAJIO,2024-06-30,537,526,11,0.0204841713221601
OCCIDENTE-BAJIO,2024-07-01,522,511,11,0.0210727969348659
OCCIDENTE-BAJIO,2024-07-02,585,575,10,0.0170940170940171
OCCIDENTE-BAJIO,2024-07-03,507,494,13,0.0256410256410256
OCCIDENTE-BAJIO,2024-07-04,511,501,10,0.0195694716242661
OCCIDENTE-BAJIO,2024-07-05,536,520,16,0.0298507462686567
OCCIDENTE-BAJIO,2024-07-06,575,560,15,0.0260869565217391
OCCIDENTE-BAJIO,2024-07-07,399,391,8,0.0200501253132832
OCCIDENTE-BAJIO,2024-07-08,496,489,7,0.0141129032258065
OCCIDENTE-BAJIO,2024-07-09,545,533,12,0.0220183486238532
OCCIDENTE-BAJIO,2024-07-10,507,507,0,0
OCCIDENTE-BAJIO,2024-07-11,527,513,14,0.0265654648956357
OCCIDENTE-BAJIO,2024-07-12,595,580,15,0.0252100840336134
OCCIDENTE-BAJIO,2024-07-13,719,700,19,0.0264255910987483
OCCIDENTE-BAJIO,2024-07-14,467,451,16,0.0342612419700214
OCCIDENTE-BAJIO,2024-07-15,569,552,17,0.0298769771528998
OCCIDENTE-BAJIO,2024-07-16,630,623,7,0.0111111111111111
OCCIDENTE-BAJIO,2024-07-17,621,604,17,0.0273752012882448
OCCIDENTE-BAJIO,2024-07-18,561,552,9,0.0160427807486631
OCCIDENTE-BAJIO,2024-07-19,581,564,17,0.0292598967297762
OCCIDENTE-BAJIO,2024-07-20,676,661,15,0.022189349112426
OCCIDENTE-BAJIO,2024-07-21,458,445,13,0.0283842794759825
OCCIDENTE-BAJIO,2024-07-22,521,506,15,0.0287907869481766
OCCIDENTE-BAJIO,2024-07-23,560,552,8,0.0142857142857143
OCCIDENTE-BAJIO,2024-07-24,599,583,16,0.0267111853088481
OCCIDENTE-BAJIO,2024-07-25,601,585,16,0.0266222961730449
OCCIDENTE-BAJIO,2024-07-26,531,516,15,0.0282485875706215
OCCIDENTE-BAJIO,2024-07-27,680,664,16,0.0235294117647059
OCCIDENTE-BAJIO,2024-07-28,420,411,9,0.0214285714285714
OCCIDENTE-BAJIO,2024-07-29,550,524,26,0.0472727272727273
OCCIDENTE-BAJIO,2024-07-30,631,616,15,0.0237717908082409
OCCIDENTE-BAJIO,2024-07-31,665,650,15,0.0225563909774436
OCCIDENTE-BAJIO,2024-08-01,524,506,18,0.0343511450381679
OCCIDENTE-BAJIO,2024-08-02,591,573,18,0.0304568527918782
OCCIDENTE-BAJIO,2024-08-03,623,606,17,0.0272873194221509
OCCIDENTE-BAJIO,2024-08-04,437,431,6,0.0137299771167048
OCCIDENTE-BAJIO,2024-08-05,579,561,18,0.0310880829015544
OCCIDENTE-BAJIO,2024-08-06,579,562,17,0.0293609671848014
OCCIDENTE-BAJIO,2024-08-07,642,627,15,0.0233644859813084
OCCIDENTE-BAJIO,2024-08-08,569,549,20,0.0351493848857645
OCCIDENTE-BAJIO,2024-08-09,507,498,9,0.0177514792899408
OCCIDENTE-BAJIO,2024-08-10,629,614,15,0.0238473767885533
OCCIDENTE-BAJIO,2024-08-11,406,396,10,0.0246305418719212
OCCIDENTE-BAJIO,2024-08-12,586,579,7,0.0119453924914676
OCCIDENTE-BAJIO,2024-08-13,622,609,13,0.0209003215434084
OCCIDENTE-BAJIO,2024-08-14,543,526,17,0.0313075506445672
OCCIDENTE-BAJIO,2024-08-15,613,596,17,0.0277324632952692
OCCIDENTE-BAJIO,2024-08-16,627,614,13,0.0207336523125997
OCCIDENTE-BAJIO,2024-08-17,630,614,16,0.0253968253968254
OCCIDENTE-BAJIO,2024-08-18,460,450,10,0.0217391304347826
ORIENTE,2023-08-19,409,400,9,0.0220048899755501
ORIENTE,2023-08-20,298,288,10,0.0335570469798658
ORIENTE,2023-08-21,323,319,4,0.0123839009287926
ORIENTE,2023-08-22,339,338,1,0.00294985250737463
ORIENTE,2023-08-23,330,327,3,0.00909090909090909
ORIENTE,2023-08-24,371,366,5,0.0134770889487871
ORIENTE,2023-08-25,412,406,6,0.0145631067961165
ORIENTE,2023-08-26,412,408,4,0.00970873786407767
ORIENTE,2023-08-27,303,299,4,0.0132013201320132
ORIENTE,2023-08-28,356,354,2,0.00561797752808989
ORIENTE,2023-08-29,364,362,2,0.00549450549450549
ORIENTE,2023-08-30,359,357,2,0.00557103064066852
ORIENTE,2023-08-31,365,364,1,0.00273972602739726
ORIENTE,2023-09-01,308,301,7,0.0227272727272727
ORIENTE,2023-09-02,321,321,0,0
ORIENTE,2023-09-03,264,263,1,0.00378787878787879
ORIENTE,2023-09-04,334,333,1,0.0029940119760479
ORIENTE,2023-09-05,380,379,1,0.00263157894736842
ORIENTE,2023-09-06,341,340,1,0.00293255131964809
ORIENTE,2023-09-07,311,308,3,0.00964630225080386
ORIENTE,2023-09-08,317,314,3,0.00946372239747634
ORIENTE,2023-09-09,371,369,2,0.00539083557951483
ORIENTE,2023-09-10,262,261,1,0.00381679389312977
ORIENTE,2023-09-11,299,297,2,0.00668896321070234
ORIENTE,2023-09-12,370,366,4,0.0108108108108108
ORIENTE,2023-09-13,309,305,4,0.0129449838187702
ORIENTE,2023-09-14,369,367,2,0.00542005420054201
ORIENTE,2023-09-15,426,422,4,0.00938967136150235
ORIENTE,2023-09-16,313,310,3,0.00958466453674121
ORIENTE,2023-09-17,258,257,1,0.00387596899224806
ORIENTE,2023-09-18,338,338,0,0
ORIENTE,2023-09-19,341,339,2,0.00586510263929619
ORIENTE,2023-09-20,287,286,1,0.00348432055749129
ORIENTE,2023-09-21,309,306,3,0.00970873786407767
ORIENTE,2023-09-22,314,313,1,0.00318471337579618
ORIENTE,2023-09-23,374,372,2,0.0053475935828877
ORIENTE,2023-09-24,304,302,2,0.00657894736842105
ORIENTE,2023-09-25,346,344,2,0.00578034682080925
ORIENTE,2023-09-26,375,372,3,0.008
ORIENTE,2023-09-27,315,314,1,0.00317460317460317
ORIENTE,2023-09-28,330,329,1,0.00303030303030303
ORIENTE,2023-09-29,415,412,3,0.0072289156626506
ORIENTE,2023-09-30,506,503,3,0.00592885375494071
ORIENTE,2023-10-01,309,308,1,0.00323624595469256
ORIENTE,2023-10-02,299,296,3,0.0100334448160535
ORIENTE,2023-10-03,301,295,6,0.0199335548172757
ORIENTE,2023-10-04,306,301,5,0.0163398692810458
ORIENTE,2023-10-05,300,296,4,0.0133333333333333
ORIENTE,2023-10-06,356,345,11,0.0308988764044944
ORIENTE,2023-10-07,351,344,7,0.0199430199430199
ORIENTE,2023-10-08,236,229,7,0.0296610169491525
ORIENTE,2023-10-09,266,259,7,0.0263157894736842
ORIENTE,2023-10-10,256,249,7,0.02734375
ORIENTE,2023-10-11,300,292,8,0.0266666666666667
ORIENTE,2023-10-12,272,269,3,0.0110294117647059
ORIENTE,2023-10-13,323,314,9,0.0278637770897833
ORIENTE,2023-10-14,375,365,10,0.0266666666666667
ORIENTE,2023-10-15,286,283,3,0.0104895104895105
ORIENTE,2023-10-16,341,337,4,0.0117302052785924
ORIENTE,2023-10-17,296,288,8,0.027027027027027
ORIENTE,2023-10-18,309,299,10,0.0323624595469256
ORIENTE,2023-10-19,318,312,6,0.0188679245283019
ORIENTE,2023-10-20,306,294,12,0.0392156862745098
ORIENTE,2023-10-21,416,407,9,0.0216346153846154
ORIENTE,2023-10-22,309,303,6,0.0194174757281553
ORIENTE,2023-10-23,344,336,8,0.0232558139534884
ORIENTE,2023-10-24,322,315,7,0.0217391304347826
ORIENTE,2023-10-25,271,264,7,0.025830258302583
ORIENTE,2023-10-26,316,305,11,0.0348101265822785
ORIENTE,2023-10-27,307,293,14,0.0456026058631922
ORIENTE,2023-10-28,373,360,13,0.0348525469168901
ORIENTE,2023-10-29,267,257,10,0.0374531835205993
ORIENTE,2023-10-30,293,290,3,0.0102389078498294
ORIENTE,2023-10-31,402,395,7,0.0174129353233831
ORIENTE,2023-11-01,321,309,12,0.0373831775700935
ORIENTE,2023-11-02,259,254,5,0.0193050193050193
ORIENTE,2023-11-03,270,263,7,0.0259259259259259
ORIENTE,2023-11-04,311,305,6,0.0192926045016077
ORIENTE,2023-11-05,274,270,4,0.0145985401459854
ORIENTE,2023-11-06,347,335,12,0.0345821325648415
ORIENTE,2023-11-07,338,332,6,0.0177514792899408
ORIENTE,2023-11-08,326,319,7,0.0214723926380368
ORIENTE,2023-11-09,336,326,10,0.0297619047619048
ORIENTE,2023-11-10,334,325,9,0.0269461077844311
ORIENTE,2023-11-11,389,381,8,0.0205655526992288
ORIENTE,2023-11-12,284,274,10,0.0352112676056338
ORIENTE,2023-11-13,293,283,10,0.0341296928327645
ORIENTE,2023-11-14,382,376,6,0.0157068062827225
ORIENTE,2023-11-15,402,391,11,0.027363184079602
ORIENTE,2023-11-16,365,358,7,0.0191780821917808
ORIENTE,2023-11-17,392,382,10,0.0255102040816327
ORIENTE,2023-11-18,410,404,6,0.0146341463414634
ORIENTE,2023-11-19,342,332,10,0.0292397660818713
ORIENTE,2023-11-20,349,342,7,0.0200573065902579
ORIENTE,2023-11-21,339,332,7,0.0206489675516224
ORIENTE,2023-11-22,311,306,5,0.0160771704180064
ORIENTE,2023-11-23,337,329,8,0.0237388724035608
ORIENTE,2023-11-24,338,329,9,0.0266272189349112
ORIENTE,2023-11-25,397,394,3,0.00755667506297229
ORIENTE,2023-11-26,260,254,6,0.0230769230769231
ORIENTE,2023-11-27,345,339,6,0.0173913043478261
ORIENTE,2023-11-28,339,330,9,0.0265486725663717
ORIENTE,2023-11-29,391,369,22,0.0562659846547315
ORIENTE,2023-11-30,476,459,17,0.0357142857142857
ORIENTE,2023-12-01,373,359,14,0.0375335120643432
ORIENTE,2023-12-02,412,403,9,0.0218446601941748
ORIENTE,2023-12-03,316,304,12,0.0379746835443038
ORIENTE,2023-12-04,324,317,7,0.0216049382716049
ORIENTE,2023-12-05,359,349,10,0.0278551532033426
ORIENTE,2023-12-06,391,381,10,0.0255754475703325
ORIENTE,2023-12-07,389,376,13,0.0334190231362468
ORIENTE,2023-12-08,410,398,12,0.0292682926829268
ORIENTE,2023-12-09,410,400,10,0.024390243902439
ORIENTE,2023-12-10,282,271,11,0.0390070921985816
ORIENTE,2023-12-11,333,328,5,0.015015015015015
ORIENTE,2023-12-12,362,354,8,0.0220994475138122
ORIENTE,2023-12-13,329,323,6,0.0182370820668693
ORIENTE,2023-12-14,329,317,12,0.0364741641337386
ORIENTE,2023-12-15,347,337,10,0.0288184438040346
ORIENTE,2023-12-16,396,389,7,0.0176767676767677
ORIENTE,2023-12-17,348,335,13,0.0373563218390805
ORIENTE,2023-12-18,399,391,8,0.0200501253132832
ORIENTE,2023-12-19,425,408,17,0.04
ORIENTE,2023-12-20,358,349,9,0.0251396648044693
ORIENTE,2023-12-21,422,413,9,0.0213270142180095
ORIENTE,2023-12-22,380,373,7,0.0184210526315789
ORIENTE,2023-12-23,432,418,14,0.0324074074074074
ORIENTE,2023-12-24,239,232,7,0.0292887029288703
ORIENTE,2023-12-25,85,85,0,0
ORIENTE,2023-12-26,334,330,4,0.0119760479041916
ORIENTE,2023-12-27,415,405,10,0.0240963855421687
ORIENTE,2023-12-28,417,408,9,0.0215827338129496
ORIENTE,2023-12-29,406,393,13,0.0320197044334975
ORIENTE,2023-12-30,415,404,11,0.0265060240963855
ORIENTE,2023-12-31,174,170,4,0.0229885057471264
ORIENTE,2024-01-01,74,70,4,0.0540540540540541
ORIENTE,2024-01-02,276,270,6,0.0217391304347826
ORIENTE,2024-01-03,359,351,8,0.0222841225626741
ORIENTE,2024-01-04,378,373,5,0.0132275132275132
ORIENTE,2024-01-05,371,360,11,0.0296495956873315
ORIENTE,2024-01-06,386,380,6,0.0155440414507772
ORIENTE,2024-01-07,263,258,5,0.0190114068441065
ORIENTE,2024-01-08,358,350,8,0.0223463687150838
ORIENTE,2024-01-09,418,403,15,0.0358851674641148
ORIENTE,2024-01-10,422,414,8,0.018957345971564
ORIENTE,2024-01-11,385,372,13,0.0337662337662338
ORIENTE,2024-01-12,393,386,7,0.0178117048346056
ORIENTE,2024-01-13,460,449,11,0.0239130434782609
ORIENTE,2024-01-14,379,372,7,0.0184696569920844
ORIENTE,2024-01-15,417,402,15,0.0359712230215827
ORIENTE,2024-01-16,467,453,14,0.0299785867237687
ORIENTE,2024-01-17,442,434,8,0.0180995475113122
ORIENTE,2024-01-18,403,393,10,0.0248138957816377
ORIENTE,2024-01-19,334,324,10,0.029940119760479
ORIENTE,2024-01-20,404,396,8,0.0198019801980198
ORIENTE,2024-01-21,279,273,6,0.021505376344086
ORIENTE,2024-01-22,356,346,10,0.0280898876404494
ORIENTE,2024-01-23,340,332,8,0.0235294117647059
ORIENTE,2024-01-24,358,349,9,0.0251396648044693
ORIENTE,2024-01-25,317,310,7,0.0220820189274448
ORIENTE,2024-01-26,334,325,9,0.0269461077844311
ORIENTE,2024-01-27,370,362,8,0.0216216216216216
ORIENTE,2024-01-28,270,263,7,0.0259259259259259
ORIENTE,2024-01-29,333,325,8,0.024024024024024
ORIENTE,2024-01-30,369,358,11,0.029810298102981
ORIENTE,2024-01-31,463,452,11,0.0237580993520518
ORIENTE,2024-02-01,356,348,8,0.0224719101123595
ORIENTE,2024-02-02,340,329,11,0.0323529411764706
ORIENTE,2024-02-03,382,370,12,0.031413612565445
ORIENTE,2024-02-04,307,304,3,0.00977198697068404
ORIENTE,2024-02-05,341,334,7,0.0205278592375367
ORIENTE,2024-02-06,344,335,9,0.0261627906976744
ORIENTE,2024-02-07,356,345,11,0.0308988764044944
ORIENTE,2024-02-08,352,349,3,0.00852272727272727
ORIENTE,2024-02-09,343,334,9,0.0262390670553936
ORIENTE,2024-02-10,371,360,11,0.0296495956873315
ORIENTE,2024-02-11,241,227,14,0.0580912863070539
ORIENTE,2024-02-12,310,300,10,0.032258064516129
ORIENTE,2024-02-13,338,328,10,0.029585798816568
ORIENTE,2024-02-14,309,303,6,0.0194174757281553
ORIENTE,2024-02-15,350,346,4,0.0114285714285714
ORIENTE,2024-02-16,352,344,8,0.0227272727272727
ORIENTE,2024-02-17,343,335,8,0.0233236151603499
ORIENTE,2024-02-18,342,334,8,0.0233918128654971
ORIENTE,2024-02-19,355,343,12,0.0338028169014084
ORIENTE,2024-02-20,377,364,13,0.0344827586206897
ORIENTE,2024-02-21,416,402,14,0.0336538461538462
ORIENTE,2024-02-22,338,334,4,0.0118343195266272
ORIENTE,2024-02-23,221,197,24,0.108597285067873
ORIENTE,2024-02-24,459,442,17,0.037037037037037
ORIENTE,2024-02-25,276,266,10,0.036231884057971
ORIENTE,2024-02-26,326,313,13,0.0398773006134969
ORIENTE,2024-02-27,370,358,12,0.0324324324324324
ORIENTE,2024-02-28,393,383,10,0.0254452926208651
ORIENTE,2024-02-29,417,406,11,0.026378896882494
ORIENTE,2024-03-01,379,374,5,0.0131926121372032
ORIENTE,2024-03-02,380,372,8,0.0210526315789474
ORIENTE,2024-03-03,311,303,8,0.0257234726688103
ORIENTE,2024-03-04,387,379,8,0.020671834625323
ORIENTE,2024-03-05,372,362,10,0.0268817204301075
ORIENTE,2024-03-06,351,344,7,0.0199430199430199
ORIENTE,2024-03-07,360,356,4,0.0111111111111111
ORIENTE,2024-03-08,350,343,7,0.02
ORIENTE,2024-03-09,378,368,10,0.0264550264550265
ORIENTE,2024-03-10,274,268,6,0.0218978102189781
ORIENTE,2024-03-11,329,325,4,0.0121580547112462
ORIENTE,2024-03-12,358,345,13,0.0363128491620112
ORIENTE,2024-03-13,297,290,7,0.0235690235690236
ORIENTE,2024-03-14,279,270,9,0.032258064516129
ORIENTE,2024-03-15,310,300,10,0.032258064516129
ORIENTE,2024-03-16,358,350,8,0.0223463687150838
ORIENTE,2024-03-17,257,249,8,0.0311284046692607
ORIENTE,2024-03-18,327,317,10,0.0305810397553517
ORIENTE,2024-03-19,348,340,8,0.0229885057471264
ORIENTE,2024-03-20,304,296,8,0.0263157894736842
ORIENTE,2024-03-21,326,320,6,0.0184049079754601
ORIENTE,2024-03-22,319,307,12,0.0376175548589342
ORIENTE,2024-03-23,325,320,5,0.0153846153846154
ORIENTE,2024-03-24,222,213,9,0.0405405405405405
ORIENTE,2024-03-25,303,292,11,0.0363036303630363
ORIENTE,2024-03-26,341,330,11,0.032258064516129
ORIENTE,2024-03-27,311,298,13,0.0418006430868167
ORIENTE,2024-03-28,371,355,16,0.0431266846361186
ORIENTE,2024-03-29,329,317,12,0.0364741641337386
ORIENTE,2024-03-30,314,308,6,0.0191082802547771
ORIENTE,2024-03-31,247,235,12,0.048582995951417
ORIENTE,2024-04-01,342,326,16,0.0467836257309941
ORIENTE,2024-04-02,342,329,13,0.0380116959064327
ORIENTE,2024-04-03,274,274,0,0
ORIENTE,2024-04-04,330,330,0,0
ORIENTE,2024-04-05,366,355,11,0.0300546448087432
ORIENTE,2024-04-06,342,328,14,0.0409356725146199
ORIENTE,2024-04-07,228,221,7,0.0307017543859649
ORIENTE,2024-04-08,304,290,14,0.0460526315789474
ORIENTE,2024-04-09,301,291,10,0.0332225913621262
ORIENTE,2024-04-10,314,299,15,0.0477707006369427
ORIENTE,2024-04-11,274,268,6,0.0218978102189781
ORIENTE,2024-04-12,323,315,8,0.0247678018575851
ORIENTE,2024-04-13,329,309,20,0.060790273556231
ORIENTE,2024-04-14,250,245,5,0.02
ORIENTE,2024-04-15,360,351,9,0.025
ORIENTE,2024-04-16,398,372,26,0.0653266331658292
ORIENTE,2024-04-17,291,274,17,0.0584192439862543
ORIENTE,2024-04-18,289,275,14,0.0484429065743945
ORIENTE,2024-04-19,319,307,12,0.0376175548589342
ORIENTE,2024-04-20,329,318,11,0.033434650455927
ORIENTE,2024-04-21,229,217,12,0.0524017467248908
ORIENTE,2024-04-22,216,201,15,0.0694444444444444
ORIENTE,2024-04-23,433,404,29,0.0669745958429561
ORIENTE,2024-04-24,287,277,10,0.0348432055749129
ORIENTE,2024-04-25,295,286,9,0.0305084745762712
ORIENTE,2024-04-26,310,301,9,0.0290322580645161
ORIENTE,2024-04-27,282,271,11,0.0390070921985816
ORIENTE,2024-04-28,250,243,7,0.028
ORIENTE,2024-04-29,350,337,13,0.0371428571428571
ORIENTE,2024-04-30,384,369,15,0.0390625
ORIENTE,2024-05-01,339,330,9,0.0265486725663717
ORIENTE,2024-05-02,283,274,9,0.0318021201413428
ORIENTE,2024-05-03,298,288,10,0.0335570469798658
ORIENTE,2024-05-04,325,316,9,0.0276923076923077
ORIENTE,2024-05-05,206,203,3,0.0145631067961165
ORIENTE,2024-05-06,310,310,0,0
ORIENTE,2024-05-07,310,296,14,0.0451612903225806
ORIENTE,2024-05-08,283,263,20,0.0706713780918728
ORIENTE,2024-05-09,285,278,7,0.0245614035087719
ORIENTE,2024-05-10,255,238,17,0.0666666666666667
ORIENTE,2024-05-11,293,278,15,0.0511945392491468
ORIENTE,2024-05-12,203,189,14,0.0689655172413793
ORIENTE,2024-05-13,285,272,13,0.0456140350877193
ORIENTE,2024-05-14,357,338,19,0.0532212885154062
ORIENTE,2024-05-15,360,338,22,0.0611111111111111
ORIENTE,2024-05-16,356,291,65,0.182584269662921
ORIENTE,2024-05-17,311,296,15,0.0482315112540193
ORIENTE,2024-05-18,336,321,15,0.0446428571428571
ORIENTE,2024-05-19,251,236,15,0.0597609561752988
ORIENTE,2024-05-20,339,329,10,0.0294985250737463
ORIENTE,2024-05-21,316,307,9,0.0284810126582278
ORIENTE,2024-05-22,322,316,6,0.0186335403726708
ORIENTE,2024-05-23,292,283,9,0.0308219178082192
ORIENTE,2024-05-24,310,296,14,0.0451612903225806
ORIENTE,2024-05-25,338,330,8,0.0236686390532544
ORIENTE,2024-05-26,220,214,6,0.0272727272727273
ORIENTE,2024-05-27,303,296,7,0.0231023102310231
ORIENTE,2024-05-28,293,291,2,0.0068259385665529
ORIENTE,2024-05-29,293,286,7,0.0238907849829352
ORIENTE,2024-05-30,333,325,8,0.024024024024024
ORIENTE,2024-05-31,464,459,5,0.0107758620689655
ORIENTE,2024-06-01,369,361,8,0.021680216802168
ORIENTE,2024-06-02,195,189,6,0.0307692307692308
ORIENTE,2024-06-03,295,286,9,0.0305084745762712
ORIENTE,2024-06-04,305,294,11,0.0360655737704918
ORIENTE,2024-06-05,321,305,16,0.0498442367601246
ORIENTE,2024-06-06,350,337,13,0.0371428571428571
ORIENTE,2024-06-07,322,311,11,0.0341614906832298
ORIENTE,2024-06-08,312,303,9,0.0288461538461538
ORIENTE,2024-06-09,214,208,6,0.0280373831775701
ORIENTE,2024-06-10,345,337,8,0.0231884057971014
ORIENTE,2024-06-11,319,307,12,0.0376175548589342
ORIENTE,2024-06-12,339,332,7,0.0206489675516224
ORIENTE,2024-06-13,338,325,13,0.0384615384615385
ORIENTE,2024-06-14,330,316,14,0.0424242424242424
ORIENTE,2024-06-15,352,345,7,0.0198863636363636
ORIENTE,2024-06-16,229,225,4,0.0174672489082969
ORIENTE,2024-06-17,333,323,10,0.03003003003003
ORIENTE,2024-06-18,363,354,9,0.0247933884297521
ORIENTE,2024-06-19,331,319,12,0.0362537764350453
ORIENTE,2024-06-20,297,282,15,0.0505050505050505
ORIENTE,2024-06-21,332,324,8,0.0240963855421687
ORIENTE,2024-06-22,356,342,14,0.0393258426966292
ORIENTE,2024-06-23,254,248,6,0.0236220472440945
ORIENTE,2024-06-24,322,313,9,0.0279503105590062
ORIENTE,2024-06-25,346,336,10,0.0289017341040462
ORIENTE,2024-06-26,300,283,17,0.0566666666666667
ORIENTE,2024-06-27,247,235,12,0.048582995951417
ORIENTE,2024-06-28,359,352,7,0.0194986072423398
ORIENTE,2024-06-29,424,412,12,0.0283018867924528
ORIENTE,2024-06-30,322,312,10,0.031055900621118
ORIENTE,2024-07-01,301,288,13,0.0431893687707641
ORIENTE,2024-07-02,313,308,5,0.0159744408945687
ORIENTE,2024-07-03,310,292,18,0.0580645161290323
ORIENTE,2024-07-04,321,315,6,0.0186915887850467
ORIENTE,2024-07-05,272,263,9,0.0330882352941176
ORIENTE,2024-07-06,339,332,7,0.0206489675516224
ORIENTE,2024-07-07,227,216,11,0.0484581497797357
ORIENTE,2024-07-08,270,263,7,0.0259259259259259
ORIENTE,2024-07-09,260,251,9,0.0346153846153846
ORIENTE,2024-07-10,298,298,0,0
ORIENTE,2024-07-11,320,310,10,0.03125
ORIENTE,2024-07-12,328,324,4,0.0121951219512195
ORIENTE,2024-07-13,413,406,7,0.0169491525423729
ORIENTE,2024-07-14,297,293,4,0.0134680134680135
ORIENTE,2024-07-15,363,346,17,0.046831955922865
ORIENTE,2024-07-16,395,388,7,0.0177215189873418
ORIENTE,2024-07-17,393,378,15,0.0381679389312977
ORIENTE,2024-07-18,339,332,7,0.0206489675516224
ORIENTE,2024-07-19,357,349,8,0.0224089635854342
ORIENTE,2024-07-20,357,348,9,0.0252100840336134
ORIENTE,2024-07-21,262,259,3,0.0114503816793893
ORIENTE,2024-07-22,336,326,10,0.0297619047619048
ORIENTE,2024-07-23,386,378,8,0.0207253886010363
ORIENTE,2024-07-24,360,349,11,0.0305555555555556
ORIENTE,2024-07-25,374,366,8,0.0213903743315508
ORIENTE,2024-07-26,329,320,9,0.027355623100304
ORIENTE,2024-07-27,383,378,5,0.0130548302872063
ORIENTE,2024-07-28,259,253,6,0.0231660231660232
ORIENTE,2024-07-29,347,335,12,0.0345821325648415
ORIENTE,2024-07-30,408,396,12,0.0294117647058824
ORIENTE,2024-07-31,469,461,8,0.0170575692963753
ORIENTE,2024-08-01,359,352,7,0.0194986072423398
ORIENTE,2024-08-02,369,368,1,0.002710027100271
ORIENTE,2024-08-03,380,373,7,0.0184210526315789
ORIENTE,2024-08-04,297,290,7,0.0235690235690236
ORIENTE,2024-08-05,322,313,9,0.0279503105590062
ORIENTE,2024-08-06,396,375,21,0.053030303030303
ORIENTE,2024-08-07,394,384,10,0.0253807106598985
ORIENTE,2024-08-08,363,350,13,0.0358126721763085
ORIENTE,2024-08-09,363,357,6,0.0165289256198347
ORIENTE,2024-08-10,402,392,10,0.0248756218905473
ORIENTE,2024-08-11,272,268,4,0.0147058823529412
ORIENTE,2024-08-12,358,350,8,0.0223463687150838
ORIENTE,2024-08-13,397,388,9,0.0226700251889169
ORIENTE,2024-08-14,382,370,12,0.031413612565445
ORIENTE,2024-08-15,389,374,15,0.038560411311054
ORIENTE,2024-08-16,378,366,12,0.0317460317460317
ORIENTE,2024-08-17,415,405,10,0.0240963855421687
ORIENTE,2024-08-18,276,266,10,0.036231884057971
PACIFICO,2023-08-19,152,144,8,0.0526315789473684
PACIFICO,2023-08-20,127,121,6,0.047244094488189
PACIFICO,2023-08-21,140,138,2,0.0142857142857143
PACIFICO,2023-08-22,126,126,0,0
PACIFICO,2023-08-23,120,117,3,0.025
PACIFICO,2023-08-24,159,154,5,0.0314465408805031
PACIFICO,2023-08-25,136,133,3,0.0220588235294118
PACIFICO,2023-08-26,162,156,6,0.037037037037037
PACIFICO,2023-08-27,120,120,0,0
PACIFICO,2023-08-28,126,123,3,0.0238095238095238
PACIFICO,2023-08-29,110,109,1,0.00909090909090909
PACIFICO,2023-08-30,94,92,2,0.0212765957446809
PACIFICO,2023-08-31,150,148,2,0.0133333333333333
PACIFICO,2023-09-01,75,72,3,0.04
PACIFICO,2023-09-02,158,157,1,0.00632911392405063
PACIFICO,2023-09-03,113,112,1,0.00884955752212389
PACIFICO,2023-09-04,122,122,0,0
PACIFICO,2023-09-05,142,140,2,0.0140845070422535
PACIFICO,2023-09-06,159,158,1,0.00628930817610063
PACIFICO,2023-09-07,129,129,0,0
PACIFICO,2023-09-08,130,127,3,0.0230769230769231
PACIFICO,2023-09-09,157,156,1,0.00636942675159236
PACIFICO,2023-09-10,116,116,0,0
PACIFICO,2023-09-11,113,113,0,0
PACIFICO,2023-09-12,150,150,0,0
PACIFICO,2023-09-13,127,126,1,0.0078740157480315
PACIFICO,2023-09-14,129,126,3,0.0232558139534884
PACIFICO,2023-09-15,121,120,1,0.00826446280991736
PACIFICO,2023-09-16,127,125,2,0.015748031496063
PACIFICO,2023-09-17,99,98,1,0.0101010101010101
PACIFICO,2023-09-18,105,104,1,0.00952380952380952
PACIFICO,2023-09-19,112,111,1,0.00892857142857143
PACIFICO,2023-09-20,104,104,0,0
PACIFICO,2023-09-21,133,132,1,0.0075187969924812
PACIFICO,2023-09-22,127,126,1,0.0078740157480315
PACIFICO,2023-09-23,149,147,2,0.0134228187919463
PACIFICO,2023-09-24,111,109,2,0.018018018018018
PACIFICO,2023-09-25,122,118,4,0.0327868852459016
PACIFICO,2023-09-26,116,115,1,0.00862068965517241
PACIFICO,2023-09-27,124,123,1,0.00806451612903226
PACIFICO,2023-09-28,143,141,2,0.013986013986014
PACIFICO,2023-09-29,141,141,0,0
PACIFICO,2023-09-30,166,166,0,0
PACIFICO,2023-10-01,94,94,0,0
PACIFICO,2023-10-02,99,98,1,0.0101010101010101
PACIFICO,2023-10-03,129,126,3,0.0232558139534884
PACIFICO,2023-10-04,138,135,3,0.0217391304347826
PACIFICO,2023-10-05,124,122,2,0.0161290322580645
PACIFICO,2023-10-06,147,142,5,0.0340136054421769
PACIFICO,2023-10-07,159,152,7,0.0440251572327044
PACIFICO,2023-10-08,105,99,6,0.0571428571428571
PACIFICO,2023-10-09,119,119,0,0
PACIFICO,2023-10-10,104,101,3,0.0288461538461538
PACIFICO,2023-10-11,115,110,5,0.0434782608695652
PACIFICO,2023-10-12,104,100,4,0.0384615384615385
PACIFICO,2023-10-13,125,122,3,0.024
PACIFICO,2023-10-14,144,140,4,0.0277777777777778
PACIFICO,2023-10-15,105,104,1,0.00952380952380952
PACIFICO,2023-10-16,104,98,6,0.0576923076923077
PACIFICO,2023-10-17,115,112,3,0.0260869565217391
PACIFICO,2023-10-18,105,103,2,0.019047619047619
PACIFICO,2023-10-19,112,110,2,0.0178571428571429
PACIFICO,2023-10-20,99,96,3,0.0303030303030303
PACIFICO,2023-10-21,92,92,0,0
PACIFICO,2023-10-22,60,59,1,0.0166666666666667
PACIFICO,2023-10-23,57,54,3,0.0526315789473684
PACIFICO,2023-10-24,117,115,2,0.0170940170940171
PACIFICO,2023-10-25,104,98,6,0.0576923076923077
PACIFICO,2023-10-26,122,122,0,0
PACIFICO,2023-10-27,113,110,3,0.0265486725663717
PACIFICO,2023-10-28,123,121,2,0.016260162601626
PACIFICO,2023-10-29,78,75,3,0.0384615384615385
PACIFICO,2023-10-30,105,103,2,0.019047619047619
PACIFICO,2023-10-31,151,150,1,0.00662251655629139
PACIFICO,2023-11-01,139,139,0,0
PACIFICO,2023-11-02,132,128,4,0.0303030303030303
PACIFICO,2023-11-03,122,118,4,0.0327868852459016
PACIFICO,2023-11-04,141,140,1,0.00709219858156028
PACIFICO,2023-11-05,100,98,2,0.02
PACIFICO,2023-11-06,136,133,3,0.0220588235294118
PACIFICO,2023-11-07,159,156,3,0.0188679245283019
PACIFICO,2023-11-08,146,143,3,0.0205479452054795
PACIFICO,2023-11-09,143,138,5,0.034965034965035
PACIFICO,2023-11-10,134,131,3,0.0223880597014925
PACIFICO,2023-11-11,141,141,0,0
PACIFICO,2023-11-12,106,103,3,0.0283018867924528
PACIFICO,2023-11-13,138,133,5,0.036231884057971
PACIFICO,2023-11-14,137,135,2,0.0145985401459854
PACIFICO,2023-11-15,158,153,5,0.0316455696202532
PACIFICO,2023-11-16,165,161,4,0.0242424242424242
PACIFICO,2023-11-17,128,125,3,0.0234375
PACIFICO,2023-11-18,147,145,2,0.0136054421768707
PACIFICO,2023-11-19,98,97,1,0.0102040816326531
PACIFICO,2023-11-20,135,133,2,0.0148148148148148
PACIFICO,2023-11-21,121,117,4,0.0330578512396694
PACIFICO,2023-11-22,145,141,4,0.0275862068965517
PACIFICO,2023-11-23,151,149,2,0.0132450331125828
PACIFICO,2023-11-24,147,146,1,0.00680272108843537
PACIFICO,2023-11-25,152,148,4,0.0263157894736842
PACIFICO,2023-11-26,104,104,0,0
PACIFICO,2023-11-27,96,92,4,0.0416666666666667
PACIFICO,2023-11-28,128,123,5,0.0390625
PACIFICO,2023-11-29,155,154,1,0.00645161290322581
PACIFICO,2023-11-30,154,150,4,0.025974025974026
PACIFICO,2023-12-01,140,139,1,0.00714285714285714
PACIFICO,2023-12-02,158,155,3,0.0189873417721519
PACIFICO,2023-12-03,122,119,3,0.0245901639344262
PACIFICO,2023-12-04,120,116,4,0.0333333333333333
PACIFICO,2023-12-05,151,144,7,0.0463576158940397
PACIFICO,2023-12-06,149,143,6,0.0402684563758389
PACIFICO,2023-12-07,161,161,0,0
PACIFICO,2023-12-08,155,151,4,0.0258064516129032
PACIFICO,2023-12-09,149,148,1,0.00671140939597315
PACIFICO,2023-12-10,131,131,0,0
PACIFICO,2023-12-11,138,137,1,0.0072463768115942
PACIFICO,2023-12-12,136,133,3,0.0220588235294118
PACIFICO,2023-12-13,144,144,0,0
PACIFICO,2023-12-14,118,115,3,0.0254237288135593
PACIFICO,2023-12-15,137,134,3,0.0218978102189781
PACIFICO,2023-12-16,142,139,3,0.0211267605633803
PACIFICO,2023-12-17,108,106,2,0.0185185185185185
PACIFICO,2023-12-18,150,147,3,0.02
PACIFICO,2023-12-19,144,143,1,0.00694444444444444
PACIFICO,2023-12-20,144,142,2,0.0138888888888889
PACIFICO,2023-12-21,172,167,5,0.0290697674418605
PACIFICO,2023-12-22,121,119,2,0.0165289256198347
PACIFICO,2023-12-23,127,126,1,0.0078740157480315
PACIFICO,2023-12-24,94,94,0,0
PACIFICO,2023-12-25,18,18,0,0
PACIFICO,2023-12-26,115,114,1,0.00869565217391304
PACIFICO,2023-12-27,134,132,2,0.0149253731343284
PACIFICO,2023-12-28,130,128,2,0.0153846153846154
PACIFICO,2023-12-29,137,134,3,0.0218978102189781
PACIFICO,2023-12-30,136,134,2,0.0147058823529412
PACIFICO,2023-12-31,80,80,0,0
PACIFICO,2024-01-01,18,18,0,0
PACIFICO,2024-01-02,103,100,3,0.029126213592233
PACIFICO,2024-01-03,137,135,2,0.0145985401459854
PACIFICO,2024-01-04,145,144,1,0.00689655172413793
PACIFICO,2024-01-05,147,143,4,0.0272108843537415
PACIFICO,2024-01-06,169,163,6,0.0355029585798817
PACIFICO,2024-01-07,101,100,1,0.0099009900990099
PACIFICO,2024-01-08,146,142,4,0.0273972602739726
PACIFICO,2024-01-09,159,154,5,0.0314465408805031
PACIFICO,2024-01-10,138,136,2,0.0144927536231884
PACIFICO,2024-01-11,128,124,4,0.03125
PACIFICO,2024-01-12,151,149,2,0.0132450331125828
PACIFICO,2024-01-13,158,155,3,0.0189873417721519
PACIFICO,2024-01-14,112,108,4,0.0357142857142857
PACIFICO,2024-01-15,132,126,6,0.0454545454545455
PACIFICO,2024-01-16,168,164,4,0.0238095238095238
PACIFICO,2024-01-17,131,129,2,0.0152671755725191
PACIFICO,2024-01-18,151,146,5,0.033112582781457
PACIFICO,2024-01-19,147,141,6,0.0408163265306122
PACIFICO,2024-01-20,148,148,0,0
PACIFICO,2024-01-21,88,88,0,0
PACIFICO,2024-01-22,107,104,3,0.0280373831775701
PACIFICO,2024-01-23,141,139,2,0.0141843971631206
PACIFICO,2024-01-24,136,133,3,0.0220588235294118
PACIFICO,2024-01-25,139,137,2,0.0143884892086331
PACIFICO,2024-01-26,136,134,2,0.0147058823529412
PACIFICO,2024-01-27,127,124,3,0.0236220472440945
PACIFICO,2024-01-28,93,90,3,0.032258064516129
PACIFICO,2024-01-29,119,118,1,0.00840336134453781
PACIFICO,2024-01-30,127,125,2,0.015748031496063
PACIFICO,2024-01-31,130,127,3,0.0230769230769231
PACIFICO,2024-02-01,109,108,1,0.00917431192660551
PACIFICO,2024-02-02,132,130,2,0.0151515151515152
PACIFICO,2024-02-03,127,123,4,0.031496062992126
PACIFICO,2024-02-04,103,100,3,0.029126213592233
PACIFICO,2024-02-05,122,122,0,0
PACIFICO,2024-02-06,132,129,3,0.0227272727272727
PACIFICO,2024-02-07,144,142,2,0.0138888888888889
PACIFICO,2024-02-08,119,117,2,0.0168067226890756
PACIFICO,2024-02-09,110,107,3,0.0272727272727273
PACIFICO,2024-02-10,148,144,4,0.027027027027027
PACIFICO,2024-02-11,96,92,4,0.0416666666666667
PACIFICO,2024-02-12,111,111,0,0
PACIFICO,2024-02-13,118,114,4,0.0338983050847458
PACIFICO,2024-02-14,90,90,0,0
PACIFICO,2024-02-15,105,104,1,0.00952380952380952
PACIFICO,2024-02-16,114,110,4,0.0350877192982456
PACIFICO,2024-02-17,154,154,0,0
PACIFICO,2024-02-18,120,120,0,0
PACIFICO,2024-02-19,110,108,2,0.0181818181818182
PACIFICO,2024-02-20,151,146,5,0.033112582781457
PACIFICO,2024-02-21,119,115,4,0.0336134453781513
PACIFICO,2024-02-22,133,130,3,0.0225563909774436
PACIFICO,2024-02-23,82,71,11,0.134146341463415
PACIFICO,2024-02-24,166,163,3,0.0180722891566265
PACIFICO,2024-02-25,92,89,3,0.0326086956521739
PACIFICO,2024-02-26,123,120,3,0.024390243902439
PACIFICO,2024-02-27,128,126,2,0.015625
PACIFICO,2024-02-28,136,133,3,0.0220588235294118
PACIFICO,2024-02-29,149,147,2,0.0134228187919463
PACIFICO,2024-03-01,138,136,2,0.0144927536231884
PACIFICO,2024-03-02,145,144,1,0.00689655172413793
PACIFICO,2024-03-03,102,101,1,0.00980392156862745
PACIFICO,2024-03-04,130,129,1,0.00769230769230769
PACIFICO,2024-03-05,133,131,2,0.0150375939849624
PACIFICO,2024-03-06,153,152,1,0.0065359477124183
PACIFICO,2024-03-07,147,144,3,0.0204081632653061
PACIFICO,2024-03-08,161,158,3,0.0186335403726708
PACIFICO,2024-03-09,144,143,1,0.00694444444444444
PACIFICO,2024-03-10,98,96,2,0.0204081632653061
PACIFICO,2024-03-11,144,141,3,0.0208333333333333
PACIFICO,2024-03-12,167,165,2,0.0119760479041916
PACIFICO,2024-03-13,128,125,3,0.0234375
PACIFICO,2024-03-14,115,113,2,0.0173913043478261
PACIFICO,2024-03-15,114,112,2,0.0175438596491228
PACIFICO,2024-03-16,145,141,4,0.0275862068965517
PACIFICO,2024-03-17,103,102,1,0.00970873786407767
PACIFICO,2024-03-18,122,121,1,0.00819672131147541
PACIFICO,2024-03-19,139,135,4,0.0287769784172662
PACIFICO,2024-03-20,102,97,5,0.0490196078431373
PACIFICO,2024-03-21,120,120,0,0
PACIFICO,2024-03-22,108,106,2,0.0185185185185185
PACIFICO,2024-03-23,123,121,2,0.016260162601626
PACIFICO,2024-03-24,75,73,2,0.0266666666666667
PACIFICO,2024-03-25,108,106,2,0.0185185185185185
PACIFICO,2024-03-26,133,130,3,0.0225563909774436
PACIFICO,2024-03-27,135,134,1,0.00740740740740741
PACIFICO,2024-03-28,115,108,7,0.0608695652173913
PACIFICO,2024-03-29,94,90,4,0.0425531914893617
PACIFICO,2024-03-30,76,75,1,0.0131578947368421
PACIFICO,2024-03-31,59,57,2,0.0338983050847458
PACIFICO,2024-04-01,108,105,3,0.0277777777777778
PACIFICO,2024-04-02,118,114,4,0.0338983050847458
PACIFICO,2024-04-03,114,114,0,0
PACIFICO,2024-04-04,129,129,0,0
PACIFICO,2024-04-05,139,135,4,0.0287769784172662
PACIFICO,2024-04-06,156,154,2,0.0128205128205128
PACIFICO,2024-04-07,84,82,2,0.0238095238095238
PACIFICO,2024-04-08,131,128,3,0.0229007633587786
PACIFICO,2024-04-09,121,118,3,0.0247933884297521
PACIFICO,2024-04-10,143,140,3,0.020979020979021
PACIFICO,2024-04-11,145,141,4,0.0275862068965517
PACIFICO,2024-04-12,166,161,5,0.0301204819277108
PACIFICO,2024-04-13,143,137,6,0.041958041958042
PACIFICO,2024-04-14,92,91,1,0.0108695652173913
PACIFICO,2024-04-15,145,140,5,0.0344827586206897
PACIFICO,2024-04-16,133,126,7,0.0526315789473684
PACIFICO,2024-04-17,122,114,8,0.0655737704918033
PACIFICO,2024-04-18,106,103,3,0.0283018867924528
PACIFICO,2024-04-19,122,116,6,0.0491803278688525
PACIFICO,2024-04-20,133,129,4,0.0300751879699248
PACIFICO,2024-04-21,67,65,2,0.0298507462686567
PACIFICO,2024-04-22,48,47,1,0.0208333333333333
PACIFICO,2024-04-23,172,157,15,0.0872093023255814
PACIFICO,2024-04-24,110,108,2,0.0181818181818182
PACIFICO,2024-04-25,116,114,2,0.0172413793103448
PACIFICO,2024-04-26,116,110,6,0.0517241379310345
PACIFICO,2024-04-27,131,124,7,0.0534351145038168
PACIFICO,2024-04-28,76,74,2,0.0263157894736842
PACIFICO,2024-04-29,134,127,7,0.0522388059701493
PACIFICO,2024-04-30,137,131,6,0.0437956204379562
PACIFICO,2024-05-01,113,111,2,0.0176991150442478
PACIFICO,2024-05-02,90,90,0,0
PACIFICO,2024-05-03,110,107,3,0.0272727272727273
PACIFICO,2024-05-04,126,122,4,0.0317460317460317
PACIFICO,2024-05-05,79,74,5,0.0632911392405063
PACIFICO,2024-05-06,110,110,0,0
PACIFICO,2024-05-07,124,123,1,0.00806451612903226
PACIFICO,2024-05-08,141,140,1,0.00709219858156028
PACIFICO,2024-05-09,112,108,4,0.0357142857142857
PACIFICO,2024-05-10,89,87,2,0.0224719101123595
PACIFICO,2024-05-11,129,124,5,0.0387596899224806
PACIFICO,2024-05-12,76,73,3,0.0394736842105263
PACIFICO,2024-05-13,127,119,8,0.062992125984252
PACIFICO,2024-05-14,138,132,6,0.0434782608695652
PACIFICO,2024-05-15,153,148,5,0.0326797385620915
PACIFICO,2024-05-16,105,86,19,0.180952380952381
PACIFICO,2024-05-17,137,132,5,0.0364963503649635
PACIFICO,2024-05-18,119,114,5,0.0420168067226891
PACIFICO,2024-05-19,71,70,1,0.0140845070422535
PACIFICO,2024-05-20,111,107,4,0.036036036036036
PACIFICO,2024-05-21,149,146,3,0.0201342281879195
PACIFICO,2024-05-22,111,111,0,0
PACIFICO,2024-05-23,133,126,7,0.0526315789473684
PACIFICO,2024-05-24,111,109,2,0.018018018018018
PACIFICO,2024-05-25,107,106,1,0.00934579439252336
PACIFICO,2024-05-26,75,75,0,0
PACIFICO,2024-05-27,93,91,2,0.021505376344086
PACIFICO,2024-05-28,105,104,1,0.00952380952380952
PACIFICO,2024-05-29,116,111,5,0.0431034482758621
PACIFICO,2024-05-30,115,114,1,0.00869565217391304
PACIFICO,2024-05-31,146,139,7,0.0479452054794521
PACIFICO,2024-06-01,119,116,3,0.0252100840336134
PACIFICO,2024-06-02,76,74,2,0.0263157894736842
PACIFICO,2024-06-03,106,103,3,0.0283018867924528
PACIFICO,2024-06-04,122,115,7,0.0573770491803279
PACIFICO,2024-06-05,122,118,4,0.0327868852459016
PACIFICO,2024-06-06,151,144,7,0.0463576158940397
PACIFICO,2024-06-07,142,137,5,0.0352112676056338
PACIFICO,2024-06-08,142,136,6,0.0422535211267606
PACIFICO,2024-06-09,95,90,5,0.0526315789473684
PACIFICO,2024-06-10,106,104,2,0.0188679245283019
PACIFICO,2024-06-11,105,103,2,0.019047619047619
PACIFICO,2024-06-12,114,110,4,0.0350877192982456
PACIFICO,2024-06-13,109,106,3,0.0275229357798165
PACIFICO,2024-06-14,104,99,5,0.0480769230769231
PACIFICO,2024-06-15,134,129,5,0.0373134328358209
PACIFICO,2024-06-16,70,67,3,0.0428571428571429
PACIFICO,2024-06-17,113,111,2,0.0176991150442478
PACIFICO,2024-06-18,126,119,7,0.0555555555555556
PACIFICO,2024-06-19,131,128,3,0.0229007633587786
PACIFICO,2024-06-20,112,109,3,0.0267857142857143
PACIFICO,2024-06-21,125,118,7,0.056
PACIFICO,2024-06-22,134,129,5,0.0373134328358209
PACIFICO,2024-06-23,111,110,1,0.00900900900900901
PACIFICO,2024-06-24,119,112,7,0.0588235294117647
PACIFICO,2024-06-25,115,114,1,0.00869565217391304
PACIFICO,2024-06-26,104,100,4,0.0384615384615385
PACIFICO,2024-06-27,111,106,5,0.045045045045045
PACIFICO,2024-06-28,142,141,1,0.00704225352112676
PACIFICO,2024-06-29,163,160,3,0.0184049079754601
PACIFICO,2024-06-30,110,110,0,0
PACIFICO,2024-07-01,136,128,8,0.0588235294117647
PACIFICO,2024-07-02,116,111,5,0.0431034482758621
PACIFICO,2024-07-03,111,106,5,0.045045045045045
PACIFICO,2024-07-04,133,131,2,0.0150375939849624
PACIFICO,2024-07-05,126,122,4,0.0317460317460317
PACIFICO,2024-07-06,147,143,4,0.0272108843537415
PACIFICO,2024-07-07,87,86,1,0.0114942528735632
PACIFICO,2024-07-08,117,112,5,0.0427350427350427
PACIFICO,2024-07-09,142,135,7,0.0492957746478873
PACIFICO,2024-07-10,129,129,0,0
PACIFICO,2024-07-11,163,159,4,0.0245398773006135
PACIFICO,2024-07-12,147,141,6,0.0408163265306122
PACIFICO,2024-07-13,144,141,3,0.0208333333333333
PACIFICO,2024-07-14,101,100,1,0.0099009900990099
PACIFICO,2024-07-15,137,134,3,0.0218978102189781
PACIFICO,2024-07-16,149,148,1,0.00671140939597315
PACIFICO,2024-07-17,141,137,4,0.0283687943262411
PACIFICO,2024-07-18,130,126,4,0.0307692307692308
PACIFICO,2024-07-19,147,142,5,0.0340136054421769
PACIFICO,2024-07-20,161,156,5,0.031055900621118
PACIFICO,2024-07-21,107,101,6,0.0560747663551402
PACIFICO,2024-07-22,130,130,0,0
PACIFICO,2024-07-23,135,124,11,0.0814814814814815
PACIFICO,2024-07-24,133,130,3,0.0225563909774436
PACIFICO,2024-07-25,139,135,4,0.0287769784172662
PACIFICO,2024-07-26,145,140,5,0.0344827586206897
PACIFICO,2024-07-27,139,136,3,0.0215827338129496
PACIFICO,2024-07-28,86,85,1,0.0116279069767442
PACIFICO,2024-07-29,122,119,3,0.0245901639344262
PACIFICO,2024-07-30,153,151,2,0.0130718954248366
PACIFICO,2024-07-31,162,160,2,0.0123456790123457
PACIFICO,2024-08-01,137,134,3,0.0218978102189781
PACIFICO,2024-08-02,132,129,3,0.0227272727272727
PACIFICO,2024-08-03,161,159,2,0.0124223602484472
PACIFICO,2024-08-04,114,110,4,0.0350877192982456
PACIFICO,2024-08-05,148,146,2,0.0135135135135135
PACIFICO,2024-08-06,164,156,8,0.0487804878048781
PACIFICO,2024-08-07,178,177,1,0.00561797752808989
PACIFICO,2024-08-08,149,146,3,0.0201342281879195
PACIFICO,2024-08-09,140,136,4,0.0285714285714286
PACIFICO,2024-08-10,152,147,5,0.0328947368421053
PACIFICO,2024-08-11,115,111,4,0.0347826086956522
PACIFICO,2024-08-12,136,134,2,0.0147058823529412
PACIFICO,2024-08-13,165,158,7,0.0424242424242424
PACIFICO,2024-08-14,167,164,3,0.0179640718562874
PACIFICO,2024-08-15,146,142,4,0.0273972602739726
PACIFICO,2024-08-16,170,165,5,0.0294117647058824
PACIFICO,2024-08-17,174,170,4,0.0229885057471264
PACIFICO,2024-08-18,112,109,3,0.0267857142857143
SURESTE,2023-08-19,236,228,8,0.0338983050847458
SURESTE,2023-08-20,211,204,7,0.033175355450237
SURESTE,2023-08-21,199,199,0,0
SURESTE,2023-08-22,178,175,3,0.0168539325842697
SURESTE,2023-08-23,178,177,1,0.00561797752808989
SURESTE,2023-08-24,219,218,1,0.0045662100456621
SURESTE,2023-08-25,209,206,3,0.0143540669856459
SURESTE,2023-08-26,241,238,3,0.012448132780083
SURESTE,2023-08-27,199,199,0,0
SURESTE,2023-08-28,209,204,5,0.0239234449760766
SURESTE,2023-08-29,207,206,1,0.00483091787439614
SURESTE,2023-08-30,198,197,1,0.00505050505050505
SURESTE,2023-08-31,200,199,1,0.005
SURESTE,2023-09-01,191,191,0,0
SURESTE,2023-09-02,203,201,2,0.00985221674876847
SURESTE,2023-09-03,176,175,1,0.00568181818181818
SURESTE,2023-09-04,162,161,1,0.00617283950617284
SURESTE,2023-09-05,223,222,1,0.00448430493273543
SURESTE,2023-09-06,202,201,1,0.00495049504950495
SURESTE,2023-09-07,228,227,1,0.0043859649122807
SURESTE,2023-09-08,220,220,0,0
SURESTE,2023-09-09,225,224,1,0.00444444444444444
SURESTE,2023-09-10,180,180,0,0
SURESTE,2023-09-11,202,200,2,0.0099009900990099
SURESTE,2023-09-12,234,233,1,0.00427350427350427
SURESTE,2023-09-13,211,209,2,0.00947867298578199
SURESTE,2023-09-14,204,202,2,0.00980392156862745
SURESTE,2023-09-15,222,220,2,0.00900900900900901
SURESTE,2023-09-16,207,206,1,0.00483091787439614
SURESTE,2023-09-17,169,168,1,0.00591715976331361
SURESTE,2023-09-18,189,189,0,0
SURESTE,2023-09-19,189,188,1,0.00529100529100529
SURESTE,2023-09-20,182,179,3,0.0164835164835165
SURESTE,2023-09-21,187,186,1,0.0053475935828877
SURESTE,2023-09-22,196,195,1,0.00510204081632653
SURESTE,2023-09-23,224,222,2,0.00892857142857143
SURESTE,2023-09-24,180,178,2,0.0111111111111111
SURESTE,2023-09-25,192,190,2,0.0104166666666667
SURESTE,2023-09-26,205,204,1,0.0048780487804878
SURESTE,2023-09-27,212,212,0,0
SURESTE,2023-09-28,188,186,2,0.0106382978723404
SURESTE,2023-09-29,238,237,1,0.00420168067226891
SURESTE,2023-09-30,249,248,1,0.00401606425702811
SURESTE,2023-10-01,196,196,0,0
SURESTE,2023-10-02,198,198,0,0
SURESTE,2023-10-03,195,192,3,0.0153846153846154
SURESTE,2023-10-04,167,164,3,0.0179640718562874
SURESTE,2023-10-05,176,172,4,0.0227272727272727
SURESTE,2023-10-06,187,182,5,0.0267379679144385
SURESTE,2023-10-07,199,196,3,0.0150753768844221
SURESTE,2023-10-08,156,152,4,0.0256410256410256
SURESTE,2023-10-09,162,158,4,0.0246913580246914
SURESTE,2023-10-10,155,149,6,0.0387096774193548
SURESTE,2023-10-11,176,169,7,0.0397727272727273
SURESTE,2023-10-12,144,142,2,0.0138888888888889
SURESTE,2023-10-13,180,179,1,0.00555555555555556
SURESTE,2023-10-14,189,189,0,0
SURESTE,2023-10-15,174,170,4,0.0229885057471264
SURESTE,2023-10-16,179,177,2,0.0111731843575419
SURESTE,2023-10-17,189,182,7,0.037037037037037
SURESTE,2023-10-18,214,207,7,0.0327102803738318
SURESTE,2023-10-19,193,188,5,0.0259067357512953
SURESTE,2023-10-20,197,193,4,0.0203045685279188
SURESTE,2023-10-21,212,207,5,0.0235849056603774
SURESTE,2023-10-22,160,151,9,0.05625
SURESTE,2023-10-23,144,140,4,0.0277777777777778
SURESTE,2023-10-24,174,168,6,0.0344827586206897
SURESTE,2023-10-25,181,177,4,0.0220994475138122
SURESTE,2023-10-26,189,183,6,0.0317460317460317
SURESTE,2023-10-27,195,189,6,0.0307692307692308
SURESTE,2023-10-28,214,213,1,0.00467289719626168
SURESTE,2023-10-29,146,142,4,0.0273972602739726
SURESTE,2023-10-30,209,202,7,0.0334928229665072
SURESTE,2023-10-31,211,207,4,0.018957345971564
SURESTE,2023-11-01,202,199,3,0.0148514851485149
SURESTE,2023-11-02,184,181,3,0.016304347826087
SURESTE,2023-11-03,197,192,5,0.0253807106598985
SURESTE,2023-11-04,185,178,7,0.0378378378378378
SURESTE,2023-11-05,174,171,3,0.0172413793103448
SURESTE,2023-11-06,200,193,7,0.035
SURESTE,2023-11-07,211,209,2,0.00947867298578199
SURESTE,2023-11-08,229,220,9,0.0393013100436681
SURESTE,2023-11-09,217,214,3,0.0138248847926267
SURESTE,2023-11-10,190,187,3,0.0157894736842105
SURESTE,2023-11-11,223,220,3,0.0134529147982063
SURESTE,2023-11-12,218,215,3,0.0137614678899083
SURESTE,2023-11-13,203,195,8,0.0394088669950739
SURESTE,2023-11-14,229,223,6,0.0262008733624454
SURESTE,2023-11-15,275,260,15,0.0545454545454545
SURESTE,2023-11-16,240,233,7,0.0291666666666667
SURESTE,2023-11-17,232,224,8,0.0344827586206897
SURESTE,2023-11-18,285,279,6,0.0210526315789474
SURESTE,2023-11-19,246,238,8,0.032520325203252
SURESTE,2023-11-20,256,254,2,0.0078125
SURESTE,2023-11-21,234,229,5,0.0213675213675214
SURESTE,2023-11-22,212,206,6,0.0283018867924528
SURESTE,2023-11-23,228,225,3,0.0131578947368421
SURESTE,2023-11-24,201,196,5,0.0248756218905473
SURESTE,2023-11-25,237,230,7,0.029535864978903
SURESTE,2023-11-26,209,205,4,0.0191387559808612
SURESTE,2023-11-27,242,236,6,0.0247933884297521
SURESTE,2023-11-28,242,237,5,0.0206611570247934
SURESTE,2023-11-29,247,239,8,0.0323886639676113
SURESTE,2023-11-30,263,255,8,0.0304182509505703
SURESTE,2023-12-01,223,212,11,0.0493273542600897
SURESTE,2023-12-02,238,233,5,0.0210084033613445
SURESTE,2023-12-03,164,160,4,0.024390243902439
SURESTE,2023-12-04,180,179,1,0.00555555555555556
SURESTE,2023-12-05,199,192,7,0.0351758793969849
SURESTE,2023-12-06,209,204,5,0.0239234449760766
SURESTE,2023-12-07,227,222,5,0.0220264317180617
SURESTE,2023-12-08,232,224,8,0.0344827586206897
SURESTE,2023-12-09,248,242,6,0.0241935483870968
SURESTE,2023-12-10,195,188,7,0.0358974358974359
SURESTE,2023-12-11,196,191,5,0.0255102040816327
SURESTE,2023-12-12,198,191,7,0.0353535353535354
SURESTE,2023-12-13,197,194,3,0.0152284263959391
SURESTE,2023-12-14,213,205,8,0.0375586854460094
SURESTE,2023-12-15,177,174,3,0.0169491525423729
SURESTE,2023-12-16,212,210,2,0.00943396226415094
SURESTE,2023-12-17,199,197,2,0.0100502512562814
SURESTE,2023-12-18,210,202,8,0.0380952380952381
SURESTE,2023-12-19,240,238,2,0.00833333333333333
SURESTE,2023-12-20,210,203,7,0.0333333333333333
SURESTE,2023-12-21,224,218,6,0.0267857142857143
SURESTE,2023-12-22,202,200,2,0.0099009900990099
SURESTE,2023-12-23,246,240,6,0.024390243902439
SURESTE,2023-12-24,176,172,4,0.0227272727272727
SURESTE,2023-12-25,60,60,0,0
SURESTE,2023-12-26,203,200,3,0.0147783251231527
SURESTE,2023-12-27,250,244,6,0.024
SURESTE,2023-12-28,252,248,4,0.0158730158730159
SURESTE,2023-12-29,225,222,3,0.0133333333333333
SURESTE,2023-12-30,262,259,3,0.0114503816793893
SURESTE,2023-12-31,110,108,2,0.0181818181818182
SURESTE,2024-01-01,42,41,1,0.0238095238095238
SURESTE,2024-01-02,174,172,2,0.0114942528735632
SURESTE,2024-01-03,231,228,3,0.012987012987013
SURESTE,2024-01-04,219,214,5,0.0228310502283105
SURESTE,2024-01-05,214,210,4,0.0186915887850467
SURESTE,2024-01-06,242,237,5,0.0206611570247934
SURESTE,2024-01-07,170,166,4,0.0235294117647059
SURESTE,2024-01-08,220,214,6,0.0272727272727273
SURESTE,2024-01-09,208,205,3,0.0144230769230769
SURESTE,2024-01-10,209,208,1,0.00478468899521531
SURESTE,2024-01-11,229,224,5,0.0218340611353712
SURESTE,2024-01-12,217,213,4,0.0184331797235023
SURESTE,2024-01-13,241,236,5,0.020746887966805
SURESTE,2024-01-14,214,209,5,0.0233644859813084
SURESTE,2024-01-15,238,229,9,0.0378151260504202
SURESTE,2024-01-16,226,222,4,0.0176991150442478
SURESTE,2024-01-17,200,198,2,0.01
SURESTE,2024-01-18,192,190,2,0.0104166666666667
SURESTE,2024-01-19,235,230,5,0.0212765957446809
SURESTE,2024-01-20,219,216,3,0.0136986301369863
SURESTE,2024-01-21,176,171,5,0.0284090909090909
SURESTE,2024-01-22,184,183,1,0.00543478260869565
SURESTE,2024-01-23,226,218,8,0.0353982300884956
SURESTE,2024-01-24,268,256,12,0.0447761194029851
SURESTE,2024-01-25,215,210,5,0.0232558139534884
SURESTE,2024-01-26,235,230,5,0.0212765957446809
SURESTE,2024-01-27,233,226,7,0.0300429184549356
SURESTE,2024-01-28,193,188,5,0.0259067357512953
SURESTE,2024-01-29,186,180,6,0.032258064516129
SURESTE,2024-01-30,177,168,9,0.0508474576271186
SURESTE,2024-01-31,212,204,8,0.0377358490566038
SURESTE,2024-02-01,220,217,3,0.0136363636363636
SURESTE,2024-02-02,200,192,8,0.04
SURESTE,2024-02-03,242,232,10,0.0413223140495868
SURESTE,2024-02-04,186,182,4,0.021505376344086
SURESTE,2024-02-05,173,168,5,0.0289017341040462
SURESTE,2024-02-06,202,200,2,0.0099009900990099
SURESTE,2024-02-07,206,204,2,0.00970873786407767
SURESTE,2024-02-08,204,199,5,0.0245098039215686
SURESTE,2024-02-09,220,215,5,0.0227272727272727
SURESTE,2024-02-10,188,182,6,0.0319148936170213
SURESTE,2024-02-11,157,154,3,0.0191082802547771
SURESTE,2024-02-12,162,158,4,0.0246913580246914
SURESTE,2024-02-13,220,217,3,0.0136363636363636
SURESTE,2024-02-14,191,182,9,0.0471204188481675
SURESTE,2024-02-15,226,221,5,0.0221238938053097
SURESTE,2024-02-16,208,205,3,0.0144230769230769
SURESTE,2024-02-17,207,204,3,0.0144927536231884
SURESTE,2024-02-18,161,158,3,0.0186335403726708
SURESTE,2024-02-19,205,199,6,0.0292682926829268
SURESTE,2024-02-20,199,195,4,0.0201005025125628
SURESTE,2024-02-21,231,227,4,0.0173160173160173
SURESTE,2024-02-22,203,196,7,0.0344827586206897
SURESTE,2024-02-23,155,135,20,0.129032258064516
SURESTE,2024-02-24,258,248,10,0.0387596899224806
SURESTE,2024-02-25,185,183,2,0.0108108108108108
SURESTE,2024-02-26,220,211,9,0.0409090909090909
SURESTE,2024-02-27,223,216,7,0.031390134529148
SURESTE,2024-02-28,217,212,5,0.0230414746543779
SURESTE,2024-02-29,219,211,8,0.0365296803652968
SURESTE,2024-03-01,227,222,5,0.0220264317180617
SURESTE,2024-03-02,250,244,6,0.024
SURESTE,2024-03-03,176,169,7,0.0397727272727273
SURESTE,2024-03-04,201,197,4,0.0199004975124378
SURESTE,2024-03-05,188,182,6,0.0319148936170213
SURESTE,2024-03-06,182,175,7,0.0384615384615385
SURESTE,2024-03-07,189,182,7,0.037037037037037
SURESTE,2024-03-08,208,199,9,0.0432692307692308
SURESTE,2024-03-09,215,209,6,0.027906976744186
SURESTE,2024-03-10,166,165,1,0.00602409638554217
SURESTE,2024-03-11,194,185,9,0.0463917525773196
SURESTE,2024-03-12,199,193,6,0.0301507537688442
SURESTE,2024-03-13,178,165,13,0.0730337078651685
SURESTE,2024-03-14,178,169,9,0.050561797752809
SURESTE,2024-03-15,212,205,7,0.0330188679245283
SURESTE,2024-03-16,236,228,8,0.0338983050847458
SURESTE,2024-03-17,147,143,4,0.0272108843537415
SURESTE,2024-03-18,165,162,3,0.0181818181818182
SURESTE,2024-03-19,198,189,9,0.0454545454545455
SURESTE,2024-03-20,180,176,4,0.0222222222222222
SURESTE,2024-03-21,160,156,4,0.025
SURESTE,2024-03-22,167,163,4,0.0239520958083832
SURESTE,2024-03-23,222,210,12,0.0540540540540541
SURESTE,2024-03-24,154,151,3,0.0194805194805195
SURESTE,2024-03-25,171,162,9,0.0526315789473684
SURESTE,2024-03-26,213,205,8,0.0375586854460094
SURESTE,2024-03-27,169,166,3,0.0177514792899408
SURESTE,2024-03-28,227,223,4,0.0176211453744493
SURESTE,2024-03-29,196,187,9,0.0459183673469388
SURESTE,2024-03-30,179,175,4,0.0223463687150838
SURESTE,2024-03-31,132,130,2,0.0151515151515152
SURESTE,2024-04-01,168,165,3,0.0178571428571429
SURESTE,2024-04-02,213,211,2,0.00938967136150235
SURESTE,2024-04-03,187,187,0,0
SURESTE,2024-04-04,177,177,0,0
SURESTE,2024-04-05,194,190,4,0.0206185567010309
SURESTE,2024-04-06,192,184,8,0.0416666666666667
SURESTE,2024-04-07,137,136,1,0.0072992700729927
SURESTE,2024-04-08,170,166,4,0.0235294117647059
SURESTE,2024-04-09,174,167,7,0.0402298850574713
SURESTE,2024-04-10,181,170,11,0.0607734806629834
SURESTE,2024-04-11,164,157,7,0.0426829268292683
SURESTE,2024-04-12,185,181,4,0.0216216216216216
SURESTE,2024-04-13,226,222,4,0.0176991150442478
SURESTE,2024-04-14,143,139,4,0.027972027972028
SURESTE,2024-04-15,194,189,5,0.0257731958762887
SURESTE,2024-04-16,206,198,8,0.0388349514563107
SURESTE,2024-04-17,208,198,10,0.0480769230769231
SURESTE,2024-04-18,190,185,5,0.0263157894736842
SURESTE,2024-04-19,166,155,11,0.0662650602409639
SURESTE,2024-04-20,203,194,9,0.0443349753694581
SURESTE,2024-04-21,149,144,5,0.0335570469798658
SURESTE,2024-04-22,96,92,4,0.0416666666666667
SURESTE,2024-04-23,215,193,22,0.102325581395349
SURESTE,2024-04-24,191,188,3,0.0157068062827225
SURESTE,2024-04-25,195,191,4,0.0205128205128205
SURESTE,2024-04-26,176,169,7,0.0397727272727273
SURESTE,2024-04-27,180,178,2,0.0111111111111111
SURESTE,2024-04-28,130,127,3,0.0230769230769231
SURESTE,2024-04-29,185,177,8,0.0432432432432432
SURESTE,2024-04-30,174,172,2,0.0114942528735632
SURESTE,2024-05-01,166,162,4,0.0240963855421687
SURESTE,2024-05-02,178,175,3,0.0168539325842697
SURESTE,2024-05-03,186,181,5,0.0268817204301075
SURESTE,2024-05-04,197,191,6,0.0304568527918782
SURESTE,2024-05-05,136,133,3,0.0220588235294118
SURESTE,2024-05-06,179,179,0,0
SURESTE,2024-05-07,172,170,2,0.0116279069767442
SURESTE,2024-05-08,153,146,7,0.0457516339869281
SURESTE,2024-05-09,158,150,8,0.0506329113924051
SURESTE,2024-05-10,141,140,1,0.00709219858156028
SURESTE,2024-05-11,177,174,3,0.0169491525423729
SURESTE,2024-05-12,96,94,2,0.0208333333333333
SURESTE,2024-05-13,154,149,5,0.0324675324675325
SURESTE,2024-05-14,182,173,9,0.0494505494505494
SURESTE,2024-05-15,215,210,5,0.0232558139534884
SURESTE,2024-05-16,180,172,8,0.0444444444444444
SURESTE,2024-05-17,177,173,4,0.0225988700564972
SURESTE,2024-05-18,202,193,9,0.0445544554455446
SURESTE,2024-05-19,149,142,7,0.0469798657718121
SURESTE,2024-05-20,186,181,5,0.0268817204301075
SURESTE,2024-05-21,181,180,1,0.00552486187845304
SURESTE,2024-05-22,186,181,5,0.0268817204301075
SURESTE,2024-05-23,165,161,4,0.0242424242424242
SURESTE,2024-05-24,179,176,3,0.0167597765363128
SURESTE,2024-05-25,192,190,2,0.0104166666666667
SURESTE,2024-05-26,138,137,1,0.0072463768115942
SURESTE,2024-05-27,134,127,7,0.0522388059701493
SURESTE,2024-05-28,187,184,3,0.0160427807486631
SURESTE,2024-05-29,168,162,6,0.0357142857142857
SURESTE,2024-05-30,187,185,2,0.0106951871657754
SURESTE,2024-05-31,216,211,5,0.0231481481481481
SURESTE,2024-06-01,202,196,6,0.0297029702970297
SURESTE,2024-06-02,114,111,3,0.0263157894736842
SURESTE,2024-06-03,184,183,1,0.00543478260869565
SURESTE,2024-06-04,201,199,2,0.00995024875621891
SURESTE,2024-06-05,213,208,5,0.0234741784037559
SURESTE,2024-06-06,200,192,8,0.04
SURESTE,2024-06-07,179,172,7,0.0391061452513966
SURESTE,2024-06-08,205,194,11,0.0536585365853659
SURESTE,2024-06-09,148,147,1,0.00675675675675676
SURESTE,2024-06-10,156,154,2,0.0128205128205128
SURESTE,2024-06-11,160,154,6,0.0375
SURESTE,2024-06-12,182,180,2,0.010989010989011
SURESTE,2024-06-13,174,169,5,0.028735632183908
SURESTE,2024-06-14,188,184,4,0.0212765957446809
SURESTE,2024-06-15,199,196,3,0.0150753768844221
SURESTE,2024-06-16,157,151,6,0.0382165605095541
SURESTE,2024-06-17,171,165,6,0.0350877192982456
SURESTE,2024-06-18,204,200,4,0.0196078431372549
SURESTE,2024-06-19,194,189,5,0.0257731958762887
SURESTE,2024-06-20,188,186,2,0.0106382978723404
SURESTE,2024-06-21,170,167,3,0.0176470588235294
SURESTE,2024-06-22,184,182,2,0.0108695652173913
SURESTE,2024-06-23,176,172,4,0.0227272727272727
SURESTE,2024-06-24,189,184,5,0.0264550264550265
SURESTE,2024-06-25,192,186,6,0.03125
SURESTE,2024-06-26,195,192,3,0.0153846153846154
SURESTE,2024-06-27,198,194,4,0.0202020202020202
SURESTE,2024-06-28,209,203,6,0.0287081339712919
SURESTE,2024-06-29,201,198,3,0.0149253731343284
SURESTE,2024-06-30,198,193,5,0.0252525252525253
SURESTE,2024-07-01,175,172,3,0.0171428571428571
SURESTE,2024-07-02,192,189,3,0.015625
SURESTE,2024-07-03,164,161,3,0.0182926829268293
SURESTE,2024-07-04,155,153,2,0.0129032258064516
SURESTE,2024-07-05,88,87,1,0.0113636363636364
SURESTE,2024-07-06,167,165,2,0.0119760479041916
SURESTE,2024-07-07,137,134,3,0.0218978102189781
SURESTE,2024-07-08,148,142,6,0.0405405405405405
SURESTE,2024-07-09,178,175,3,0.0168539325842697
SURESTE,2024-07-10,183,183,0,0
SURESTE,2024-07-11,197,196,1,0.0050761421319797
SURESTE,2024-07-12,199,198,1,0.0050251256281407
SURESTE,2024-07-13,199,193,6,0.0301507537688442
SURESTE,2024-07-14,174,169,5,0.028735632183908
SURESTE,2024-07-15,178,171,7,0.0393258426966292
SURESTE,2024-07-16,213,212,1,0.00469483568075117
SURESTE,2024-07-17,213,207,6,0.028169014084507
SURESTE,2024-07-18,217,212,5,0.0230414746543779
SURESTE,2024-07-19,239,231,8,0.0334728033472803
SURESTE,2024-07-20,236,230,6,0.0254237288135593
SURESTE,2024-07-21,165,163,2,0.0121212121212121
SURESTE,2024-07-22,207,204,3,0.0144927536231884
SURESTE,2024-07-23,210,204,6,0.0285714285714286
SURESTE,2024-07-24,227,225,2,0.00881057268722467
SURESTE,2024-07-25,200,197,3,0.015
SURESTE,2024-07-26,195,194,1,0.00512820512820513
SURESTE,2024-07-27,199,197,2,0.0100502512562814
SURESTE,2024-07-28,150,148,2,0.0133333333333333
SURESTE,2024-07-29,216,212,4,0.0185185185185185
SURESTE,2024-07-30,229,223,6,0.0262008733624454
SURESTE,2024-07-31,249,244,5,0.0200803212851406
SURESTE,2024-08-01,231,226,5,0.0216450216450216
SURESTE,2024-08-02,193,186,7,0.0362694300518135
SURESTE,2024-08-03,198,193,5,0.0252525252525253
SURESTE,2024-08-04,176,172,4,0.0227272727272727
SURESTE,2024-08-05,191,184,7,0.0366492146596859
SURESTE,2024-08-06,206,202,4,0.0194174757281553
SURESTE,2024-08-07,240,234,6,0.025
SURESTE,2024-08-08,238,234,4,0.0168067226890756
SURESTE,2024-08-09,206,205,1,0.00485436893203883
SURESTE,2024-08-10,204,197,7,0.0343137254901961
SURESTE,2024-08-11,180,179,1,0.00555555555555556
SURESTE,2024-08-12,188,188,0,0
SURESTE,2024-08-13,221,218,3,0.0135746606334842
SURESTE,2024-08-14,209,207,2,0.00956937799043062
SURESTE,2024-08-15,216,213,3,0.0138888888888889
SURESTE,2024-08-16,241,232,9,0.037344398340249
SURESTE,2024-08-17,221,215,6,0.0271493212669683
SURESTE,2024-08-18,173,170,3,0.0173410404624277