DISTRITO,Fecha,Instalaciones,Activaciones_automaticas,Ativaciones_manuales,%Act_Manuales
ACAPULCO,2023-01-02,23,21,2,0.08696
ACAPULCO,2023-01-03,28,18,10,0.35714
ACAPULCO,2023-01-04,36,34,2,0.05556
ACAPULCO,2023-01-05,29,24,5,0.17241
ACAPULCO,2023-01-06,45,24,21,0.46667
ACAPULCO,2023-01-07,30,22,8,0.26667
ACAPULCO,2023-01-08,41,37,4,0.09756
ACAPULCO,2023-01-09,33,31,2,0.06061
ACAPULCO,2023-01-10,29,20,9,0.31034
ACAPULCO,2023-01-11,31,24,7,0.22581
ACAPULCO,2023-01-12,38,36,2,0.05263
ACAPULCO,2023-01-13,49,25,24,0.4898
ACAPULCO,2023-01-14,35,25,10,0.28571
ACAPULCO,2023-01-15,27,24,3,0.11111
ACAPULCO,2023-01-16,49,45,4,0.08163
ACAPULCO,2023-01-17,67,40,27,0.40299
ACAPULCO,2023-01-18,87,45,42,0.48276
ACAPULCO,2023-01-19,57,49,8,0.14035
ACAPULCO,2023-01-20,83,62,21,0.25301
ACAPULCO,2023-01-21,62,32,30,0.48387
ACAPULCO,2023-01-22,52,22,30,0.57692
ACAPULCO,2023-01-23,84,63,21,0.25
ACAPULCO,2023-01-24,106,70,36,0.33962
ACAPULCO,2023-01-25,55,52,3,0.05455
ACAPULCO,2023-01-26,62,58,4,0.06452
ACAPULCO,2023-01-27,62,55,7,0.1129
ACAPULCO,2023-01-28,124,99,25,0.20161
ACAPULCO,2023-01-29,44,38,6,0.13636
ACAPULCO,2023-01-30,74,73,1,0.01351
ACAPULCO,2023-01-31,68,56,12,0.17647
ACAPULCO,2023-02-02,51,38,13,0.2549
ACAPULCO,2023-02-03,95,83,12,0.12632
ACAPULCO,2023-02-04,158,143,15,0.09494
ACAPULCO,2023-02-05,121,120,1,0.00826
ACAPULCO,2023-02-06,61,61,0,0
ACAPULCO,2023-02-07,57,56,1,0.01754
ACAPULCO,2023-02-08,91,90,1,0.01099
ACAPULCO,2023-02-09,68,58,10,0.14706
ACAPULCO,2023-02-10,45,35,10,0.22222
ACAPULCO,2023-02-11,94,84,10,0.10638
ACAPULCO,2023-02-12,38,34,4,0.10526
ACAPULCO,2023-02-13,64,55,9,0.14062
ACAPULCO,2023-02-14,33,26,7,0.21212
ACAPULCO,2023-02-15,79,41,38,0.48101
ACAPULCO,2023-02-16,43,38,5,0.11628
ACAPULCO,2023-02-17,41,25,16,0.39024
ACAPULCO,2023-02-18,112,46,66,0.58929
ACAPULCO,2023-02-19,78,75,3,0.03846
ACAPULCO,2023-02-20,150,150,0,0
ACAPULCO,2023-02-21,105,69,36,0.34286
ACAPULCO,2023-02-22,227,146,81,0.35683
ACAPULCO,2023-02-23,87,63,24,0.27586
ACAPULCO,2023-02-24,68,60,8,0.11765
ACAPULCO,2023-02-25,106,71,35,0.33019
ACAPULCO,2023-02-26,23,21,2,0.08696
ACAPULCO,2023-02-27,141,134,7,0.04965
ACAPULCO,2023-02-28,67,59,8,0.1194
ACAPULCO,2023-03-01,51,49,2,0.03922
ACAPULCO,2023-03-14,1,0,1,1
AEROPUERTO,2023-01-01,21,21,0,0
AEROPUERTO,2023-01-02,28,27,1,0.03571
AEROPUERTO,2023-01-03,46,43,3,0.06522
AEROPUERTO,2023-01-04,64,64,0,0
AEROPUERTO,2023-01-05,94,94,0,0
AEROPUERTO,2023-01-06,63,57,6,0.09524
AEROPUERTO,2023-01-07,72,66,6,0.08333
AEROPUERTO,2023-01-08,67,67,0,0
AEROPUERTO,2023-01-09,38,38,0,0
AEROPUERTO,2023-01-10,28,27,1,0.03571
AEROPUERTO,2023-01-11,56,55,1,0.01786
AEROPUERTO,2023-01-12,72,69,3,0.04167
AEROPUERTO,2023-01-13,67,65,2,0.02985
AEROPUERTO,2023-01-14,57,55,2,0.03509
AEROPUERTO,2023-01-15,81,76,5,0.06173
AEROPUERTO,2023-01-16,71,58,13,0.1831
AEROPUERTO,2023-01-17,46,46,0,0
AEROPUERTO,2023-01-18,128,91,37,0.28906
AEROPUERTO,2023-01-19,64,63,1,0.01562
AEROPUERTO,2023-01-20,64,64,0,0
AEROPUERTO,2023-01-21,131,131,0,0
AEROPUERTO,2023-01-22,64,62,2,0.03125
AEROPUERTO,2023-01-23,64,57,7,0.10938
AEROPUERTO,2023-01-24,66,64,2,0.0303
AEROPUERTO,2023-01-25,47,46,1,0.02128
AEROPUERTO,2023-01-26,125,111,14,0.112
AEROPUERTO,2023-01-27,51,44,7,0.13725
AEROPUERTO,2023-01-28,152,146,6,0.03947
AEROPUERTO,2023-01-29,57,53,4,0.07018
AEROPUERTO,2023-01-30,105,104,1,0.00952
AEROPUERTO,2023-01-31,96,94,2,0.02083
AEROPUERTO,2023-02-02,63,60,3,0.04762
AEROPUERTO,2023-02-03,91,87,4,0.04396
AEROPUERTO,2023-02-04,52,52,0,0
AEROPUERTO,2023-02-05,89,88,1,0.01124
AEROPUERTO,2023-02-06,64,61,3,0.04688
AEROPUERTO,2023-02-07,47,47,0,0
AEROPUERTO,2023-02-08,59,59,0,0
AEROPUERTO,2023-02-09,76,76,0,0
AEROPUERTO,2023-02-10,51,51,0,0
AEROPUERTO,2023-02-11,64,62,2,0.03125
AEROPUERTO,2023-02-12,69,67,2,0.02899
AEROPUERTO,2023-02-13,90,90,0,0
AEROPUERTO,2023-02-14,85,74,11,0.12941
AEROPUERTO,2023-02-15,246,245,1,0.00407
AEROPUERTO,2023-02-16,365,356,9,0.02466
AEROPUERTO,2023-02-17,216,216,0,0
AEROPUERTO,2023-02-18,77,72,5,0.06494
AEROPUERTO,2023-02-19,80,76,4,0.05
AEROPUERTO,2023-02-20,76,75,1,0.01316
AEROPUERTO,2023-02-21,46,44,2,0.04348
AEROPUERTO,2023-02-22,107,107,0,0
AEROPUERTO,2023-02-23,98,96,2,0.02041
AEROPUERTO,2023-02-24,67,67,0,0
AEROPUERTO,2023-02-25,88,64,24,0.27273
AEROPUERTO,2023-02-26,82,82,0,0
AEROPUERTO,2023-02-27,72,72,0,0
AEROPUERTO,2023-02-28,76,70,6,0.07895
AEROPUERTO,2023-03-01,65,65,0,0
AEROPUERTO,2023-03-02,48,48,0,0
AEROPUERTO,2023-03-03,38,38,0,0
AEROPUERTO,2023-03-04,70,70,0,0
AEROPUERTO,2023-03-05,101,101,0,0
AEROPUERTO,2023-03-07,61,61,0,0
AEROPUERTO,2023-03-08,60,59,1,0.01667
AEROPUERTO,2023-03-09,42,42,0,0
AEROPUERTO,2023-03-10,39,39,0,0
AEROPUERTO,2023-03-11,63,63,0,0
AEROPUERTO,2023-03-12,33,33,0,0
AEROPUERTO,2023-03-13,69,69,0,0
AEROPUERTO,2023-03-14,49,49,0,0
AEROPUERTO,2023-03-15,58,58,0,0
AEROPUERTO,2023-03-16,58,58,0,0
AEROPUERTO,2023-03-17,84,84,0,0
AEROPUERTO,2023-03-18,76,76,0,0
AEROPUERTO,2023-03-19,59,59,0,0
AEROPUERTO,2023-03-20,60,59,1,0.01667
AGUASCALIENTES,2023-01-01,7,5,2,0.28571
AGUASCALIENTES,2023-01-02,54,47,7,0.12963
AGUASCALIENTES,2023-01-03,66,57,9,0.13636
AGUASCALIENTES,2023-01-04,65,55,10,0.15385
AGUASCALIENTES,2023-01-05,52,47,5,0.09615
AGUASCALIENTES,2023-01-06,53,46,7,0.13208
AGUASCALIENTES,2023-01-07,64,52,12,0.1875
AGUASCALIENTES,2023-01-08,32,24,8,0.25
AGUASCALIENTES,2023-01-09,47,25,22,0.46809
AGUASCALIENTES,2023-01-10,56,51,5,0.08929
AGUASCALIENTES,2023-01-11,76,54,22,0.28947
AGUASCALIENTES,2023-01-12,66,49,17,0.25758
AGUASCALIENTES,2023-01-13,52,49,3,0.05769
AGUASCALIENTES,2023-01-14,87,76,11,0.12644
AGUASCALIENTES,2023-01-15,26,25,1,0.03846
AGUASCALIENTES,2023-01-16,68,64,4,0.05882
AGUASCALIENTES,2023-01-17,56,48,8,0.14286
AGUASCALIENTES,2023-01-18,45,44,1,0.02222
AGUASCALIENTES,2023-01-19,80,72,8,0.1
AGUASCALIENTES,2023-01-20,69,68,1,0.01449
AGUASCALIENTES,2023-01-21,105,103,2,0.01905
AGUASCALIENTES,2023-01-22,47,43,4,0.08511
AGUASCALIENTES,2023-01-23,102,98,4,0.03922
AGUASCALIENTES,2023-01-24,157,151,6,0.03822
AGUASCALIENTES,2023-01-25,186,179,7,0.03763
AGUASCALIENTES,2023-01-26,143,130,13,0.09091
AGUASCALIENTES,2023-01-27,152,99,53,0.34868
AGUASCALIENTES,2023-01-28,173,162,11,0.06358
AGUASCALIENTES,2023-01-29,50,37,13,0.26
AGUASCALIENTES,2023-01-30,105,94,11,0.10476
AGUASCALIENTES,2023-01-31,169,155,14,0.08284
AGUASCALIENTES,2023-02-02,134,94,40,0.29851
AGUASCALIENTES,2023-02-03,171,160,11,0.06433
AGUASCALIENTES,2023-02-04,142,122,20,0.14085
AGUASCALIENTES,2023-02-05,113,109,4,0.0354
AGUASCALIENTES,2023-02-06,149,130,19,0.12752
AGUASCALIENTES,2023-02-07,219,197,22,0.10046
AGUASCALIENTES,2023-02-08,129,109,20,0.15504
AGUASCALIENTES,2023-02-09,136,109,27,0.19853
AGUASCALIENTES,2023-02-10,144,105,39,0.27083
AGUASCALIENTES,2023-02-11,159,140,19,0.1195
AGUASCALIENTES,2023-02-12,53,53,0,0
AGUASCALIENTES,2023-02-13,249,168,81,0.3253
AGUASCALIENTES,2023-02-14,165,147,18,0.10909
AGUASCALIENTES,2023-02-15,148,135,13,0.08784
AGUASCALIENTES,2023-02-16,251,165,86,0.34263
AGUASCALIENTES,2023-02-17,269,251,18,0.06691
AGUASCALIENTES,2023-02-18,267,246,21,0.07865
AGUASCALIENTES,2023-02-19,100,96,4,0.04
AGUASCALIENTES,2023-02-20,226,218,8,0.0354
AGUASCALIENTES,2023-02-21,166,138,28,0.16867
AGUASCALIENTES,2023-02-22,181,112,69,0.38122
AGUASCALIENTES,2023-02-23,108,77,31,0.28704
AGUASCALIENTES,2023-02-24,80,68,12,0.15
AGUASCALIENTES,2023-02-25,199,146,53,0.26633
AGUASCALIENTES,2023-02-26,100,95,5,0.05
AGUASCALIENTES,2023-02-27,202,193,9,0.04455
AGUASCALIENTES,2023-02-28,94,86,8,0.08511
AGUASCALIENTES,2023-03-01,81,59,22,0.2716
AGUASCALIENTES,2023-03-02,130,85,45,0.34615
AGUASCALIENTES,2023-03-03,89,52,37,0.41573
AGUASCALIENTES,2023-03-04,272,266,6,0.02206
AGUASCALIENTES,2023-03-05,33,28,5,0.15152
AGUASCALIENTES,2023-03-07,52,49,3,0.05769
AGUASCALIENTES,2023-03-08,70,53,17,0.24286
AGUASCALIENTES,2023-03-09,77,71,6,0.07792
AGUASCALIENTES,2023-03-10,45,35,10,0.22222
AGUASCALIENTES,2023-03-11,65,54,11,0.16923
AGUASCALIENTES,2023-03-12,13,12,1,0.07692
AGUASCALIENTES,2023-03-13,48,43,5,0.10417
AGUASCALIENTES,2023-03-14,82,58,24,0.29268
AGUASCALIENTES,2023-03-15,82,64,18,0.21951
AGUASCALIENTES,2023-03-16,70,58,12,0.17143
AGUASCALIENTES,2023-03-17,104,97,7,0.06731
AGUASCALIENTES,2023-03-18,106,102,4,0.03774
AGUASCALIENTES,2023-03-19,43,39,4,0.09302
AGUASCALIENTES,2023-03-20,51,49,2,0.03922
ARAGON,2023-01-01,9,9,0,0
ARAGON,2023-01-02,32,32,0,0
ARAGON,2023-01-03,54,54,0,0
ARAGON,2023-01-04,38,38,0,0
ARAGON,2023-01-05,58,58,0,0
ARAGON,2023-01-06,35,35,0,0
ARAGON,2023-01-07,55,55,0,0
ARAGON,2023-01-08,43,43,0,0
ARAGON,2023-01-09,49,49,0,0
ARAGON,2023-01-10,54,54,0,0
ARAGON,2023-01-11,108,108,0,0
ARAGON,2023-01-12,94,94,0,0
ARAGON,2023-01-13,64,64,0,0
ARAGON,2023-01-14,76,76,0,0
ARAGON,2023-01-15,56,56,0,0
ARAGON,2023-01-16,45,45,0,0
ARAGON,2023-01-17,60,60,0,0
ARAGON,2023-01-18,139,139,0,0
ARAGON,2023-01-19,234,234,0,0
ARAGON,2023-01-20,164,164,0,0
ARAGON,2023-01-21,164,164,0,0
ARAGON,2023-01-22,202,202,0,0
ARAGON,2023-01-23,212,212,0,0
ARAGON,2023-01-24,191,191,0,0
ARAGON,2023-01-25,436,436,0,0
ARAGON,2023-01-26,315,315,0,0
ARAGON,2023-01-27,177,177,0,0
ARAGON,2023-01-28,349,349,0,0
ARAGON,2023-01-29,282,282,0,0
ARAGON,2023-01-30,284,283,1,0.00352
ARAGON,2023-01-31,349,349,0,0
ARAGON,2023-02-02,304,304,0,0
ARAGON,2023-02-03,249,249,0,0
ARAGON,2023-02-04,272,272,0,0
ARAGON,2023-02-05,109,109,0,0
ARAGON,2023-02-06,567,567,0,0
ARAGON,2023-02-07,189,186,3,0.01587
ARAGON,2023-02-08,140,139,1,0.00714
ARAGON,2023-02-09,210,205,5,0.02381
ARAGON,2023-02-10,299,299,0,0
ARAGON,2023-02-11,363,363,0,0
ARAGON,2023-02-12,137,137,0,0
ARAGON,2023-02-13,166,166,0,0
ARAGON,2023-02-14,326,326,0,0
ARAGON,2023-02-15,374,374,0,0
ARAGON,2023-02-16,343,343,0,0
ARAGON,2023-02-17,213,213,0,0
ARAGON,2023-02-18,321,321,0,0
ARAGON,2023-02-19,384,384,0,0
ARAGON,2023-02-20,211,211,0,0
ARAGON,2023-02-21,336,336,0,0
ARAGON,2023-02-22,178,178,0,0
ARAGON,2023-02-23,157,157,0,0
ARAGON,2023-02-24,98,98,0,0
ARAGON,2023-02-25,157,157,0,0
ARAGON,2023-02-26,174,174,0,0
ARAGON,2023-02-27,123,123,0,0
ARAGON,2023-02-28,109,109,0,0
ARAGON,2023-03-01,144,140,4,0.02778
ARAGON,2023-03-02,85,85,0,0
ARAGON,2023-03-03,60,60,0,0
ARAGON,2023-03-04,149,149,0,0
ARAGON,2023-03-05,98,98,0,0
ARAGON,2023-03-07,73,73,0,0
ARAGON,2023-03-08,138,138,0,0
ARAGON,2023-03-09,282,282,0,0
ARAGON,2023-03-10,56,56,0,0
ARAGON,2023-03-11,57,57,0,0
ARAGON,2023-03-12,56,55,1,0.01786
ARAGON,2023-03-13,82,82,0,0
ARAGON,2023-03-14,56,56,0,0
ARAGON,2023-03-15,84,84,0,0
ARAGON,2023-03-16,72,72,0,0
ARAGON,2023-03-17,105,105,0,0
ARAGON,2023-03-18,96,95,1,0.01042
ARAGON,2023-03-19,103,103,0,0
ARAGON,2023-03-20,86,86,0,0
AZCAPOTZALCO,2023-01-01,5,5,0,0
AZCAPOTZALCO,2023-01-02,42,42,0,0
AZCAPOTZALCO,2023-01-03,92,92,0,0
AZCAPOTZALCO,2023-01-04,93,93,0,0
AZCAPOTZALCO,2023-01-05,69,69,0,0
AZCAPOTZALCO,2023-01-06,102,102,0,0
AZCAPOTZALCO,2023-01-07,54,52,2,0.03704
AZCAPOTZALCO,2023-01-08,68,62,6,0.08824
AZCAPOTZALCO,2023-01-09,40,40,0,0
AZCAPOTZALCO,2023-01-10,89,89,0,0
AZCAPOTZALCO,2023-01-11,70,70,0,0
AZCAPOTZALCO,2023-01-12,62,62,0,0
AZCAPOTZALCO,2023-01-13,55,55,0,0
AZCAPOTZALCO,2023-01-14,101,101,0,0
AZCAPOTZALCO,2023-01-15,69,68,1,0.01449
AZCAPOTZALCO,2023-01-16,147,147,0,0
AZCAPOTZALCO,2023-01-17,109,109,0,0
AZCAPOTZALCO,2023-01-18,196,196,0,0
AZCAPOTZALCO,2023-01-19,207,207,0,0
AZCAPOTZALCO,2023-01-20,178,178,0,0
AZCAPOTZALCO,2023-01-21,186,175,11,0.05914
AZCAPOTZALCO,2023-01-22,128,128,0,0
AZCAPOTZALCO,2023-01-23,158,158,0,0
AZCAPOTZALCO,2023-01-24,302,302,0,0
AZCAPOTZALCO,2023-01-25,214,214,0,0
AZCAPOTZALCO,2023-01-26,247,245,2,0.0081
AZCAPOTZALCO,2023-01-27,312,312,0,0
AZCAPOTZALCO,2023-01-28,451,451,0,0
AZCAPOTZALCO,2023-01-29,181,181,0,0
AZCAPOTZALCO,2023-01-30,255,255,0,0
AZCAPOTZALCO,2023-01-31,399,399,0,0
AZCAPOTZALCO,2023-02-02,230,223,7,0.03043
AZCAPOTZALCO,2023-02-03,159,159,0,0
AZCAPOTZALCO,2023-02-04,524,522,2,0.00382
AZCAPOTZALCO,2023-02-05,224,208,16,0.07143
AZCAPOTZALCO,2023-02-06,130,130,0,0
AZCAPOTZALCO,2023-02-07,340,338,2,0.00588
AZCAPOTZALCO,2023-02-08,167,167,0,0
AZCAPOTZALCO,2023-02-09,274,268,6,0.0219
AZCAPOTZALCO,2023-02-10,224,215,9,0.04018
AZCAPOTZALCO,2023-02-11,167,166,1,0.00599
AZCAPOTZALCO,2023-02-12,202,202,0,0
AZCAPOTZALCO,2023-02-13,201,200,1,0.00498
AZCAPOTZALCO,2023-02-14,68,66,2,0.02941
AZCAPOTZALCO,2023-02-15,47,47,0,0
AZCAPOTZALCO,2023-02-16,63,63,0,0
AZCAPOTZALCO,2023-02-17,344,344,0,0
AZCAPOTZALCO,2023-02-18,297,273,24,0.08081
AZCAPOTZALCO,2023-02-19,134,131,3,0.02239
AZCAPOTZALCO,2023-02-20,273,250,23,0.08425
AZCAPOTZALCO,2023-02-21,115,112,3,0.02609
AZCAPOTZALCO,2023-02-22,230,198,32,0.13913
AZCAPOTZALCO,2023-02-23,171,171,0,0
AZCAPOTZALCO,2023-02-24,107,104,3,0.02804
AZCAPOTZALCO,2023-02-25,235,159,76,0.3234
AZCAPOTZALCO,2023-02-26,71,67,4,0.05634
AZCAPOTZALCO,2023-02-27,205,205,0,0
AZCAPOTZALCO,2023-02-28,212,197,15,0.07075
AZCAPOTZALCO,2023-03-01,103,102,1,0.00971
AZCAPOTZALCO,2023-03-02,81,63,18,0.22222
AZCAPOTZALCO,2023-03-03,158,144,14,0.08861
AZCAPOTZALCO,2023-03-04,153,150,3,0.01961
AZCAPOTZALCO,2023-03-05,66,65,1,0.01515
AZCAPOTZALCO,2023-03-07,74,67,7,0.09459
AZCAPOTZALCO,2023-03-08,84,79,5,0.05952
AZCAPOTZALCO,2023-03-09,88,78,10,0.11364
AZCAPOTZALCO,2023-03-10,108,73,35,0.32407
AZCAPOTZALCO,2023-03-11,131,120,11,0.08397
AZCAPOTZALCO,2023-03-12,106,101,5,0.04717
AZCAPOTZALCO,2023-03-13,184,170,14,0.07609
AZCAPOTZALCO,2023-03-14,94,94,0,0
AZCAPOTZALCO,2023-03-15,74,72,2,0.02703
AZCAPOTZALCO,2023-03-16,85,80,5,0.05882
AZCAPOTZALCO,2023-03-17,86,78,8,0.09302
AZCAPOTZALCO,2023-03-18,117,114,3,0.02564
AZCAPOTZALCO,2023-03-19,68,63,5,0.07353
AZCAPOTZALCO,2023-03-20,116,112,4,0.03448
CANCUN 1,2023-01-01,5,5,0,0
CANCUN 1,2023-01-02,43,41,2,0.04651
CANCUN 1,2023-01-03,69,45,24,0.34783
CANCUN 1,2023-01-04,76,33,43,0.56579
CANCUN 1,2023-01-05,58,53,5,0.08621
CANCUN 1,2023-01-06,66,44,22,0.33333
CANCUN 1,2023-01-07,114,86,28,0.24561
CANCUN 1,2023-01-08,72,66,6,0.08333
CANCUN 1,2023-01-09,80,67,13,0.1625
CANCUN 1,2023-01-10,144,102,42,0.29167
CANCUN 1,2023-01-11,113,78,35,0.30973
CANCUN 1,2023-01-12,55,41,14,0.25455
CANCUN 1,2023-01-13,60,27,33,0.55
CANCUN 1,2023-01-14,89,83,6,0.06742
CANCUN 1,2023-01-15,90,83,7,0.07778
CANCUN 1,2023-01-16,93,85,8,0.08602
CANCUN 1,2023-01-17,128,108,20,0.15625
CANCUN 1,2023-01-18,54,47,7,0.12963
CANCUN 1,2023-01-19,89,76,13,0.14607
CANCUN 1,2023-01-20,158,148,10,0.06329
CANCUN 1,2023-01-21,148,123,25,0.16892
CANCUN 1,2023-01-22,157,86,71,0.45223
CANCUN 1,2023-01-23,124,64,60,0.48387
CANCUN 1,2023-01-24,220,123,97,0.44091
CANCUN 1,2023-01-25,151,78,73,0.48344
CANCUN 1,2023-01-26,159,96,63,0.39623
CANCUN 1,2023-01-27,63,29,34,0.53968
CANCUN 1,2023-01-28,73,53,20,0.27397
CANCUN 1,2023-01-29,88,31,57,0.64773
CANCUN 1,2023-01-30,135,121,14,0.1037
CANCUN 1,2023-01-31,114,82,32,0.2807
CANCUN 1,2023-02-02,167,151,16,0.09581
CANCUN 1,2023-02-03,198,137,61,0.30808
CANCUN 1,2023-02-04,271,239,32,0.11808
CANCUN 1,2023-02-05,213,208,5,0.02347
CANCUN 1,2023-02-06,183,158,25,0.13661
CANCUN 1,2023-02-07,114,33,81,0.71053
CANCUN 1,2023-02-08,129,114,15,0.11628
CANCUN 1,2023-02-09,62,44,18,0.29032
CANCUN 1,2023-02-10,122,82,40,0.32787
CANCUN 1,2023-02-11,84,66,18,0.21429
CANCUN 1,2023-02-12,104,76,28,0.26923
CANCUN 1,2023-02-13,110,56,54,0.49091
CANCUN 1,2023-02-14,146,131,15,0.10274
CANCUN 1,2023-02-15,155,107,48,0.30968
CANCUN 1,2023-02-16,147,110,37,0.2517
CANCUN 1,2023-02-17,146,141,5,0.03425
CANCUN 1,2023-02-18,409,364,45,0.11002
CANCUN 1,2023-02-19,337,265,72,0.21365
CANCUN 1,2023-02-20,418,331,87,0.20813
CANCUN 1,2023-02-21,269,153,116,0.43123
CANCUN 1,2023-02-22,216,168,48,0.22222
CANCUN 1,2023-02-23,123,53,70,0.56911
CANCUN 1,2023-02-24,81,76,5,0.06173
CANCUN 1,2023-02-25,65,29,36,0.55385
CANCUN 1,2023-02-26,119,92,27,0.22689
CANCUN 1,2023-02-27,246,230,16,0.06504
CANCUN 1,2023-02-28,117,114,3,0.02564
CANCUN 1,2023-03-01,86,73,13,0.15116
CANCUN 1,2023-03-02,174,146,28,0.16092
CANCUN 1,2023-03-03,119,114,5,0.04202
CANCUN 1,2023-03-04,173,159,14,0.08092
CANCUN 1,2023-03-05,159,133,26,0.16352
CANCUN 1,2023-03-07,135,129,6,0.04444
CANCUN 1,2023-03-08,112,89,23,0.20536
CANCUN 1,2023-03-09,95,54,41,0.43158
CANCUN 1,2023-03-10,64,56,8,0.125
CANCUN 1,2023-03-11,93,68,25,0.26882
CANCUN 1,2023-03-12,71,36,35,0.49296
CANCUN 1,2023-03-13,83,38,45,0.54217
CANCUN 1,2023-03-14,83,54,29,0.3494
CANCUN 1,2023-03-15,92,71,21,0.22826
CANCUN 1,2023-03-16,66,62,4,0.06061
CANCUN 1,2023-03-17,88,81,7,0.07955
CANCUN 1,2023-03-18,104,102,2,0.01923
CANCUN 1,2023-03-19,50,50,0,0
CANCUN 1,2023-03-20,90,76,14,0.15556
CANCUN 2,2023-01-01,9,9,0,0
CANCUN 2,2023-01-02,49,49,0,0
CANCUN 2,2023-01-03,94,94,0,0
CANCUN 2,2023-01-04,75,75,0,0
CANCUN 2,2023-01-05,52,51,1,0.01923
CANCUN 2,2023-01-06,58,57,1,0.01724
CANCUN 2,2023-01-07,36,32,4,0.11111
CANCUN 2,2023-01-08,76,76,0,0
CANCUN 2,2023-01-09,51,50,1,0.01961
CANCUN 2,2023-01-10,84,84,0,0
CANCUN 2,2023-01-11,132,131,1,0.00758
CANCUN 2,2023-01-12,101,101,0,0
CANCUN 2,2023-01-13,49,47,2,0.04082
CANCUN 2,2023-01-14,62,57,5,0.08065
CANCUN 2,2023-01-15,46,40,6,0.13043
CANCUN 2,2023-01-16,80,80,0,0
CANCUN 2,2023-01-17,78,78,0,0
CANCUN 2,2023-01-18,66,66,0,0
CANCUN 2,2023-01-19,169,153,16,0.09467
CANCUN 2,2023-01-20,85,84,1,0.01176
CANCUN 2,2023-01-21,140,140,0,0
CANCUN 2,2023-01-22,167,163,4,0.02395
CANCUN 2,2023-01-23,141,123,18,0.12766
CANCUN 2,2023-01-24,137,121,16,0.11679
CANCUN 2,2023-01-25,99,58,41,0.41414
CANCUN 2,2023-01-26,171,168,3,0.01754
CANCUN 2,2023-01-27,80,52,28,0.35
CANCUN 2,2023-01-28,68,67,1,0.01471
CANCUN 2,2023-01-29,143,111,32,0.22378
CANCUN 2,2023-01-30,123,120,3,0.02439
CANCUN 2,2023-01-31,114,105,9,0.07895
CANCUN 2,2023-02-02,97,86,11,0.1134
CANCUN 2,2023-02-03,184,152,32,0.17391
CANCUN 2,2023-02-04,100,88,12,0.12
CANCUN 2,2023-02-05,52,40,12,0.23077
CANCUN 2,2023-02-06,47,34,13,0.2766
CANCUN 2,2023-02-07,158,154,4,0.02532
CANCUN 2,2023-02-08,82,71,11,0.13415
CANCUN 2,2023-02-09,65,34,31,0.47692
CANCUN 2,2023-02-10,82,54,28,0.34146
CANCUN 2,2023-02-11,123,101,22,0.17886
CANCUN 2,2023-02-12,113,106,7,0.06195
CANCUN 2,2023-02-13,84,78,6,0.07143
CANCUN 2,2023-02-14,72,43,29,0.40278
CANCUN 2,2023-02-15,68,61,7,0.10294
CANCUN 2,2023-02-16,133,133,0,0
CANCUN 2,2023-02-17,43,38,5,0.11628
CANCUN 2,2023-02-18,192,181,11,0.05729
CANCUN 2,2023-02-19,157,44,113,0.71975
CANCUN 2,2023-02-20,151,121,30,0.19868
CANCUN 2,2023-02-21,116,113,3,0.02586
CANCUN 2,2023-02-22,92,79,13,0.1413
CANCUN 2,2023-02-23,156,150,6,0.03846
CANCUN 2,2023-02-24,59,49,10,0.16949
CANCUN 2,2023-02-25,87,85,2,0.02299
CANCUN 2,2023-02-26,38,38,0,0
CANCUN 2,2023-02-27,128,122,6,0.04688
CANCUN 2,2023-02-28,149,146,3,0.02013
CANCUN 2,2023-03-01,50,41,9,0.18
CANCUN 2,2023-03-02,99,73,26,0.26263
CANCUN 2,2023-03-03,83,68,15,0.18072
CANCUN 2,2023-03-04,104,43,61,0.58654
CANCUN 2,2023-03-05,32,24,8,0.25
CANCUN 2,2023-03-07,148,145,3,0.02027
CANCUN 2,2023-03-08,92,43,49,0.53261
CANCUN 2,2023-03-09,66,58,8,0.12121
CANCUN 2,2023-03-10,37,27,10,0.27027
CANCUN 2,2023-03-11,39,26,13,0.33333
CANCUN 2,2023-03-12,39,37,2,0.05128
CANCUN 2,2023-03-13,80,58,22,0.275
CANCUN 2,2023-03-14,42,38,4,0.09524
CANCUN 2,2023-03-15,32,32,0,0
CANCUN 2,2023-03-16,21,20,1,0.04762
CANCUN 2,2023-03-17,64,60,4,0.0625
CANCUN 2,2023-03-18,38,36,2,0.05263
CANCUN 2,2023-03-19,21,20,1,0.04762
CANCUN 2,2023-03-20,25,17,8,0.32
CELAYA,2023-01-01,9,9,0,0
CELAYA,2023-01-02,33,28,5,0.15152
CELAYA,2023-01-03,36,31,5,0.13889
CELAYA,2023-01-04,10,10,0,0
CELAYA,2023-01-05,22,18,4,0.18182
CELAYA,2023-01-06,13,13,0,0
CELAYA,2023-01-07,29,28,1,0.03448
CELAYA,2023-01-08,23,16,7,0.30435
CELAYA,2023-01-09,25,23,2,0.08
CELAYA,2023-01-10,13,13,0,0
CELAYA,2023-01-11,36,27,9,0.25
CELAYA,2023-01-12,57,57,0,0
CELAYA,2023-01-13,39,39,0,0
CELAYA,2023-01-14,20,20,0,0
CELAYA,2023-01-15,27,27,0,0
CELAYA,2023-01-16,37,37,0,0
CELAYA,2023-01-17,26,26,0,0
CELAYA,2023-01-18,26,26,0,0
CELAYA,2023-01-19,39,39,0,0
CELAYA,2023-01-20,25,24,1,0.04
CELAYA,2023-01-21,34,34,0,0
CELAYA,2023-01-22,19,19,0,0
CELAYA,2023-01-23,21,21,0,0
CELAYA,2023-01-24,19,19,0,0
CELAYA,2023-01-25,34,34,0,0
CELAYA,2023-01-26,32,32,0,0
CELAYA,2023-01-27,25,25,0,0
CELAYA,2023-01-28,40,40,0,0
CELAYA,2023-01-29,20,20,0,0
CELAYA,2023-01-30,22,22,0,0
CELAYA,2023-01-31,33,33,0,0
CELAYA,2023-02-02,29,27,2,0.06897
CELAYA,2023-02-03,41,41,0,0
CELAYA,2023-02-04,29,29,0,0
CELAYA,2023-02-05,25,25,0,0
CELAYA,2023-02-06,17,17,0,0
CELAYA,2023-02-07,22,22,0,0
CELAYA,2023-02-08,26,26,0,0
CELAYA,2023-02-09,28,28,0,0
CELAYA,2023-02-10,8,8,0,0
CELAYA,2023-02-11,41,41,0,0
CELAYA,2023-02-12,9,9,0,0
CELAYA,2023-02-13,21,21,0,0
CELAYA,2023-02-14,38,38,0,0
CELAYA,2023-02-15,55,55,0,0
CELAYA,2023-02-16,79,79,0,0
CELAYA,2023-02-17,100,100,0,0
CELAYA,2023-02-18,113,112,1,0.00885
CELAYA,2023-02-19,53,52,1,0.01887
CELAYA,2023-02-20,68,68,0,0
CELAYA,2023-02-21,49,49,0,0
CELAYA,2023-02-22,33,33,0,0
CELAYA,2023-02-23,44,44,0,0
CELAYA,2023-02-24,67,67,0,0
CELAYA,2023-02-25,33,33,0,0
CELAYA,2023-02-26,32,16,16,0.5
CELAYA,2023-02-27,31,31,0,0
CELAYA,2023-02-28,64,64,0,0
CELAYA,2023-03-01,45,45,0,0
CELAYA,2023-03-02,36,36,0,0
CELAYA,2023-03-03,33,33,0,0
CELAYA,2023-03-04,75,75,0,0
CELAYA,2023-03-05,44,44,0,0
CELAYA,2023-03-07,18,18,0,0
CENTRO HISTORICO,2023-01-01,2,2,0,0
CENTRO HISTORICO,2023-01-02,16,15,1,0.0625
CENTRO HISTORICO,2023-01-03,16,16,0,0
CENTRO HISTORICO,2023-01-04,31,31,0,0
CENTRO HISTORICO,2023-01-05,33,33,0,0
CENTRO HISTORICO,2023-01-06,25,25,0,0
CENTRO HISTORICO,2023-01-07,21,21,0,0
CENTRO HISTORICO,2023-01-08,82,82,0,0
CENTRO HISTORICO,2023-01-09,30,30,0,0
CENTRO HISTORICO,2023-01-10,32,32,0,0
CENTRO HISTORICO,2023-01-11,22,22,0,0
CENTRO HISTORICO,2023-01-12,23,23,0,0
CENTRO HISTORICO,2023-01-13,30,30,0,0
CENTRO HISTORICO,2023-01-14,26,23,3,0.11538
CENTRO HISTORICO,2023-01-15,33,33,0,0
CENTRO HISTORICO,2023-01-16,54,54,0,0
CENTRO HISTORICO,2023-01-17,134,127,7,0.05224
CENTRO HISTORICO,2023-01-18,108,108,0,0
CENTRO HISTORICO,2023-01-19,149,120,29,0.19463
CENTRO HISTORICO,2023-01-20,99,78,21,0.21212
CENTRO HISTORICO,2023-01-21,151,143,8,0.05298
CENTRO HISTORICO,2023-01-22,126,123,3,0.02381
CENTRO HISTORICO,2023-01-23,170,170,0,0
CENTRO HISTORICO,2023-01-24,215,213,2,0.0093
CENTRO HISTORICO,2023-01-25,111,111,0,0
CENTRO HISTORICO,2023-01-26,288,288,0,0
CENTRO HISTORICO,2023-01-27,163,163,0,0
CENTRO HISTORICO,2023-01-28,180,180,0,0
CENTRO HISTORICO,2023-01-29,121,115,6,0.04959
CENTRO HISTORICO,2023-01-30,82,82,0,0
CENTRO HISTORICO,2023-01-31,172,172,0,0
CENTRO HISTORICO,2023-02-02,202,186,16,0.07921
CENTRO HISTORICO,2023-02-03,206,205,1,0.00485
CENTRO HISTORICO,2023-02-04,184,179,5,0.02717
CENTRO HISTORICO,2023-02-05,214,163,51,0.23832
CENTRO HISTORICO,2023-02-06,63,63,0,0
CENTRO HISTORICO,2023-02-07,155,153,2,0.0129
CENTRO HISTORICO,2023-02-08,96,74,22,0.22917
CENTRO HISTORICO,2023-02-09,183,183,0,0
CENTRO HISTORICO,2023-02-10,253,253,0,0
CENTRO HISTORICO,2023-02-11,168,168,0,0
CENTRO HISTORICO,2023-02-12,70,69,1,0.01429
CENTRO HISTORICO,2023-02-13,127,123,4,0.0315
CENTRO HISTORICO,2023-02-14,126,125,1,0.00794
CENTRO HISTORICO,2023-02-15,59,57,2,0.0339
CENTRO HISTORICO,2023-02-16,385,381,4,0.01039
CENTRO HISTORICO,2023-02-17,136,132,4,0.02941
CENTRO HISTORICO,2023-02-18,114,114,0,0
CENTRO HISTORICO,2023-02-19,135,135,0,0
CENTRO HISTORICO,2023-02-20,119,117,2,0.01681
CENTRO HISTORICO,2023-02-21,59,57,2,0.0339
CENTRO HISTORICO,2023-02-22,87,85,2,0.02299
CENTRO HISTORICO,2023-02-23,143,134,9,0.06294
CENTRO HISTORICO,2023-02-24,58,52,6,0.10345
CENTRO HISTORICO,2023-02-25,146,141,5,0.03425
CENTRO HISTORICO,2023-02-26,12,9,3,0.25
CENTRO HISTORICO,2023-02-27,94,93,1,0.01064
CENTRO HISTORICO,2023-02-28,57,51,6,0.10526
CENTRO HISTORICO,2023-03-01,56,56,0,0
CENTRO HISTORICO,2023-03-02,27,27,0,0
CENTRO HISTORICO,2023-03-03,126,126,0,0
CENTRO HISTORICO,2023-03-04,56,44,12,0.21429
CENTRO HISTORICO,2023-03-05,73,72,1,0.0137
CENTRO HISTORICO,2023-03-07,68,68,0,0
CENTRO HISTORICO,2023-03-08,40,32,8,0.2
CENTRO HISTORICO,2023-03-09,41,32,9,0.21951
CENTRO HISTORICO,2023-03-10,53,43,10,0.18868
CENTRO HISTORICO,2023-03-11,38,34,4,0.10526
CENTRO HISTORICO,2023-03-12,103,94,9,0.08738
CENTRO HISTORICO,2023-03-13,40,35,5,0.125
CENTRO HISTORICO,2023-03-14,50,43,7,0.14
CENTRO HISTORICO,2023-03-15,27,24,3,0.11111
CENTRO HISTORICO,2023-03-16,31,25,6,0.19355
CENTRO HISTORICO,2023-03-17,55,53,2,0.03636
CENTRO HISTORICO,2023-03-18,62,61,1,0.01613
CENTRO HISTORICO,2023-03-19,46,44,2,0.04348
CENTRO HISTORICO,2023-03-20,50,42,8,0.16
CERRO GORDO,2023-01-01,14,12,2,0.14286
CERRO GORDO,2023-01-02,84,79,5,0.05952
CERRO GORDO,2023-01-03,181,135,46,0.25414
CERRO GORDO,2023-01-04,192,162,30,0.15625
CERRO GORDO,2023-01-05,88,88,0,0
CERRO GORDO,2023-01-06,172,172,0,0
CERRO GORDO,2023-01-07,205,196,9,0.0439
CERRO GORDO,2023-01-08,64,56,8,0.125
CERRO GORDO,2023-01-09,167,154,13,0.07784
CERRO GORDO,2023-01-10,297,288,9,0.0303
CERRO GORDO,2023-01-11,94,92,2,0.02128
CERRO GORDO,2023-01-12,77,67,10,0.12987
CERRO GORDO,2023-01-13,189,146,43,0.22751
CERRO GORDO,2023-01-14,175,118,57,0.32571
CERRO GORDO,2023-01-15,133,127,6,0.04511
CERRO GORDO,2023-01-16,149,141,8,0.05369
CERRO GORDO,2023-01-17,134,123,11,0.08209
CERRO GORDO,2023-01-18,85,79,6,0.07059
CERRO GORDO,2023-01-19,212,208,4,0.01887
CERRO GORDO,2023-01-20,165,158,7,0.04242
CERRO GORDO,2023-01-21,119,90,29,0.2437
CERRO GORDO,2023-01-22,58,57,1,0.01724
CERRO GORDO,2023-01-23,166,157,9,0.05422
CERRO GORDO,2023-01-24,170,149,21,0.12353
CERRO GORDO,2023-01-25,184,174,10,0.05435
CERRO GORDO,2023-01-26,312,310,2,0.00641
CERRO GORDO,2023-01-27,246,222,24,0.09756
CERRO GORDO,2023-01-28,209,207,2,0.00957
CERRO GORDO,2023-01-29,77,70,7,0.09091
CERRO GORDO,2023-01-30,196,190,6,0.03061
CERRO GORDO,2023-01-31,264,219,45,0.17045
CERRO GORDO,2023-02-02,233,193,40,0.17167
CERRO GORDO,2023-02-03,268,215,53,0.19776
CERRO GORDO,2023-02-04,258,136,122,0.47287
CERRO GORDO,2023-02-05,141,81,60,0.42553
CERRO GORDO,2023-02-06,118,109,9,0.07627
CERRO GORDO,2023-02-07,197,190,7,0.03553
CERRO GORDO,2023-02-08,259,227,32,0.12355
CERRO GORDO,2023-02-09,229,171,58,0.25328
CERRO GORDO,2023-02-10,170,158,12,0.07059
CERRO GORDO,2023-02-11,258,248,10,0.03876
CERRO GORDO,2023-02-12,158,155,3,0.01899
CERRO GORDO,2023-02-13,138,133,5,0.03623
CERRO GORDO,2023-02-14,189,178,11,0.0582
CERRO GORDO,2023-02-15,157,107,50,0.31847
CERRO GORDO,2023-02-16,524,512,12,0.0229
CERRO GORDO,2023-02-17,322,292,30,0.09317
CERRO GORDO,2023-02-18,600,486,114,0.19
CERRO GORDO,2023-02-19,155,153,2,0.0129
CERRO GORDO,2023-02-20,356,333,23,0.06461
CERRO GORDO,2023-02-21,230,211,19,0.08261
CERRO GORDO,2023-02-22,189,175,14,0.07407
CERRO GORDO,2023-02-23,260,211,49,0.18846
CERRO GORDO,2023-02-24,110,69,41,0.37273
CERRO GORDO,2023-02-25,367,260,107,0.29155
CERRO GORDO,2023-02-26,131,125,6,0.0458
CERRO GORDO,2023-02-27,242,222,20,0.08264
CERRO GORDO,2023-02-28,199,166,33,0.16583
CERRO GORDO,2023-03-01,297,266,31,0.10438
CERRO GORDO,2023-03-02,160,154,6,0.0375
CERRO GORDO,2023-03-03,436,411,25,0.05734
CERRO GORDO,2023-03-04,180,171,9,0.05
CERRO GORDO,2023-03-05,129,129,0,0
CERRO GORDO,2023-03-07,168,143,25,0.14881
CERRO GORDO,2023-03-08,148,129,19,0.12838
CERRO GORDO,2023-03-09,96,78,18,0.1875
CERRO GORDO,2023-03-10,120,109,11,0.09167
CERRO GORDO,2023-03-11,143,119,24,0.16783
CERRO GORDO,2023-03-12,81,65,16,0.19753
CERRO GORDO,2023-03-13,177,170,7,0.03955
CERRO GORDO,2023-03-14,145,134,11,0.07586
CERRO GORDO,2023-03-15,104,78,26,0.25
CERRO GORDO,2023-03-16,144,139,5,0.03472
CERRO GORDO,2023-03-17,218,211,7,0.03211
CERRO GORDO,2023-03-18,149,137,12,0.08054
CERRO GORDO,2023-03-19,81,69,12,0.14815
CERRO GORDO,2023-03-20,184,182,2,0.01087
CHALCO IXTAPALUCA,2023-01-01,14,14,0,0
CHALCO IXTAPALUCA,2023-01-02,56,56,0,0
CHALCO IXTAPALUCA,2023-01-03,63,63,0,0
CHALCO IXTAPALUCA,2023-01-04,69,69,0,0
CHALCO IXTAPALUCA,2023-01-05,75,75,0,0
CHALCO IXTAPALUCA,2023-01-06,66,66,0,0
CHALCO IXTAPALUCA,2023-01-07,80,80,0,0
CHALCO IXTAPALUCA,2023-01-08,71,70,1,0.01408
CHALCO IXTAPALUCA,2023-01-09,59,59,0,0
CHALCO IXTAPALUCA,2023-01-10,73,73,0,0
CHALCO IXTAPALUCA,2023-01-11,88,88,0,0
CHALCO IXTAPALUCA,2023-01-12,81,80,1,0.01235
CHALCO IXTAPALUCA,2023-01-13,48,47,1,0.02083
CHALCO IXTAPALUCA,2023-01-14,82,82,0,0
CHALCO IXTAPALUCA,2023-01-15,88,88,0,0
CHALCO IXTAPALUCA,2023-01-16,82,82,0,0
CHALCO IXTAPALUCA,2023-01-17,72,71,1,0.01389
CHALCO IXTAPALUCA,2023-01-18,164,163,1,0.0061
CHALCO IXTAPALUCA,2023-01-19,99,96,3,0.0303
CHALCO IXTAPALUCA,2023-01-20,114,114,0,0
CHALCO IXTAPALUCA,2023-01-21,131,131,0,0
CHALCO IXTAPALUCA,2023-01-22,65,62,3,0.04615
CHALCO IXTAPALUCA,2023-01-23,76,76,0,0
CHALCO IXTAPALUCA,2023-01-24,99,99,0,0
CHALCO IXTAPALUCA,2023-01-25,82,80,2,0.02439
CHALCO IXTAPALUCA,2023-01-26,190,171,19,0.1
CHALCO IXTAPALUCA,2023-01-27,101,101,0,0
CHALCO IXTAPALUCA,2023-01-28,142,142,0,0
CHALCO IXTAPALUCA,2023-01-29,89,89,0,0
CHALCO IXTAPALUCA,2023-01-30,100,100,0,0
CHALCO IXTAPALUCA,2023-01-31,151,151,0,0
CHALCO IXTAPALUCA,2023-02-02,90,90,0,0
CHALCO IXTAPALUCA,2023-02-03,88,87,1,0.01136
CHALCO IXTAPALUCA,2023-02-04,136,134,2,0.01471
CHALCO IXTAPALUCA,2023-02-05,110,110,0,0
CHALCO IXTAPALUCA,2023-02-06,111,111,0,0
CHALCO IXTAPALUCA,2023-02-07,188,188,0,0
CHALCO IXTAPALUCA,2023-02-08,63,63,0,0
CHALCO IXTAPALUCA,2023-02-09,151,151,0,0
CHALCO IXTAPALUCA,2023-02-10,114,113,1,0.00877
CHALCO IXTAPALUCA,2023-02-11,203,201,2,0.00985
CHALCO IXTAPALUCA,2023-02-12,88,83,5,0.05682
CHALCO IXTAPALUCA,2023-02-13,158,149,9,0.05696
CHALCO IXTAPALUCA,2023-02-14,182,182,0,0
CHALCO IXTAPALUCA,2023-02-15,151,151,0,0
CHALCO IXTAPALUCA,2023-02-16,73,67,6,0.08219
CHALCO IXTAPALUCA,2023-02-17,94,93,1,0.01064
CHALCO IXTAPALUCA,2023-02-18,97,95,2,0.02062
CHALCO IXTAPALUCA,2023-02-19,123,106,17,0.13821
CHALCO IXTAPALUCA,2023-02-20,82,82,0,0
CHALCO IXTAPALUCA,2023-02-21,101,92,9,0.08911
CHALCO IXTAPALUCA,2023-02-22,177,164,13,0.07345
CHALCO IXTAPALUCA,2023-02-23,194,193,1,0.00515
CHALCO IXTAPALUCA,2023-02-24,74,68,6,0.08108
CHALCO IXTAPALUCA,2023-02-25,180,171,9,0.05
CHALCO IXTAPALUCA,2023-02-26,174,132,42,0.24138
CHALCO IXTAPALUCA,2023-02-27,122,120,2,0.01639
CHALCO IXTAPALUCA,2023-02-28,81,78,3,0.03704
CHALCO IXTAPALUCA,2023-03-01,76,73,3,0.03947
CHALCO IXTAPALUCA,2023-03-02,97,97,0,0
CHALCO IXTAPALUCA,2023-03-03,102,100,2,0.01961
CHALCO IXTAPALUCA,2023-03-04,109,100,9,0.08257
CHALCO IXTAPALUCA,2023-03-05,144,143,1,0.00694
CHALCO IXTAPALUCA,2023-03-07,85,81,4,0.04706
CHALCO IXTAPALUCA,2023-03-08,141,140,1,0.00709
CHALCO IXTAPALUCA,2023-03-09,137,134,3,0.0219
CHALCO IXTAPALUCA,2023-03-10,52,47,5,0.09615
CHALCO IXTAPALUCA,2023-03-11,118,108,10,0.08475
CHALCO IXTAPALUCA,2023-03-12,80,79,1,0.0125
CHALCO IXTAPALUCA,2023-03-13,125,117,8,0.064
CHALCO IXTAPALUCA,2023-03-14,144,138,6,0.04167
CHALCO IXTAPALUCA,2023-03-15,93,91,2,0.02151
CHALCO IXTAPALUCA,2023-03-16,115,104,11,0.09565
CHALCO IXTAPALUCA,2023-03-17,87,83,4,0.04598
CHALCO IXTAPALUCA,2023-03-18,146,144,2,0.0137
CHALCO IXTAPALUCA,2023-03-19,123,120,3,0.02439
CHALCO IXTAPALUCA,2023-03-20,140,140,0,0
CHALCO VALLE,2023-01-01,9,9,0,0
CHALCO VALLE,2023-01-02,33,33,0,0
CHALCO VALLE,2023-01-03,25,25,0,0
CHALCO VALLE,2023-01-04,34,34,0,0
CHALCO VALLE,2023-01-05,32,32,0,0
CHALCO VALLE,2023-01-06,36,36,0,0
CHALCO VALLE,2023-01-07,29,29,0,0
CHALCO VALLE,2023-01-08,31,31,0,0
CHALCO VALLE,2023-01-09,34,34,0,0
CHALCO VALLE,2023-01-10,36,36,0,0
CHALCO VALLE,2023-01-11,25,25,0,0
CHALCO VALLE,2023-01-12,31,31,0,0
CHALCO VALLE,2023-01-13,29,29,0,0
CHALCO VALLE,2023-01-14,36,36,0,0
CHALCO VALLE,2023-01-15,34,34,0,0
CHALCO VALLE,2023-01-16,46,46,0,0
CHALCO VALLE,2023-01-17,28,28,0,0
CHALCO VALLE,2023-01-18,43,41,2,0.04651
CHALCO VALLE,2023-01-19,31,31,0,0
CHALCO VALLE,2023-01-20,44,44,0,0
CHALCO VALLE,2023-01-21,42,42,0,0
CHALCO VALLE,2023-01-22,28,28,0,0
CHALCO VALLE,2023-01-23,30,30,0,0
CHALCO VALLE,2023-01-24,46,45,1,0.02174
CHALCO VALLE,2023-01-25,18,18,0,0
CHALCO VALLE,2023-01-26,37,37,0,0
CHALCO VALLE,2023-01-27,36,36,0,0
CHALCO VALLE,2023-01-28,42,42,0,0
CHALCO VALLE,2023-01-29,35,35,0,0
CHALCO VALLE,2023-01-30,47,47,0,0
CHALCO VALLE,2023-01-31,42,42,0,0
CHALCO VALLE,2023-02-02,25,25,0,0
CHALCO VALLE,2023-02-03,36,36,0,0
CHALCO VALLE,2023-02-04,41,41,0,0
CHALCO VALLE,2023-02-05,30,30,0,0
CHALCO VALLE,2023-02-06,36,36,0,0
CHALCO VALLE,2023-02-07,36,36,0,0
CHALCO VALLE,2023-02-08,52,52,0,0
CHALCO VALLE,2023-02-09,22,22,0,0
CHALCO VALLE,2023-02-10,23,23,0,0
CHALCO VALLE,2023-02-11,22,22,0,0
CHALCO VALLE,2023-02-12,31,31,0,0
CHALCO VALLE,2023-02-13,40,40,0,0
CHALCO VALLE,2023-02-14,56,56,0,0
CHALCO VALLE,2023-02-15,36,36,0,0
CHALCO VALLE,2023-02-16,60,60,0,0
CHALCO VALLE,2023-02-17,47,47,0,0
CHALCO VALLE,2023-02-18,40,40,0,0
CHALCO VALLE,2023-02-19,27,27,0,0
CHALCO VALLE,2023-02-20,232,232,0,0
CHIHUAHUA CUMBRES,2023-01-01,1,1,0,0
CHIHUAHUA CUMBRES,2023-01-02,24,20,4,0.16667
CHIHUAHUA CUMBRES,2023-01-03,43,30,13,0.30233
CHIHUAHUA CUMBRES,2023-01-04,42,30,12,0.28571
CHIHUAHUA CUMBRES,2023-01-05,54,33,21,0.38889
CHIHUAHUA CUMBRES,2023-01-06,53,36,17,0.32075
CHIHUAHUA CUMBRES,2023-01-07,68,50,18,0.26471
CHIHUAHUA CUMBRES,2023-01-08,17,6,11,0.64706
CHIHUAHUA CUMBRES,2023-01-09,57,36,21,0.36842
CHIHUAHUA CUMBRES,2023-01-10,60,32,28,0.46667
CHIHUAHUA CUMBRES,2023-01-11,32,23,9,0.28125
CHIHUAHUA CUMBRES,2023-01-12,45,20,25,0.55556
CHIHUAHUA CUMBRES,2023-01-13,43,30,13,0.30233
CHIHUAHUA CUMBRES,2023-01-14,70,28,42,0.6
CHIHUAHUA CUMBRES,2023-01-15,36,28,8,0.22222
CHIHUAHUA CUMBRES,2023-01-16,64,41,23,0.35938
CHIHUAHUA CUMBRES,2023-01-17,38,30,8,0.21053
CHIHUAHUA CUMBRES,2023-01-18,54,31,23,0.42593
CHIHUAHUA CUMBRES,2023-01-19,53,29,24,0.45283
CHIHUAHUA CUMBRES,2023-01-20,49,27,22,0.44898
CHIHUAHUA CUMBRES,2023-01-21,61,43,18,0.29508
CHIHUAHUA CUMBRES,2023-01-22,28,6,22,0.78571
CHIHUAHUA CUMBRES,2023-01-23,55,35,20,0.36364
CHIHUAHUA CUMBRES,2023-01-24,67,42,25,0.37313
CHIHUAHUA CUMBRES,2023-01-25,41,28,13,0.31707
CHIHUAHUA CUMBRES,2023-01-26,29,11,18,0.62069
CHIHUAHUA CUMBRES,2023-01-27,49,31,18,0.36735
CHIHUAHUA CUMBRES,2023-01-28,48,19,29,0.60417
CHIHUAHUA CUMBRES,2023-01-29,19,5,14,0.73684
CHIHUAHUA CUMBRES,2023-01-30,37,17,20,0.54054
CHIHUAHUA CUMBRES,2023-01-31,59,33,26,0.44068
CHIHUAHUA CUMBRES,2023-02-02,34,23,11,0.32353
CHIHUAHUA CUMBRES,2023-02-03,58,39,19,0.32759
CHIHUAHUA CUMBRES,2023-02-04,68,39,29,0.42647
CHIHUAHUA CUMBRES,2023-02-05,22,14,8,0.36364
CHIHUAHUA CUMBRES,2023-02-06,27,17,10,0.37037
CHIHUAHUA CUMBRES,2023-02-07,69,34,35,0.50725
CHIHUAHUA CUMBRES,2023-02-08,45,18,27,0.6
CHIHUAHUA CUMBRES,2023-02-09,41,32,9,0.21951
CHIHUAHUA CUMBRES,2023-02-10,50,25,25,0.5
CHIHUAHUA CUMBRES,2023-02-11,46,20,26,0.56522
CHIHUAHUA CUMBRES,2023-02-12,32,15,17,0.53125
CHIHUAHUA CUMBRES,2023-02-13,44,19,25,0.56818
CHIHUAHUA CUMBRES,2023-02-14,37,29,8,0.21622
CHIHUAHUA CUMBRES,2023-02-15,43,27,16,0.37209
CHIHUAHUA CUMBRES,2023-02-16,37,27,10,0.27027
CHIHUAHUA CUMBRES,2023-02-17,59,24,35,0.59322
CHIHUAHUA CUMBRES,2023-02-18,72,41,31,0.43056
CHIHUAHUA CUMBRES,2023-02-19,25,13,12,0.48
CHIHUAHUA CUMBRES,2023-02-20,39,25,14,0.35897
CHIHUAHUA CUMBRES,2023-02-21,44,23,21,0.47727
CHIHUAHUA CUMBRES,2023-02-22,28,22,6,0.21429
CHIHUAHUA CUMBRES,2023-02-23,44,20,24,0.54545
CHIHUAHUA CUMBRES,2023-02-24,37,17,20,0.54054
CHIHUAHUA CUMBRES,2023-02-25,54,36,18,0.33333
CHIHUAHUA CUMBRES,2023-02-26,17,4,13,0.76471
CHIHUAHUA CUMBRES,2023-02-27,25,12,13,0.52
CHIHUAHUA CUMBRES,2023-02-28,55,26,29,0.52727
CHIHUAHUA CUMBRES,2023-03-01,67,24,43,0.64179
CHIHUAHUA CUMBRES,2023-03-02,39,25,14,0.35897
CHIHUAHUA CUMBRES,2023-03-03,42,16,26,0.61905
CHIHUAHUA CUMBRES,2023-03-04,92,18,74,0.80435
CHIHUAHUA CUMBRES,2023-03-05,38,26,12,0.31579
CHIHUAHUA CUMBRES,2023-03-07,42,17,25,0.59524
CHIHUAHUA CUMBRES,2023-03-08,50,13,37,0.74
CHIHUAHUA CUMBRES,2023-03-09,50,20,30,0.6
CHIHUAHUA CUMBRES,2023-03-10,46,17,29,0.63043
CHIHUAHUA CUMBRES,2023-03-11,49,20,29,0.59184
CHIHUAHUA CUMBRES,2023-03-12,21,4,17,0.80952
CHIHUAHUA CUMBRES,2023-03-13,40,16,24,0.6
CHIHUAHUA CUMBRES,2023-03-14,46,17,29,0.63043
CHIHUAHUA CUMBRES,2023-03-15,28,24,4,0.14286
CHIHUAHUA CUMBRES,2023-03-16,45,28,17,0.37778
CHIHUAHUA CUMBRES,2023-03-17,21,13,8,0.38095
CHIHUAHUA CUMBRES,2023-03-18,49,41,8,0.16327
CHIHUAHUA CUMBRES,2023-03-19,28,27,1,0.03571
CHIHUAHUA CUMBRES,2023-03-20,38,31,7,0.18421
CHIHUAHUA DEL RELIZ,2023-01-01,13,8,5,0.38462
CHIHUAHUA DEL RELIZ,2023-01-02,34,24,10,0.29412
CHIHUAHUA DEL RELIZ,2023-01-03,35,23,12,0.34286
CHIHUAHUA DEL RELIZ,2023-01-04,80,53,27,0.3375
CHIHUAHUA DEL RELIZ,2023-01-05,49,28,21,0.42857
CHIHUAHUA DEL RELIZ,2023-01-06,52,25,27,0.51923
CHIHUAHUA DEL RELIZ,2023-01-07,46,25,21,0.45652
CHIHUAHUA DEL RELIZ,2023-01-08,28,14,14,0.5
CHIHUAHUA DEL RELIZ,2023-01-09,44,35,9,0.20455
CHIHUAHUA DEL RELIZ,2023-01-10,63,29,34,0.53968
CHIHUAHUA DEL RELIZ,2023-01-11,44,26,18,0.40909
CHIHUAHUA DEL RELIZ,2023-01-12,31,16,15,0.48387
CHIHUAHUA DEL RELIZ,2023-01-13,54,32,22,0.40741
CHIHUAHUA DEL RELIZ,2023-01-14,52,40,12,0.23077
CHIHUAHUA DEL RELIZ,2023-01-15,35,16,19,0.54286
CHIHUAHUA DEL RELIZ,2023-01-16,42,31,11,0.2619
CHIHUAHUA DEL RELIZ,2023-01-17,48,38,10,0.20833
CHIHUAHUA DEL RELIZ,2023-01-18,32,28,4,0.125
CHIHUAHUA DEL RELIZ,2023-01-19,58,23,35,0.60345
CHIHUAHUA DEL RELIZ,2023-01-20,55,43,12,0.21818
CHIHUAHUA DEL RELIZ,2023-01-21,69,50,19,0.27536
CHIHUAHUA DEL RELIZ,2023-01-22,33,21,12,0.36364
CHIHUAHUA DEL RELIZ,2023-01-23,29,20,9,0.31034
CHIHUAHUA DEL RELIZ,2023-01-24,50,23,27,0.54
CHIHUAHUA DEL RELIZ,2023-01-25,38,30,8,0.21053
CHIHUAHUA DEL RELIZ,2023-01-26,41,24,17,0.41463
CHIHUAHUA DEL RELIZ,2023-01-27,40,25,15,0.375
CHIHUAHUA DEL RELIZ,2023-01-28,51,25,26,0.5098
CHIHUAHUA DEL RELIZ,2023-01-29,23,12,11,0.47826
CHIHUAHUA DEL RELIZ,2023-01-30,38,26,12,0.31579
CHIHUAHUA DEL RELIZ,2023-01-31,50,30,20,0.4
CHIHUAHUA DEL RELIZ,2023-02-02,43,29,14,0.32558
CHIHUAHUA DEL RELIZ,2023-02-03,37,32,5,0.13514
CHIHUAHUA DEL RELIZ,2023-02-04,54,32,22,0.40741
CHIHUAHUA DEL RELIZ,2023-02-05,26,21,5,0.19231
CHIHUAHUA DEL RELIZ,2023-02-06,60,38,22,0.36667
CHIHUAHUA DEL RELIZ,2023-02-07,51,27,24,0.47059
CHIHUAHUA DEL RELIZ,2023-02-08,54,34,20,0.37037
CHIHUAHUA DEL RELIZ,2023-02-09,45,21,24,0.53333
CHIHUAHUA DEL RELIZ,2023-02-10,64,22,42,0.65625
CHIHUAHUA DEL RELIZ,2023-02-11,37,18,19,0.51351
CHIHUAHUA DEL RELIZ,2023-02-12,28,21,7,0.25
CHIHUAHUA DEL RELIZ,2023-02-13,22,12,10,0.45455
CHIHUAHUA DEL RELIZ,2023-02-14,47,34,13,0.2766
CHIHUAHUA DEL RELIZ,2023-02-15,35,19,16,0.45714
CHIHUAHUA DEL RELIZ,2023-02-16,53,26,27,0.50943
CHIHUAHUA DEL RELIZ,2023-02-17,51,41,10,0.19608
CHIHUAHUA DEL RELIZ,2023-02-18,48,31,17,0.35417
CHIHUAHUA DEL RELIZ,2023-02-19,18,7,11,0.61111
CHIHUAHUA DEL RELIZ,2023-02-20,52,22,30,0.57692
CHIHUAHUA DEL RELIZ,2023-02-21,39,31,8,0.20513
CHIHUAHUA DEL RELIZ,2023-02-22,49,36,13,0.26531
CHIHUAHUA DEL RELIZ,2023-02-23,57,35,22,0.38596
CHIHUAHUA DEL RELIZ,2023-02-24,71,50,21,0.29577
CHIHUAHUA DEL RELIZ,2023-02-25,61,42,19,0.31148
CHIHUAHUA DEL RELIZ,2023-02-26,10,6,4,0.4
CHIHUAHUA DEL RELIZ,2023-02-27,52,39,13,0.25
CHIHUAHUA DEL RELIZ,2023-02-28,58,43,15,0.25862
CHIHUAHUA DEL RELIZ,2023-03-01,41,27,14,0.34146
CHIHUAHUA DEL RELIZ,2023-03-02,27,21,6,0.22222
CHIHUAHUA DEL RELIZ,2023-03-03,55,27,28,0.50909
CHIHUAHUA DEL RELIZ,2023-03-04,40,24,16,0.4
CHIHUAHUA DEL RELIZ,2023-03-05,36,29,7,0.19444
CHIHUAHUA DEL RELIZ,2023-03-07,42,21,21,0.5
CHIHUAHUA DEL RELIZ,2023-03-08,48,22,26,0.54167
CHIHUAHUA DEL RELIZ,2023-03-09,34,26,8,0.23529
CHIHUAHUA DEL RELIZ,2023-03-10,30,14,16,0.53333
CHIHUAHUA DEL RELIZ,2023-03-11,63,31,32,0.50794
CHIHUAHUA DEL RELIZ,2023-03-12,29,16,13,0.44828
CHIHUAHUA DEL RELIZ,2023-03-13,23,7,16,0.69565
CHIHUAHUA DEL RELIZ,2023-03-14,38,23,15,0.39474
CHIHUAHUA DEL RELIZ,2023-03-15,37,34,3,0.08108
CHIHUAHUA DEL RELIZ,2023-03-16,52,44,8,0.15385
CHIHUAHUA DEL RELIZ,2023-03-17,38,35,3,0.07895
CHIHUAHUA DEL RELIZ,2023-03-18,38,33,5,0.13158
CHIHUAHUA DEL RELIZ,2023-03-19,38,36,2,0.05263
CHIHUAHUA DEL RELIZ,2023-03-20,38,25,13,0.34211
CIUDAD OBREGON / NAVOJOA,2023-01-01,2,2,0,0
CIUDAD OBREGON / NAVOJOA,2023-01-02,20,18,2,0.1
CIUDAD OBREGON / NAVOJOA,2023-01-03,37,29,8,0.21622
CIUDAD OBREGON / NAVOJOA,2023-01-04,21,21,0,0
CIUDAD OBREGON / NAVOJOA,2023-01-05,36,35,1,0.02778
CIUDAD OBREGON / NAVOJOA,2023-01-06,33,31,2,0.06061
CIUDAD OBREGON / NAVOJOA,2023-01-07,42,41,1,0.02381
CIUDAD OBREGON / NAVOJOA,2023-01-08,27,27,0,0
CIUDAD OBREGON / NAVOJOA,2023-01-09,32,32,0,0
CIUDAD OBREGON / NAVOJOA,2023-01-10,35,34,1,0.02857
CIUDAD OBREGON / NAVOJOA,2023-01-11,33,33,0,0
CIUDAD OBREGON / NAVOJOA,2023-01-12,33,33,0,0
CIUDAD OBREGON / NAVOJOA,2023-01-13,24,23,1,0.04167
CIUDAD OBREGON / NAVOJOA,2023-01-14,39,39,0,0
CIUDAD OBREGON / NAVOJOA,2023-01-15,30,27,3,0.1
CIUDAD OBREGON / NAVOJOA,2023-01-16,32,32,0,0
CIUDAD OBREGON / NAVOJOA,2023-01-17,25,25,0,0
CIUDAD OBREGON / NAVOJOA,2023-01-18,46,46,0,0
CIUDAD OBREGON / NAVOJOA,2023-01-19,32,32,0,0
CIUDAD OBREGON / NAVOJOA,2023-01-20,18,18,0,0
CIUDAD OBREGON / NAVOJOA,2023-01-21,38,32,6,0.15789
CIUDAD OBREGON / NAVOJOA,2023-01-22,29,24,5,0.17241
CIUDAD OBREGON / NAVOJOA,2023-01-23,21,21,0,0
CIUDAD OBREGON / NAVOJOA,2023-01-24,28,27,1,0.03571
CIUDAD OBREGON / NAVOJOA,2023-01-25,33,33,0,0
CIUDAD OBREGON / NAVOJOA,2023-01-26,34,33,1,0.02941
CIUDAD OBREGON / NAVOJOA,2023-01-27,33,30,3,0.09091
CIUDAD OBREGON / NAVOJOA,2023-01-28,29,25,4,0.13793
CIUDAD OBREGON / NAVOJOA,2023-01-29,33,31,2,0.06061
CIUDAD OBREGON / NAVOJOA,2023-01-30,36,36,0,0
CIUDAD OBREGON / NAVOJOA,2023-01-31,43,43,0,0
CIUDAD OBREGON / NAVOJOA,2023-02-02,27,25,2,0.07407
CIUDAD OBREGON / NAVOJOA,2023-02-03,38,36,2,0.05263
CIUDAD OBREGON / NAVOJOA,2023-02-04,31,29,2,0.06452
CIUDAD OBREGON / NAVOJOA,2023-02-05,23,20,3,0.13043
CIUDAD OBREGON / NAVOJOA,2023-02-06,23,22,1,0.04348
CIUDAD OBREGON / NAVOJOA,2023-02-07,24,24,0,0
CIUDAD OBREGON / NAVOJOA,2023-02-08,29,29,0,0
CIUDAD OBREGON / NAVOJOA,2023-02-09,20,20,0,0
CIUDAD OBREGON / NAVOJOA,2023-02-10,31,30,1,0.03226
CIUDAD OBREGON / NAVOJOA,2023-02-11,31,31,0,0
CIUDAD OBREGON / NAVOJOA,2023-02-12,9,9,0,0
CIUDAD OBREGON / NAVOJOA,2023-02-13,22,22,0,0
CIUDAD OBREGON / NAVOJOA,2023-02-14,29,29,0,0
CIUDAD OBREGON / NAVOJOA,2023-02-15,35,33,2,0.05714
CIUDAD OBREGON / NAVOJOA,2023-02-16,25,25,0,0
CIUDAD OBREGON / NAVOJOA,2023-02-17,31,31,0,0
CIUDAD OBREGON / NAVOJOA,2023-02-18,25,23,2,0.08
CIUDAD OBREGON / NAVOJOA,2023-02-19,16,16,0,0
CIUDAD OBREGON / NAVOJOA,2023-02-20,35,35,0,0
CIUDAD OBREGON / NAVOJOA,2023-02-21,30,30,0,0
CIUDAD OBREGON / NAVOJOA,2023-02-22,18,18,0,0
CIUDAD OBREGON / NAVOJOA,2023-02-23,32,32,0,0
CIUDAD OBREGON / NAVOJOA,2023-02-24,34,34,0,0
CIUDAD OBREGON / NAVOJOA,2023-02-25,27,26,1,0.03704
CIUDAD OBREGON / NAVOJOA,2023-02-26,9,9,0,0
CIUDAD OBREGON / NAVOJOA,2023-02-27,31,31,0,0
CIUDAD OBREGON / NAVOJOA,2023-02-28,41,41,0,0
CIUDAD OBREGON / NAVOJOA,2023-03-01,23,23,0,0
CIUDAD OBREGON / NAVOJOA,2023-03-02,25,25,0,0
CIUDAD OBREGON / NAVOJOA,2023-03-03,29,28,1,0.03448
CIUDAD OBREGON / NAVOJOA,2023-03-04,30,30,0,0
CIUDAD OBREGON / NAVOJOA,2023-03-05,19,17,2,0.10526
CIUDAD OBREGON / NAVOJOA,2023-03-07,37,37,0,0
CIUDAD OBREGON / NAVOJOA,2023-03-08,30,30,0,0
CIUDAD OBREGON / NAVOJOA,2023-03-09,29,29,0,0
CIUDAD OBREGON / NAVOJOA,2023-03-10,26,25,1,0.03846
CIUDAD OBREGON / NAVOJOA,2023-03-11,30,28,2,0.06667
CIUDAD OBREGON / NAVOJOA,2023-03-12,20,17,3,0.15
CIUDAD OBREGON / NAVOJOA,2023-03-13,22,22,0,0
CIUDAD OBREGON / NAVOJOA,2023-03-14,19,19,0,0
CIUDAD OBREGON / NAVOJOA,2023-03-15,10,10,0,0
CIUDAD OBREGON / NAVOJOA,2023-03-16,28,28,0,0
CIUDAD OBREGON / NAVOJOA,2023-03-17,30,29,1,0.03333
CIUDAD OBREGON / NAVOJOA,2023-03-18,30,30,0,0
CIUDAD OBREGON / NAVOJOA,2023-03-19,17,17,0,0
CIUDAD OBREGON / NAVOJOA,2023-03-20,33,33,0,0
CIUDAD VICTORIA,2023-01-02,3,1,2,0.66667
CIUDAD VICTORIA,2023-01-03,2,2,0,0
CIUDAD VICTORIA,2023-01-04,5,5,0,0
CIUDAD VICTORIA,2023-01-05,10,10,0,0
CIUDAD VICTORIA,2023-01-06,1,1,0,0
CIUDAD VICTORIA,2023-01-07,1,1,0,0
CIUDAD VICTORIA,2023-01-08,1,1,0,0
CIUDAD VICTORIA,2023-01-09,4,4,0,0
CIUDAD VICTORIA,2023-01-10,4,4,0,0
CIUDAD VICTORIA,2023-01-11,3,3,0,0
CIUDAD VICTORIA,2023-01-12,4,2,2,0.5
CIUDAD VICTORIA,2023-01-13,27,26,1,0.03704
CIUDAD VICTORIA,2023-01-14,31,31,0,0
CIUDAD VICTORIA,2023-01-15,22,21,1,0.04545
CIUDAD VICTORIA,2023-01-16,35,35,0,0
CIUDAD VICTORIA,2023-01-17,31,30,1,0.03226
CIUDAD VICTORIA,2023-01-18,36,34,2,0.05556
CIUDAD VICTORIA,2023-01-19,32,29,3,0.09375
CIUDAD VICTORIA,2023-01-20,34,34,0,0
CIUDAD VICTORIA,2023-01-21,35,30,5,0.14286
CIUDAD VICTORIA,2023-01-22,18,18,0,0
CIUDAD VICTORIA,2023-01-23,16,10,6,0.375
CIUDAD VICTORIA,2023-01-24,28,25,3,0.10714
CIUDAD VICTORIA,2023-01-25,18,18,0,0
CIUDAD VICTORIA,2023-01-26,30,25,5,0.16667
CIUDAD VICTORIA,2023-01-27,25,25,0,0
CIUDAD VICTORIA,2023-01-28,49,49,0,0
CIUDAD VICTORIA,2023-01-29,18,17,1,0.05556
CIUDAD VICTORIA,2023-01-30,20,20,0,0
CIUDAD VICTORIA,2023-01-31,24,24,0,0
CIUDAD VICTORIA,2023-02-02,33,33,0,0
CIUDAD VICTORIA,2023-02-03,18,17,1,0.05556
CIUDAD VICTORIA,2023-02-04,33,33,0,0
CIUDAD VICTORIA,2023-02-05,25,24,1,0.04
CIUDAD VICTORIA,2023-02-06,18,18,0,0
CIUDAD VICTORIA,2023-02-07,25,25,0,0
CIUDAD VICTORIA,2023-02-08,23,20,3,0.13043
CIUDAD VICTORIA,2023-02-09,27,25,2,0.07407
CIUDAD VICTORIA,2023-02-10,24,24,0,0
CIUDAD VICTORIA,2023-02-11,31,31,0,0
CIUDAD VICTORIA,2023-02-12,19,19,0,0
CIUDAD VICTORIA,2023-02-13,18,17,1,0.05556
CIUDAD VICTORIA,2023-02-14,27,26,1,0.03704
CIUDAD VICTORIA,2023-02-15,28,28,0,0
CIUDAD VICTORIA,2023-02-16,32,29,3,0.09375
CIUDAD VICTORIA,2023-02-17,19,19,0,0
CIUDAD VICTORIA,2023-02-18,27,22,5,0.18519
CIUDAD VICTORIA,2023-02-19,11,11,0,0
CIUDAD VICTORIA,2023-02-20,24,24,0,0
CIUDAD VICTORIA,2023-02-21,21,21,0,0
CIUDAD VICTORIA,2023-02-22,28,28,0,0
CIUDAD VICTORIA,2023-02-23,22,22,0,0
CIUDAD VICTORIA,2023-02-24,19,19,0,0
CIUDAD VICTORIA,2023-02-25,20,20,0,0
CIUDAD VICTORIA,2023-02-26,11,11,0,0
CIUDAD VICTORIA,2023-02-27,22,22,0,0
CIUDAD VICTORIA,2023-02-28,33,31,2,0.06061
CIUDAD VICTORIA,2023-03-01,25,25,0,0
CIUDAD VICTORIA,2023-03-02,55,55,0,0
CIUDAD VICTORIA,2023-03-03,30,26,4,0.13333
CIUDAD VICTORIA,2023-03-04,36,36,0,0
CIUDAD VICTORIA,2023-03-05,18,18,0,0
CIUDAD VICTORIA,2023-03-07,30,26,4,0.13333
CIUDAD VICTORIA,2023-03-08,17,15,2,0.11765
CIUDAD VICTORIA,2023-03-09,31,29,2,0.06452
CIUDAD VICTORIA,2023-03-10,25,25,0,0
CIUDAD VICTORIA,2023-03-11,29,23,6,0.2069
CIUDAD VICTORIA,2023-03-12,14,11,3,0.21429
CIUDAD VICTORIA,2023-03-13,41,38,3,0.07317
CIUDAD VICTORIA,2023-03-14,44,43,1,0.02273
CIUDAD VICTORIA,2023-03-15,37,37,0,0
CIUDAD VICTORIA,2023-03-16,36,36,0,0
CIUDAD VICTORIA,2023-03-17,34,34,0,0
CIUDAD VICTORIA,2023-03-18,53,50,3,0.0566
CIUDAD VICTORIA,2023-03-19,45,45,0,0
CIUDAD VICTORIA,2023-03-20,33,33,0,0
COACALCO,2023-01-01,10,10,0,0
COACALCO,2023-01-02,40,40,0,0
COACALCO,2023-01-03,57,57,0,0
COACALCO,2023-01-04,54,54,0,0
COACALCO,2023-01-05,57,57,0,0
COACALCO,2023-01-06,37,37,0,0
COACALCO,2023-01-07,158,158,0,0
COACALCO,2023-01-08,65,65,0,0
COACALCO,2023-01-09,84,84,0,0
COACALCO,2023-01-10,62,62,0,0
COACALCO,2023-01-11,68,68,0,0
COACALCO,2023-01-12,81,81,0,0
COACALCO,2023-01-13,70,70,0,0
COACALCO,2023-01-14,78,78,0,0
COACALCO,2023-01-15,84,81,3,0.03571
COACALCO,2023-01-16,52,52,0,0
COACALCO,2023-01-17,72,72,0,0
COACALCO,2023-01-18,107,107,0,0
COACALCO,2023-01-19,88,88,0,0
COACALCO,2023-01-20,42,42,0,0
COACALCO,2023-01-21,75,75,0,0
COACALCO,2023-01-22,46,46,0,0
COACALCO,2023-01-23,84,83,1,0.0119
COACALCO,2023-01-24,38,38,0,0
COACALCO,2023-01-25,81,81,0,0
COACALCO,2023-01-26,65,64,1,0.01538
COACALCO,2023-01-27,80,80,0,0
COACALCO,2023-01-28,96,90,6,0.0625
COACALCO,2023-01-29,87,87,0,0
COACALCO,2023-01-30,81,81,0,0
COACALCO,2023-01-31,64,62,2,0.03125
COACALCO,2023-02-02,128,128,0,0
COACALCO,2023-02-03,64,64,0,0
COACALCO,2023-02-04,115,115,0,0
COACALCO,2023-02-05,69,69,0,0
COACALCO,2023-02-06,71,71,0,0
COACALCO,2023-02-07,59,59,0,0
COACALCO,2023-02-08,78,78,0,0
COACALCO,2023-02-09,102,102,0,0
COACALCO,2023-02-10,62,62,0,0
COACALCO,2023-02-11,45,44,1,0.02222
COACALCO,2023-02-12,92,92,0,0
COACALCO,2023-02-13,55,55,0,0
COACALCO,2023-02-14,82,82,0,0
COACALCO,2023-02-15,66,66,0,0
COACALCO,2023-02-16,92,92,0,0
COACALCO,2023-02-17,81,81,0,0
COACALCO,2023-02-18,74,71,3,0.04054
COACALCO,2023-02-19,144,144,0,0
COACALCO,2023-02-20,111,111,0,0
COACALCO,2023-02-21,47,47,0,0
COACALCO,2023-02-22,80,79,1,0.0125
COACALCO,2023-02-23,67,67,0,0
COACALCO,2023-02-24,97,97,0,0
COACALCO,2023-02-25,99,99,0,0
COACALCO,2023-02-26,78,77,1,0.01282
COACALCO,2023-02-27,58,57,1,0.01724
COACALCO,2023-02-28,81,81,0,0
COACALCO,2023-03-01,68,68,0,0
COACALCO,2023-03-02,68,68,0,0
COACALCO,2023-03-03,84,84,0,0
COACALCO,2023-03-04,58,58,0,0
COACALCO,2023-03-05,66,66,0,0
COACALCO,2023-03-07,43,43,0,0
COACALCO,2023-03-08,81,81,0,0
COACALCO,2023-03-09,79,79,0,0
COACALCO,2023-03-10,49,49,0,0
COACALCO,2023-03-11,75,75,0,0
COACALCO,2023-03-12,45,45,0,0
COACALCO,2023-03-13,56,56,0,0
COACALCO,2023-03-14,63,62,1,0.01587
COACALCO,2023-03-15,69,69,0,0
COACALCO,2023-03-16,83,78,5,0.06024
COACALCO,2023-03-17,118,117,1,0.00847
COACALCO,2023-03-18,94,93,1,0.01064
COACALCO,2023-03-19,125,121,4,0.032
COACALCO,2023-03-20,116,112,4,0.03448
COATZA / MINA,2023-01-02,14,14,0,0
COATZA / MINA,2023-01-03,15,15,0,0
COATZA / MINA,2023-01-04,19,19,0,0
COATZA / MINA,2023-01-05,15,15,0,0
COATZA / MINA,2023-01-06,32,30,2,0.0625
COATZA / MINA,2023-01-07,32,30,2,0.0625
COATZA / MINA,2023-01-08,28,28,0,0
COATZA / MINA,2023-01-09,38,34,4,0.10526
COATZA / MINA,2023-01-10,29,29,0,0
COATZA / MINA,2023-01-11,30,30,0,0
COATZA / MINA,2023-01-12,19,19,0,0
COATZA / MINA,2023-01-13,38,38,0,0
COATZA / MINA,2023-01-14,19,17,2,0.10526
COATZA / MINA,2023-01-15,25,25,0,0
COATZA / MINA,2023-01-16,28,24,4,0.14286
COATZA / MINA,2023-01-17,56,38,18,0.32143
COATZA / MINA,2023-01-18,97,70,27,0.27835
COATZA / MINA,2023-01-19,81,56,25,0.30864
COATZA / MINA,2023-01-20,119,112,7,0.05882
COATZA / MINA,2023-01-21,78,48,30,0.38462
COATZA / MINA,2023-01-22,73,44,29,0.39726
COATZA / MINA,2023-01-23,70,50,20,0.28571
COATZA / MINA,2023-01-24,92,89,3,0.03261
COATZA / MINA,2023-01-25,81,54,27,0.33333
COATZA / MINA,2023-01-26,92,65,27,0.29348
COATZA / MINA,2023-01-27,40,33,7,0.175
COATZA / MINA,2023-01-28,52,50,2,0.03846
COATZA / MINA,2023-01-29,78,56,22,0.28205
COATZA / MINA,2023-01-30,39,34,5,0.12821
COATZA / MINA,2023-01-31,62,41,21,0.33871
COATZA / MINA,2023-02-02,94,51,43,0.45745
COATZA / MINA,2023-02-03,62,39,23,0.37097
COATZA / MINA,2023-02-04,56,25,31,0.55357
COATZA / MINA,2023-02-05,74,48,26,0.35135
COATZA / MINA,2023-02-06,185,113,72,0.38919
COATZA / MINA,2023-02-07,57,55,2,0.03509
COATZA / MINA,2023-02-08,74,63,11,0.14865
COATZA / MINA,2023-02-09,142,104,38,0.26761
COATZA / MINA,2023-02-10,80,56,24,0.3
COATZA / MINA,2023-02-11,43,40,3,0.06977
COATZA / MINA,2023-02-12,150,132,18,0.12
COATZA / MINA,2023-02-13,28,24,4,0.14286
COATZA / MINA,2023-02-14,99,31,68,0.68687
COATZA / MINA,2023-02-15,104,81,23,0.22115
COATZA / MINA,2023-02-16,73,48,25,0.34247
COATZA / MINA,2023-02-17,23,15,8,0.34783
COATZA / MINA,2023-02-18,103,38,65,0.63107
COATZA / MINA,2023-02-19,103,59,44,0.42718
COATZA / MINA,2023-02-20,36,21,15,0.41667
COATZA / MINA,2023-02-21,65,64,1,0.01538
COATZA / MINA,2023-02-22,77,66,11,0.14286
COATZA / MINA,2023-02-23,52,52,0,0
COATZA / MINA,2023-02-24,117,104,13,0.11111
COATZA / MINA,2023-02-25,71,40,31,0.43662
COATZA / MINA,2023-02-26,104,43,61,0.58654
COATZA / MINA,2023-02-27,44,37,7,0.15909
COATZA / MINA,2023-02-28,95,84,11,0.11579
COATZA / MINA,2023-03-01,68,58,10,0.14706
COATZA / MINA,2023-03-02,111,69,42,0.37838
COATZA / MINA,2023-03-03,85,54,31,0.36471
COATZA / MINA,2023-03-04,128,82,46,0.35938
COATZA / MINA,2023-03-05,39,37,2,0.05128
COATZA / MINA,2023-03-07,64,39,25,0.39062
COATZA / MINA,2023-03-08,46,44,2,0.04348
COATZA / MINA,2023-03-09,66,27,39,0.59091
COATZA / MINA,2023-03-10,92,60,32,0.34783
COATZA / MINA,2023-03-11,54,35,19,0.35185
COATZA / MINA,2023-03-12,36,25,11,0.30556
COATZA / MINA,2023-03-13,56,22,34,0.60714
COATZA / MINA,2023-03-14,66,48,18,0.27273
COATZA / MINA,2023-03-15,19,19,0,0
COATZA / MINA,2023-03-16,50,40,10,0.2
COATZA / MINA,2023-03-17,44,33,11,0.25
COATZA / MINA,2023-03-18,46,46,0,0
COATZA / MINA,2023-03-19,43,43,0,0
COATZA / MINA,2023-03-20,32,32,0,0
COLIMA / MANZANILLO,2023-01-01,9,9,0,0
COLIMA / MANZANILLO,2023-01-02,65,65,0,0
COLIMA / MANZANILLO,2023-01-03,69,69,0,0
COLIMA / MANZANILLO,2023-01-04,47,45,2,0.04255
COLIMA / MANZANILLO,2023-01-05,28,28,0,0
COLIMA / MANZANILLO,2023-01-06,30,30,0,0
COLIMA / MANZANILLO,2023-01-07,35,35,0,0
COLIMA / MANZANILLO,2023-01-08,13,13,0,0
COLIMA / MANZANILLO,2023-01-09,32,32,0,0
COLIMA / MANZANILLO,2023-01-10,32,32,0,0
COLIMA / MANZANILLO,2023-01-11,15,15,0,0
COLIMA / MANZANILLO,2023-01-12,19,19,0,0
COLIMA / MANZANILLO,2023-01-13,26,26,0,0
COLIMA / MANZANILLO,2023-01-14,22,22,0,0
COLIMA / MANZANILLO,2023-01-15,23,23,0,0
COLIMA / MANZANILLO,2023-01-16,27,27,0,0
COLIMA / MANZANILLO,2023-01-17,27,27,0,0
COLIMA / MANZANILLO,2023-01-18,41,41,0,0
COLIMA / MANZANILLO,2023-01-19,163,163,0,0
COLIMA / MANZANILLO,2023-01-20,124,124,0,0
COLIMA / MANZANILLO,2023-01-21,66,66,0,0
COLIMA / MANZANILLO,2023-01-22,25,25,0,0
COLIMA / MANZANILLO,2023-01-23,55,55,0,0
COLIMA / MANZANILLO,2023-01-24,69,69,0,0
COLIMA / MANZANILLO,2023-01-25,95,95,0,0
COLIMA / MANZANILLO,2023-01-26,162,162,0,0
COLIMA / MANZANILLO,2023-01-27,96,96,0,0
COLIMA / MANZANILLO,2023-01-28,53,52,1,0.01887
COLIMA / MANZANILLO,2023-01-29,84,81,3,0.03571
COLIMA / MANZANILLO,2023-01-30,74,70,4,0.05405
COLIMA / MANZANILLO,2023-01-31,125,125,0,0
COLIMA / MANZANILLO,2023-02-02,178,158,20,0.11236
COLIMA / MANZANILLO,2023-02-03,71,71,0,0
COLIMA / MANZANILLO,2023-02-04,97,97,0,0
COLIMA / MANZANILLO,2023-02-05,136,136,0,0
COLIMA / MANZANILLO,2023-02-06,70,45,25,0.35714
COLIMA / MANZANILLO,2023-02-07,219,219,0,0
COLIMA / MANZANILLO,2023-02-08,105,103,2,0.01905
COLIMA / MANZANILLO,2023-02-09,122,122,0,0
COLIMA / MANZANILLO,2023-02-10,61,56,5,0.08197
COLIMA / MANZANILLO,2023-02-11,253,253,0,0
COLIMA / MANZANILLO,2023-02-12,51,47,4,0.07843
COLIMA / MANZANILLO,2023-02-13,179,179,0,0
COLIMA / MANZANILLO,2023-02-14,150,147,3,0.02
COLIMA / MANZANILLO,2023-02-15,81,81,0,0
COLIMA / MANZANILLO,2023-02-16,231,177,54,0.23377
COLIMA / MANZANILLO,2023-02-17,187,186,1,0.00535
COLIMA / MANZANILLO,2023-02-18,248,247,1,0.00403
COLIMA / MANZANILLO,2023-02-19,168,146,22,0.13095
COLIMA / MANZANILLO,2023-02-20,283,203,80,0.28269
COLIMA / MANZANILLO,2023-02-21,101,86,15,0.14851
COLIMA / MANZANILLO,2023-02-22,105,105,0,0
COLIMA / MANZANILLO,2023-02-23,111,111,0,0
COLIMA / MANZANILLO,2023-02-24,66,53,13,0.19697
COLIMA / MANZANILLO,2023-02-25,132,118,14,0.10606
COLIMA / MANZANILLO,2023-02-26,15,14,1,0.06667
COLIMA / MANZANILLO,2023-02-27,43,41,2,0.04651
COLIMA / MANZANILLO,2023-02-28,24,23,1,0.04167
COLIMA / MANZANILLO,2023-03-01,59,58,1,0.01695
COLIMA / MANZANILLO,2023-03-02,128,125,3,0.02344
COLIMA / MANZANILLO,2023-03-03,55,55,0,0
COLIMA / MANZANILLO,2023-03-04,25,22,3,0.12
COLIMA / MANZANILLO,2023-03-05,61,57,4,0.06557
COLIMA / MANZANILLO,2023-03-07,37,36,1,0.02703
COLIMA / MANZANILLO,2023-03-08,46,44,2,0.04348
COLIMA / MANZANILLO,2023-03-09,66,49,17,0.25758
COLIMA / MANZANILLO,2023-03-10,90,86,4,0.04444
COLIMA / MANZANILLO,2023-03-11,56,56,0,0
COLIMA / MANZANILLO,2023-03-12,69,68,1,0.01449
COLIMA / MANZANILLO,2023-03-13,42,42,0,0
COLIMA / MANZANILLO,2023-03-14,38,37,1,0.02632
COLIMA / MANZANILLO,2023-03-15,86,85,1,0.01163
COLIMA / MANZANILLO,2023-03-16,47,43,4,0.08511
COLIMA / MANZANILLO,2023-03-17,70,70,0,0
COLIMA / MANZANILLO,2023-03-18,154,154,0,0
COLIMA / MANZANILLO,2023-03-19,68,68,0,0
COLIMA / MANZANILLO,2023-03-20,89,89,0,0
CONDESA,2023-01-01,10,10,0,0
CONDESA,2023-01-02,877,504,373,0.42531
CONDESA,2023-01-03,787,563,224,0.28463
CONDESA,2023-01-04,751,401,350,0.46605
CONDESA,2023-01-05,873,661,212,0.24284
CONDESA,2023-01-06,320,119,201,0.62813
CONDESA,2023-01-07,1638,1203,435,0.26557
CONDESA,2023-01-08,464,343,121,0.26078
CONDESA,2023-01-09,1520,1280,240,0.15789
CONDESA,2023-01-10,768,528,240,0.3125
CONDESA,2023-01-11,862,683,179,0.20766
CONDESA,2023-01-12,1191,723,468,0.39295
CONDESA,2023-01-13,785,590,195,0.24841
CONDESA,2023-01-14,660,549,111,0.16818
CONDESA,2023-01-15,260,175,85,0.32692
CONDESA,2023-01-16,852,596,256,0.30047
CONDESA,2023-01-17,552,313,239,0.43297
CONDESA,2023-01-18,1506,843,663,0.44024
CONDESA,2023-01-19,2502,1163,1339,0.53517
CONDESA,2023-01-20,1965,1318,647,0.32926
CONDESA,2023-01-21,1025,927,98,0.09561
CONDESA,2023-01-22,695,580,115,0.16547
CONDESA,2023-01-23,1555,826,729,0.46881
CONDESA,2023-01-24,1441,1120,321,0.22276
CONDESA,2023-01-25,1240,977,263,0.2121
CONDESA,2023-01-26,844,652,192,0.22749
CONDESA,2023-01-27,574,459,115,0.20035
CONDESA,2023-01-28,903,644,259,0.28682
CONDESA,2023-01-29,1948,859,1089,0.55903
CONDESA,2023-01-30,1341,855,486,0.36242
CONDESA,2023-01-31,1656,1392,264,0.15942
CONDESA,2023-02-02,1049,801,248,0.23642
CONDESA,2023-02-03,1341,1160,181,0.13497
CONDESA,2023-02-04,1326,916,410,0.3092
CONDESA,2023-02-05,520,444,76,0.14615
CONDESA,2023-02-06,393,317,76,0.19338
CONDESA,2023-02-07,1061,784,277,0.26107
CONDESA,2023-02-08,1049,612,437,0.41659
CONDESA,2023-02-09,672,374,298,0.44345
CONDESA,2023-02-10,889,670,219,0.24634
CONDESA,2023-02-11,833,616,217,0.2605
CONDESA,2023-02-12,220,131,89,0.40455
CONDESA,2023-02-13,918,786,132,0.14379
CONDESA,2023-02-14,743,582,161,0.21669
CONDESA,2023-02-15,649,419,230,0.35439
CONDESA,2023-02-16,684,277,407,0.59503
CONDESA,2023-02-17,770,593,177,0.22987
CONDESA,2023-02-18,753,612,141,0.18725
CONDESA,2023-02-19,596,409,187,0.31376
CONDESA,2023-02-20,1200,914,286,0.23833
CONDESA,2023-02-21,539,438,101,0.18738
CONDESA,2023-02-22,787,675,112,0.14231
CONDESA,2023-02-23,647,450,197,0.30448
CONDESA,2023-02-24,460,260,200,0.43478
CONDESA,2023-02-25,683,551,132,0.19327
CONDESA,2023-02-26,314,155,159,0.50637
CONDESA,2023-02-27,542,386,156,0.28782
CONDESA,2023-02-28,369,280,89,0.24119
CONDESA,2023-03-01,395,324,71,0.17975
CONDESA,2023-03-02,786,598,188,0.23919
CONDESA,2023-03-03,417,299,118,0.28297
CONDESA,2023-03-04,485,302,183,0.37732
CONDESA,2023-03-05,542,393,149,0.27491
CONDESA,2023-03-07,630,340,290,0.46032
CONDESA,2023-03-08,605,310,295,0.4876
CONDESA,2023-03-09,477,305,172,0.36059
CONDESA,2023-03-10,363,248,115,0.3168
CONDESA,2023-03-11,284,184,100,0.35211
CONDESA,2023-03-12,156,140,16,0.10256
CONDESA,2023-03-13,246,183,63,0.2561
CONDESA,2023-03-14,361,290,71,0.19668
CONDESA,2023-03-15,253,185,68,0.26877
CONDESA,2023-03-16,348,258,90,0.25862
CONDESA,2023-03-17,342,267,75,0.2193
CONDESA,2023-03-18,345,304,41,0.11884
CONDESA,2023-03-19,154,126,28,0.18182
CONDESA,2023-03-20,192,154,38,0.19792
CONSTITUCION,2023-01-01,6,6,0,0
CONSTITUCION,2023-01-02,34,33,1,0.02941
CONSTITUCION,2023-01-03,43,41,2,0.04651
CONSTITUCION,2023-01-04,41,38,3,0.07317
CONSTITUCION,2023-01-05,20,17,3,0.15
CONSTITUCION,2023-01-06,44,41,3,0.06818
CONSTITUCION,2023-01-07,42,30,12,0.28571
CONSTITUCION,2023-01-08,41,31,10,0.2439
CONSTITUCION,2023-01-09,49,36,13,0.26531
CONSTITUCION,2023-01-10,66,51,15,0.22727
CONSTITUCION,2023-01-11,42,37,5,0.11905
CONSTITUCION,2023-01-12,76,73,3,0.03947
CONSTITUCION,2023-01-13,43,37,6,0.13953
CONSTITUCION,2023-01-14,71,66,5,0.07042
CONSTITUCION,2023-01-15,90,78,12,0.13333
CONSTITUCION,2023-01-16,61,53,8,0.13115
CONSTITUCION,2023-01-17,65,56,9,0.13846
CONSTITUCION,2023-01-18,124,119,5,0.04032
CONSTITUCION,2023-01-19,57,47,10,0.17544
CONSTITUCION,2023-01-20,61,55,6,0.09836
CONSTITUCION,2023-01-21,44,42,2,0.04545
CONSTITUCION,2023-01-22,96,91,5,0.05208
CONSTITUCION,2023-01-23,53,43,10,0.18868
CONSTITUCION,2023-01-24,89,88,1,0.01124
CONSTITUCION,2023-01-25,35,31,4,0.11429
CONSTITUCION,2023-01-26,84,84,0,0
CONSTITUCION,2023-01-27,42,35,7,0.16667
CONSTITUCION,2023-01-28,138,77,61,0.44203
CONSTITUCION,2023-01-29,110,58,52,0.47273
CONSTITUCION,2023-01-30,107,99,8,0.07477
CONSTITUCION,2023-01-31,54,42,12,0.22222
CONSTITUCION,2023-02-02,89,61,28,0.31461
CONSTITUCION,2023-02-03,63,49,14,0.22222
CONSTITUCION,2023-02-04,68,52,16,0.23529
CONSTITUCION,2023-02-05,51,48,3,0.05882
CONSTITUCION,2023-02-06,85,69,16,0.18824
CONSTITUCION,2023-02-07,55,46,9,0.16364
CONSTITUCION,2023-02-08,145,139,6,0.04138
CONSTITUCION,2023-02-09,44,25,19,0.43182
CONSTITUCION,2023-02-10,61,51,10,0.16393
CONSTITUCION,2023-02-11,54,37,17,0.31481
CONSTITUCION,2023-02-12,80,64,16,0.2
CONSTITUCION,2023-02-13,66,33,33,0.5
CONSTITUCION,2023-02-14,68,59,9,0.13235
CONSTITUCION,2023-02-15,84,61,23,0.27381
CONSTITUCION,2023-02-16,91,73,18,0.1978
CONSTITUCION,2023-02-17,203,194,9,0.04433
CONSTITUCION,2023-02-18,277,197,80,0.28881
CONSTITUCION,2023-02-19,83,42,41,0.49398
CONSTITUCION,2023-02-20,77,63,14,0.18182
CONSTITUCION,2023-02-21,62,55,7,0.1129
CONSTITUCION,2023-02-22,55,29,26,0.47273
CONSTITUCION,2023-02-23,72,35,37,0.51389
CONSTITUCION,2023-02-24,98,46,52,0.53061
CONSTITUCION,2023-02-25,67,44,23,0.34328
CONSTITUCION,2023-02-26,54,36,18,0.33333
CONSTITUCION,2023-02-27,84,77,7,0.08333
CONSTITUCION,2023-02-28,88,68,20,0.22727
CONSTITUCION,2023-03-01,28,6,22,0.78571
CONSTITUCION,2023-03-02,80,57,23,0.2875
CONSTITUCION,2023-03-03,89,70,19,0.21348
CONSTITUCION,2023-03-04,136,119,17,0.125
CONSTITUCION,2023-03-05,46,26,20,0.43478
CONSTITUCION,2023-03-07,149,139,10,0.06711
CONSTITUCION,2023-03-08,93,89,4,0.04301
CONSTITUCION,2023-03-09,50,42,8,0.16
CONSTITUCION,2023-03-10,54,25,29,0.53704
CONSTITUCION,2023-03-11,58,50,8,0.13793
CONSTITUCION,2023-03-12,137,126,11,0.08029
CONSTITUCION,2023-03-13,44,42,2,0.04545
CONSTITUCION,2023-03-14,105,90,15,0.14286
CONSTITUCION,2023-03-15,46,36,10,0.21739
CONSTITUCION,2023-03-16,54,54,0,0
CONSTITUCION,2023-03-17,68,68,0,0
CONSTITUCION,2023-03-18,83,83,0,0
CONSTITUCION,2023-03-19,126,123,3,0.02381
CONSTITUCION,2023-03-20,115,114,1,0.0087
CORDOBA / ORIZABA,2023-01-01,1,1,0,0
CORDOBA / ORIZABA,2023-01-02,27,22,5,0.18519
CORDOBA / ORIZABA,2023-01-03,69,65,4,0.05797
CORDOBA / ORIZABA,2023-01-04,62,58,4,0.06452
CORDOBA / ORIZABA,2023-01-05,50,43,7,0.14
CORDOBA / ORIZABA,2023-01-06,55,42,13,0.23636
CORDOBA / ORIZABA,2023-01-07,47,40,7,0.14894
CORDOBA / ORIZABA,2023-01-08,45,43,2,0.04444
CORDOBA / ORIZABA,2023-01-09,34,34,0,0
CORDOBA / ORIZABA,2023-01-10,50,31,19,0.38
CORDOBA / ORIZABA,2023-01-11,43,43,0,0
CORDOBA / ORIZABA,2023-01-12,50,38,12,0.24
CORDOBA / ORIZABA,2023-01-13,44,33,11,0.25
CORDOBA / ORIZABA,2023-01-14,40,40,0,0
CORDOBA / ORIZABA,2023-01-15,31,29,2,0.06452
CORDOBA / ORIZABA,2023-01-16,75,67,8,0.10667
CORDOBA / ORIZABA,2023-01-17,76,75,1,0.01316
CORDOBA / ORIZABA,2023-01-18,62,60,2,0.03226
CORDOBA / ORIZABA,2023-01-19,97,67,30,0.30928
CORDOBA / ORIZABA,2023-01-20,77,58,19,0.24675
CORDOBA / ORIZABA,2023-01-21,81,70,11,0.1358
CORDOBA / ORIZABA,2023-01-22,55,54,1,0.01818
CORDOBA / ORIZABA,2023-01-23,90,85,5,0.05556
CORDOBA / ORIZABA,2023-01-24,119,108,11,0.09244
CORDOBA / ORIZABA,2023-01-25,187,155,32,0.17112
CORDOBA / ORIZABA,2023-01-26,130,106,24,0.18462
CORDOBA / ORIZABA,2023-01-27,103,102,1,0.00971
CORDOBA / ORIZABA,2023-01-28,175,147,28,0.16
CORDOBA / ORIZABA,2023-01-29,85,73,12,0.14118
CORDOBA / ORIZABA,2023-01-30,137,133,4,0.0292
CORDOBA / ORIZABA,2023-01-31,163,150,13,0.07975
CORDOBA / ORIZABA,2023-02-02,127,103,24,0.18898
CORDOBA / ORIZABA,2023-02-03,143,128,15,0.1049
CORDOBA / ORIZABA,2023-02-04,147,88,59,0.40136
CORDOBA / ORIZABA,2023-02-05,55,51,4,0.07273
CORDOBA / ORIZABA,2023-02-06,121,80,41,0.33884
CORDOBA / ORIZABA,2023-02-07,202,134,68,0.33663
CORDOBA / ORIZABA,2023-02-08,126,96,30,0.2381
CORDOBA / ORIZABA,2023-02-09,124,95,29,0.23387
CORDOBA / ORIZABA,2023-02-10,115,101,14,0.12174
CORDOBA / ORIZABA,2023-02-11,78,64,14,0.17949
CORDOBA / ORIZABA,2023-02-12,72,63,9,0.125
CORDOBA / ORIZABA,2023-02-13,144,129,15,0.10417
CORDOBA / ORIZABA,2023-02-14,151,87,64,0.42384
CORDOBA / ORIZABA,2023-02-15,197,193,4,0.0203
CORDOBA / ORIZABA,2023-02-16,206,98,108,0.52427
CORDOBA / ORIZABA,2023-02-17,180,179,1,0.00556
CORDOBA / ORIZABA,2023-02-18,177,172,5,0.02825
CORDOBA / ORIZABA,2023-02-19,141,120,21,0.14894
CORDOBA / ORIZABA,2023-02-20,332,205,127,0.38253
CORDOBA / ORIZABA,2023-02-21,184,171,13,0.07065
CORDOBA / ORIZABA,2023-02-22,181,127,54,0.29834
CORDOBA / ORIZABA,2023-02-23,130,111,19,0.14615
CORDOBA / ORIZABA,2023-02-24,200,184,16,0.08
CORDOBA / ORIZABA,2023-02-25,99,84,15,0.15152
CORDOBA / ORIZABA,2023-02-26,75,74,1,0.01333
CORDOBA / ORIZABA,2023-02-27,165,157,8,0.04848
CORDOBA / ORIZABA,2023-02-28,215,172,43,0.2
CORDOBA / ORIZABA,2023-03-01,109,88,21,0.19266
CORDOBA / ORIZABA,2023-03-02,112,104,8,0.07143
CORDOBA / ORIZABA,2023-03-03,128,124,4,0.03125
CORDOBA / ORIZABA,2023-03-04,117,111,6,0.05128
CORDOBA / ORIZABA,2023-03-05,77,49,28,0.36364
CORDOBA / ORIZABA,2023-03-07,116,83,33,0.28448
CORDOBA / ORIZABA,2023-03-08,128,93,35,0.27344
CORDOBA / ORIZABA,2023-03-09,65,38,27,0.41538
CORDOBA / ORIZABA,2023-03-10,91,82,9,0.0989
CORDOBA / ORIZABA,2023-03-11,82,79,3,0.03659
CORDOBA / ORIZABA,2023-03-12,83,83,0,0
CORDOBA / ORIZABA,2023-03-13,101,96,5,0.0495
CORDOBA / ORIZABA,2023-03-14,123,119,4,0.03252
CORDOBA / ORIZABA,2023-03-15,136,120,16,0.11765
CORDOBA / ORIZABA,2023-03-16,82,78,4,0.04878
CORDOBA / ORIZABA,2023-03-17,90,90,0,0
CORDOBA / ORIZABA,2023-03-18,158,154,4,0.02532
CORDOBA / ORIZABA,2023-03-19,35,32,3,0.08571
CORDOBA / ORIZABA,2023-03-20,111,101,10,0.09009
CUERNAVACA BUGAMBILIAS,2023-01-01,15,15,0,0
CUERNAVACA BUGAMBILIAS,2023-01-02,38,38,0,0
CUERNAVACA BUGAMBILIAS,2023-01-03,52,47,5,0.09615
CUERNAVACA BUGAMBILIAS,2023-01-04,84,69,15,0.17857
CUERNAVACA BUGAMBILIAS,2023-01-05,41,37,4,0.09756
CUERNAVACA BUGAMBILIAS,2023-01-06,32,32,0,0
CUERNAVACA BUGAMBILIAS,2023-01-07,20,20,0,0
CUERNAVACA BUGAMBILIAS,2023-01-08,38,38,0,0
CUERNAVACA BUGAMBILIAS,2023-01-09,37,33,4,0.10811
CUERNAVACA BUGAMBILIAS,2023-01-10,44,44,0,0
CUERNAVACA BUGAMBILIAS,2023-01-11,50,44,6,0.12
CUERNAVACA BUGAMBILIAS,2023-01-12,63,59,4,0.06349
CUERNAVACA BUGAMBILIAS,2023-01-13,32,28,4,0.125
CUERNAVACA BUGAMBILIAS,2023-01-14,45,42,3,0.06667
CUERNAVACA BUGAMBILIAS,2023-01-15,35,33,2,0.05714
CUERNAVACA BUGAMBILIAS,2023-01-16,108,102,6,0.05556
CUERNAVACA BUGAMBILIAS,2023-01-17,136,136,0,0
CUERNAVACA BUGAMBILIAS,2023-01-18,190,180,10,0.05263
CUERNAVACA BUGAMBILIAS,2023-01-19,134,131,3,0.02239
CUERNAVACA BUGAMBILIAS,2023-01-20,134,134,0,0
CUERNAVACA BUGAMBILIAS,2023-01-21,167,167,0,0
CUERNAVACA BUGAMBILIAS,2023-01-22,138,129,9,0.06522
CUERNAVACA BUGAMBILIAS,2023-01-23,139,138,1,0.00719
CUERNAVACA BUGAMBILIAS,2023-01-24,139,138,1,0.00719
CUERNAVACA BUGAMBILIAS,2023-01-25,91,83,8,0.08791
CUERNAVACA BUGAMBILIAS,2023-01-26,218,198,20,0.09174
CUERNAVACA BUGAMBILIAS,2023-01-27,180,173,7,0.03889
CUERNAVACA BUGAMBILIAS,2023-01-28,245,163,82,0.33469
CUERNAVACA BUGAMBILIAS,2023-01-29,180,178,2,0.01111
CUERNAVACA BUGAMBILIAS,2023-01-30,158,157,1,0.00633
CUERNAVACA BUGAMBILIAS,2023-01-31,141,133,8,0.05674
CUERNAVACA BUGAMBILIAS,2023-02-02,102,100,2,0.01961
CUERNAVACA BUGAMBILIAS,2023-02-03,127,100,27,0.2126
CUERNAVACA BUGAMBILIAS,2023-02-04,261,257,4,0.01533
CUERNAVACA BUGAMBILIAS,2023-02-05,250,224,26,0.104
CUERNAVACA BUGAMBILIAS,2023-02-06,153,143,10,0.06536
CUERNAVACA BUGAMBILIAS,2023-02-07,177,168,9,0.05085
CUERNAVACA BUGAMBILIAS,2023-02-08,168,159,9,0.05357
CUERNAVACA BUGAMBILIAS,2023-02-09,251,244,7,0.02789
CUERNAVACA BUGAMBILIAS,2023-02-10,216,205,11,0.05093
CUERNAVACA BUGAMBILIAS,2023-02-11,202,202,0,0
CUERNAVACA BUGAMBILIAS,2023-02-12,135,130,5,0.03704
CUERNAVACA BUGAMBILIAS,2023-02-13,216,209,7,0.03241
CUERNAVACA BUGAMBILIAS,2023-02-14,97,59,38,0.39175
CUERNAVACA BUGAMBILIAS,2023-02-15,466,454,12,0.02575
CUERNAVACA BUGAMBILIAS,2023-02-16,465,400,65,0.13978
CUERNAVACA BUGAMBILIAS,2023-02-17,531,433,98,0.18456
CUERNAVACA BUGAMBILIAS,2023-02-18,344,344,0,0
CUERNAVACA BUGAMBILIAS,2023-02-19,340,326,14,0.04118
CUERNAVACA BUGAMBILIAS,2023-02-20,249,163,86,0.34538
CUERNAVACA BUGAMBILIAS,2023-02-21,271,206,65,0.23985
CUERNAVACA BUGAMBILIAS,2023-02-22,163,140,23,0.1411
CUERNAVACA BUGAMBILIAS,2023-02-23,157,155,2,0.01274
CUERNAVACA BUGAMBILIAS,2023-02-24,158,128,30,0.18987
CUERNAVACA BUGAMBILIAS,2023-02-25,178,142,36,0.20225
CUERNAVACA BUGAMBILIAS,2023-02-26,92,40,52,0.56522
CUERNAVACA BUGAMBILIAS,2023-02-27,184,156,28,0.15217
CUERNAVACA BUGAMBILIAS,2023-02-28,102,90,12,0.11765
CUERNAVACA BUGAMBILIAS,2023-03-01,242,220,22,0.09091
CUERNAVACA BUGAMBILIAS,2023-03-02,88,85,3,0.03409
CUERNAVACA BUGAMBILIAS,2023-03-03,118,112,6,0.05085
CUERNAVACA BUGAMBILIAS,2023-03-04,184,184,0,0
CUERNAVACA BUGAMBILIAS,2023-03-05,78,77,1,0.01282
CUERNAVACA BUGAMBILIAS,2023-03-07,93,93,0,0
CUERNAVACA BUGAMBILIAS,2023-03-08,86,86,0,0
CUERNAVACA BUGAMBILIAS,2023-03-09,19,19,0,0
CUERNAVACA BUGAMBILIAS,2023-03-10,67,67,0,0
CUERNAVACA BUGAMBILIAS,2023-03-11,42,40,2,0.04762
CUERNAVACA BUGAMBILIAS,2023-03-12,160,142,18,0.1125
CUERNAVACA BUGAMBILIAS,2023-03-13,41,40,1,0.02439
CUERNAVACA BUGAMBILIAS,2023-03-14,37,37,0,0
CUERNAVACA BUGAMBILIAS,2023-03-15,123,123,0,0
CUERNAVACA BUGAMBILIAS,2023-03-16,49,44,5,0.10204
CUERNAVACA BUGAMBILIAS,2023-03-17,132,132,0,0
CUERNAVACA BUGAMBILIAS,2023-03-18,128,128,0,0
CUERNAVACA BUGAMBILIAS,2023-03-19,132,128,4,0.0303
CUERNAVACA BUGAMBILIAS,2023-03-20,58,56,2,0.03448
CUERNAVACA DE CORTEZ,2023-01-01,5,3,2,0.4
CUERNAVACA DE CORTEZ,2023-01-02,18,16,2,0.11111
CUERNAVACA DE CORTEZ,2023-01-03,58,56,2,0.03448
CUERNAVACA DE CORTEZ,2023-01-04,51,23,28,0.54902
CUERNAVACA DE CORTEZ,2023-01-05,46,37,9,0.19565
CUERNAVACA DE CORTEZ,2023-01-06,47,35,12,0.25532
CUERNAVACA DE CORTEZ,2023-01-07,26,20,6,0.23077
CUERNAVACA DE CORTEZ,2023-01-08,33,33,0,0
CUERNAVACA DE CORTEZ,2023-01-09,42,37,5,0.11905
CUERNAVACA DE CORTEZ,2023-01-10,71,70,1,0.01408
CUERNAVACA DE CORTEZ,2023-01-11,57,57,0,0
CUERNAVACA DE CORTEZ,2023-01-12,28,28,0,0
CUERNAVACA DE CORTEZ,2023-01-13,67,67,0,0
CUERNAVACA DE CORTEZ,2023-01-14,58,53,5,0.08621
CUERNAVACA DE CORTEZ,2023-01-15,41,39,2,0.04878
CUERNAVACA DE CORTEZ,2023-01-16,130,83,47,0.36154
CUERNAVACA DE CORTEZ,2023-01-17,94,76,18,0.19149
CUERNAVACA DE CORTEZ,2023-01-18,87,35,52,0.5977
CUERNAVACA DE CORTEZ,2023-01-19,86,83,3,0.03488
CUERNAVACA DE CORTEZ,2023-01-20,135,127,8,0.05926
CUERNAVACA DE CORTEZ,2023-01-21,199,121,78,0.39196
CUERNAVACA DE CORTEZ,2023-01-22,107,103,4,0.03738
CUERNAVACA DE CORTEZ,2023-01-23,125,86,39,0.312
CUERNAVACA DE CORTEZ,2023-01-24,118,112,6,0.05085
CUERNAVACA DE CORTEZ,2023-01-25,145,126,19,0.13103
CUERNAVACA DE CORTEZ,2023-01-26,104,102,2,0.01923
CUERNAVACA DE CORTEZ,2023-01-27,138,89,49,0.35507
CUERNAVACA DE CORTEZ,2023-01-28,104,84,20,0.19231
CUERNAVACA DE CORTEZ,2023-01-29,89,79,10,0.11236
CUERNAVACA DE CORTEZ,2023-01-30,76,50,26,0.34211
CUERNAVACA DE CORTEZ,2023-01-31,172,116,56,0.32558
CUERNAVACA DE CORTEZ,2023-02-02,119,83,36,0.30252
CUERNAVACA DE CORTEZ,2023-02-03,203,133,70,0.34483
CUERNAVACA DE CORTEZ,2023-02-04,104,80,24,0.23077
CUERNAVACA DE CORTEZ,2023-02-05,78,76,2,0.02564
CUERNAVACA DE CORTEZ,2023-02-06,125,97,28,0.224
CUERNAVACA DE CORTEZ,2023-02-07,107,58,49,0.45794
CUERNAVACA DE CORTEZ,2023-02-08,110,57,53,0.48182
CUERNAVACA DE CORTEZ,2023-02-09,128,66,62,0.48438
CUERNAVACA DE CORTEZ,2023-02-10,134,70,64,0.47761
CUERNAVACA DE CORTEZ,2023-02-11,208,110,98,0.47115
CUERNAVACA DE CORTEZ,2023-02-12,67,46,21,0.31343
CUERNAVACA DE CORTEZ,2023-02-13,77,64,13,0.16883
CUERNAVACA DE CORTEZ,2023-02-14,115,98,17,0.14783
CUERNAVACA DE CORTEZ,2023-02-15,130,95,35,0.26923
CUERNAVACA DE CORTEZ,2023-02-16,155,125,30,0.19355
CUERNAVACA DE CORTEZ,2023-02-17,161,134,27,0.1677
CUERNAVACA DE CORTEZ,2023-02-18,100,84,16,0.16
CUERNAVACA DE CORTEZ,2023-02-19,80,43,37,0.4625
CUERNAVACA DE CORTEZ,2023-02-20,134,117,17,0.12687
CUERNAVACA DE CORTEZ,2023-02-21,109,70,39,0.3578
CUERNAVACA DE CORTEZ,2023-02-22,138,119,19,0.13768
CUERNAVACA DE CORTEZ,2023-02-23,97,97,0,0
CUERNAVACA DE CORTEZ,2023-02-24,196,194,2,0.0102
CUERNAVACA DE CORTEZ,2023-02-25,111,111,0,0
CUERNAVACA DE CORTEZ,2023-02-26,44,43,1,0.02273
CUERNAVACA DE CORTEZ,2023-02-27,110,110,0,0
CUERNAVACA DE CORTEZ,2023-02-28,66,62,4,0.06061
CUERNAVACA DE CORTEZ,2023-03-01,93,88,5,0.05376
CUERNAVACA DE CORTEZ,2023-03-02,90,90,0,0
CUERNAVACA DE CORTEZ,2023-03-03,69,69,0,0
CUERNAVACA DE CORTEZ,2023-03-04,80,80,0,0
CUERNAVACA DE CORTEZ,2023-03-05,31,27,4,0.12903
CUERNAVACA DE CORTEZ,2023-03-07,115,115,0,0
CUERNAVACA DE CORTEZ,2023-03-08,173,173,0,0
CUERNAVACA DE CORTEZ,2023-03-09,39,39,0,0
CUERNAVACA DE CORTEZ,2023-03-10,30,30,0,0
CUERNAVACA DE CORTEZ,2023-03-11,46,46,0,0
CUERNAVACA DE CORTEZ,2023-03-12,81,81,0,0
CUERNAVACA DE CORTEZ,2023-03-13,51,51,0,0
CUERNAVACA DE CORTEZ,2023-03-14,111,90,21,0.18919
CUERNAVACA DE CORTEZ,2023-03-15,67,67,0,0
CUERNAVACA DE CORTEZ,2023-03-16,49,49,0,0
CUERNAVACA DE CORTEZ,2023-03-17,69,69,0,0
CUERNAVACA DE CORTEZ,2023-03-18,103,100,3,0.02913
CUERNAVACA DE CORTEZ,2023-03-19,27,27,0,0
CUERNAVACA DE CORTEZ,2023-03-20,65,64,1,0.01538
CULIACAN,2023-01-01,4,2,2,0.5
CULIACAN,2023-01-02,39,34,5,0.12821
CULIACAN,2023-01-03,71,61,10,0.14085
CULIACAN,2023-01-04,75,63,12,0.16
CULIACAN,2023-01-06,1,0,1,1
CULIACAN,2023-01-07,86,84,2,0.02326
CULIACAN,2023-01-08,67,51,16,0.23881
CULIACAN,2023-01-09,62,55,7,0.1129
CULIACAN,2023-01-10,54,50,4,0.07407
CULIACAN,2023-01-11,76,61,15,0.19737
CULIACAN,2023-01-12,66,55,11,0.16667
CULIACAN,2023-01-13,40,33,7,0.175
CULIACAN,2023-01-14,56,41,15,0.26786
CULIACAN,2023-01-15,35,27,8,0.22857
CULIACAN,2023-01-16,45,38,7,0.15556
CULIACAN,2023-01-17,43,37,6,0.13953
CULIACAN,2023-01-18,56,43,13,0.23214
CULIACAN,2023-01-19,87,62,25,0.28736
CULIACAN,2023-01-20,40,21,19,0.475
CULIACAN,2023-01-21,53,33,20,0.37736
CULIACAN,2023-01-22,61,51,10,0.16393
CULIACAN,2023-01-23,58,39,19,0.32759
CULIACAN,2023-01-24,84,40,44,0.52381
CULIACAN,2023-01-25,64,48,16,0.25
CULIACAN,2023-01-26,57,44,13,0.22807
CULIACAN,2023-01-27,51,44,7,0.13725
CULIACAN,2023-01-28,44,28,16,0.36364
CULIACAN,2023-01-29,62,44,18,0.29032
CULIACAN,2023-01-30,60,49,11,0.18333
CULIACAN,2023-01-31,63,44,19,0.30159
CULIACAN,2023-02-02,75,50,25,0.33333
CULIACAN,2023-02-03,60,42,18,0.3
CULIACAN,2023-02-04,58,50,8,0.13793
CULIACAN,2023-02-05,46,44,2,0.04348
CULIACAN,2023-02-06,50,36,14,0.28
CULIACAN,2023-02-07,68,46,22,0.32353
CULIACAN,2023-02-08,50,25,25,0.5
CULIACAN,2023-02-09,58,43,15,0.25862
CULIACAN,2023-02-10,64,40,24,0.375
CULIACAN,2023-02-11,65,36,29,0.44615
CULIACAN,2023-02-12,45,34,11,0.24444
CULIACAN,2023-02-13,42,20,22,0.52381
CULIACAN,2023-02-14,34,22,12,0.35294
CULIACAN,2023-02-15,40,32,8,0.2
CULIACAN,2023-02-16,51,33,18,0.35294
CULIACAN,2023-02-17,78,51,27,0.34615
CULIACAN,2023-02-18,48,28,20,0.41667
CULIACAN,2023-02-19,33,21,12,0.36364
CULIACAN,2023-02-20,49,34,15,0.30612
CULIACAN,2023-02-21,58,28,30,0.51724
CULIACAN,2023-02-22,71,37,34,0.47887
CULIACAN,2023-02-23,67,35,32,0.47761
CULIACAN,2023-02-24,55,41,14,0.25455
CULIACAN,2023-02-25,60,42,18,0.3
CULIACAN,2023-02-26,53,37,16,0.30189
CULIACAN,2023-02-27,49,11,38,0.77551
CULIACAN,2023-02-28,55,41,14,0.25455
CULIACAN,2023-03-01,50,29,21,0.42
CULIACAN,2023-03-02,71,47,24,0.33803
CULIACAN,2023-03-03,58,33,25,0.43103
CULIACAN,2023-03-04,87,55,32,0.36782
CULIACAN,2023-03-05,43,25,18,0.4186
CULIACAN,2023-03-07,55,28,27,0.49091
CULIACAN,2023-03-08,54,21,33,0.61111
CULIACAN,2023-03-09,45,29,16,0.35556
CULIACAN,2023-03-10,54,20,34,0.62963
CULIACAN,2023-03-11,60,22,38,0.63333
CULIACAN,2023-03-12,44,2,42,0.95455
CULIACAN,2023-03-13,51,28,23,0.45098
CULIACAN,2023-03-14,37,14,23,0.62162
CULIACAN,2023-03-15,63,23,40,0.63492
CULIACAN,2023-03-16,48,40,8,0.16667
CULIACAN,2023-03-17,87,45,42,0.48276
CULIACAN,2023-03-18,94,51,43,0.45745
CULIACAN,2023-03-19,55,28,27,0.49091
CULIACAN,2023-03-20,54,21,33,0.61111
DELTA,2023-01-01,11,11,0,0
DELTA,2023-01-02,45,37,8,0.17778
DELTA,2023-01-03,63,62,1,0.01587
DELTA,2023-01-04,61,57,4,0.06557
DELTA,2023-01-05,88,82,6,0.06818
DELTA,2023-01-06,66,56,10,0.15152
DELTA,2023-01-07,84,76,8,0.09524
DELTA,2023-01-08,35,31,4,0.11429
DELTA,2023-01-09,62,51,11,0.17742
DELTA,2023-01-10,58,53,5,0.08621
DELTA,2023-01-11,81,80,1,0.01235
DELTA,2023-01-12,65,52,13,0.2
DELTA,2023-01-13,53,49,4,0.07547
DELTA,2023-01-14,89,84,5,0.05618
DELTA,2023-01-15,72,70,2,0.02778
DELTA,2023-01-16,54,42,12,0.22222
DELTA,2023-01-17,76,56,20,0.26316
DELTA,2023-01-18,47,36,11,0.23404
DELTA,2023-01-19,40,37,3,0.075
DELTA,2023-01-20,57,49,8,0.14035
DELTA,2023-01-21,91,57,34,0.37363
DELTA,2023-01-22,51,34,17,0.33333
DELTA,2023-01-23,62,44,18,0.29032
DELTA,2023-01-24,55,41,14,0.25455
DELTA,2023-01-25,137,104,33,0.24088
DELTA,2023-01-26,52,44,8,0.15385
DELTA,2023-01-27,196,119,77,0.39286
DELTA,2023-01-28,298,192,106,0.3557
DELTA,2023-01-29,50,28,22,0.44
DELTA,2023-01-30,122,88,34,0.27869
DELTA,2023-01-31,134,103,31,0.23134
DELTA,2023-02-02,176,106,70,0.39773
DELTA,2023-02-03,171,150,21,0.12281
DELTA,2023-02-04,100,72,28,0.28
DELTA,2023-02-05,221,190,31,0.14027
DELTA,2023-02-06,130,100,30,0.23077
DELTA,2023-02-07,88,78,10,0.11364
DELTA,2023-02-08,90,71,19,0.21111
DELTA,2023-02-09,81,63,18,0.22222
DELTA,2023-02-10,177,80,97,0.54802
DELTA,2023-02-11,149,102,47,0.31544
DELTA,2023-02-12,43,33,10,0.23256
DELTA,2023-02-13,134,112,22,0.16418
DELTA,2023-02-14,149,103,46,0.30872
DELTA,2023-02-15,140,86,54,0.38571
DELTA,2023-02-16,191,162,29,0.15183
DELTA,2023-02-17,180,130,50,0.27778
DELTA,2023-02-18,187,150,37,0.19786
DELTA,2023-02-19,155,48,107,0.69032
DELTA,2023-02-20,110,66,44,0.4
DELTA,2023-02-21,218,120,98,0.44954
DELTA,2023-02-22,146,94,52,0.35616
DELTA,2023-02-23,189,136,53,0.28042
DELTA,2023-02-24,136,85,51,0.375
DELTA,2023-02-25,85,59,26,0.30588
DELTA,2023-02-26,64,31,33,0.51562
DELTA,2023-02-27,90,78,12,0.13333
DELTA,2023-02-28,75,58,17,0.22667
DELTA,2023-03-01,88,64,24,0.27273
DELTA,2023-03-02,59,45,14,0.23729
DELTA,2023-03-03,126,68,58,0.46032
DELTA,2023-03-04,82,58,24,0.29268
DELTA,2023-03-05,57,27,30,0.52632
DELTA,2023-03-07,63,42,21,0.33333
DELTA,2023-03-08,117,48,69,0.58974
DELTA,2023-03-09,74,56,18,0.24324
DELTA,2023-03-10,59,27,32,0.54237
DELTA,2023-03-11,81,56,25,0.30864
DELTA,2023-03-12,42,23,19,0.45238
DELTA,2023-03-13,40,27,13,0.325
DELTA,2023-03-14,45,30,15,0.33333
DELTA,2023-03-15,75,59,16,0.21333
DELTA,2023-03-16,71,57,14,0.19718
DELTA,2023-03-17,71,41,30,0.42254
DELTA,2023-03-18,173,148,25,0.14451
DELTA,2023-03-19,71,56,15,0.21127
DELTA,2023-03-20,72,57,15,0.20833
ECATEPEC,2023-01-01,10,10,0,0
ECATEPEC,2023-01-02,24,24,0,0
ECATEPEC,2023-01-03,31,31,0,0
ECATEPEC,2023-01-04,26,26,0,0
ECATEPEC,2023-01-05,57,54,3,0.05263
ECATEPEC,2023-01-06,42,42,0,0
ECATEPEC,2023-01-07,56,56,0,0
ECATEPEC,2023-01-08,34,34,0,0
ECATEPEC,2023-01-09,41,41,0,0
ECATEPEC,2023-01-10,48,48,0,0
ECATEPEC,2023-01-11,49,46,3,0.06122
ECATEPEC,2023-01-12,57,56,1,0.01754
ECATEPEC,2023-01-13,60,58,2,0.03333
ECATEPEC,2023-01-14,86,86,0,0
ECATEPEC,2023-01-15,55,55,0,0
ECATEPEC,2023-01-16,72,72,0,0
ECATEPEC,2023-01-17,77,77,0,0
ECATEPEC,2023-01-18,42,42,0,0
ECATEPEC,2023-01-19,32,32,0,0
ECATEPEC,2023-01-20,122,98,24,0.19672
ECATEPEC,2023-01-21,226,207,19,0.08407
ECATEPEC,2023-01-22,176,167,9,0.05114
ECATEPEC,2023-01-23,213,202,11,0.05164
ECATEPEC,2023-01-24,161,158,3,0.01863
ECATEPEC,2023-01-25,74,59,15,0.2027
ECATEPEC,2023-01-26,133,127,6,0.04511
ECATEPEC,2023-01-27,149,148,1,0.00671
ECATEPEC,2023-01-28,264,262,2,0.00758
ECATEPEC,2023-01-29,110,103,7,0.06364
ECATEPEC,2023-01-30,239,154,85,0.35565
ECATEPEC,2023-01-31,186,158,28,0.15054
ECATEPEC,2023-02-02,182,181,1,0.00549
ECATEPEC,2023-02-03,88,86,2,0.02273
ECATEPEC,2023-02-04,152,150,2,0.01316
ECATEPEC,2023-02-05,107,102,5,0.04673
ECATEPEC,2023-02-06,242,180,62,0.2562
ECATEPEC,2023-02-07,278,277,1,0.0036
ECATEPEC,2023-02-08,230,169,61,0.26522
ECATEPEC,2023-02-09,197,197,0,0
ECATEPEC,2023-02-10,195,195,0,0
ECATEPEC,2023-02-11,207,207,0,0
ECATEPEC,2023-02-12,99,97,2,0.0202
ECATEPEC,2023-02-13,96,96,0,0
ECATEPEC,2023-02-14,101,101,0,0
ECATEPEC,2023-02-15,202,197,5,0.02475
ECATEPEC,2023-02-16,80,80,0,0
ECATEPEC,2023-02-17,81,81,0,0
ECATEPEC,2023-02-18,261,261,0,0
ECATEPEC,2023-02-19,211,211,0,0
ECATEPEC,2023-02-20,106,106,0,0
ECATEPEC,2023-02-21,299,299,0,0
ECATEPEC,2023-02-22,46,46,0,0
ECATEPEC,2023-02-23,53,53,0,0
ECATEPEC,2023-02-24,65,65,0,0
ECATEPEC,2023-02-25,60,60,0,0
ECATEPEC,2023-02-26,64,64,0,0
ECATEPEC,2023-02-27,56,56,0,0
ECATEPEC,2023-02-28,65,65,0,0
ECATEPEC,2023-03-01,50,50,0,0
ECATEPEC,2023-03-02,49,49,0,0
ECATEPEC,2023-03-03,51,49,2,0.03922
ECATEPEC,2023-03-04,55,55,0,0
ECATEPEC,2023-03-05,57,56,1,0.01754
ECATEPEC,2023-03-07,49,48,1,0.02041
ECATEPEC,2023-03-08,58,58,0,0
ECATEPEC,2023-03-09,50,50,0,0
ECATEPEC,2023-03-10,50,50,0,0
ECATEPEC,2023-03-11,76,76,0,0
ECATEPEC,2023-03-12,50,50,0,0
ECATEPEC,2023-03-13,27,27,0,0
ECATEPEC,2023-03-14,44,44,0,0
ECATEPEC,2023-03-15,64,64,0,0
ECATEPEC,2023-03-16,60,60,0,0
ECATEPEC,2023-03-17,94,94,0,0
ECATEPEC,2023-03-18,88,88,0,0
ECATEPEC,2023-03-19,102,102,0,0
ECATEPEC,2023-03-20,193,193,0,0
GDL BARRANCA,2023-01-01,7,7,0,0
GDL BARRANCA,2023-01-02,21,21,0,0
GDL BARRANCA,2023-01-03,27,27,0,0
GDL BARRANCA,2023-01-04,24,24,0,0
GDL BARRANCA,2023-01-05,20,20,0,0
GDL BARRANCA,2023-01-06,38,38,0,0
GDL BARRANCA,2023-01-07,47,47,0,0
GDL BARRANCA,2023-01-08,32,32,0,0
GDL BARRANCA,2023-01-09,24,24,0,0
GDL BARRANCA,2023-01-10,43,43,0,0
GDL BARRANCA,2023-01-11,37,37,0,0
GDL BARRANCA,2023-01-12,23,23,0,0
GDL BARRANCA,2023-01-13,55,55,0,0
GDL BARRANCA,2023-01-14,30,30,0,0
GDL BARRANCA,2023-01-15,36,36,0,0
GDL BARRANCA,2023-01-16,30,30,0,0
GDL BARRANCA,2023-01-17,32,32,0,0
GDL BARRANCA,2023-01-18,29,29,0,0
GDL BARRANCA,2023-01-19,35,33,2,0.05714
GDL BARRANCA,2023-01-20,46,46,0,0
GDL BARRANCA,2023-01-21,45,45,0,0
GDL BARRANCA,2023-01-22,33,33,0,0
GDL BARRANCA,2023-01-23,29,29,0,0
GDL BARRANCA,2023-01-24,52,52,0,0
GDL BARRANCA,2023-01-25,51,51,0,0
GDL BARRANCA,2023-01-26,74,74,0,0
GDL BARRANCA,2023-01-27,21,21,0,0
GDL BARRANCA,2023-01-28,60,60,0,0
GDL BARRANCA,2023-01-29,41,40,1,0.02439
GDL BARRANCA,2023-01-30,34,34,0,0
GDL BARRANCA,2023-01-31,55,55,0,0
GDL BARRANCA,2023-02-02,31,28,3,0.09677
GDL BARRANCA,2023-02-03,71,71,0,0
GDL BARRANCA,2023-02-04,57,57,0,0
GDL BARRANCA,2023-02-05,44,44,0,0
GDL BARRANCA,2023-02-06,38,38,0,0
GDL BARRANCA,2023-02-07,68,68,0,0
GDL BARRANCA,2023-02-08,49,49,0,0
GDL BARRANCA,2023-02-09,19,19,0,0
GDL BARRANCA,2023-02-10,24,24,0,0
GDL BARRANCA,2023-02-11,46,46,0,0
GDL BARRANCA,2023-02-12,23,23,0,0
GDL BARRANCA,2023-02-13,36,36,0,0
GDL BARRANCA,2023-02-14,37,37,0,0
GDL BARRANCA,2023-02-15,31,31,0,0
GDL BARRANCA,2023-02-16,31,31,0,0
GDL BARRANCA,2023-02-17,46,46,0,0
GDL BARRANCA,2023-02-18,41,41,0,0
GDL BARRANCA,2023-02-19,31,31,0,0
GDL BARRANCA,2023-02-20,70,70,0,0
GDL BARRANCA,2023-02-21,22,22,0,0
GDL BARRANCA,2023-02-22,32,32,0,0
GDL BARRANCA,2023-02-23,26,26,0,0
GDL BARRANCA,2023-02-24,38,38,0,0
GDL BARRANCA,2023-02-25,34,34,0,0
GDL BARRANCA,2023-02-26,15,15,0,0
GDL BARRANCA,2023-02-27,43,43,0,0
GDL BARRANCA,2023-02-28,38,36,2,0.05263
GDL BARRANCA,2023-03-01,28,28,0,0
GDL BARRANCA,2023-03-02,33,33,0,0
GDL BARRANCA,2023-03-03,9,9,0,0
GDL BARRANCA,2023-03-04,30,30,0,0
GDL BARRANCA,2023-03-05,19,19,0,0
GDL BARRANCA,2023-03-07,56,51,5,0.08929
GDL BARRANCA,2023-03-08,33,33,0,0
GDL BARRANCA,2023-03-09,39,39,0,0
GDL BARRANCA,2023-03-10,17,17,0,0
GDL BARRANCA,2023-03-11,46,43,3,0.06522
GDL BARRANCA,2023-03-12,22,22,0,0
GDL BARRANCA,2023-03-13,18,17,1,0.05556
GDL BARRANCA,2023-03-14,31,31,0,0
GDL BARRANCA,2023-03-15,27,27,0,0
GDL BARRANCA,2023-03-16,38,32,6,0.15789
GDL BARRANCA,2023-03-17,39,34,5,0.12821
GDL BARRANCA,2023-03-18,40,40,0,0
GDL BARRANCA,2023-03-19,40,40,0,0
GDL BARRANCA,2023-03-20,32,32,0,0
GDL CHAPULTEPEC,2023-01-01,5,5,0,0
GDL CHAPULTEPEC,2023-01-02,31,31,0,0
GDL CHAPULTEPEC,2023-01-03,43,42,1,0.02326
GDL CHAPULTEPEC,2023-01-04,30,26,4,0.13333
GDL CHAPULTEPEC,2023-01-05,70,65,5,0.07143
GDL CHAPULTEPEC,2023-01-06,21,19,2,0.09524
GDL CHAPULTEPEC,2023-01-07,24,21,3,0.125
GDL CHAPULTEPEC,2023-01-08,8,6,2,0.25
GDL CHAPULTEPEC,2023-01-09,38,38,0,0
GDL CHAPULTEPEC,2023-01-10,62,61,1,0.01613
GDL CHAPULTEPEC,2023-01-11,56,53,3,0.05357
GDL CHAPULTEPEC,2023-01-12,53,50,3,0.0566
GDL CHAPULTEPEC,2023-01-13,38,36,2,0.05263
GDL CHAPULTEPEC,2023-01-14,30,30,0,0
GDL CHAPULTEPEC,2023-01-15,16,12,4,0.25
GDL CHAPULTEPEC,2023-01-16,44,39,5,0.11364
GDL CHAPULTEPEC,2023-01-17,32,31,1,0.03125
GDL CHAPULTEPEC,2023-01-18,39,36,3,0.07692
GDL CHAPULTEPEC,2023-01-19,28,24,4,0.14286
GDL CHAPULTEPEC,2023-01-20,31,23,8,0.25806
GDL CHAPULTEPEC,2023-01-21,139,112,27,0.19424
GDL CHAPULTEPEC,2023-01-22,29,29,0,0
GDL CHAPULTEPEC,2023-01-23,89,84,5,0.05618
GDL CHAPULTEPEC,2023-01-24,171,158,13,0.07602
GDL CHAPULTEPEC,2023-01-25,19,16,3,0.15789
GDL CHAPULTEPEC,2023-01-26,85,83,2,0.02353
GDL CHAPULTEPEC,2023-01-27,79,66,13,0.16456
GDL CHAPULTEPEC,2023-01-28,125,121,4,0.032
GDL CHAPULTEPEC,2023-01-29,34,20,14,0.41176
GDL CHAPULTEPEC,2023-01-30,60,60,0,0
GDL CHAPULTEPEC,2023-01-31,103,83,20,0.19417
GDL CHAPULTEPEC,2023-02-02,80,68,12,0.15
GDL CHAPULTEPEC,2023-02-03,76,69,7,0.09211
GDL CHAPULTEPEC,2023-02-04,79,75,4,0.05063
GDL CHAPULTEPEC,2023-02-05,42,42,0,0
GDL CHAPULTEPEC,2023-02-06,26,26,0,0
GDL CHAPULTEPEC,2023-02-07,53,48,5,0.09434
GDL CHAPULTEPEC,2023-02-08,77,76,1,0.01299
GDL CHAPULTEPEC,2023-02-09,93,89,4,0.04301
GDL CHAPULTEPEC,2023-02-10,163,163,0,0
GDL CHAPULTEPEC,2023-02-11,46,46,0,0
GDL CHAPULTEPEC,2023-02-12,21,19,2,0.09524
GDL CHAPULTEPEC,2023-02-13,46,36,10,0.21739
GDL CHAPULTEPEC,2023-02-14,80,75,5,0.0625
GDL CHAPULTEPEC,2023-02-15,73,54,19,0.26027
GDL CHAPULTEPEC,2023-02-16,65,60,5,0.07692
GDL CHAPULTEPEC,2023-02-17,61,60,1,0.01639
GDL CHAPULTEPEC,2023-02-18,112,58,54,0.48214
GDL CHAPULTEPEC,2023-02-19,13,13,0,0
GDL CHAPULTEPEC,2023-02-20,49,44,5,0.10204
GDL CHAPULTEPEC,2023-02-21,64,61,3,0.04688
GDL CHAPULTEPEC,2023-02-22,33,29,4,0.12121
GDL CHAPULTEPEC,2023-02-23,54,52,2,0.03704
GDL CHAPULTEPEC,2023-02-24,42,40,2,0.04762
GDL CHAPULTEPEC,2023-02-25,41,39,2,0.04878
GDL CHAPULTEPEC,2023-02-26,25,24,1,0.04
GDL CHAPULTEPEC,2023-02-27,62,60,2,0.03226
GDL CHAPULTEPEC,2023-02-28,69,67,2,0.02899
GDL CHAPULTEPEC,2023-03-01,81,77,4,0.04938
GDL CHAPULTEPEC,2023-03-02,41,41,0,0
GDL CHAPULTEPEC,2023-03-03,77,76,1,0.01299
GDL CHAPULTEPEC,2023-03-04,63,61,2,0.03175
GDL CHAPULTEPEC,2023-03-05,45,44,1,0.02222
GDL CHAPULTEPEC,2023-03-07,47,43,4,0.08511
GDL CHAPULTEPEC,2023-03-08,59,55,4,0.0678
GDL CHAPULTEPEC,2023-03-09,42,36,6,0.14286
GDL CHAPULTEPEC,2023-03-10,36,36,0,0
GDL CHAPULTEPEC,2023-03-11,43,34,9,0.2093
GDL CHAPULTEPEC,2023-03-12,22,18,4,0.18182
GDL CHAPULTEPEC,2023-03-13,43,42,1,0.02326
GDL CHAPULTEPEC,2023-03-14,53,32,21,0.39623
GDL CHAPULTEPEC,2023-03-15,45,42,3,0.06667
GDL CHAPULTEPEC,2023-03-16,37,37,0,0
GDL CHAPULTEPEC,2023-03-17,46,46,0,0
GDL CHAPULTEPEC,2023-03-18,47,45,2,0.04255
GDL CHAPULTEPEC,2023-03-19,21,21,0,0
GDL CHAPULTEPEC,2023-03-20,32,32,0,0
GDL COLOMOS,2023-01-01,15,14,1,0.06667
GDL COLOMOS,2023-01-02,49,33,16,0.32653
GDL COLOMOS,2023-01-03,73,56,17,0.23288
GDL COLOMOS,2023-01-04,74,49,25,0.33784
GDL COLOMOS,2023-01-05,112,94,18,0.16071
GDL COLOMOS,2023-01-06,89,74,15,0.16854
GDL COLOMOS,2023-01-07,79,65,14,0.17722
GDL COLOMOS,2023-01-08,42,36,6,0.14286
GDL COLOMOS,2023-01-09,77,54,23,0.2987
GDL COLOMOS,2023-01-10,65,54,11,0.16923
GDL COLOMOS,2023-01-11,116,92,24,0.2069
GDL COLOMOS,2023-01-12,66,54,12,0.18182
GDL COLOMOS,2023-01-13,71,55,16,0.22535
GDL COLOMOS,2023-01-14,94,66,28,0.29787
GDL COLOMOS,2023-01-15,51,42,9,0.17647
GDL COLOMOS,2023-01-16,83,76,7,0.08434
GDL COLOMOS,2023-01-17,101,73,28,0.27723
GDL COLOMOS,2023-01-18,89,58,31,0.34831
GDL COLOMOS,2023-01-19,68,59,9,0.13235
GDL COLOMOS,2023-01-20,144,111,33,0.22917
GDL COLOMOS,2023-01-21,293,160,133,0.45392
GDL COLOMOS,2023-01-22,71,57,14,0.19718
GDL COLOMOS,2023-01-23,178,171,7,0.03933
GDL COLOMOS,2023-01-24,238,230,8,0.03361
GDL COLOMOS,2023-01-25,210,165,45,0.21429
GDL COLOMOS,2023-01-26,309,246,63,0.20388
GDL COLOMOS,2023-01-27,204,133,71,0.34804
GDL COLOMOS,2023-01-28,195,132,63,0.32308
GDL COLOMOS,2023-01-29,57,40,17,0.29825
GDL COLOMOS,2023-01-30,206,148,58,0.28155
GDL COLOMOS,2023-01-31,373,292,81,0.21716
GDL COLOMOS,2023-02-02,292,179,113,0.38699
GDL COLOMOS,2023-02-03,220,190,30,0.13636
GDL COLOMOS,2023-02-04,246,173,73,0.29675
GDL COLOMOS,2023-02-05,92,56,36,0.3913
GDL COLOMOS,2023-02-06,212,121,91,0.42925
GDL COLOMOS,2023-02-07,238,221,17,0.07143
GDL COLOMOS,2023-02-08,142,103,39,0.27465
GDL COLOMOS,2023-02-09,198,63,135,0.68182
GDL COLOMOS,2023-02-10,126,93,33,0.2619
GDL COLOMOS,2023-02-11,159,130,29,0.18239
GDL COLOMOS,2023-02-12,57,55,2,0.03509
GDL COLOMOS,2023-02-13,237,114,123,0.51899
GDL COLOMOS,2023-02-14,143,119,24,0.16783
GDL COLOMOS,2023-02-15,156,138,18,0.11538
GDL COLOMOS,2023-02-16,279,265,14,0.05018
GDL COLOMOS,2023-02-17,106,73,33,0.31132
GDL COLOMOS,2023-02-18,371,241,130,0.3504
GDL COLOMOS,2023-02-19,115,94,21,0.18261
GDL COLOMOS,2023-02-20,85,77,8,0.09412
GDL COLOMOS,2023-02-21,289,99,190,0.65744
GDL COLOMOS,2023-02-22,127,100,27,0.2126
GDL COLOMOS,2023-02-23,98,81,17,0.17347
GDL COLOMOS,2023-02-24,148,120,28,0.18919
GDL COLOMOS,2023-02-25,118,98,20,0.16949
GDL COLOMOS,2023-02-26,11,6,5,0.45455
GDL COLOMOS,2023-02-27,95,83,12,0.12632
GDL COLOMOS,2023-02-28,174,143,31,0.17816
GDL COLOMOS,2023-03-01,91,74,17,0.18681
GDL COLOMOS,2023-03-02,123,110,13,0.10569
GDL COLOMOS,2023-03-03,111,100,11,0.0991
GDL COLOMOS,2023-03-04,278,265,13,0.04676
GDL COLOMOS,2023-03-05,79,47,32,0.40506
GDL COLOMOS,2023-03-07,137,121,16,0.11679
GDL COLOMOS,2023-03-08,96,85,11,0.11458
GDL COLOMOS,2023-03-09,63,46,17,0.26984
GDL COLOMOS,2023-03-10,67,50,17,0.25373
GDL COLOMOS,2023-03-11,107,88,19,0.17757
GDL COLOMOS,2023-03-12,55,54,1,0.01818
GDL COLOMOS,2023-03-13,77,64,13,0.16883
GDL COLOMOS,2023-03-14,108,92,16,0.14815
GDL COLOMOS,2023-03-15,125,102,23,0.184
GDL COLOMOS,2023-03-16,92,82,10,0.1087
GDL COLOMOS,2023-03-17,105,94,11,0.10476
GDL COLOMOS,2023-03-18,107,101,6,0.05607
GDL COLOMOS,2023-03-19,49,48,1,0.02041
GDL COLOMOS,2023-03-20,67,65,2,0.02985
GDL EL SALTO,2023-01-01,14,14,0,0
GDL EL SALTO,2023-01-02,26,23,3,0.11538
GDL EL SALTO,2023-01-03,28,26,2,0.07143
GDL EL SALTO,2023-01-04,60,60,0,0
GDL EL SALTO,2023-01-05,22,22,0,0
GDL EL SALTO,2023-01-06,40,40,0,0
GDL EL SALTO,2023-01-07,63,57,6,0.09524
GDL EL SALTO,2023-01-08,39,37,2,0.05128
GDL EL SALTO,2023-01-09,31,31,0,0
GDL EL SALTO,2023-01-10,54,53,1,0.01852
GDL EL SALTO,2023-01-11,36,29,7,0.19444
GDL EL SALTO,2023-01-12,33,28,5,0.15152
GDL EL SALTO,2023-01-13,49,46,3,0.06122
GDL EL SALTO,2023-01-14,52,48,4,0.07692
GDL EL SALTO,2023-01-15,19,14,5,0.26316
GDL EL SALTO,2023-01-16,31,31,0,0
GDL EL SALTO,2023-01-17,38,34,4,0.10526
GDL EL SALTO,2023-01-18,32,30,2,0.0625
GDL EL SALTO,2023-01-19,30,29,1,0.03333
GDL EL SALTO,2023-01-20,35,33,2,0.05714
GDL EL SALTO,2023-01-21,40,32,8,0.2
GDL EL SALTO,2023-01-22,68,67,1,0.01471
GDL EL SALTO,2023-01-23,19,16,3,0.15789
GDL EL SALTO,2023-01-24,30,24,6,0.2
GDL EL SALTO,2023-01-25,48,45,3,0.0625
GDL EL SALTO,2023-01-26,27,26,1,0.03704
GDL EL SALTO,2023-01-27,33,26,7,0.21212
GDL EL SALTO,2023-01-28,51,48,3,0.05882
GDL EL SALTO,2023-01-29,36,31,5,0.13889
GDL EL SALTO,2023-01-30,34,34,0,0
GDL EL SALTO,2023-01-31,59,58,1,0.01695
GDL EL SALTO,2023-02-02,60,56,4,0.06667
GDL EL SALTO,2023-02-03,48,39,9,0.1875
GDL EL SALTO,2023-02-04,83,80,3,0.03614
GDL EL SALTO,2023-02-05,54,47,7,0.12963
GDL EL SALTO,2023-02-06,54,44,10,0.18519
GDL EL SALTO,2023-02-07,52,52,0,0
GDL EL SALTO,2023-02-08,47,44,3,0.06383
GDL EL SALTO,2023-02-09,34,34,0,0
GDL EL SALTO,2023-02-10,62,56,6,0.09677
GDL EL SALTO,2023-02-11,53,50,3,0.0566
GDL EL SALTO,2023-02-12,26,26,0,0
GDL EL SALTO,2023-02-13,29,29,0,0
GDL EL SALTO,2023-02-14,18,18,0,0
GDL EL SALTO,2023-02-15,50,47,3,0.06
GDL EL SALTO,2023-02-16,42,38,4,0.09524
GDL EL SALTO,2023-02-17,30,29,1,0.03333
GDL EL SALTO,2023-02-18,33,30,3,0.09091
GDL EL SALTO,2023-02-19,34,34,0,0
GDL EL SALTO,2023-02-20,12,11,1,0.08333
GDL EL SALTO,2023-02-21,39,34,5,0.12821
GDL EL SALTO,2023-02-22,25,24,1,0.04
GDL EL SALTO,2023-02-23,26,24,2,0.07692
GDL EL SALTO,2023-02-24,31,30,1,0.03226
GDL EL SALTO,2023-02-25,60,52,8,0.13333
GDL EL SALTO,2023-02-26,36,32,4,0.11111
GDL EL SALTO,2023-02-27,29,29,0,0
GDL EL SALTO,2023-02-28,42,38,4,0.09524
GDL EL SALTO,2023-03-01,35,33,2,0.05714
GDL EL SALTO,2023-03-02,34,34,0,0
GDL EL SALTO,2023-03-03,33,33,0,0
GDL EL SALTO,2023-03-04,54,51,3,0.05556
GDL EL SALTO,2023-03-05,29,29,0,0
GDL EL SALTO,2023-03-07,41,41,0,0
GDL EL SALTO,2023-03-08,31,28,3,0.09677
GDL EL SALTO,2023-03-09,50,44,6,0.12
GDL EL SALTO,2023-03-10,27,25,2,0.07407
GDL EL SALTO,2023-03-11,37,35,2,0.05405
GDL EL SALTO,2023-03-12,24,22,2,0.08333
GDL EL SALTO,2023-03-13,23,22,1,0.04348
GDL EL SALTO,2023-03-14,41,41,0,0
GDL EL SALTO,2023-03-15,26,25,1,0.03846
GDL EL SALTO,2023-03-16,36,36,0,0
GDL EL SALTO,2023-03-17,28,28,0,0
GDL EL SALTO,2023-03-18,37,31,6,0.16216
GDL EL SALTO,2023-03-19,52,52,0,0
GDL EL SALTO,2023-03-20,52,51,1,0.01923
GDL EL TAPATIO,2023-01-01,21,20,1,0.04762
GDL EL TAPATIO,2023-01-02,46,46,0,0
GDL EL TAPATIO,2023-01-03,56,53,3,0.05357
GDL EL TAPATIO,2023-01-04,58,49,9,0.15517
GDL EL TAPATIO,2023-01-05,71,62,9,0.12676
GDL EL TAPATIO,2023-01-06,55,52,3,0.05455
GDL EL TAPATIO,2023-01-07,82,64,18,0.21951
GDL EL TAPATIO,2023-01-08,69,61,8,0.11594
GDL EL TAPATIO,2023-01-09,42,38,4,0.09524
GDL EL TAPATIO,2023-01-10,45,36,9,0.2
GDL EL TAPATIO,2023-01-11,62,47,15,0.24194
GDL EL TAPATIO,2023-01-12,45,34,11,0.24444
GDL EL TAPATIO,2023-01-13,45,44,1,0.02222
GDL EL TAPATIO,2023-01-14,50,46,4,0.08
GDL EL TAPATIO,2023-01-15,55,55,0,0
GDL EL TAPATIO,2023-01-16,58,58,0,0
GDL EL TAPATIO,2023-01-17,29,29,0,0
GDL EL TAPATIO,2023-01-18,51,50,1,0.01961
GDL EL TAPATIO,2023-01-19,42,41,1,0.02381
GDL EL TAPATIO,2023-01-20,104,93,11,0.10577
GDL EL TAPATIO,2023-01-21,153,152,1,0.00654
GDL EL TAPATIO,2023-01-22,112,111,1,0.00893
GDL EL TAPATIO,2023-01-23,207,204,3,0.01449
GDL EL TAPATIO,2023-01-24,160,157,3,0.01875
GDL EL TAPATIO,2023-01-25,469,448,21,0.04478
GDL EL TAPATIO,2023-01-26,74,70,4,0.05405
GDL EL TAPATIO,2023-01-27,56,56,0,0
GDL EL TAPATIO,2023-01-28,172,169,3,0.01744
GDL EL TAPATIO,2023-01-29,336,335,1,0.00298
GDL EL TAPATIO,2023-01-30,123,121,2,0.01626
GDL EL TAPATIO,2023-01-31,200,199,1,0.005
GDL EL TAPATIO,2023-02-02,186,186,0,0
GDL EL TAPATIO,2023-02-03,70,67,3,0.04286
GDL EL TAPATIO,2023-02-04,216,215,1,0.00463
GDL EL TAPATIO,2023-02-05,237,233,4,0.01688
GDL EL TAPATIO,2023-02-06,110,76,34,0.30909
GDL EL TAPATIO,2023-02-07,132,131,1,0.00758
GDL EL TAPATIO,2023-02-08,103,96,7,0.06796
GDL EL TAPATIO,2023-02-09,82,38,44,0.53659
GDL EL TAPATIO,2023-02-10,101,93,8,0.07921
GDL EL TAPATIO,2023-02-11,230,227,3,0.01304
GDL EL TAPATIO,2023-02-12,80,80,0,0
GDL EL TAPATIO,2023-02-13,68,63,5,0.07353
GDL EL TAPATIO,2023-02-14,79,70,9,0.11392
GDL EL TAPATIO,2023-02-15,49,29,20,0.40816
GDL EL TAPATIO,2023-02-16,121,119,2,0.01653
GDL EL TAPATIO,2023-02-17,143,137,6,0.04196
GDL EL TAPATIO,2023-02-18,93,82,11,0.11828
GDL EL TAPATIO,2023-02-19,73,58,15,0.20548
GDL EL TAPATIO,2023-02-20,34,31,3,0.08824
GDL EL TAPATIO,2023-02-21,188,184,4,0.02128
GDL EL TAPATIO,2023-02-22,131,123,8,0.06107
GDL EL TAPATIO,2023-02-23,63,54,9,0.14286
GDL EL TAPATIO,2023-02-24,48,43,5,0.10417
GDL EL TAPATIO,2023-02-25,57,48,9,0.15789
GDL EL TAPATIO,2023-02-26,101,53,48,0.47525
GDL EL TAPATIO,2023-02-27,48,38,10,0.20833
GDL EL TAPATIO,2023-02-28,139,138,1,0.00719
GDL EL TAPATIO,2023-03-01,182,180,2,0.01099
GDL EL TAPATIO,2023-03-02,145,137,8,0.05517
GDL EL TAPATIO,2023-03-03,178,170,8,0.04494
GDL EL TAPATIO,2023-03-04,119,109,10,0.08403
GDL EL TAPATIO,2023-03-05,46,45,1,0.02174
GDL EL TAPATIO,2023-03-07,103,102,1,0.00971
GDL EL TAPATIO,2023-03-08,186,147,39,0.20968
GDL EL TAPATIO,2023-03-09,25,23,2,0.08
GDL EL TAPATIO,2023-03-10,78,78,0,0
GDL EL TAPATIO,2023-03-11,87,84,3,0.03448
GDL EL TAPATIO,2023-03-12,79,73,6,0.07595
GDL EL TAPATIO,2023-03-13,39,33,6,0.15385
GDL EL TAPATIO,2023-03-14,48,39,9,0.1875
GDL EL TAPATIO,2023-03-15,174,173,1,0.00575
GDL EL TAPATIO,2023-03-16,82,82,0,0
GDL EL TAPATIO,2023-03-17,137,137,0,0
GDL EL TAPATIO,2023-03-18,138,138,0,0
GDL EL TAPATIO,2023-03-19,67,67,0,0
GDL EL TAPATIO,2023-03-20,70,70,0,0
GDL ESTADIO,2023-01-01,16,10,6,0.375
GDL ESTADIO,2023-01-02,21,19,2,0.09524
GDL ESTADIO,2023-01-03,42,32,10,0.2381
GDL ESTADIO,2023-01-04,25,12,13,0.52
GDL ESTADIO,2023-01-05,42,27,15,0.35714
GDL ESTADIO,2023-01-06,32,23,9,0.28125
GDL ESTADIO,2023-01-07,50,42,8,0.16
GDL ESTADIO,2023-01-08,29,20,9,0.31034
GDL ESTADIO,2023-01-09,54,44,10,0.18519
GDL ESTADIO,2023-01-10,49,31,18,0.36735
GDL ESTADIO,2023-01-11,36,14,22,0.61111
GDL ESTADIO,2023-01-12,52,18,34,0.65385
GDL ESTADIO,2023-01-13,46,29,17,0.36957
GDL ESTADIO,2023-01-14,56,47,9,0.16071
GDL ESTADIO,2023-01-15,42,42,0,0
GDL ESTADIO,2023-01-16,54,48,6,0.11111
GDL ESTADIO,2023-01-17,35,24,11,0.31429
GDL ESTADIO,2023-01-18,32,31,1,0.03125
GDL ESTADIO,2023-01-19,35,30,5,0.14286
GDL ESTADIO,2023-01-20,32,28,4,0.125
GDL ESTADIO,2023-01-21,102,94,8,0.07843
GDL ESTADIO,2023-01-22,50,42,8,0.16
GDL ESTADIO,2023-01-23,97,75,22,0.2268
GDL ESTADIO,2023-01-24,51,43,8,0.15686
GDL ESTADIO,2023-01-25,59,46,13,0.22034
GDL ESTADIO,2023-01-26,63,54,9,0.14286
GDL ESTADIO,2023-01-27,99,97,2,0.0202
GDL ESTADIO,2023-01-28,56,51,5,0.08929
GDL ESTADIO,2023-01-29,50,44,6,0.12
GDL ESTADIO,2023-01-30,85,74,11,0.12941
GDL ESTADIO,2023-01-31,93,80,13,0.13978
GDL ESTADIO,2023-02-02,74,71,3,0.04054
GDL ESTADIO,2023-02-03,62,61,1,0.01613
GDL ESTADIO,2023-02-04,83,65,18,0.21687
GDL ESTADIO,2023-02-05,77,77,0,0
GDL ESTADIO,2023-02-06,64,54,10,0.15625
GDL ESTADIO,2023-02-07,75,69,6,0.08
GDL ESTADIO,2023-02-08,61,56,5,0.08197
GDL ESTADIO,2023-02-09,44,37,7,0.15909
GDL ESTADIO,2023-02-10,133,133,0,0
GDL ESTADIO,2023-02-11,39,32,7,0.17949
GDL ESTADIO,2023-02-12,33,23,10,0.30303
GDL ESTADIO,2023-02-13,149,59,90,0.60403
GDL ESTADIO,2023-02-14,74,64,10,0.13514
GDL ESTADIO,2023-02-15,41,38,3,0.07317
GDL ESTADIO,2023-02-16,82,63,19,0.23171
GDL ESTADIO,2023-02-17,35,27,8,0.22857
GDL ESTADIO,2023-02-18,64,62,2,0.03125
GDL ESTADIO,2023-02-19,49,45,4,0.08163
GDL ESTADIO,2023-02-20,37,35,2,0.05405
GDL ESTADIO,2023-02-21,58,38,20,0.34483
GDL ESTADIO,2023-02-22,42,33,9,0.21429
GDL ESTADIO,2023-02-23,43,30,13,0.30233
GDL ESTADIO,2023-02-24,45,36,9,0.2
GDL ESTADIO,2023-02-25,59,45,14,0.23729
GDL ESTADIO,2023-02-26,23,15,8,0.34783
GDL ESTADIO,2023-02-27,59,42,17,0.28814
GDL ESTADIO,2023-02-28,57,52,5,0.08772
GDL ESTADIO,2023-03-01,32,20,12,0.375
GDL ESTADIO,2023-03-02,48,45,3,0.0625
GDL ESTADIO,2023-03-03,44,42,2,0.04545
GDL ESTADIO,2023-03-04,42,38,4,0.09524
GDL ESTADIO,2023-03-05,63,63,0,0
GDL ESTADIO,2023-03-07,57,44,13,0.22807
GDL ESTADIO,2023-03-08,51,44,7,0.13725
GDL ESTADIO,2023-03-09,34,33,1,0.02941
GDL ESTADIO,2023-03-10,36,25,11,0.30556
GDL ESTADIO,2023-03-11,29,21,8,0.27586
GDL ESTADIO,2023-03-12,36,32,4,0.11111
GDL ESTADIO,2023-03-13,34,27,7,0.20588
GDL ESTADIO,2023-03-14,154,137,17,0.11039
GDL ESTADIO,2023-03-15,32,25,7,0.21875
GDL ESTADIO,2023-03-16,60,56,4,0.06667
GDL ESTADIO,2023-03-17,45,38,7,0.15556
GDL ESTADIO,2023-03-18,47,46,1,0.02128
GDL ESTADIO,2023-03-19,43,43,0,0
GDL ESTADIO,2023-03-20,52,50,2,0.03846
GDL LA PRIMAVERA,2023-01-01,14,12,2,0.14286
GDL LA PRIMAVERA,2023-01-02,73,31,42,0.57534
GDL LA PRIMAVERA,2023-01-03,42,27,15,0.35714
GDL LA PRIMAVERA,2023-01-04,47,28,19,0.40426
GDL LA PRIMAVERA,2023-01-05,51,21,30,0.58824
GDL LA PRIMAVERA,2023-01-06,40,26,14,0.35
GDL LA PRIMAVERA,2023-01-07,44,26,18,0.40909
GDL LA PRIMAVERA,2023-01-08,17,4,13,0.76471
GDL LA PRIMAVERA,2023-01-09,59,40,19,0.32203
GDL LA PRIMAVERA,2023-01-10,52,33,19,0.36538
GDL LA PRIMAVERA,2023-01-11,50,32,18,0.36
GDL LA PRIMAVERA,2023-01-12,46,24,22,0.47826
GDL LA PRIMAVERA,2023-01-13,63,28,35,0.55556
GDL LA PRIMAVERA,2023-01-14,59,36,23,0.38983
GDL LA PRIMAVERA,2023-01-15,32,20,12,0.375
GDL LA PRIMAVERA,2023-01-16,62,45,17,0.27419
GDL LA PRIMAVERA,2023-01-17,86,79,7,0.0814
GDL LA PRIMAVERA,2023-01-18,58,43,15,0.25862
GDL LA PRIMAVERA,2023-01-19,65,53,12,0.18462
GDL LA PRIMAVERA,2023-01-20,53,45,8,0.15094
GDL LA PRIMAVERA,2023-01-21,142,134,8,0.05634
GDL LA PRIMAVERA,2023-01-22,23,22,1,0.04348
GDL LA PRIMAVERA,2023-01-23,52,50,2,0.03846
GDL LA PRIMAVERA,2023-01-24,92,79,13,0.1413
GDL LA PRIMAVERA,2023-01-25,127,111,16,0.12598
GDL LA PRIMAVERA,2023-01-26,114,87,27,0.23684
GDL LA PRIMAVERA,2023-01-27,249,192,57,0.22892
GDL LA PRIMAVERA,2023-01-28,89,44,45,0.50562
GDL LA PRIMAVERA,2023-01-29,61,45,16,0.2623
GDL LA PRIMAVERA,2023-01-30,146,120,26,0.17808
GDL LA PRIMAVERA,2023-01-31,128,101,27,0.21094
GDL LA PRIMAVERA,2023-02-02,134,132,2,0.01493
GDL LA PRIMAVERA,2023-02-03,149,74,75,0.50336
GDL LA PRIMAVERA,2023-02-04,206,162,44,0.21359
GDL LA PRIMAVERA,2023-02-05,55,54,1,0.01818
GDL LA PRIMAVERA,2023-02-06,85,65,20,0.23529
GDL LA PRIMAVERA,2023-02-07,86,31,55,0.63953
GDL LA PRIMAVERA,2023-02-08,168,84,84,0.5
GDL LA PRIMAVERA,2023-02-09,84,75,9,0.10714
GDL LA PRIMAVERA,2023-02-10,99,76,23,0.23232
GDL LA PRIMAVERA,2023-02-11,130,111,19,0.14615
GDL LA PRIMAVERA,2023-02-12,77,57,20,0.25974
GDL LA PRIMAVERA,2023-02-13,140,108,32,0.22857
GDL LA PRIMAVERA,2023-02-14,138,89,49,0.35507
GDL LA PRIMAVERA,2023-02-15,150,135,15,0.1
GDL LA PRIMAVERA,2023-02-16,96,71,25,0.26042
GDL LA PRIMAVERA,2023-02-17,123,106,17,0.13821
GDL LA PRIMAVERA,2023-02-18,58,52,6,0.10345
GDL LA PRIMAVERA,2023-02-19,86,77,9,0.10465
GDL LA PRIMAVERA,2023-02-20,115,87,28,0.24348
GDL LA PRIMAVERA,2023-02-21,100,77,23,0.23
GDL LA PRIMAVERA,2023-02-22,89,82,7,0.07865
GDL LA PRIMAVERA,2023-02-23,62,29,33,0.53226
GDL LA PRIMAVERA,2023-02-24,58,40,18,0.31034
GDL LA PRIMAVERA,2023-02-25,93,92,1,0.01075
GDL LA PRIMAVERA,2023-02-26,43,28,15,0.34884
GDL LA PRIMAVERA,2023-02-27,46,38,8,0.17391
GDL LA PRIMAVERA,2023-02-28,41,41,0,0
GDL LA PRIMAVERA,2023-03-01,113,106,7,0.06195
GDL LA PRIMAVERA,2023-03-02,93,63,30,0.32258
GDL LA PRIMAVERA,2023-03-03,66,61,5,0.07576
GDL LA PRIMAVERA,2023-03-04,112,63,49,0.4375
GDL LA PRIMAVERA,2023-03-05,68,61,7,0.10294
GDL LA PRIMAVERA,2023-03-07,102,83,19,0.18627
GDL LA PRIMAVERA,2023-03-08,60,52,8,0.13333
GDL LA PRIMAVERA,2023-03-09,40,31,9,0.225
GDL LA PRIMAVERA,2023-03-10,77,62,15,0.19481
GDL LA PRIMAVERA,2023-03-11,69,46,23,0.33333
GDL LA PRIMAVERA,2023-03-12,22,22,0,0
GDL LA PRIMAVERA,2023-03-13,53,44,9,0.16981
GDL LA PRIMAVERA,2023-03-14,83,62,21,0.25301
GDL LA PRIMAVERA,2023-03-15,76,65,11,0.14474
GDL LA PRIMAVERA,2023-03-16,49,45,4,0.08163
GDL LA PRIMAVERA,2023-03-17,52,42,10,0.19231
GDL LA PRIMAVERA,2023-03-18,56,45,11,0.19643
GDL LA PRIMAVERA,2023-03-19,28,26,2,0.07143
GDL LA PRIMAVERA,2023-03-20,32,29,3,0.09375
GDL LAZARO CARDENAS,2023-01-01,10,10,0,0
GDL LAZARO CARDENAS,2023-01-02,41,37,4,0.09756
GDL LAZARO CARDENAS,2023-01-03,64,57,7,0.10938
GDL LAZARO CARDENAS,2023-01-04,59,59,0,0
GDL LAZARO CARDENAS,2023-01-05,61,58,3,0.04918
GDL LAZARO CARDENAS,2023-01-06,67,67,0,0
GDL LAZARO CARDENAS,2023-01-07,61,61,0,0
GDL LAZARO CARDENAS,2023-01-08,51,51,0,0
GDL LAZARO CARDENAS,2023-01-09,42,42,0,0
GDL LAZARO CARDENAS,2023-01-10,58,58,0,0
GDL LAZARO CARDENAS,2023-01-11,83,81,2,0.0241
GDL LAZARO CARDENAS,2023-01-12,30,30,0,0
GDL LAZARO CARDENAS,2023-01-13,75,67,8,0.10667
GDL LAZARO CARDENAS,2023-01-14,114,104,10,0.08772
GDL LAZARO CARDENAS,2023-01-15,37,36,1,0.02703
GDL LAZARO CARDENAS,2023-01-16,81,81,0,0
GDL LAZARO CARDENAS,2023-01-17,66,66,0,0
GDL LAZARO CARDENAS,2023-01-18,84,81,3,0.03571
GDL LAZARO CARDENAS,2023-01-19,52,51,1,0.01923
GDL LAZARO CARDENAS,2023-01-20,69,69,0,0
GDL LAZARO CARDENAS,2023-01-21,35,35,0,0
GDL LAZARO CARDENAS,2023-01-22,83,83,0,0
GDL LAZARO CARDENAS,2023-01-23,141,137,4,0.02837
GDL LAZARO CARDENAS,2023-01-24,137,114,23,0.16788
GDL LAZARO CARDENAS,2023-01-25,157,102,55,0.35032
GDL LAZARO CARDENAS,2023-01-26,187,186,1,0.00535
GDL LAZARO CARDENAS,2023-01-27,166,166,0,0
GDL LAZARO CARDENAS,2023-01-28,171,170,1,0.00585
GDL LAZARO CARDENAS,2023-01-29,42,33,9,0.21429
GDL LAZARO CARDENAS,2023-01-30,192,191,1,0.00521
GDL LAZARO CARDENAS,2023-01-31,245,244,1,0.00408
GDL LAZARO CARDENAS,2023-02-02,337,329,8,0.02374
GDL LAZARO CARDENAS,2023-02-03,47,47,0,0
GDL LAZARO CARDENAS,2023-02-04,53,50,3,0.0566
GDL LAZARO CARDENAS,2023-02-05,27,23,4,0.14815
GDL LAZARO CARDENAS,2023-02-06,132,124,8,0.06061
GDL LAZARO CARDENAS,2023-02-07,105,105,0,0
GDL LAZARO CARDENAS,2023-02-08,253,253,0,0
GDL LAZARO CARDENAS,2023-02-09,103,103,0,0
GDL LAZARO CARDENAS,2023-02-10,60,60,0,0
GDL LAZARO CARDENAS,2023-02-11,142,142,0,0
GDL LAZARO CARDENAS,2023-02-12,25,25,0,0
GDL LAZARO CARDENAS,2023-02-13,67,63,4,0.0597
GDL LAZARO CARDENAS,2023-02-14,186,185,1,0.00538
GDL LAZARO CARDENAS,2023-02-15,170,143,27,0.15882
GDL LAZARO CARDENAS,2023-02-16,59,59,0,0
GDL LAZARO CARDENAS,2023-02-17,104,104,0,0
GDL LAZARO CARDENAS,2023-02-18,116,116,0,0
GDL LAZARO CARDENAS,2023-02-19,41,41,0,0
GDL LAZARO CARDENAS,2023-02-20,154,150,4,0.02597
GDL LAZARO CARDENAS,2023-02-21,75,71,4,0.05333
GDL LAZARO CARDENAS,2023-02-22,49,49,0,0
GDL LAZARO CARDENAS,2023-02-23,53,53,0,0
GDL LAZARO CARDENAS,2023-02-24,85,85,0,0
GDL LAZARO CARDENAS,2023-02-25,73,71,2,0.0274
GDL LAZARO CARDENAS,2023-02-26,21,21,0,0
GDL LAZARO CARDENAS,2023-02-27,41,41,0,0
GDL LAZARO CARDENAS,2023-02-28,68,56,12,0.17647
GDL LAZARO CARDENAS,2023-03-01,78,78,0,0
GDL LAZARO CARDENAS,2023-03-02,67,67,0,0
GDL LAZARO CARDENAS,2023-03-03,50,49,1,0.02
GDL LAZARO CARDENAS,2023-03-04,49,43,6,0.12245
GDL LAZARO CARDENAS,2023-03-05,24,24,0,0
GDL LAZARO CARDENAS,2023-03-07,47,47,0,0
GDL LAZARO CARDENAS,2023-03-08,62,39,23,0.37097
GDL LAZARO CARDENAS,2023-03-09,24,24,0,0
GDL LAZARO CARDENAS,2023-03-10,44,41,3,0.06818
GDL LAZARO CARDENAS,2023-03-11,48,43,5,0.10417
GDL LAZARO CARDENAS,2023-03-12,33,31,2,0.06061
GDL LAZARO CARDENAS,2023-03-13,67,60,7,0.10448
GDL LAZARO CARDENAS,2023-03-14,51,44,7,0.13725
GDL LAZARO CARDENAS,2023-03-15,64,64,0,0
GDL LAZARO CARDENAS,2023-03-16,54,54,0,0
GDL LAZARO CARDENAS,2023-03-17,49,46,3,0.06122
GDL LAZARO CARDENAS,2023-03-18,60,58,2,0.03333
GDL LAZARO CARDENAS,2023-03-19,51,51,0,0
GDL LAZARO CARDENAS,2023-03-20,45,45,0,0
GDL LOPEZ MATEOS,2023-01-01,7,7,0,0
GDL LOPEZ MATEOS,2023-01-02,8,8,0,0
GDL LOPEZ MATEOS,2023-01-03,45,38,7,0.15556
GDL LOPEZ MATEOS,2023-01-04,52,51,1,0.01923
GDL LOPEZ MATEOS,2023-01-05,67,51,16,0.23881
GDL LOPEZ MATEOS,2023-01-06,34,34,0,0
GDL LOPEZ MATEOS,2023-01-07,38,35,3,0.07895
GDL LOPEZ MATEOS,2023-01-08,28,28,0,0
GDL LOPEZ MATEOS,2023-01-09,44,44,0,0
GDL LOPEZ MATEOS,2023-01-10,44,42,2,0.04545
GDL LOPEZ MATEOS,2023-01-11,48,40,8,0.16667
GDL LOPEZ MATEOS,2023-01-12,36,36,0,0
GDL LOPEZ MATEOS,2023-01-13,55,50,5,0.09091
GDL LOPEZ MATEOS,2023-01-14,64,59,5,0.07812
GDL LOPEZ MATEOS,2023-01-15,20,20,0,0
GDL LOPEZ MATEOS,2023-01-16,68,68,0,0
GDL LOPEZ MATEOS,2023-01-17,40,34,6,0.15
GDL LOPEZ MATEOS,2023-01-18,65,56,9,0.13846
GDL LOPEZ MATEOS,2023-01-19,67,65,2,0.02985
GDL LOPEZ MATEOS,2023-01-20,45,45,0,0
GDL LOPEZ MATEOS,2023-01-21,55,55,0,0
GDL LOPEZ MATEOS,2023-01-22,59,59,0,0
GDL LOPEZ MATEOS,2023-01-23,70,70,0,0
GDL LOPEZ MATEOS,2023-01-24,95,92,3,0.03158
GDL LOPEZ MATEOS,2023-01-25,103,100,3,0.02913
GDL LOPEZ MATEOS,2023-01-26,91,85,6,0.06593
GDL LOPEZ MATEOS,2023-01-27,83,73,10,0.12048
GDL LOPEZ MATEOS,2023-01-28,68,60,8,0.11765
GDL LOPEZ MATEOS,2023-01-29,82,79,3,0.03659
GDL LOPEZ MATEOS,2023-01-30,100,94,6,0.06
GDL LOPEZ MATEOS,2023-01-31,198,188,10,0.05051
GDL LOPEZ MATEOS,2023-02-02,68,59,9,0.13235
GDL LOPEZ MATEOS,2023-02-03,73,62,11,0.15068
GDL LOPEZ MATEOS,2023-02-04,91,91,0,0
GDL LOPEZ MATEOS,2023-02-05,18,18,0,0
GDL LOPEZ MATEOS,2023-02-06,70,70,0,0
GDL LOPEZ MATEOS,2023-02-07,64,64,0,0
GDL LOPEZ MATEOS,2023-02-08,84,84,0,0
GDL LOPEZ MATEOS,2023-02-09,107,84,23,0.21495
GDL LOPEZ MATEOS,2023-02-10,97,81,16,0.16495
GDL LOPEZ MATEOS,2023-02-11,148,129,19,0.12838
GDL LOPEZ MATEOS,2023-02-12,363,363,0,0
GDL LOPEZ MATEOS,2023-02-13,327,304,23,0.07034
GDL LOPEZ MATEOS,2023-02-14,218,218,0,0
GDL LOPEZ MATEOS,2023-02-15,222,216,6,0.02703
GDL LOPEZ MATEOS,2023-02-16,63,61,2,0.03175
GDL LOPEZ MATEOS,2023-02-17,69,67,2,0.02899
GDL LOPEZ MATEOS,2023-02-18,198,197,1,0.00505
GDL LOPEZ MATEOS,2023-02-19,123,123,0,0
GDL LOPEZ MATEOS,2023-02-20,203,203,0,0
GDL LOPEZ MATEOS,2023-02-21,88,88,0,0
GDL LOPEZ MATEOS,2023-02-22,32,29,3,0.09375
GDL LOPEZ MATEOS,2023-02-23,66,56,10,0.15152
GDL LOPEZ MATEOS,2023-02-24,63,62,1,0.01587
GDL LOPEZ MATEOS,2023-02-25,117,115,2,0.01709
GDL LOPEZ MATEOS,2023-02-26,310,227,83,0.26774
GDL LOPEZ MATEOS,2023-02-27,49,49,0,0
GDL LOPEZ MATEOS,2023-02-28,110,107,3,0.02727
GDL LOPEZ MATEOS,2023-03-01,113,108,5,0.04425
GDL LOPEZ MATEOS,2023-03-02,91,91,0,0
GDL LOPEZ MATEOS,2023-03-03,121,117,4,0.03306
GDL LOPEZ MATEOS,2023-03-04,131,128,3,0.0229
GDL LOPEZ MATEOS,2023-03-05,32,27,5,0.15625
GDL LOPEZ MATEOS,2023-03-07,94,87,7,0.07447
GDL LOPEZ MATEOS,2023-03-08,70,70,0,0
GDL LOPEZ MATEOS,2023-03-09,191,155,36,0.18848
GDL LOPEZ MATEOS,2023-03-10,43,40,3,0.06977
GDL LOPEZ MATEOS,2023-03-11,96,90,6,0.0625
GDL LOPEZ MATEOS,2023-03-12,117,115,2,0.01709
GDL LOPEZ MATEOS,2023-03-13,42,42,0,0
GDL LOPEZ MATEOS,2023-03-14,79,77,2,0.02532
GDL LOPEZ MATEOS,2023-03-15,63,63,0,0
GDL LOPEZ MATEOS,2023-03-16,53,53,0,0
GDL LOPEZ MATEOS,2023-03-17,129,124,5,0.03876
GDL LOPEZ MATEOS,2023-03-18,112,109,3,0.02679
GDL LOPEZ MATEOS,2023-03-19,809,255,554,0.6848
GDL LOPEZ MATEOS,2023-03-20,36,36,0,0
GUADALUPE TEPEYAC,2023-01-01,5,4,1,0.2
GUADALUPE TEPEYAC,2023-01-02,37,33,4,0.10811
GUADALUPE TEPEYAC,2023-01-03,22,21,1,0.04545
GUADALUPE TEPEYAC,2023-01-04,44,42,2,0.04545
GUADALUPE TEPEYAC,2023-01-05,37,37,0,0
GUADALUPE TEPEYAC,2023-01-06,42,42,0,0
GUADALUPE TEPEYAC,2023-01-07,41,37,4,0.09756
GUADALUPE TEPEYAC,2023-01-08,44,42,2,0.04545
GUADALUPE TEPEYAC,2023-01-09,57,54,3,0.05263
GUADALUPE TEPEYAC,2023-01-10,76,68,8,0.10526
GUADALUPE TEPEYAC,2023-01-11,109,104,5,0.04587
GUADALUPE TEPEYAC,2023-01-12,52,51,1,0.01923
GUADALUPE TEPEYAC,2023-01-13,86,82,4,0.04651
GUADALUPE TEPEYAC,2023-01-14,53,52,1,0.01887
GUADALUPE TEPEYAC,2023-01-15,69,67,2,0.02899
GUADALUPE TEPEYAC,2023-01-16,104,60,44,0.42308
GUADALUPE TEPEYAC,2023-01-17,129,113,16,0.12403
GUADALUPE TEPEYAC,2023-01-18,109,109,0,0
GUADALUPE TEPEYAC,2023-01-19,138,117,21,0.15217
GUADALUPE TEPEYAC,2023-01-20,123,101,22,0.17886
GUADALUPE TEPEYAC,2023-01-21,212,178,34,0.16038
GUADALUPE TEPEYAC,2023-01-22,195,194,1,0.00513
GUADALUPE TEPEYAC,2023-01-23,112,87,25,0.22321
GUADALUPE TEPEYAC,2023-01-24,140,129,11,0.07857
GUADALUPE TEPEYAC,2023-01-25,149,145,4,0.02685
GUADALUPE TEPEYAC,2023-01-26,152,148,4,0.02632
GUADALUPE TEPEYAC,2023-01-27,108,87,21,0.19444
GUADALUPE TEPEYAC,2023-01-28,199,195,4,0.0201
GUADALUPE TEPEYAC,2023-01-29,131,127,4,0.03053
GUADALUPE TEPEYAC,2023-01-30,136,132,4,0.02941
GUADALUPE TEPEYAC,2023-01-31,233,233,0,0
GUADALUPE TEPEYAC,2023-02-02,88,65,23,0.26136
GUADALUPE TEPEYAC,2023-02-03,167,159,8,0.0479
GUADALUPE TEPEYAC,2023-02-04,271,269,2,0.00738
GUADALUPE TEPEYAC,2023-02-05,94,93,1,0.01064
GUADALUPE TEPEYAC,2023-02-06,174,123,51,0.2931
GUADALUPE TEPEYAC,2023-02-07,143,136,7,0.04895
GUADALUPE TEPEYAC,2023-02-08,112,112,0,0
GUADALUPE TEPEYAC,2023-02-09,171,162,9,0.05263
GUADALUPE TEPEYAC,2023-02-10,140,128,12,0.08571
GUADALUPE TEPEYAC,2023-02-11,185,184,1,0.00541
GUADALUPE TEPEYAC,2023-02-12,68,66,2,0.02941
GUADALUPE TEPEYAC,2023-02-13,115,114,1,0.0087
GUADALUPE TEPEYAC,2023-02-14,170,135,35,0.20588
GUADALUPE TEPEYAC,2023-02-15,77,57,20,0.25974
GUADALUPE TEPEYAC,2023-02-16,233,230,3,0.01288
GUADALUPE TEPEYAC,2023-02-17,174,174,0,0
GUADALUPE TEPEYAC,2023-02-18,194,187,7,0.03608
GUADALUPE TEPEYAC,2023-02-19,170,170,0,0
GUADALUPE TEPEYAC,2023-02-20,122,120,2,0.01639
GUADALUPE TEPEYAC,2023-02-21,97,85,12,0.12371
GUADALUPE TEPEYAC,2023-02-22,54,50,4,0.07407
GUADALUPE TEPEYAC,2023-02-23,55,47,8,0.14545
GUADALUPE TEPEYAC,2023-02-24,57,46,11,0.19298
GUADALUPE TEPEYAC,2023-02-25,168,158,10,0.05952
GUADALUPE TEPEYAC,2023-02-26,62,62,0,0
GUADALUPE TEPEYAC,2023-02-27,150,142,8,0.05333
GUADALUPE TEPEYAC,2023-02-28,122,112,10,0.08197
GUADALUPE TEPEYAC,2023-03-01,51,47,4,0.07843
GUADALUPE TEPEYAC,2023-03-02,144,138,6,0.04167
GUADALUPE TEPEYAC,2023-03-03,53,50,3,0.0566
GUADALUPE TEPEYAC,2023-03-04,94,94,0,0
GUADALUPE TEPEYAC,2023-03-05,159,159,0,0
GUADALUPE TEPEYAC,2023-03-07,108,106,2,0.01852
GUADALUPE TEPEYAC,2023-03-08,134,122,12,0.08955
GUADALUPE TEPEYAC,2023-03-09,77,77,0,0
GUADALUPE TEPEYAC,2023-03-10,46,32,14,0.30435
GUADALUPE TEPEYAC,2023-03-11,109,108,1,0.00917
GUADALUPE TEPEYAC,2023-03-12,82,73,9,0.10976
GUADALUPE TEPEYAC,2023-03-13,83,83,0,0
GUADALUPE TEPEYAC,2023-03-14,73,69,4,0.05479
GUADALUPE TEPEYAC,2023-03-15,71,71,0,0
GUADALUPE TEPEYAC,2023-03-16,63,58,5,0.07937
GUADALUPE TEPEYAC,2023-03-17,77,68,9,0.11688
GUADALUPE TEPEYAC,2023-03-18,143,141,2,0.01399
GUADALUPE TEPEYAC,2023-03-19,95,95,0,0
GUADALUPE TEPEYAC,2023-03-20,108,104,4,0.03704
GUANAJUATO,2023-01-01,3,3,0,0
GUANAJUATO,2023-01-02,47,47,0,0
GUANAJUATO,2023-01-03,40,37,3,0.075
GUANAJUATO,2023-01-04,30,30,0,0
GUANAJUATO,2023-01-05,29,29,0,0
GUANAJUATO,2023-01-06,42,42,0,0
GUANAJUATO,2023-01-07,42,39,3,0.07143
GUANAJUATO,2023-01-08,29,23,6,0.2069
GUANAJUATO,2023-01-09,30,28,2,0.06667
GUANAJUATO,2023-01-10,52,52,0,0
GUANAJUATO,2023-01-11,40,40,0,0
GUANAJUATO,2023-01-12,37,37,0,0
GUANAJUATO,2023-01-13,30,30,0,0
GUANAJUATO,2023-01-14,58,58,0,0
GUANAJUATO,2023-01-15,25,25,0,0
GUANAJUATO,2023-01-16,11,11,0,0
GUANAJUATO,2023-01-17,49,49,0,0
GUANAJUATO,2023-01-18,19,19,0,0
GUANAJUATO,2023-01-19,36,36,0,0
GUANAJUATO,2023-01-20,32,32,0,0
GUANAJUATO,2023-01-21,26,26,0,0
GUANAJUATO,2023-01-22,40,40,0,0
GUANAJUATO,2023-01-23,47,47,0,0
GUANAJUATO,2023-01-24,41,39,2,0.04878
GUANAJUATO,2023-01-25,36,36,0,0
GUANAJUATO,2023-01-26,34,34,0,0
GUANAJUATO,2023-01-27,33,33,0,0
GUANAJUATO,2023-01-28,62,62,0,0
GUANAJUATO,2023-01-29,24,24,0,0
GUANAJUATO,2023-01-30,56,55,1,0.01786
GUANAJUATO,2023-01-31,58,51,7,0.12069
GUANAJUATO,2023-02-02,35,32,3,0.08571
GUANAJUATO,2023-02-03,45,45,0,0
GUANAJUATO,2023-02-04,55,55,0,0
GUANAJUATO,2023-02-05,17,17,0,0
GUANAJUATO,2023-02-06,33,33,0,0
GUANAJUATO,2023-02-07,32,32,0,0
GUANAJUATO,2023-02-08,29,29,0,0
GUANAJUATO,2023-02-09,27,27,0,0
GUANAJUATO,2023-02-10,31,31,0,0
GUANAJUATO,2023-02-11,34,34,0,0
GUANAJUATO,2023-02-12,28,28,0,0
GUANAJUATO,2023-02-13,38,38,0,0
GUANAJUATO,2023-02-14,35,35,0,0
GUANAJUATO,2023-02-15,60,60,0,0
GUANAJUATO,2023-02-16,77,77,0,0
GUANAJUATO,2023-02-17,120,120,0,0
GUANAJUATO,2023-02-18,77,75,2,0.02597
GUANAJUATO,2023-02-19,37,37,0,0
GUANAJUATO,2023-02-20,105,105,0,0
GUANAJUATO,2023-02-21,102,102,0,0
GUANAJUATO,2023-02-22,100,100,0,0
GUANAJUATO,2023-02-23,121,121,0,0
GUANAJUATO,2023-02-24,90,90,0,0
GUANAJUATO,2023-02-25,86,86,0,0
GUANAJUATO,2023-02-26,36,36,0,0
GUANAJUATO,2023-02-27,66,66,0,0
GUANAJUATO,2023-02-28,65,65,0,0
GUANAJUATO,2023-03-01,52,52,0,0
GUANAJUATO,2023-03-02,65,65,0,0
GUANAJUATO,2023-03-03,51,51,0,0
GUANAJUATO,2023-03-04,41,41,0,0
GUANAJUATO,2023-03-05,7,7,0,0
GUANAJUATO,2023-03-07,40,36,4,0.1
GUANAJUATO,2023-03-08,37,37,0,0
GUANAJUATO,2023-03-09,45,45,0,0
GUANAJUATO,2023-03-10,26,26,0,0
GUANAJUATO,2023-03-11,34,34,0,0
GUANAJUATO,2023-03-12,16,16,0,0
GUANAJUATO,2023-03-13,26,26,0,0
GUANAJUATO,2023-03-14,32,32,0,0
GUANAJUATO,2023-03-15,40,40,0,0
GUANAJUATO,2023-03-16,47,47,0,0
GUANAJUATO,2023-03-17,51,51,0,0
GUANAJUATO,2023-03-18,54,54,0,0
GUANAJUATO,2023-03-19,26,26,0,0
GUANAJUATO,2023-03-20,40,40,0,0
HERMOSILLO,2023-01-01,6,5,1,0.16667
HERMOSILLO,2023-01-02,30,25,5,0.16667
HERMOSILLO,2023-01-03,36,33,3,0.08333
HERMOSILLO,2023-01-04,41,37,4,0.09756
HERMOSILLO,2023-01-05,44,43,1,0.02273
HERMOSILLO,2023-01-06,35,34,1,0.02857
HERMOSILLO,2023-01-07,34,34,0,0
HERMOSILLO,2023-01-08,41,40,1,0.02439
HERMOSILLO,2023-01-09,22,21,1,0.04545
HERMOSILLO,2023-01-10,28,26,2,0.07143
HERMOSILLO,2023-01-11,48,45,3,0.0625
HERMOSILLO,2023-01-12,34,31,3,0.08824
HERMOSILLO,2023-01-13,33,30,3,0.09091
HERMOSILLO,2023-01-14,55,46,9,0.16364
HERMOSILLO,2023-01-15,44,33,11,0.25
HERMOSILLO,2023-01-16,35,33,2,0.05714
HERMOSILLO,2023-01-17,14,12,2,0.14286
HERMOSILLO,2023-01-18,37,31,6,0.16216
HERMOSILLO,2023-01-19,71,59,12,0.16901
HERMOSILLO,2023-01-20,49,40,9,0.18367
HERMOSILLO,2023-01-21,60,41,19,0.31667
HERMOSILLO,2023-01-22,56,34,22,0.39286
HERMOSILLO,2023-01-23,49,30,19,0.38776
HERMOSILLO,2023-01-24,67,55,12,0.1791
HERMOSILLO,2023-01-25,65,58,7,0.10769
HERMOSILLO,2023-01-26,35,30,5,0.14286
HERMOSILLO,2023-01-27,95,71,24,0.25263
HERMOSILLO,2023-01-28,80,62,18,0.225
HERMOSILLO,2023-01-29,56,41,15,0.26786
HERMOSILLO,2023-01-30,88,79,9,0.10227
HERMOSILLO,2023-01-31,84,68,16,0.19048
HERMOSILLO,2023-02-02,100,91,9,0.09
HERMOSILLO,2023-02-03,87,56,31,0.35632
HERMOSILLO,2023-02-04,80,65,15,0.1875
HERMOSILLO,2023-02-05,38,36,2,0.05263
HERMOSILLO,2023-02-06,50,44,6,0.12
HERMOSILLO,2023-02-07,60,37,23,0.38333
HERMOSILLO,2023-02-08,63,52,11,0.1746
HERMOSILLO,2023-02-09,80,73,7,0.0875
HERMOSILLO,2023-02-10,59,42,17,0.28814
HERMOSILLO,2023-02-11,50,42,8,0.16
HERMOSILLO,2023-02-12,15,14,1,0.06667
HERMOSILLO,2023-02-13,29,28,1,0.03448
HERMOSILLO,2023-02-14,49,46,3,0.06122
HERMOSILLO,2023-02-15,56,53,3,0.05357
HERMOSILLO,2023-02-16,38,32,6,0.15789
HERMOSILLO,2023-02-17,78,50,28,0.35897
HERMOSILLO,2023-02-18,63,45,18,0.28571
HERMOSILLO,2023-02-19,22,18,4,0.18182
HERMOSILLO,2023-02-20,17,13,4,0.23529
HERMOSILLO,2023-02-21,45,34,11,0.24444
HERMOSILLO,2023-02-22,56,48,8,0.14286
HERMOSILLO,2023-02-23,48,29,19,0.39583
HERMOSILLO,2023-02-24,64,45,19,0.29688
HERMOSILLO,2023-02-25,39,30,9,0.23077
HERMOSILLO,2023-02-26,38,24,14,0.36842
HERMOSILLO,2023-02-27,49,30,19,0.38776
HERMOSILLO,2023-02-28,88,34,54,0.61364
HERMOSILLO,2023-03-01,52,36,16,0.30769
HERMOSILLO,2023-03-02,60,54,6,0.1
HERMOSILLO,2023-03-03,38,32,6,0.15789
HERMOSILLO,2023-03-04,46,36,10,0.21739
HERMOSILLO,2023-03-05,29,21,8,0.27586
HERMOSILLO,2023-03-07,52,46,6,0.11538
HERMOSILLO,2023-03-08,79,71,8,0.10127
HERMOSILLO,2023-03-09,47,41,6,0.12766
HERMOSILLO,2023-03-10,43,39,4,0.09302
HERMOSILLO,2023-03-11,61,51,10,0.16393
HERMOSILLO,2023-03-12,18,16,2,0.11111
HERMOSILLO,2023-03-13,41,39,2,0.04878
HERMOSILLO,2023-03-14,45,41,4,0.08889
HERMOSILLO,2023-03-15,51,51,0,0
HERMOSILLO,2023-03-16,55,43,12,0.21818
HERMOSILLO,2023-03-17,40,36,4,0.1
HERMOSILLO,2023-03-18,82,61,21,0.2561
HERMOSILLO,2023-03-19,27,22,5,0.18519
HERMOSILLO,2023-03-20,34,32,2,0.05882
HUEHUETOCA,2023-01-01,15,15,0,0
HUEHUETOCA,2023-01-02,58,50,8,0.13793
HUEHUETOCA,2023-01-03,74,66,8,0.10811
HUEHUETOCA,2023-01-04,70,58,12,0.17143
HUEHUETOCA,2023-01-05,108,95,13,0.12037
HUEHUETOCA,2023-01-06,59,45,14,0.23729
HUEHUETOCA,2023-01-07,90,74,16,0.17778
HUEHUETOCA,2023-01-08,106,94,12,0.11321
HUEHUETOCA,2023-01-09,61,56,5,0.08197
HUEHUETOCA,2023-01-10,101,59,42,0.41584
HUEHUETOCA,2023-01-11,132,116,16,0.12121
HUEHUETOCA,2023-01-12,92,81,11,0.11957
HUEHUETOCA,2023-01-13,66,53,13,0.19697
HUEHUETOCA,2023-01-14,66,60,6,0.09091
HUEHUETOCA,2023-01-15,55,40,15,0.27273
HUEHUETOCA,2023-01-16,98,69,29,0.29592
HUEHUETOCA,2023-01-17,62,48,14,0.22581
HUEHUETOCA,2023-01-18,65,42,23,0.35385
HUEHUETOCA,2023-01-19,101,89,12,0.11881
HUEHUETOCA,2023-01-20,118,81,37,0.31356
HUEHUETOCA,2023-01-21,143,88,55,0.38462
HUEHUETOCA,2023-01-22,113,52,61,0.53982
HUEHUETOCA,2023-01-23,120,90,30,0.25
HUEHUETOCA,2023-01-24,108,84,24,0.22222
HUEHUETOCA,2023-01-25,109,82,27,0.24771
HUEHUETOCA,2023-01-26,82,59,23,0.28049
HUEHUETOCA,2023-01-27,83,62,21,0.25301
HUEHUETOCA,2023-01-28,145,130,15,0.10345
HUEHUETOCA,2023-01-29,79,67,12,0.1519
HUEHUETOCA,2023-01-30,94,66,28,0.29787
HUEHUETOCA,2023-01-31,85,74,11,0.12941
HUEHUETOCA,2023-02-02,90,85,5,0.05556
HUEHUETOCA,2023-02-03,96,76,20,0.20833
HUEHUETOCA,2023-02-04,243,240,3,0.01235
HUEHUETOCA,2023-02-05,89,85,4,0.04494
HUEHUETOCA,2023-02-06,132,113,19,0.14394
HUEHUETOCA,2023-02-07,165,150,15,0.09091
HUEHUETOCA,2023-02-08,132,124,8,0.06061
HUEHUETOCA,2023-02-09,125,123,2,0.016
HUEHUETOCA,2023-02-10,136,128,8,0.05882
HUEHUETOCA,2023-02-11,105,93,12,0.11429
HUEHUETOCA,2023-02-12,87,74,13,0.14943
HUEHUETOCA,2023-02-13,120,103,17,0.14167
HUEHUETOCA,2023-02-14,77,59,18,0.23377
HUEHUETOCA,2023-02-15,88,75,13,0.14773
HUEHUETOCA,2023-02-16,121,115,6,0.04959
HUEHUETOCA,2023-02-17,89,82,7,0.07865
HUEHUETOCA,2023-02-18,142,140,2,0.01408
HUEHUETOCA,2023-02-19,165,162,3,0.01818
HUEHUETOCA,2023-02-20,123,118,5,0.04065
HUEHUETOCA,2023-02-21,152,137,15,0.09868
HUEHUETOCA,2023-02-22,173,148,25,0.14451
HUEHUETOCA,2023-02-23,94,89,5,0.05319
HUEHUETOCA,2023-02-24,79,68,11,0.13924
HUEHUETOCA,2023-02-25,130,117,13,0.1
HUEHUETOCA,2023-02-26,80,68,12,0.15
HUEHUETOCA,2023-02-27,100,95,5,0.05
HUEHUETOCA,2023-02-28,107,81,26,0.24299
HUEHUETOCA,2023-03-01,178,132,46,0.25843
HUEHUETOCA,2023-03-02,131,77,54,0.41221
HUEHUETOCA,2023-03-03,192,132,60,0.3125
HUEHUETOCA,2023-03-04,125,101,24,0.192
HUEHUETOCA,2023-03-05,56,50,6,0.10714
HUEHUETOCA,2023-03-07,76,71,5,0.06579
HUEHUETOCA,2023-03-08,107,93,14,0.13084
HUEHUETOCA,2023-03-09,90,79,11,0.12222
HUEHUETOCA,2023-03-10,75,65,10,0.13333
HUEHUETOCA,2023-03-11,123,103,20,0.1626
HUEHUETOCA,2023-03-12,52,52,0,0
HUEHUETOCA,2023-03-13,85,74,11,0.12941
HUEHUETOCA,2023-03-14,83,73,10,0.12048
HUEHUETOCA,2023-03-15,55,49,6,0.10909
HUEHUETOCA,2023-03-16,86,84,2,0.02326
HUEHUETOCA,2023-03-17,115,115,0,0
HUEHUETOCA,2023-03-18,133,133,0,0
HUEHUETOCA,2023-03-19,96,96,0,0
HUEHUETOCA,2023-03-20,83,83,0,0
IRAPUATO,2023-01-01,1,0,1,1
IRAPUATO,2023-01-02,32,29,3,0.09375
IRAPUATO,2023-01-03,30,28,2,0.06667
IRAPUATO,2023-01-04,27,20,7,0.25926
IRAPUATO,2023-01-05,36,34,2,0.05556
IRAPUATO,2023-01-06,54,53,1,0.01852
IRAPUATO,2023-01-07,41,40,1,0.02439
IRAPUATO,2023-01-08,14,13,1,0.07143
IRAPUATO,2023-01-09,44,40,4,0.09091
IRAPUATO,2023-01-10,46,46,0,0
IRAPUATO,2023-01-11,46,42,4,0.08696
IRAPUATO,2023-01-12,37,33,4,0.10811
IRAPUATO,2023-01-13,28,28,0,0
IRAPUATO,2023-01-14,44,44,0,0
IRAPUATO,2023-01-15,39,36,3,0.07692
IRAPUATO,2023-01-16,23,20,3,0.13043
IRAPUATO,2023-01-17,40,39,1,0.025
IRAPUATO,2023-01-18,53,48,5,0.09434
IRAPUATO,2023-01-19,53,48,5,0.09434
IRAPUATO,2023-01-20,59,58,1,0.01695
IRAPUATO,2023-01-21,48,45,3,0.0625
IRAPUATO,2023-01-22,30,26,4,0.13333
IRAPUATO,2023-01-23,27,24,3,0.11111
IRAPUATO,2023-01-24,46,43,3,0.06522
IRAPUATO,2023-01-25,33,33,0,0
IRAPUATO,2023-01-26,43,24,19,0.44186
IRAPUATO,2023-01-27,50,44,6,0.12
IRAPUATO,2023-01-28,61,56,5,0.08197
IRAPUATO,2023-01-29,29,26,3,0.10345
IRAPUATO,2023-01-30,72,68,4,0.05556
IRAPUATO,2023-01-31,40,37,3,0.075
IRAPUATO,2023-02-02,36,32,4,0.11111
IRAPUATO,2023-02-03,41,30,11,0.26829
IRAPUATO,2023-02-04,55,53,2,0.03636
IRAPUATO,2023-02-05,14,13,1,0.07143
IRAPUATO,2023-02-06,40,38,2,0.05
IRAPUATO,2023-02-07,35,32,3,0.08571
IRAPUATO,2023-02-08,39,38,1,0.02564
IRAPUATO,2023-02-09,31,28,3,0.09677
IRAPUATO,2023-02-10,36,32,4,0.11111
IRAPUATO,2023-02-11,49,41,8,0.16327
IRAPUATO,2023-02-12,14,13,1,0.07143
IRAPUATO,2023-02-13,30,30,0,0
IRAPUATO,2023-02-14,50,42,8,0.16
IRAPUATO,2023-02-15,211,90,121,0.57346
IRAPUATO,2023-02-16,95,86,9,0.09474
IRAPUATO,2023-02-17,84,73,11,0.13095
IRAPUATO,2023-02-18,192,145,47,0.24479
IRAPUATO,2023-02-19,110,68,42,0.38182
IRAPUATO,2023-02-20,158,134,24,0.1519
IRAPUATO,2023-02-21,102,92,10,0.09804
IRAPUATO,2023-02-22,74,71,3,0.04054
IRAPUATO,2023-02-23,84,72,12,0.14286
IRAPUATO,2023-02-24,93,52,41,0.44086
IRAPUATO,2023-02-25,171,159,12,0.07018
IRAPUATO,2023-02-26,75,71,4,0.05333
IRAPUATO,2023-02-27,136,133,3,0.02206
IRAPUATO,2023-02-28,85,75,10,0.11765
IRAPUATO,2023-03-01,45,22,23,0.51111
IRAPUATO,2023-03-02,111,66,45,0.40541
IRAPUATO,2023-03-03,114,113,1,0.00877
IRAPUATO,2023-03-04,108,100,8,0.07407
IRAPUATO,2023-03-05,41,41,0,0
IRAPUATO,2023-03-07,115,94,21,0.18261
IRAPUATO,2023-03-08,130,124,6,0.04615
IRAPUATO,2023-03-09,52,46,6,0.11538
IRAPUATO,2023-03-10,54,51,3,0.05556
IRAPUATO,2023-03-11,87,69,18,0.2069
IRAPUATO,2023-03-12,32,27,5,0.15625
IRAPUATO,2023-03-13,42,35,7,0.16667
IRAPUATO,2023-03-14,31,28,3,0.09677
IRAPUATO,2023-03-15,63,58,5,0.07937
IRAPUATO,2023-03-16,40,28,12,0.3
IRAPUATO,2023-03-17,77,72,5,0.06494
IRAPUATO,2023-03-18,114,106,8,0.07018
IRAPUATO,2023-03-19,40,40,0,0
IRAPUATO,2023-03-20,55,51,4,0.07273
IZTAPALAPA,2023-01-01,3,3,0,0
IZTAPALAPA,2023-01-02,45,45,0,0
IZTAPALAPA,2023-01-03,51,49,2,0.03922
IZTAPALAPA,2023-01-04,51,51,0,0
IZTAPALAPA,2023-01-05,50,49,1,0.02
IZTAPALAPA,2023-01-06,41,39,2,0.04878
IZTAPALAPA,2023-01-07,48,48,0,0
IZTAPALAPA,2023-01-08,51,51,0,0
IZTAPALAPA,2023-01-09,34,33,1,0.02941
IZTAPALAPA,2023-01-10,50,50,0,0
IZTAPALAPA,2023-01-11,62,61,1,0.01613
IZTAPALAPA,2023-01-12,53,52,1,0.01887
IZTAPALAPA,2023-01-13,56,54,2,0.03571
IZTAPALAPA,2023-01-14,50,48,2,0.04
IZTAPALAPA,2023-01-15,47,47,0,0
IZTAPALAPA,2023-01-16,45,41,4,0.08889
IZTAPALAPA,2023-01-17,68,68,0,0
IZTAPALAPA,2023-01-18,59,55,4,0.0678
IZTAPALAPA,2023-01-19,66,65,1,0.01515
IZTAPALAPA,2023-01-20,50,49,1,0.02
IZTAPALAPA,2023-01-21,80,78,2,0.025
IZTAPALAPA,2023-01-22,88,88,0,0
IZTAPALAPA,2023-01-23,53,53,0,0
IZTAPALAPA,2023-01-24,47,45,2,0.04255
IZTAPALAPA,2023-01-25,37,37,0,0
IZTAPALAPA,2023-01-26,79,79,0,0
IZTAPALAPA,2023-01-27,92,92,0,0
IZTAPALAPA,2023-01-28,149,148,1,0.00671
IZTAPALAPA,2023-01-29,81,79,2,0.02469
IZTAPALAPA,2023-01-30,143,141,2,0.01399
IZTAPALAPA,2023-01-31,104,104,0,0
IZTAPALAPA,2023-02-02,57,48,9,0.15789
IZTAPALAPA,2023-02-03,65,63,2,0.03077
IZTAPALAPA,2023-02-04,71,70,1,0.01408
IZTAPALAPA,2023-02-05,58,57,1,0.01724
IZTAPALAPA,2023-02-06,37,37,0,0
IZTAPALAPA,2023-02-07,29,26,3,0.10345
IZTAPALAPA,2023-02-08,43,43,0,0
IZTAPALAPA,2023-02-09,49,46,3,0.06122
IZTAPALAPA,2023-02-10,69,64,5,0.07246
IZTAPALAPA,2023-02-11,65,65,0,0
IZTAPALAPA,2023-02-12,68,58,10,0.14706
IZTAPALAPA,2023-02-13,41,40,1,0.02439
IZTAPALAPA,2023-02-14,27,27,0,0
IZTAPALAPA,2023-02-15,106,104,2,0.01887
IZTAPALAPA,2023-02-16,34,25,9,0.26471
IZTAPALAPA,2023-02-17,32,31,1,0.03125
IZTAPALAPA,2023-02-18,57,57,0,0
IZTAPALAPA,2023-02-19,97,93,4,0.04124
IZTAPALAPA,2023-02-20,77,72,5,0.06494
IZTAPALAPA,2023-02-21,58,57,1,0.01724
IZTAPALAPA,2023-02-22,54,53,1,0.01852
IZTAPALAPA,2023-02-23,31,30,1,0.03226
IZTAPALAPA,2023-02-24,56,53,3,0.05357
IZTAPALAPA,2023-02-25,57,56,1,0.01754
IZTAPALAPA,2023-02-26,70,70,0,0
IZTAPALAPA,2023-02-27,84,84,0,0
IZTAPALAPA,2023-02-28,88,77,11,0.125
IZTAPALAPA,2023-03-01,115,111,4,0.03478
IZTAPALAPA,2023-03-02,73,35,38,0.52055
IZTAPALAPA,2023-03-03,63,62,1,0.01587
IZTAPALAPA,2023-03-04,81,81,0,0
IZTAPALAPA,2023-03-05,53,53,0,0
IZTAPALAPA,2023-03-07,67,67,0,0
IZTAPALAPA,2023-03-08,48,48,0,0
IZTAPALAPA,2023-03-09,82,77,5,0.06098
IZTAPALAPA,2023-03-10,40,38,2,0.05
IZTAPALAPA,2023-03-11,53,52,1,0.01887
IZTAPALAPA,2023-03-12,56,56,0,0
IZTAPALAPA,2023-03-13,47,47,0,0
IZTAPALAPA,2023-03-14,56,56,0,0
IZTAPALAPA,2023-03-15,51,50,1,0.01961
IZTAPALAPA,2023-03-16,48,48,0,0
IZTAPALAPA,2023-03-17,77,77,0,0
IZTAPALAPA,2023-03-18,116,116,0,0
IZTAPALAPA,2023-03-19,70,70,0,0
IZTAPALAPA,2023-03-20,87,86,1,0.01149
JUAREZ NORTE,2023-01-01,7,5,2,0.28571
JUAREZ NORTE,2023-01-02,30,15,15,0.5
JUAREZ NORTE,2023-01-03,75,35,40,0.53333
JUAREZ NORTE,2023-01-04,56,26,30,0.53571
JUAREZ NORTE,2023-01-05,67,23,44,0.65672
JUAREZ NORTE,2023-01-06,71,26,45,0.6338
JUAREZ NORTE,2023-01-07,87,33,54,0.62069
JUAREZ NORTE,2023-01-08,77,25,52,0.67532
JUAREZ NORTE,2023-01-09,97,25,72,0.74227
JUAREZ NORTE,2023-01-10,75,32,43,0.57333
JUAREZ NORTE,2023-01-11,90,44,46,0.51111
JUAREZ NORTE,2023-01-12,130,38,92,0.70769
JUAREZ NORTE,2023-01-13,96,57,39,0.40625
JUAREZ NORTE,2023-01-14,150,48,102,0.68
JUAREZ NORTE,2023-01-15,49,22,27,0.55102
JUAREZ NORTE,2023-01-16,79,30,49,0.62025
JUAREZ NORTE,2023-01-17,57,28,29,0.50877
JUAREZ NORTE,2023-01-18,69,27,42,0.6087
JUAREZ NORTE,2023-01-19,127,38,89,0.70079
JUAREZ NORTE,2023-01-20,77,34,43,0.55844
JUAREZ NORTE,2023-01-21,130,60,70,0.53846
JUAREZ NORTE,2023-01-22,72,35,37,0.51389
JUAREZ NORTE,2023-01-23,96,33,63,0.65625
JUAREZ NORTE,2023-01-24,136,37,99,0.72794
JUAREZ NORTE,2023-01-25,105,48,57,0.54286
JUAREZ NORTE,2023-01-26,106,27,79,0.74528
JUAREZ NORTE,2023-01-27,107,39,68,0.63551
JUAREZ NORTE,2023-01-28,109,55,54,0.49541
JUAREZ NORTE,2023-01-29,64,29,35,0.54688
JUAREZ NORTE,2023-01-30,75,40,35,0.46667
JUAREZ NORTE,2023-01-31,79,45,34,0.43038
JUAREZ NORTE,2023-02-02,98,49,49,0.5
JUAREZ NORTE,2023-02-03,76,36,40,0.52632
JUAREZ NORTE,2023-02-04,107,45,62,0.57944
JUAREZ NORTE,2023-02-05,69,29,40,0.57971
JUAREZ NORTE,2023-02-06,96,43,53,0.55208
JUAREZ NORTE,2023-02-07,84,30,54,0.64286
JUAREZ NORTE,2023-02-08,108,57,51,0.47222
JUAREZ NORTE,2023-02-09,88,48,40,0.45455
JUAREZ NORTE,2023-02-10,109,54,55,0.50459
JUAREZ NORTE,2023-02-11,89,42,47,0.52809
JUAREZ NORTE,2023-02-12,88,36,52,0.59091
JUAREZ NORTE,2023-02-13,50,35,15,0.3
JUAREZ NORTE,2023-02-14,81,16,65,0.80247
JUAREZ NORTE,2023-02-15,72,27,45,0.625
JUAREZ NORTE,2023-02-16,94,28,66,0.70213
JUAREZ NORTE,2023-02-17,72,31,41,0.56944
JUAREZ NORTE,2023-02-18,94,29,65,0.69149
JUAREZ NORTE,2023-02-19,30,12,18,0.6
JUAREZ NORTE,2023-02-20,59,16,43,0.72881
JUAREZ NORTE,2023-02-21,125,46,79,0.632
JUAREZ NORTE,2023-02-22,63,27,36,0.57143
JUAREZ NORTE,2023-02-23,77,25,52,0.67532
JUAREZ NORTE,2023-02-24,95,29,66,0.69474
JUAREZ NORTE,2023-02-25,97,55,42,0.43299
JUAREZ NORTE,2023-02-26,30,19,11,0.36667
JUAREZ NORTE,2023-02-27,87,27,60,0.68966
JUAREZ NORTE,2023-02-28,93,31,62,0.66667
JUAREZ NORTE,2023-03-01,76,36,40,0.52632
JUAREZ NORTE,2023-03-02,113,26,87,0.76991
JUAREZ NORTE,2023-03-03,156,46,110,0.70513
JUAREZ NORTE,2023-03-04,143,53,90,0.62937
JUAREZ NORTE,2023-03-05,91,30,61,0.67033
JUAREZ NORTE,2023-03-07,103,36,67,0.65049
JUAREZ NORTE,2023-03-08,72,22,50,0.69444
JUAREZ NORTE,2023-03-09,81,47,34,0.41975
JUAREZ NORTE,2023-03-10,44,23,21,0.47727
JUAREZ NORTE,2023-03-11,83,21,62,0.74699
JUAREZ NORTE,2023-03-12,87,36,51,0.58621
JUAREZ NORTE,2023-03-13,72,27,45,0.625
JUAREZ NORTE,2023-03-14,70,24,46,0.65714
JUAREZ NORTE,2023-03-15,88,28,60,0.68182
JUAREZ NORTE,2023-03-16,60,25,35,0.58333
JUAREZ NORTE,2023-03-17,61,28,33,0.54098
JUAREZ NORTE,2023-03-18,80,19,61,0.7625
JUAREZ NORTE,2023-03-19,61,35,26,0.42623
JUAREZ NORTE,2023-03-20,47,26,21,0.44681
JUAREZ SUR,2023-01-01,14,9,5,0.35714
JUAREZ SUR,2023-01-02,75,48,27,0.36
JUAREZ SUR,2023-01-03,68,35,33,0.48529
JUAREZ SUR,2023-01-04,63,29,34,0.53968
JUAREZ SUR,2023-01-05,91,43,48,0.52747
JUAREZ SUR,2023-01-06,87,24,63,0.72414
JUAREZ SUR,2023-01-07,113,45,68,0.60177
JUAREZ SUR,2023-01-08,106,36,70,0.66038
JUAREZ SUR,2023-01-09,87,35,52,0.5977
JUAREZ SUR,2023-01-10,109,64,45,0.41284
JUAREZ SUR,2023-01-11,88,36,52,0.59091
JUAREZ SUR,2023-01-12,82,33,49,0.59756
JUAREZ SUR,2023-01-13,89,34,55,0.61798
JUAREZ SUR,2023-01-14,139,57,82,0.58993
JUAREZ SUR,2023-01-15,58,26,32,0.55172
JUAREZ SUR,2023-01-16,72,26,46,0.63889
JUAREZ SUR,2023-01-17,93,28,65,0.69892
JUAREZ SUR,2023-01-18,74,29,45,0.60811
JUAREZ SUR,2023-01-19,91,30,61,0.67033
JUAREZ SUR,2023-01-20,91,15,76,0.83516
JUAREZ SUR,2023-01-21,116,48,68,0.58621
JUAREZ SUR,2023-01-22,112,66,46,0.41071
JUAREZ SUR,2023-01-23,84,27,57,0.67857
JUAREZ SUR,2023-01-24,102,46,56,0.54902
JUAREZ SUR,2023-01-25,101,41,60,0.59406
JUAREZ SUR,2023-01-26,77,25,52,0.67532
JUAREZ SUR,2023-01-27,77,33,44,0.57143
JUAREZ SUR,2023-01-28,119,56,63,0.52941
JUAREZ SUR,2023-01-29,104,64,40,0.38462
JUAREZ SUR,2023-01-30,81,31,50,0.61728
JUAREZ SUR,2023-01-31,80,24,56,0.7
JUAREZ SUR,2023-02-01,1,0,1,1
JUAREZ SUR,2023-02-02,95,38,57,0.6
JUAREZ SUR,2023-02-03,89,28,61,0.68539
JUAREZ SUR,2023-02-04,119,47,72,0.60504
JUAREZ SUR,2023-02-05,72,23,49,0.68056
JUAREZ SUR,2023-02-06,92,46,46,0.5
JUAREZ SUR,2023-02-07,90,25,65,0.72222
JUAREZ SUR,2023-02-08,85,40,45,0.52941
JUAREZ SUR,2023-02-09,99,22,77,0.77778
JUAREZ SUR,2023-02-10,91,31,60,0.65934
JUAREZ SUR,2023-02-11,93,30,63,0.67742
JUAREZ SUR,2023-02-12,47,10,37,0.78723
JUAREZ SUR,2023-02-13,87,29,58,0.66667
JUAREZ SUR,2023-02-14,52,13,39,0.75
JUAREZ SUR,2023-02-15,72,39,33,0.45833
JUAREZ SUR,2023-02-16,83,36,47,0.56627
JUAREZ SUR,2023-02-17,89,23,66,0.74157
JUAREZ SUR,2023-02-18,107,41,66,0.61682
JUAREZ SUR,2023-02-19,28,11,17,0.60714
JUAREZ SUR,2023-02-20,91,18,73,0.8022
JUAREZ SUR,2023-02-21,85,33,52,0.61176
JUAREZ SUR,2023-02-22,71,36,35,0.49296
JUAREZ SUR,2023-02-23,77,20,57,0.74026
JUAREZ SUR,2023-02-24,82,28,54,0.65854
JUAREZ SUR,2023-02-25,124,56,68,0.54839
JUAREZ SUR,2023-02-26,31,17,14,0.45161
JUAREZ SUR,2023-02-27,85,17,68,0.8
JUAREZ SUR,2023-02-28,78,44,34,0.4359
JUAREZ SUR,2023-03-01,43,23,20,0.46512
JUAREZ SUR,2023-03-02,142,30,112,0.78873
JUAREZ SUR,2023-03-03,87,17,70,0.8046
JUAREZ SUR,2023-03-04,131,49,82,0.62595
JUAREZ SUR,2023-03-05,82,36,46,0.56098
JUAREZ SUR,2023-03-07,107,34,73,0.68224
JUAREZ SUR,2023-03-08,80,32,48,0.6
JUAREZ SUR,2023-03-09,87,21,66,0.75862
JUAREZ SUR,2023-03-10,66,27,39,0.59091
JUAREZ SUR,2023-03-11,86,26,60,0.69767
JUAREZ SUR,2023-03-12,70,29,41,0.58571
JUAREZ SUR,2023-03-13,92,41,51,0.55435
JUAREZ SUR,2023-03-14,109,36,73,0.66972
JUAREZ SUR,2023-03-15,73,23,50,0.68493
JUAREZ SUR,2023-03-16,49,16,33,0.67347
JUAREZ SUR,2023-03-17,85,24,61,0.71765
JUAREZ SUR,2023-03-18,90,42,48,0.53333
JUAREZ SUR,2023-03-19,43,16,27,0.62791
JUAREZ SUR,2023-03-20,71,32,39,0.5493
LA LAGUNA GOMEZ,2023-01-01,4,4,0,0
LA LAGUNA GOMEZ,2023-01-02,45,42,3,0.06667
LA LAGUNA GOMEZ,2023-01-03,33,33,0,0
LA LAGUNA GOMEZ,2023-01-04,49,44,5,0.10204
LA LAGUNA GOMEZ,2023-01-05,51,47,4,0.07843
LA LAGUNA GOMEZ,2023-01-06,52,45,7,0.13462
LA LAGUNA GOMEZ,2023-01-07,56,51,5,0.08929
LA LAGUNA GOMEZ,2023-01-08,30,29,1,0.03333
LA LAGUNA GOMEZ,2023-01-09,43,38,5,0.11628
LA LAGUNA GOMEZ,2023-01-10,46,45,1,0.02174
LA LAGUNA GOMEZ,2023-01-11,68,60,8,0.11765
LA LAGUNA GOMEZ,2023-01-12,47,45,2,0.04255
LA LAGUNA GOMEZ,2023-01-13,23,23,0,0
LA LAGUNA GOMEZ,2023-01-14,51,43,8,0.15686
LA LAGUNA GOMEZ,2023-01-15,28,26,2,0.07143
LA LAGUNA GOMEZ,2023-01-16,35,35,0,0
LA LAGUNA GOMEZ,2023-01-17,37,30,7,0.18919
LA LAGUNA GOMEZ,2023-01-18,27,25,2,0.07407
LA LAGUNA GOMEZ,2023-01-19,29,29,0,0
LA LAGUNA GOMEZ,2023-01-20,27,25,2,0.07407
LA LAGUNA GOMEZ,2023-01-21,74,52,22,0.2973
LA LAGUNA GOMEZ,2023-01-22,21,19,2,0.09524
LA LAGUNA GOMEZ,2023-01-23,42,40,2,0.04762
LA LAGUNA GOMEZ,2023-01-24,34,34,0,0
LA LAGUNA GOMEZ,2023-01-25,46,42,4,0.08696
LA LAGUNA GOMEZ,2023-01-26,20,16,4,0.2
LA LAGUNA GOMEZ,2023-01-27,38,32,6,0.15789
LA LAGUNA GOMEZ,2023-01-28,34,31,3,0.08824
LA LAGUNA GOMEZ,2023-01-29,23,22,1,0.04348
LA LAGUNA GOMEZ,2023-01-30,38,35,3,0.07895
LA LAGUNA GOMEZ,2023-01-31,30,30,0,0
LA LAGUNA GOMEZ,2023-02-02,60,56,4,0.06667
LA LAGUNA GOMEZ,2023-02-03,27,17,10,0.37037
LA LAGUNA GOMEZ,2023-02-04,52,43,9,0.17308
LA LAGUNA GOMEZ,2023-02-05,34,29,5,0.14706
LA LAGUNA GOMEZ,2023-02-06,32,25,7,0.21875
LA LAGUNA GOMEZ,2023-02-07,45,35,10,0.22222
LA LAGUNA GOMEZ,2023-02-08,31,29,2,0.06452
LA LAGUNA GOMEZ,2023-02-09,33,30,3,0.09091
LA LAGUNA GOMEZ,2023-02-10,57,46,11,0.19298
LA LAGUNA GOMEZ,2023-02-11,49,37,12,0.2449
LA LAGUNA GOMEZ,2023-02-12,37,26,11,0.2973
LA LAGUNA GOMEZ,2023-02-13,26,20,6,0.23077
LA LAGUNA GOMEZ,2023-02-14,38,29,9,0.23684
LA LAGUNA GOMEZ,2023-02-15,34,31,3,0.08824
LA LAGUNA GOMEZ,2023-02-16,36,27,9,0.25
LA LAGUNA GOMEZ,2023-02-17,25,18,7,0.28
LA LAGUNA GOMEZ,2023-02-18,41,32,9,0.21951
LA LAGUNA GOMEZ,2023-02-19,33,28,5,0.15152
LA LAGUNA GOMEZ,2023-02-20,29,25,4,0.13793
LA LAGUNA GOMEZ,2023-02-21,33,30,3,0.09091
LA LAGUNA GOMEZ,2023-02-22,78,21,57,0.73077
LA LAGUNA GOMEZ,2023-02-23,91,62,29,0.31868
LA LAGUNA GOMEZ,2023-02-24,61,40,21,0.34426
LA LAGUNA GOMEZ,2023-02-25,63,43,20,0.31746
LA LAGUNA GOMEZ,2023-02-26,18,12,6,0.33333
LA LAGUNA GOMEZ,2023-02-27,48,35,13,0.27083
LA LAGUNA GOMEZ,2023-02-28,70,32,38,0.54286
LA LAGUNA GOMEZ,2023-03-01,44,37,7,0.15909
LA LAGUNA GOMEZ,2023-03-02,41,28,13,0.31707
LA LAGUNA GOMEZ,2023-03-03,39,30,9,0.23077
LA LAGUNA GOMEZ,2023-03-04,44,37,7,0.15909
LA LAGUNA GOMEZ,2023-03-05,24,18,6,0.25
LA LAGUNA GOMEZ,2023-03-07,42,35,7,0.16667
LA LAGUNA GOMEZ,2023-03-08,84,74,10,0.11905
LA LAGUNA GOMEZ,2023-03-09,66,42,24,0.36364
LA LAGUNA GOMEZ,2023-03-10,52,40,12,0.23077
LA LAGUNA GOMEZ,2023-03-11,56,36,20,0.35714
LA LAGUNA GOMEZ,2023-03-12,6,5,1,0.16667
LA LAGUNA GOMEZ,2023-03-13,45,32,13,0.28889
LA LAGUNA GOMEZ,2023-03-14,38,31,7,0.18421
LA LAGUNA GOMEZ,2023-03-15,47,44,3,0.06383
LA LAGUNA GOMEZ,2023-03-16,42,38,4,0.09524
LA LAGUNA GOMEZ,2023-03-17,45,45,0,0
LA LAGUNA GOMEZ,2023-03-18,80,70,10,0.125
LA LAGUNA GOMEZ,2023-03-19,40,39,1,0.025
LA LAGUNA GOMEZ,2023-03-20,36,31,5,0.13889
LA LAGUNA TORREON,2023-01-01,14,3,11,0.78571
LA LAGUNA TORREON,2023-01-02,43,29,14,0.32558
LA LAGUNA TORREON,2023-01-03,40,33,7,0.175
LA LAGUNA TORREON,2023-01-04,31,26,5,0.16129
LA LAGUNA TORREON,2023-01-05,35,28,7,0.2
LA LAGUNA TORREON,2023-01-06,48,36,12,0.25
LA LAGUNA TORREON,2023-01-07,68,67,1,0.01471
LA LAGUNA TORREON,2023-01-08,39,30,9,0.23077
LA LAGUNA TORREON,2023-01-09,34,34,0,0
LA LAGUNA TORREON,2023-01-10,46,40,6,0.13043
LA LAGUNA TORREON,2023-01-11,60,49,11,0.18333
LA LAGUNA TORREON,2023-01-12,54,46,8,0.14815
LA LAGUNA TORREON,2023-01-13,36,30,6,0.16667
LA LAGUNA TORREON,2023-01-14,62,52,10,0.16129
LA LAGUNA TORREON,2023-01-15,38,20,18,0.47368
LA LAGUNA TORREON,2023-01-16,44,35,9,0.20455
LA LAGUNA TORREON,2023-01-17,39,29,10,0.25641
LA LAGUNA TORREON,2023-01-18,42,29,13,0.30952
LA LAGUNA TORREON,2023-01-19,45,40,5,0.11111
LA LAGUNA TORREON,2023-01-20,40,32,8,0.2
LA LAGUNA TORREON,2023-01-21,59,54,5,0.08475
LA LAGUNA TORREON,2023-01-22,26,18,8,0.30769
LA LAGUNA TORREON,2023-01-23,26,23,3,0.11538
LA LAGUNA TORREON,2023-01-24,43,33,10,0.23256
LA LAGUNA TORREON,2023-01-25,42,41,1,0.02381
LA LAGUNA TORREON,2023-01-26,35,24,11,0.31429
LA LAGUNA TORREON,2023-01-27,31,30,1,0.03226
LA LAGUNA TORREON,2023-01-28,47,45,2,0.04255
LA LAGUNA TORREON,2023-01-29,37,17,20,0.54054
LA LAGUNA TORREON,2023-01-30,32,26,6,0.1875
LA LAGUNA TORREON,2023-01-31,38,31,7,0.18421
LA LAGUNA TORREON,2023-02-02,38,30,8,0.21053
LA LAGUNA TORREON,2023-02-03,27,23,4,0.14815
LA LAGUNA TORREON,2023-02-04,30,29,1,0.03333
LA LAGUNA TORREON,2023-02-05,31,23,8,0.25806
LA LAGUNA TORREON,2023-02-06,42,30,12,0.28571
LA LAGUNA TORREON,2023-02-07,23,19,4,0.17391
LA LAGUNA TORREON,2023-02-08,23,18,5,0.21739
LA LAGUNA TORREON,2023-02-09,35,34,1,0.02857
LA LAGUNA TORREON,2023-02-10,30,27,3,0.1
LA LAGUNA TORREON,2023-02-11,59,50,9,0.15254
LA LAGUNA TORREON,2023-02-12,23,19,4,0.17391
LA LAGUNA TORREON,2023-02-13,45,40,5,0.11111
LA LAGUNA TORREON,2023-02-14,20,14,6,0.3
LA LAGUNA TORREON,2023-02-15,41,31,10,0.2439
LA LAGUNA TORREON,2023-02-16,48,43,5,0.10417
LA LAGUNA TORREON,2023-02-17,40,32,8,0.2
LA LAGUNA TORREON,2023-02-18,42,35,7,0.16667
LA LAGUNA TORREON,2023-02-19,25,22,3,0.12
LA LAGUNA TORREON,2023-02-20,30,23,7,0.23333
LA LAGUNA TORREON,2023-02-21,30,21,9,0.3
LA LAGUNA TORREON,2023-02-22,51,49,2,0.03922
LA LAGUNA TORREON,2023-02-23,62,39,23,0.37097
LA LAGUNA TORREON,2023-02-24,61,52,9,0.14754
LA LAGUNA TORREON,2023-02-25,55,44,11,0.2
LA LAGUNA TORREON,2023-02-26,29,19,10,0.34483
LA LAGUNA TORREON,2023-02-27,42,42,0,0
LA LAGUNA TORREON,2023-02-28,52,41,11,0.21154
LA LAGUNA TORREON,2023-03-01,50,43,7,0.14
LA LAGUNA TORREON,2023-03-02,75,47,28,0.37333
LA LAGUNA TORREON,2023-03-03,53,50,3,0.0566
LA LAGUNA TORREON,2023-03-04,58,54,4,0.06897
LA LAGUNA TORREON,2023-03-05,26,22,4,0.15385
LA LAGUNA TORREON,2023-03-07,60,42,18,0.3
LA LAGUNA TORREON,2023-03-08,56,46,10,0.17857
LA LAGUNA TORREON,2023-03-09,50,39,11,0.22
LA LAGUNA TORREON,2023-03-10,28,25,3,0.10714
LA LAGUNA TORREON,2023-03-11,44,35,9,0.20455
LA LAGUNA TORREON,2023-03-12,30,19,11,0.36667
LA LAGUNA TORREON,2023-03-13,26,21,5,0.19231
LA LAGUNA TORREON,2023-03-14,42,36,6,0.14286
LA LAGUNA TORREON,2023-03-15,36,24,12,0.33333
LA LAGUNA TORREON,2023-03-16,47,45,2,0.04255
LA LAGUNA TORREON,2023-03-17,54,49,5,0.09259
LA LAGUNA TORREON,2023-03-18,60,54,6,0.1
LA LAGUNA TORREON,2023-03-19,32,29,3,0.09375
LA LAGUNA TORREON,2023-03-20,39,34,5,0.12821
LAS AGUILAS,2023-01-01,9,9,0,0
LAS AGUILAS,2023-01-02,62,62,0,0
LAS AGUILAS,2023-01-03,75,73,2,0.02667
LAS AGUILAS,2023-01-04,82,82,0,0
LAS AGUILAS,2023-01-05,72,68,4,0.05556
LAS AGUILAS,2023-01-06,92,92,0,0
LAS AGUILAS,2023-01-07,43,42,1,0.02326
LAS AGUILAS,2023-01-08,25,21,4,0.16
LAS AGUILAS,2023-01-09,446,395,51,0.11435
LAS AGUILAS,2023-01-10,76,74,2,0.02632
LAS AGUILAS,2023-01-11,141,137,4,0.02837
LAS AGUILAS,2023-01-12,116,116,0,0
LAS AGUILAS,2023-01-13,141,127,14,0.09929
LAS AGUILAS,2023-01-14,226,226,0,0
LAS AGUILAS,2023-01-15,241,163,78,0.32365
LAS AGUILAS,2023-01-16,238,206,32,0.13445
LAS AGUILAS,2023-01-17,193,173,20,0.10363
LAS AGUILAS,2023-01-18,134,113,21,0.15672
LAS AGUILAS,2023-01-19,202,198,4,0.0198
LAS AGUILAS,2023-01-20,259,225,34,0.13127
LAS AGUILAS,2023-01-21,362,358,4,0.01105
LAS AGUILAS,2023-01-22,290,289,1,0.00345
LAS AGUILAS,2023-01-23,239,239,0,0
LAS AGUILAS,2023-01-24,152,152,0,0
LAS AGUILAS,2023-01-25,205,204,1,0.00488
LAS AGUILAS,2023-01-26,121,121,0,0
LAS AGUILAS,2023-01-27,218,218,0,0
LAS AGUILAS,2023-01-28,196,196,0,0
LAS AGUILAS,2023-01-29,363,363,0,0
LAS AGUILAS,2023-01-30,187,187,0,0
LAS AGUILAS,2023-01-31,488,456,32,0.06557
LAS AGUILAS,2023-02-02,120,115,5,0.04167
LAS AGUILAS,2023-02-03,335,335,0,0
LAS AGUILAS,2023-02-04,443,443,0,0
LAS AGUILAS,2023-02-05,192,187,5,0.02604
LAS AGUILAS,2023-02-06,205,205,0,0
LAS AGUILAS,2023-02-07,124,124,0,0
LAS AGUILAS,2023-02-08,158,152,6,0.03797
LAS AGUILAS,2023-02-09,379,379,0,0
LAS AGUILAS,2023-02-10,128,86,42,0.32812
LAS AGUILAS,2023-02-11,295,291,4,0.01356
LAS AGUILAS,2023-02-12,343,343,0,0
LAS AGUILAS,2023-02-13,271,271,0,0
LAS AGUILAS,2023-02-14,119,119,0,0
LAS AGUILAS,2023-02-15,176,176,0,0
LAS AGUILAS,2023-02-16,154,154,0,0
LAS AGUILAS,2023-02-17,161,161,0,0
LAS AGUILAS,2023-02-18,301,299,2,0.00664
LAS AGUILAS,2023-02-19,182,182,0,0
LAS AGUILAS,2023-02-20,152,140,12,0.07895
LAS AGUILAS,2023-02-21,126,126,0,0
LAS AGUILAS,2023-02-22,43,39,4,0.09302
LAS AGUILAS,2023-02-23,147,147,0,0
LAS AGUILAS,2023-02-24,81,81,0,0
LAS AGUILAS,2023-02-25,154,154,0,0
LAS AGUILAS,2023-02-26,122,122,0,0
LAS AGUILAS,2023-02-27,114,114,0,0
LAS AGUILAS,2023-02-28,198,198,0,0
LAS AGUILAS,2023-03-01,218,218,0,0
LAS AGUILAS,2023-03-02,110,110,0,0
LAS AGUILAS,2023-03-03,86,86,0,0
LAS AGUILAS,2023-03-04,119,116,3,0.02521
LAS AGUILAS,2023-03-05,124,124,0,0
LAS AGUILAS,2023-03-07,74,74,0,0
LAS AGUILAS,2023-03-08,131,131,0,0
LAS AGUILAS,2023-03-09,97,97,0,0
LAS AGUILAS,2023-03-10,57,57,0,0
LAS AGUILAS,2023-03-11,76,76,0,0
LAS AGUILAS,2023-03-12,61,61,0,0
LAS AGUILAS,2023-03-13,98,98,0,0
LAS AGUILAS,2023-03-14,143,143,0,0
LAS AGUILAS,2023-03-15,79,79,0,0
LAS AGUILAS,2023-03-16,143,143,0,0
LAS AGUILAS,2023-03-17,132,132,0,0
LAS AGUILAS,2023-03-18,227,223,4,0.01762
LAS AGUILAS,2023-03-19,153,144,9,0.05882
LAS AGUILAS,2023-03-20,133,118,15,0.11278
LOS MOCHIS,2023-01-01,8,4,4,0.5
LOS MOCHIS,2023-01-02,17,13,4,0.23529
LOS MOCHIS,2023-01-03,19,17,2,0.10526
LOS MOCHIS,2023-01-04,20,18,2,0.1
LOS MOCHIS,2023-01-06,23,17,6,0.26087
LOS MOCHIS,2023-01-07,19,14,5,0.26316
LOS MOCHIS,2023-01-08,19,16,3,0.15789
LOS MOCHIS,2023-01-09,17,14,3,0.17647
LOS MOCHIS,2023-01-10,24,20,4,0.16667
LOS MOCHIS,2023-01-11,20,17,3,0.15
LOS MOCHIS,2023-01-12,29,22,7,0.24138
LOS MOCHIS,2023-01-13,16,11,5,0.3125
LOS MOCHIS,2023-01-14,23,17,6,0.26087
LOS MOCHIS,2023-01-15,11,11,0,0
LOS MOCHIS,2023-01-16,22,20,2,0.09091
LOS MOCHIS,2023-01-17,24,20,4,0.16667
LOS MOCHIS,2023-01-18,16,15,1,0.0625
LOS MOCHIS,2023-01-19,16,14,2,0.125
LOS MOCHIS,2023-01-20,30,27,3,0.1
LOS MOCHIS,2023-01-21,16,12,4,0.25
LOS MOCHIS,2023-01-22,13,10,3,0.23077
LOS MOCHIS,2023-01-23,29,20,9,0.31034
LOS MOCHIS,2023-01-24,11,6,5,0.45455
LOS MOCHIS,2023-01-25,22,22,0,0
LOS MOCHIS,2023-01-26,20,16,4,0.2
LOS MOCHIS,2023-01-27,24,24,0,0
LOS MOCHIS,2023-01-28,29,24,5,0.17241
LOS MOCHIS,2023-01-29,10,8,2,0.2
LOS MOCHIS,2023-01-30,27,23,4,0.14815
LOS MOCHIS,2023-01-31,21,18,3,0.14286
LOS MOCHIS,2023-02-02,14,8,6,0.42857
LOS MOCHIS,2023-02-03,14,13,1,0.07143
LOS MOCHIS,2023-02-04,19,18,1,0.05263
LOS MOCHIS,2023-02-05,8,8,0,0
LOS MOCHIS,2023-02-06,19,11,8,0.42105
LOS MOCHIS,2023-02-07,21,15,6,0.28571
LOS MOCHIS,2023-02-08,16,14,2,0.125
LOS MOCHIS,2023-02-09,20,18,2,0.1
LOS MOCHIS,2023-02-10,19,12,7,0.36842
LOS MOCHIS,2023-02-11,12,10,2,0.16667
LOS MOCHIS,2023-02-12,10,9,1,0.1
LOS MOCHIS,2023-02-13,16,12,4,0.25
LOS MOCHIS,2023-02-14,21,19,2,0.09524
LOS MOCHIS,2023-02-15,18,14,4,0.22222
LOS MOCHIS,2023-02-16,16,13,3,0.1875
LOS MOCHIS,2023-02-17,17,13,4,0.23529
LOS MOCHIS,2023-02-18,20,16,4,0.2
LOS MOCHIS,2023-02-19,13,13,0,0
LOS MOCHIS,2023-02-20,19,15,4,0.21053
LOS MOCHIS,2023-02-21,16,14,2,0.125
LOS MOCHIS,2023-02-22,22,22,0,0
LOS MOCHIS,2023-02-23,22,21,1,0.04545
LOS MOCHIS,2023-02-24,42,22,20,0.47619
LOS MOCHIS,2023-02-25,70,69,1,0.01429
LOS MOCHIS,2023-02-26,7,7,0,0
LOS MOCHIS,2023-02-27,18,12,6,0.33333
LOS MOCHIS,2023-02-28,31,29,2,0.06452
LOS MOCHIS,2023-03-01,23,20,3,0.13043
LOS MOCHIS,2023-03-02,17,12,5,0.29412
LOS MOCHIS,2023-03-03,66,51,15,0.22727
LOS MOCHIS,2023-03-04,24,22,2,0.08333
LOS MOCHIS,2023-03-05,10,9,1,0.1
LOS MOCHIS,2023-03-07,19,13,6,0.31579
LOS MOCHIS,2023-03-08,18,14,4,0.22222
LOS REYES,2023-01-01,9,9,0,0
LOS REYES,2023-01-02,49,46,3,0.06122
LOS REYES,2023-01-03,51,51,0,0
LOS REYES,2023-01-04,84,84,0,0
LOS REYES,2023-01-05,66,66,0,0
LOS REYES,2023-01-06,70,70,0,0
LOS REYES,2023-01-07,95,95,0,0
LOS REYES,2023-01-08,68,68,0,0
LOS REYES,2023-01-09,72,69,3,0.04167
LOS REYES,2023-01-10,85,85,0,0
LOS REYES,2023-01-11,80,80,0,0
LOS REYES,2023-01-12,89,76,13,0.14607
LOS REYES,2023-01-13,71,71,0,0
LOS REYES,2023-01-14,61,61,0,0
LOS REYES,2023-01-15,54,54,0,0
LOS REYES,2023-01-16,90,90,0,0
LOS REYES,2023-01-17,71,65,6,0.08451
LOS REYES,2023-01-18,75,75,0,0
LOS REYES,2023-01-19,62,61,1,0.01613
LOS REYES,2023-01-20,79,79,0,0
LOS REYES,2023-01-21,167,167,0,0
LOS REYES,2023-01-22,115,114,1,0.0087
LOS REYES,2023-01-23,72,72,0,0
LOS REYES,2023-01-24,81,81,0,0
LOS REYES,2023-01-25,85,85,0,0
LOS REYES,2023-01-26,91,91,0,0
LOS REYES,2023-01-27,88,88,0,0
LOS REYES,2023-01-28,127,125,2,0.01575
LOS REYES,2023-01-29,101,101,0,0
LOS REYES,2023-01-30,89,89,0,0
LOS REYES,2023-01-31,127,127,0,0
LOS REYES,2023-02-02,100,100,0,0
LOS REYES,2023-02-03,191,190,1,0.00524
LOS REYES,2023-02-04,141,82,59,0.41844
LOS REYES,2023-02-05,100,100,0,0
LOS REYES,2023-02-06,91,91,0,0
LOS REYES,2023-02-07,185,185,0,0
LOS REYES,2023-02-08,237,237,0,0
LOS REYES,2023-02-09,320,320,0,0
LOS REYES,2023-02-10,560,560,0,0
LOS REYES,2023-02-11,356,356,0,0
LOS REYES,2023-02-12,441,441,0,0
LOS REYES,2023-02-13,254,254,0,0
LOS REYES,2023-02-14,158,158,0,0
LOS REYES,2023-02-15,384,384,0,0
LOS REYES,2023-02-16,230,226,4,0.01739
LOS REYES,2023-02-17,302,302,0,0
LOS REYES,2023-02-18,476,476,0,0
LOS REYES,2023-02-19,314,313,1,0.00318
LOS REYES,2023-02-20,394,394,0,0
LOS REYES,2023-02-21,239,239,0,0
LOS REYES,2023-02-22,79,79,0,0
LOS REYES,2023-02-23,165,165,0,0
LOS REYES,2023-02-24,110,108,2,0.01818
LOS REYES,2023-02-25,183,183,0,0
LOS REYES,2023-02-26,216,216,0,0
LOS REYES,2023-02-27,128,127,1,0.00781
LOS REYES,2023-02-28,124,124,0,0
LOS REYES,2023-03-01,178,177,1,0.00562
LOS REYES,2023-03-02,211,211,0,0
LOS REYES,2023-03-03,114,104,10,0.08772
LOS REYES,2023-03-04,160,159,1,0.00625
LOS REYES,2023-03-05,126,112,14,0.11111
LOS REYES,2023-03-07,143,142,1,0.00699
LOS REYES,2023-03-08,216,216,0,0
LOS REYES,2023-03-09,77,76,1,0.01299
LOS REYES,2023-03-10,72,68,4,0.05556
LOS REYES,2023-03-11,97,86,11,0.1134
LOS REYES,2023-03-12,78,78,0,0
LOS REYES,2023-03-13,123,120,3,0.02439
LOS REYES,2023-03-14,78,75,3,0.03846
LOS REYES,2023-03-15,64,58,6,0.09375
LOS REYES,2023-03-16,93,93,0,0
LOS REYES,2023-03-17,127,127,0,0
LOS REYES,2023-03-18,95,95,0,0
LOS REYES,2023-03-19,102,102,0,0
LOS REYES,2023-03-20,118,118,0,0
MATAMOROS,2023-01-02,6,6,0,0
MATAMOROS,2023-01-03,9,7,2,0.22222
MATAMOROS,2023-01-04,15,9,6,0.4
MATAMOROS,2023-01-05,2,2,0,0
MATAMOROS,2023-01-06,5,5,0,0
MATAMOROS,2023-01-07,3,3,0,0
MATAMOROS,2023-01-08,4,2,2,0.5
MATAMOROS,2023-01-09,3,0,3,1
MATAMOROS,2023-01-10,7,5,2,0.28571
MATAMOROS,2023-01-11,4,1,3,0.75
MATAMOROS,2023-01-12,5,2,3,0.6
MATAMOROS,2023-01-13,84,60,24,0.28571
MATAMOROS,2023-01-14,69,57,12,0.17391
MATAMOROS,2023-01-15,64,61,3,0.04688
MATAMOROS,2023-01-16,64,51,13,0.20312
MATAMOROS,2023-01-17,85,69,16,0.18824
MATAMOROS,2023-01-18,55,42,13,0.23636
MATAMOROS,2023-01-19,75,65,10,0.13333
MATAMOROS,2023-01-20,65,53,12,0.18462
MATAMOROS,2023-01-21,71,66,5,0.07042
MATAMOROS,2023-01-22,41,35,6,0.14634
MATAMOROS,2023-01-23,72,46,26,0.36111
MATAMOROS,2023-01-24,59,49,10,0.16949
MATAMOROS,2023-01-25,63,55,8,0.12698
MATAMOROS,2023-01-26,55,43,12,0.21818
MATAMOROS,2023-01-27,57,56,1,0.01754
MATAMOROS,2023-01-28,76,75,1,0.01316
MATAMOROS,2023-01-29,56,54,2,0.03571
MATAMOROS,2023-01-30,61,61,0,0
MATAMOROS,2023-01-31,47,45,2,0.04255
MATAMOROS,2023-02-02,43,32,11,0.25581
MATAMOROS,2023-02-03,55,49,6,0.10909
MATAMOROS,2023-02-04,87,78,9,0.10345
MATAMOROS,2023-02-05,44,43,1,0.02273
MATAMOROS,2023-02-06,49,47,2,0.04082
MATAMOROS,2023-02-07,82,80,2,0.02439
MATAMOROS,2023-02-08,64,46,18,0.28125
MATAMOROS,2023-02-09,44,42,2,0.04545
MATAMOROS,2023-02-10,61,57,4,0.06557
MATAMOROS,2023-02-11,53,44,9,0.16981
MATAMOROS,2023-02-12,35,32,3,0.08571
MATAMOROS,2023-02-13,64,59,5,0.07812
MATAMOROS,2023-02-14,78,59,19,0.24359
MATAMOROS,2023-02-15,59,50,9,0.15254
MATAMOROS,2023-02-16,49,44,5,0.10204
MATAMOROS,2023-02-17,46,38,8,0.17391
MATAMOROS,2023-02-18,72,70,2,0.02778
MATAMOROS,2023-02-19,40,36,4,0.1
MATAMOROS,2023-02-20,82,63,19,0.23171
MATAMOROS,2023-02-21,55,43,12,0.21818
MATAMOROS,2023-02-22,51,48,3,0.05882
MATAMOROS,2023-02-23,65,54,11,0.16923
MATAMOROS,2023-02-24,55,53,2,0.03636
MATAMOROS,2023-02-25,73,57,16,0.21918
MATAMOROS,2023-02-26,38,25,13,0.34211
MATAMOROS,2023-02-27,59,51,8,0.13559
MATAMOROS,2023-02-28,71,64,7,0.09859
MATAMOROS,2023-03-01,71,62,9,0.12676
MATAMOROS,2023-03-02,80,71,9,0.1125
MATAMOROS,2023-03-03,75,68,7,0.09333
MATAMOROS,2023-03-04,96,77,19,0.19792
MATAMOROS,2023-03-05,42,36,6,0.14286
MATAMOROS,2023-03-07,99,75,24,0.24242
MATAMOROS,2023-03-08,112,99,13,0.11607
MATAMOROS,2023-03-09,76,63,13,0.17105
MATAMOROS,2023-03-10,85,64,21,0.24706
MATAMOROS,2023-03-11,82,62,20,0.2439
MATAMOROS,2023-03-12,70,58,12,0.17143
MATAMOROS,2023-03-13,57,47,10,0.17544
MATAMOROS,2023-03-14,85,57,28,0.32941
MATAMOROS,2023-03-15,79,63,16,0.20253
MATAMOROS,2023-03-16,71,60,11,0.15493
MATAMOROS,2023-03-17,110,90,20,0.18182
MATAMOROS,2023-03-18,117,104,13,0.11111
MATAMOROS,2023-03-19,81,79,2,0.02469
MATAMOROS,2023-03-20,83,78,5,0.06024
MAZATLAN,2023-01-01,5,5,0,0
MAZATLAN,2023-01-02,46,44,2,0.04348
MAZATLAN,2023-01-03,38,37,1,0.02632
MAZATLAN,2023-01-04,36,32,4,0.11111
MAZATLAN,2023-01-05,5,5,0,0
MAZATLAN,2023-01-06,43,41,2,0.04651
MAZATLAN,2023-01-07,49,44,5,0.10204
MAZATLAN,2023-01-08,13,11,2,0.15385
MAZATLAN,2023-01-09,48,45,3,0.0625
MAZATLAN,2023-01-10,47,44,3,0.06383
MAZATLAN,2023-01-11,30,30,0,0
MAZATLAN,2023-01-12,43,31,12,0.27907
MAZATLAN,2023-01-13,33,31,2,0.06061
MAZATLAN,2023-01-14,46,37,9,0.19565
MAZATLAN,2023-01-15,20,19,1,0.05
MAZATLAN,2023-01-16,30,28,2,0.06667
MAZATLAN,2023-01-17,40,33,7,0.175
MAZATLAN,2023-01-18,29,26,3,0.10345
MAZATLAN,2023-01-19,41,40,1,0.02439
MAZATLAN,2023-01-20,42,31,11,0.2619
MAZATLAN,2023-01-21,54,53,1,0.01852
MAZATLAN,2023-01-22,20,16,4,0.2
MAZATLAN,2023-01-23,35,29,6,0.17143
MAZATLAN,2023-01-24,23,19,4,0.17391
MAZATLAN,2023-01-25,37,35,2,0.05405
MAZATLAN,2023-01-26,28,28,0,0
MAZATLAN,2023-01-27,43,40,3,0.06977
MAZATLAN,2023-01-28,35,34,1,0.02857
MAZATLAN,2023-01-29,21,19,2,0.09524
MAZATLAN,2023-01-30,46,37,9,0.19565
MAZATLAN,2023-01-31,34,31,3,0.08824
MAZATLAN,2023-02-02,31,29,2,0.06452
MAZATLAN,2023-02-03,24,24,0,0
MAZATLAN,2023-02-04,29,26,3,0.10345
MAZATLAN,2023-02-05,11,11,0,0
MAZATLAN,2023-02-06,17,16,1,0.05882
MAZATLAN,2023-02-07,24,23,1,0.04167
MAZATLAN,2023-02-08,42,40,2,0.04762
MAZATLAN,2023-02-09,30,29,1,0.03333
MAZATLAN,2023-02-10,34,32,2,0.05882
MAZATLAN,2023-02-11,40,38,2,0.05
MAZATLAN,2023-02-12,17,17,0,0
MAZATLAN,2023-02-13,15,14,1,0.06667
MAZATLAN,2023-02-14,28,25,3,0.10714
MAZATLAN,2023-02-15,42,41,1,0.02381
MAZATLAN,2023-02-16,31,29,2,0.06452
MAZATLAN,2023-02-17,33,28,5,0.15152
MAZATLAN,2023-02-18,39,39,0,0
MAZATLAN,2023-02-19,4,4,0,0
MAZATLAN,2023-02-20,26,26,0,0
MAZATLAN,2023-02-21,18,18,0,0
MAZATLAN,2023-02-22,24,23,1,0.04167
MAZATLAN,2023-02-23,66,49,17,0.25758
MAZATLAN,2023-02-24,88,71,17,0.19318
MAZATLAN,2023-02-25,58,58,0,0
MAZATLAN,2023-02-26,21,20,1,0.04762
MAZATLAN,2023-02-27,62,61,1,0.01613
MAZATLAN,2023-02-28,45,40,5,0.11111
MAZATLAN,2023-03-01,38,37,1,0.02632
MAZATLAN,2023-03-02,81,77,4,0.04938
MAZATLAN,2023-03-03,29,29,0,0
MAZATLAN,2023-03-04,58,57,1,0.01724
MAZATLAN,2023-03-05,27,24,3,0.11111
MAZATLAN,2023-03-07,32,26,6,0.1875
MAZATLAN,2023-03-08,31,30,1,0.03226
MAZATLAN,2023-03-09,28,28,0,0
MAZATLAN,2023-03-10,35,31,4,0.11429
MAZATLAN,2023-03-11,56,49,7,0.125
MAZATLAN,2023-03-12,11,8,3,0.27273
MAZATLAN,2023-03-13,39,39,0,0
MAZATLAN,2023-03-14,54,51,3,0.05556
MAZATLAN,2023-03-15,42,36,6,0.14286
MAZATLAN,2023-03-16,38,38,0,0
MAZATLAN,2023-03-17,44,40,4,0.09091
MAZATLAN,2023-03-18,46,35,11,0.23913
MAZATLAN,2023-03-19,36,31,5,0.13889
MAZATLAN,2023-03-20,52,46,6,0.11538
MERIDA NORTE,2023-01-02,27,26,1,0.03704
MERIDA NORTE,2023-01-03,24,19,5,0.20833
MERIDA NORTE,2023-01-04,70,69,1,0.01429
MERIDA NORTE,2023-01-05,75,75,0,0
MERIDA NORTE,2023-01-06,47,32,15,0.31915
MERIDA NORTE,2023-01-07,48,47,1,0.02083
MERIDA NORTE,2023-01-08,41,40,1,0.02439
MERIDA NORTE,2023-01-09,71,70,1,0.01408
MERIDA NORTE,2023-01-10,85,64,21,0.24706
MERIDA NORTE,2023-01-11,78,76,2,0.02564
MERIDA NORTE,2023-01-12,80,78,2,0.025
MERIDA NORTE,2023-01-13,47,22,25,0.53191
MERIDA NORTE,2023-01-14,59,53,6,0.10169
MERIDA NORTE,2023-01-15,27,22,5,0.18519
MERIDA NORTE,2023-01-16,46,44,2,0.04348
MERIDA NORTE,2023-01-17,70,66,4,0.05714
MERIDA NORTE,2023-01-18,118,79,39,0.33051
MERIDA NORTE,2023-01-19,120,120,0,0
MERIDA NORTE,2023-01-20,53,45,8,0.15094
MERIDA NORTE,2023-01-21,39,38,1,0.02564
MERIDA NORTE,2023-01-22,77,54,23,0.2987
MERIDA NORTE,2023-01-23,239,173,66,0.27615
MERIDA NORTE,2023-01-24,103,90,13,0.12621
MERIDA NORTE,2023-01-25,69,55,14,0.2029
MERIDA NORTE,2023-01-26,85,77,8,0.09412
MERIDA NORTE,2023-01-27,97,82,15,0.15464
MERIDA NORTE,2023-01-28,58,58,0,0
MERIDA NORTE,2023-01-29,65,45,20,0.30769
MERIDA NORTE,2023-01-30,83,53,30,0.36145
MERIDA NORTE,2023-01-31,67,10,57,0.85075
MERIDA NORTE,2023-02-02,148,124,24,0.16216
MERIDA NORTE,2023-02-03,89,73,16,0.17978
MERIDA NORTE,2023-02-04,126,60,66,0.52381
MERIDA NORTE,2023-02-05,65,53,12,0.18462
MERIDA NORTE,2023-02-06,90,70,20,0.22222
MERIDA NORTE,2023-02-07,60,52,8,0.13333
MERIDA NORTE,2023-02-08,51,45,6,0.11765
MERIDA NORTE,2023-02-09,51,40,11,0.21569
MERIDA NORTE,2023-02-10,62,56,6,0.09677
MERIDA NORTE,2023-02-11,72,51,21,0.29167
MERIDA NORTE,2023-02-12,152,111,41,0.26974
MERIDA NORTE,2023-02-13,163,123,40,0.2454
MERIDA NORTE,2023-02-14,116,101,15,0.12931
MERIDA NORTE,2023-02-15,120,108,12,0.1
MERIDA NORTE,2023-02-16,89,74,15,0.16854
MERIDA NORTE,2023-02-17,88,74,14,0.15909
MERIDA NORTE,2023-02-18,45,39,6,0.13333
MERIDA NORTE,2023-02-19,57,46,11,0.19298
MERIDA NORTE,2023-02-20,55,52,3,0.05455
MERIDA NORTE,2023-02-21,74,62,12,0.16216
MERIDA NORTE,2023-02-22,88,83,5,0.05682
MERIDA NORTE,2023-02-23,75,45,30,0.4
MERIDA NORTE,2023-02-24,113,88,25,0.22124
MERIDA NORTE,2023-02-25,83,83,0,0
MERIDA NORTE,2023-02-26,70,61,9,0.12857
MERIDA NORTE,2023-02-27,70,70,0,0
MERIDA NORTE,2023-02-28,66,53,13,0.19697
MERIDA NORTE,2023-03-01,98,77,21,0.21429
MERIDA NORTE,2023-03-02,124,103,21,0.16935
MERIDA NORTE,2023-03-03,111,95,16,0.14414
MERIDA NORTE,2023-03-04,96,60,36,0.375
MERIDA NORTE,2023-03-05,100,66,34,0.34
MERIDA NORTE,2023-03-07,114,81,33,0.28947
MERIDA NORTE,2023-03-08,206,178,28,0.13592
MERIDA NORTE,2023-03-09,115,104,11,0.09565
MERIDA NORTE,2023-03-10,109,104,5,0.04587
MERIDA NORTE,2023-03-11,86,77,9,0.10465
MERIDA NORTE,2023-03-12,31,28,3,0.09677
MERIDA NORTE,2023-03-13,92,83,9,0.09783
MERIDA NORTE,2023-03-14,68,47,21,0.30882
MERIDA NORTE,2023-03-15,91,90,1,0.01099
MERIDA NORTE,2023-03-16,81,75,6,0.07407
MERIDA NORTE,2023-03-17,69,64,5,0.07246
MERIDA NORTE,2023-03-18,99,98,1,0.0101
MERIDA NORTE,2023-03-19,35,34,1,0.02857
MERIDA NORTE,2023-03-20,78,78,0,0
MERIDA SUR,2023-01-01,1,1,0,0
MERIDA SUR,2023-01-02,16,16,0,0
MERIDA SUR,2023-01-03,23,22,1,0.04348
MERIDA SUR,2023-01-04,24,24,0,0
MERIDA SUR,2023-01-05,55,51,4,0.07273
MERIDA SUR,2023-01-06,36,29,7,0.19444
MERIDA SUR,2023-01-07,34,31,3,0.08824
MERIDA SUR,2023-01-08,21,20,1,0.04762
MERIDA SUR,2023-01-09,33,33,0,0
MERIDA SUR,2023-01-10,16,15,1,0.0625
MERIDA SUR,2023-01-11,34,33,1,0.02941
MERIDA SUR,2023-01-12,31,30,1,0.03226
MERIDA SUR,2023-01-13,26,25,1,0.03846
MERIDA SUR,2023-01-14,33,29,4,0.12121
MERIDA SUR,2023-01-15,22,21,1,0.04545
MERIDA SUR,2023-01-16,63,62,1,0.01587
MERIDA SUR,2023-01-17,55,54,1,0.01818
MERIDA SUR,2023-01-18,45,35,10,0.22222
MERIDA SUR,2023-01-19,30,26,4,0.13333
MERIDA SUR,2023-01-20,83,75,8,0.09639
MERIDA SUR,2023-01-21,93,88,5,0.05376
MERIDA SUR,2023-01-22,51,46,5,0.09804
MERIDA SUR,2023-01-23,80,48,32,0.4
MERIDA SUR,2023-01-24,105,86,19,0.18095
MERIDA SUR,2023-01-25,60,49,11,0.18333
MERIDA SUR,2023-01-26,45,16,29,0.64444
MERIDA SUR,2023-01-27,138,115,23,0.16667
MERIDA SUR,2023-01-28,148,144,4,0.02703
MERIDA SUR,2023-01-29,99,91,8,0.08081
MERIDA SUR,2023-01-30,48,39,9,0.1875
MERIDA SUR,2023-01-31,115,99,16,0.13913
MERIDA SUR,2023-02-02,176,142,34,0.19318
MERIDA SUR,2023-02-03,55,52,3,0.05455
MERIDA SUR,2023-02-04,111,109,2,0.01802
MERIDA SUR,2023-02-05,39,34,5,0.12821
MERIDA SUR,2023-02-06,95,66,29,0.30526
MERIDA SUR,2023-02-07,33,30,3,0.09091
MERIDA SUR,2023-02-08,62,61,1,0.01613
MERIDA SUR,2023-02-09,36,33,3,0.08333
MERIDA SUR,2023-02-10,179,151,28,0.15642
MERIDA SUR,2023-02-11,117,116,1,0.00855
MERIDA SUR,2023-02-12,29,28,1,0.03448
MERIDA SUR,2023-02-13,45,33,12,0.26667
MERIDA SUR,2023-02-14,151,136,15,0.09934
MERIDA SUR,2023-02-15,125,125,0,0
MERIDA SUR,2023-02-16,114,108,6,0.05263
MERIDA SUR,2023-02-17,34,27,7,0.20588
MERIDA SUR,2023-02-18,91,77,14,0.15385
MERIDA SUR,2023-02-19,78,33,45,0.57692
MERIDA SUR,2023-02-20,38,33,5,0.13158
MERIDA SUR,2023-02-21,66,27,39,0.59091
MERIDA SUR,2023-02-22,63,41,22,0.34921
MERIDA SUR,2023-02-23,41,39,2,0.04878
MERIDA SUR,2023-02-24,103,52,51,0.49515
MERIDA SUR,2023-02-25,69,49,20,0.28986
MERIDA SUR,2023-02-26,76,58,18,0.23684
MERIDA SUR,2023-02-27,36,33,3,0.08333
MERIDA SUR,2023-02-28,53,46,7,0.13208
MERIDA SUR,2023-03-01,21,18,3,0.14286
MERIDA SUR,2023-03-02,55,51,4,0.07273
MERIDA SUR,2023-03-03,17,14,3,0.17647
MERIDA SUR,2023-03-04,29,28,1,0.03448
MERIDA SUR,2023-03-05,39,36,3,0.07692
MERIDA SUR,2023-03-07,38,31,7,0.18421
MERIDA SUR,2023-03-08,32,27,5,0.15625
MERIDA SUR,2023-03-09,22,21,1,0.04545
MERIDA SUR,2023-03-10,19,14,5,0.26316
MERIDA SUR,2023-03-11,37,33,4,0.10811
MERIDA SUR,2023-03-12,57,32,25,0.4386
MERIDA SUR,2023-03-13,29,26,3,0.10345
MERIDA SUR,2023-03-14,14,9,5,0.35714
MERIDA SUR,2023-03-15,63,39,24,0.38095
MERIDA SUR,2023-03-16,39,39,0,0
MERIDA SUR,2023-03-17,40,38,2,0.05
MERIDA SUR,2023-03-18,87,85,2,0.02299
MERIDA SUR,2023-03-19,17,17,0,0
MERIDA SUR,2023-03-20,39,37,2,0.05128
MEXICALI,2023-01-01,1,0,1,1
MEXICALI,2023-01-02,57,42,15,0.26316
MEXICALI,2023-01-03,55,40,15,0.27273
MEXICALI,2023-01-04,66,60,6,0.09091
MEXICALI,2023-01-05,44,42,2,0.04545
MEXICALI,2023-01-06,52,46,6,0.11538
MEXICALI,2023-01-07,59,55,4,0.0678
MEXICALI,2023-01-08,50,33,17,0.34
MEXICALI,2023-01-09,50,38,12,0.24
MEXICALI,2023-01-10,76,63,13,0.17105
MEXICALI,2023-01-11,48,36,12,0.25
MEXICALI,2023-01-12,52,39,13,0.25
MEXICALI,2023-01-13,88,73,15,0.17045
MEXICALI,2023-01-14,47,42,5,0.10638
MEXICALI,2023-01-15,56,44,12,0.21429
MEXICALI,2023-01-16,34,26,8,0.23529
MEXICALI,2023-01-17,81,43,38,0.46914
MEXICALI,2023-01-18,47,32,15,0.31915
MEXICALI,2023-01-19,99,65,34,0.34343
MEXICALI,2023-01-20,68,44,24,0.35294
MEXICALI,2023-01-21,63,38,25,0.39683
MEXICALI,2023-01-22,49,23,26,0.53061
MEXICALI,2023-01-23,71,44,27,0.38028
MEXICALI,2023-01-24,51,29,22,0.43137
MEXICALI,2023-01-25,31,15,16,0.51613
MEXICALI,2023-01-26,64,40,24,0.375
MEXICALI,2023-01-27,50,41,9,0.18
MEXICALI,2023-01-28,89,44,45,0.50562
MEXICALI,2023-01-29,47,26,21,0.44681
MEXICALI,2023-01-30,59,42,17,0.28814
MEXICALI,2023-01-31,77,46,31,0.4026
MEXICALI,2023-02-01,1,0,1,1
MEXICALI,2023-02-02,48,24,24,0.5
MEXICALI,2023-02-03,64,41,23,0.35938
MEXICALI,2023-02-04,83,57,26,0.31325
MEXICALI,2023-02-05,43,7,36,0.83721
MEXICALI,2023-02-06,61,38,23,0.37705
MEXICALI,2023-02-07,62,41,21,0.33871
MEXICALI,2023-02-08,54,22,32,0.59259
MEXICALI,2023-02-09,73,44,29,0.39726
MEXICALI,2023-02-10,69,54,15,0.21739
MEXICALI,2023-02-11,80,62,18,0.225
MEXICALI,2023-02-12,57,33,24,0.42105
MEXICALI,2023-02-13,57,31,26,0.45614
MEXICALI,2023-02-14,48,31,17,0.35417
MEXICALI,2023-02-15,37,19,18,0.48649
MEXICALI,2023-02-16,56,28,28,0.5
MEXICALI,2023-02-17,90,42,48,0.53333
MEXICALI,2023-02-18,97,39,58,0.59794
MEXICALI,2023-02-19,53,17,36,0.67925
MEXICALI,2023-02-20,69,40,29,0.42029
MEXICALI,2023-02-21,110,49,61,0.55455
MEXICALI,2023-02-22,64,52,12,0.1875
MEXICALI,2023-02-23,35,21,14,0.4
MEXICALI,2023-02-24,61,23,38,0.62295
MEXICALI,2023-02-25,85,12,73,0.85882
MEXICALI,2023-02-26,68,6,62,0.91176
MEXICALI,2023-02-27,57,8,49,0.85965
MEXICALI,2023-02-28,64,33,31,0.48438
MEXICALI,2023-03-01,37,16,21,0.56757
MEXICALI,2023-03-02,45,25,20,0.44444
MEXICALI,2023-03-03,61,23,38,0.62295
MEXICALI,2023-03-04,78,35,43,0.55128
MEXICALI,2023-03-05,39,12,27,0.69231
MEXICALI,2023-03-07,73,26,47,0.64384
MEXICALI,2023-03-08,76,15,61,0.80263
MEXICALI,2023-03-09,54,15,39,0.72222
MEXICALI,2023-03-10,67,40,27,0.40299
MEXICALI,2023-03-11,62,26,36,0.58065
MEXICALI,2023-03-12,70,33,37,0.52857
MEXICALI,2023-03-13,74,41,33,0.44595
MEXICALI,2023-03-14,52,17,35,0.67308
MEXICALI,2023-03-15,65,15,50,0.76923
MEXICALI,2023-03-16,42,15,27,0.64286
MEXICALI,2023-03-17,98,34,64,0.65306
MEXICALI,2023-03-18,83,20,63,0.75904
MEXICALI,2023-03-19,57,16,41,0.7193
MEXICALI,2023-03-20,31,13,18,0.58065
MILPA ALTA,2023-01-02,20,10,10,0.5
MILPA ALTA,2023-01-03,47,25,22,0.46809
MILPA ALTA,2023-01-04,29,22,7,0.24138
MILPA ALTA,2023-01-05,38,27,11,0.28947
MILPA ALTA,2023-01-06,31,24,7,0.22581
MILPA ALTA,2023-01-07,33,24,9,0.27273
MILPA ALTA,2023-01-08,49,37,12,0.2449
MILPA ALTA,2023-01-09,41,29,12,0.29268
MILPA ALTA,2023-01-10,31,17,14,0.45161
MILPA ALTA,2023-01-11,53,32,21,0.39623
MILPA ALTA,2023-01-12,42,26,16,0.38095
MILPA ALTA,2023-01-13,43,38,5,0.11628
MILPA ALTA,2023-01-14,43,33,10,0.23256
MILPA ALTA,2023-01-15,32,21,11,0.34375
MILPA ALTA,2023-01-16,33,20,13,0.39394
MILPA ALTA,2023-01-17,67,26,41,0.61194
MILPA ALTA,2023-01-18,71,60,11,0.15493
MILPA ALTA,2023-01-19,52,26,26,0.5
MILPA ALTA,2023-01-20,40,29,11,0.275
MILPA ALTA,2023-01-21,71,41,30,0.42254
MILPA ALTA,2023-01-22,36,25,11,0.30556
MILPA ALTA,2023-01-23,78,48,30,0.38462
MILPA ALTA,2023-01-24,66,36,30,0.45455
MILPA ALTA,2023-01-25,122,102,20,0.16393
MILPA ALTA,2023-01-26,68,39,29,0.42647
MILPA ALTA,2023-01-27,80,59,21,0.2625
MILPA ALTA,2023-01-28,118,62,56,0.47458
MILPA ALTA,2023-01-29,90,46,44,0.48889
MILPA ALTA,2023-01-30,192,79,113,0.58854
MILPA ALTA,2023-01-31,108,39,69,0.63889
MILPA ALTA,2023-02-02,73,60,13,0.17808
MILPA ALTA,2023-02-03,153,72,81,0.52941
MILPA ALTA,2023-02-04,106,77,29,0.27358
MILPA ALTA,2023-02-05,57,37,20,0.35088
MILPA ALTA,2023-02-06,98,71,27,0.27551
MILPA ALTA,2023-02-07,132,82,50,0.37879
MILPA ALTA,2023-02-08,67,28,39,0.58209
MILPA ALTA,2023-02-09,112,44,68,0.60714
MILPA ALTA,2023-02-10,63,29,34,0.53968
MILPA ALTA,2023-02-11,97,39,58,0.59794
MILPA ALTA,2023-02-12,86,83,3,0.03488
MILPA ALTA,2023-02-13,114,94,20,0.17544
MILPA ALTA,2023-02-14,79,57,22,0.27848
MILPA ALTA,2023-02-15,127,93,34,0.26772
MILPA ALTA,2023-02-16,112,37,75,0.66964
MILPA ALTA,2023-02-17,181,155,26,0.14365
MILPA ALTA,2023-02-18,112,81,31,0.27679
MILPA ALTA,2023-02-19,52,39,13,0.25
MILPA ALTA,2023-02-20,76,65,11,0.14474
MILPA ALTA,2023-02-21,38,15,23,0.60526
MILPA ALTA,2023-02-22,62,40,22,0.35484
MILPA ALTA,2023-02-23,104,90,14,0.13462
MILPA ALTA,2023-02-24,121,65,56,0.46281
MILPA ALTA,2023-02-25,92,50,42,0.45652
MILPA ALTA,2023-02-26,47,34,13,0.2766
MILPA ALTA,2023-02-27,86,61,25,0.2907
MILPA ALTA,2023-02-28,60,26,34,0.56667
MILPA ALTA,2023-03-01,99,49,50,0.50505
MILPA ALTA,2023-03-02,50,34,16,0.32
MILPA ALTA,2023-03-03,62,49,13,0.20968
MILPA ALTA,2023-03-04,72,55,17,0.23611
MILPA ALTA,2023-03-05,43,32,11,0.25581
MILPA ALTA,2023-03-07,123,74,49,0.39837
MILPA ALTA,2023-03-08,62,41,21,0.33871
MILPA ALTA,2023-03-09,73,27,46,0.63014
MILPA ALTA,2023-03-10,65,47,18,0.27692
MILPA ALTA,2023-03-11,51,27,24,0.47059
MILPA ALTA,2023-03-12,19,12,7,0.36842
MILPA ALTA,2023-03-13,21,12,9,0.42857
MILPA ALTA,2023-03-14,54,15,39,0.72222
MILPA ALTA,2023-03-15,82,67,15,0.18293
MILPA ALTA,2023-03-16,54,43,11,0.2037
MILPA ALTA,2023-03-17,100,86,14,0.14
MILPA ALTA,2023-03-18,109,91,18,0.16514
MILPA ALTA,2023-03-19,100,87,13,0.13
MILPA ALTA,2023-03-20,74,63,11,0.14865
MORELIA,2023-01-01,7,7,0,0
MORELIA,2023-01-02,23,23,0,0
MORELIA,2023-01-03,20,20,0,0
MORELIA,2023-01-04,14,14,0,0
MORELIA,2023-01-05,28,28,0,0
MORELIA,2023-01-06,25,25,0,0
MORELIA,2023-01-07,33,33,0,0
MORELIA,2023-01-08,15,15,0,0
MORELIA,2023-01-09,28,28,0,0
MORELIA,2023-01-10,32,32,0,0
MORELIA,2023-01-11,28,28,0,0
MORELIA,2023-01-12,33,32,1,0.0303
MORELIA,2023-01-13,25,25,0,0
MORELIA,2023-01-14,20,20,0,0
MORELIA,2023-01-15,17,17,0,0
MORELIA,2023-01-16,24,24,0,0
MORELIA,2023-01-17,17,17,0,0
MORELIA,2023-01-18,18,18,0,0
MORELIA,2023-01-19,25,25,0,0
MORELIA,2023-01-20,20,20,0,0
MORELIA,2023-01-21,37,37,0,0
MORELIA,2023-01-22,6,6,0,0
MORELIA,2023-01-23,32,32,0,0
MORELIA,2023-01-24,43,43,0,0
MORELIA,2023-01-25,66,64,2,0.0303
MORELIA,2023-01-26,62,62,0,0
MORELIA,2023-01-27,26,25,1,0.03846
MORELIA,2023-01-28,58,26,32,0.55172
MORELIA,2023-01-29,8,8,0,0
MORELIA,2023-01-30,16,16,0,0
MORELIA,2023-01-31,48,48,0,0
MORELIA,2023-02-02,35,35,0,0
MORELIA,2023-02-03,21,21,0,0
MORELIA,2023-02-04,38,38,0,0
MORELIA,2023-02-05,31,31,0,0
MORELIA,2023-02-06,30,30,0,0
MORELIA,2023-02-07,34,34,0,0
MORELIA,2023-02-08,81,81,0,0
MORELIA,2023-02-09,22,22,0,0
MORELIA,2023-02-10,33,32,1,0.0303
MORELIA,2023-02-11,37,37,0,0
MORELIA,2023-02-12,16,16,0,0
MORELIA,2023-02-13,70,70,0,0
MORELIA,2023-02-14,58,58,0,0
MORELIA,2023-02-15,20,20,0,0
MORELIA,2023-02-16,35,34,1,0.02857
MORELIA,2023-02-17,63,63,0,0
MORELIA,2023-02-18,40,40,0,0
MORELIA,2023-02-19,37,37,0,0
MORELIA,2023-02-20,76,76,0,0
MORELIA,2023-02-21,41,41,0,0
MORELIA,2023-02-22,82,82,0,0
MORELIA,2023-02-23,81,81,0,0
MORELIA,2023-02-24,53,53,0,0
MORELIA,2023-02-25,31,31,0,0
MORELIA,2023-02-26,10,10,0,0
MORELIA,2023-02-27,41,41,0,0
MORELIA,2023-02-28,87,87,0,0
MORELIA,2023-03-01,38,38,0,0
MORELIA,2023-03-03,1,0,1,1
MTY AEROPUERTO,2023-01-02,17,6,11,0.64706
MTY AEROPUERTO,2023-01-03,35,26,9,0.25714
MTY AEROPUERTO,2023-01-04,34,14,20,0.58824
MTY AEROPUERTO,2023-01-05,45,26,19,0.42222
MTY AEROPUERTO,2023-01-06,44,34,10,0.22727
MTY AEROPUERTO,2023-01-07,64,48,16,0.25
MTY AEROPUERTO,2023-01-08,36,24,12,0.33333
MTY AEROPUERTO,2023-01-09,56,45,11,0.19643
MTY AEROPUERTO,2023-01-10,79,40,39,0.49367
MTY AEROPUERTO,2023-01-11,24,10,14,0.58333
MTY AEROPUERTO,2023-01-12,32,26,6,0.1875
MTY AEROPUERTO,2023-01-13,54,34,20,0.37037
MTY AEROPUERTO,2023-01-14,48,25,23,0.47917
MTY AEROPUERTO,2023-01-15,39,7,32,0.82051
MTY AEROPUERTO,2023-01-16,37,29,8,0.21622
MTY AEROPUERTO,2023-01-17,50,45,5,0.1
MTY AEROPUERTO,2023-01-18,48,46,2,0.04167
MTY AEROPUERTO,2023-01-19,42,40,2,0.04762
MTY AEROPUERTO,2023-01-20,60,53,7,0.11667
MTY AEROPUERTO,2023-01-21,59,47,12,0.20339
MTY AEROPUERTO,2023-01-22,38,24,14,0.36842
MTY AEROPUERTO,2023-01-23,39,22,17,0.4359
MTY AEROPUERTO,2023-01-24,31,27,4,0.12903
MTY AEROPUERTO,2023-01-25,59,39,20,0.33898
MTY AEROPUERTO,2023-01-26,57,35,22,0.38596
MTY AEROPUERTO,2023-01-27,49,34,15,0.30612
MTY AEROPUERTO,2023-01-28,49,37,12,0.2449
MTY AEROPUERTO,2023-01-29,48,36,12,0.25
MTY AEROPUERTO,2023-01-30,37,28,9,0.24324
MTY AEROPUERTO,2023-01-31,48,27,21,0.4375
MTY AEROPUERTO,2023-02-02,67,43,24,0.35821
MTY AEROPUERTO,2023-02-03,83,35,48,0.57831
MTY AEROPUERTO,2023-02-04,77,39,38,0.49351
MTY AEROPUERTO,2023-02-05,42,31,11,0.2619
MTY AEROPUERTO,2023-02-06,24,17,7,0.29167
MTY AEROPUERTO,2023-02-07,47,13,34,0.7234
MTY AEROPUERTO,2023-02-08,35,22,13,0.37143
MTY AEROPUERTO,2023-02-09,34,26,8,0.23529
MTY AEROPUERTO,2023-02-10,32,25,7,0.21875
MTY AEROPUERTO,2023-02-11,42,12,30,0.71429
MTY AEROPUERTO,2023-02-12,49,33,16,0.32653
MTY AEROPUERTO,2023-02-13,37,27,10,0.27027
MTY AEROPUERTO,2023-02-14,53,15,38,0.71698
MTY AEROPUERTO,2023-02-15,43,29,14,0.32558
MTY AEROPUERTO,2023-02-16,35,24,11,0.31429
MTY AEROPUERTO,2023-02-17,27,15,12,0.44444
MTY AEROPUERTO,2023-02-18,52,22,30,0.57692
MTY AEROPUERTO,2023-02-19,35,16,19,0.54286
MTY AEROPUERTO,2023-02-20,32,17,15,0.46875
MTY AEROPUERTO,2023-02-21,45,21,24,0.53333
MTY AEROPUERTO,2023-02-22,47,26,21,0.44681
MTY AEROPUERTO,2023-02-23,44,30,14,0.31818
MTY AEROPUERTO,2023-02-24,40,32,8,0.2
MTY AEROPUERTO,2023-02-25,59,30,29,0.49153
MTY AEROPUERTO,2023-02-26,34,24,10,0.29412
MTY AEROPUERTO,2023-02-27,36,20,16,0.44444
MTY AEROPUERTO,2023-02-28,44,28,16,0.36364
MTY AEROPUERTO,2023-03-01,30,26,4,0.13333
MTY AEROPUERTO,2023-03-02,36,23,13,0.36111
MTY AEROPUERTO,2023-03-03,51,28,23,0.45098
MTY AEROPUERTO,2023-03-04,45,38,7,0.15556
MTY AEROPUERTO,2023-03-05,14,13,1,0.07143
MTY AEROPUERTO,2023-03-07,22,18,4,0.18182
MTY AEROPUERTO,2023-03-08,33,17,16,0.48485
MTY AEROPUERTO,2023-03-09,34,23,11,0.32353
MTY AEROPUERTO,2023-03-10,32,17,15,0.46875
MTY AEROPUERTO,2023-03-11,61,38,23,0.37705
MTY AEROPUERTO,2023-03-12,45,22,23,0.51111
MTY AEROPUERTO,2023-03-13,29,19,10,0.34483
MTY AEROPUERTO,2023-03-14,29,22,7,0.24138
MTY AEROPUERTO,2023-03-15,25,25,0,0
MTY AEROPUERTO,2023-03-16,24,23,1,0.04167
MTY AEROPUERTO,2023-03-17,27,17,10,0.37037
MTY AEROPUERTO,2023-03-18,33,23,10,0.30303
MTY AEROPUERTO,2023-03-19,25,23,2,0.08
MTY AEROPUERTO,2023-03-20,18,15,3,0.16667
MTY CARRETERA NACIONAL,2023-01-01,1,1,0,0
MTY CARRETERA NACIONAL,2023-01-02,31,16,15,0.48387
MTY CARRETERA NACIONAL,2023-01-03,50,41,9,0.18
MTY CARRETERA NACIONAL,2023-01-04,85,44,41,0.48235
MTY CARRETERA NACIONAL,2023-01-05,65,38,27,0.41538
MTY CARRETERA NACIONAL,2023-01-06,83,30,53,0.63855
MTY CARRETERA NACIONAL,2023-01-07,48,21,27,0.5625
MTY CARRETERA NACIONAL,2023-01-08,33,22,11,0.33333
MTY CARRETERA NACIONAL,2023-01-09,63,18,45,0.71429
MTY CARRETERA NACIONAL,2023-01-10,55,18,37,0.67273
MTY CARRETERA NACIONAL,2023-01-11,48,23,25,0.52083
MTY CARRETERA NACIONAL,2023-01-12,69,23,46,0.66667
MTY CARRETERA NACIONAL,2023-01-13,50,27,23,0.46
MTY CARRETERA NACIONAL,2023-01-14,51,18,33,0.64706
MTY CARRETERA NACIONAL,2023-01-15,29,18,11,0.37931
MTY CARRETERA NACIONAL,2023-01-16,59,31,28,0.47458
MTY CARRETERA NACIONAL,2023-01-17,59,45,14,0.23729
MTY CARRETERA NACIONAL,2023-01-18,47,46,1,0.02128
MTY CARRETERA NACIONAL,2023-01-19,46,34,12,0.26087
MTY CARRETERA NACIONAL,2023-01-20,52,45,7,0.13462
MTY CARRETERA NACIONAL,2023-01-21,67,32,35,0.52239
MTY CARRETERA NACIONAL,2023-01-22,28,16,12,0.42857
MTY CARRETERA NACIONAL,2023-01-23,60,41,19,0.31667
MTY CARRETERA NACIONAL,2023-01-24,68,34,34,0.5
MTY CARRETERA NACIONAL,2023-01-25,45,39,6,0.13333
MTY CARRETERA NACIONAL,2023-01-26,48,35,13,0.27083
MTY CARRETERA NACIONAL,2023-01-27,48,21,27,0.5625
MTY CARRETERA NACIONAL,2023-01-28,77,38,39,0.50649
MTY CARRETERA NACIONAL,2023-01-29,76,36,40,0.52632
MTY CARRETERA NACIONAL,2023-01-30,90,65,25,0.27778
MTY CARRETERA NACIONAL,2023-01-31,45,29,16,0.35556
MTY CARRETERA NACIONAL,2023-02-02,64,40,24,0.375
MTY CARRETERA NACIONAL,2023-02-03,66,54,12,0.18182
MTY CARRETERA NACIONAL,2023-02-04,71,66,5,0.07042
MTY CARRETERA NACIONAL,2023-02-05,37,27,10,0.27027
MTY CARRETERA NACIONAL,2023-02-06,12,6,6,0.5
MTY CARRETERA NACIONAL,2023-02-07,60,38,22,0.36667
MTY CARRETERA NACIONAL,2023-02-08,63,53,10,0.15873
MTY CARRETERA NACIONAL,2023-02-09,41,35,6,0.14634
MTY CARRETERA NACIONAL,2023-02-10,55,40,15,0.27273
MTY CARRETERA NACIONAL,2023-02-11,48,37,11,0.22917
MTY CARRETERA NACIONAL,2023-02-12,29,24,5,0.17241
MTY CARRETERA NACIONAL,2023-02-13,32,24,8,0.25
MTY CARRETERA NACIONAL,2023-02-14,40,32,8,0.2
MTY CARRETERA NACIONAL,2023-02-15,90,57,33,0.36667
MTY CARRETERA NACIONAL,2023-02-16,60,52,8,0.13333
MTY CARRETERA NACIONAL,2023-02-17,42,26,16,0.38095
MTY CARRETERA NACIONAL,2023-02-18,85,40,45,0.52941
MTY CARRETERA NACIONAL,2023-02-19,28,10,18,0.64286
MTY CARRETERA NACIONAL,2023-02-20,44,25,19,0.43182
MTY CARRETERA NACIONAL,2023-02-21,51,37,14,0.27451
MTY CARRETERA NACIONAL,2023-02-22,55,40,15,0.27273
MTY CARRETERA NACIONAL,2023-02-23,50,29,21,0.42
MTY CARRETERA NACIONAL,2023-02-24,38,30,8,0.21053
MTY CARRETERA NACIONAL,2023-02-25,70,40,30,0.42857
MTY CARRETERA NACIONAL,2023-02-26,19,14,5,0.26316
MTY CARRETERA NACIONAL,2023-02-27,58,47,11,0.18966
MTY CARRETERA NACIONAL,2023-02-28,38,17,21,0.55263
MTY CARRETERA NACIONAL,2023-03-01,30,25,5,0.16667
MTY CARRETERA NACIONAL,2023-03-02,42,21,21,0.5
MTY CARRETERA NACIONAL,2023-03-03,48,32,16,0.33333
MTY CARRETERA NACIONAL,2023-03-04,87,69,18,0.2069
MTY CARRETERA NACIONAL,2023-03-05,29,18,11,0.37931
MTY CARRETERA NACIONAL,2023-03-07,27,18,9,0.33333
MTY CARRETERA NACIONAL,2023-03-08,51,41,10,0.19608
MTY CARRETERA NACIONAL,2023-03-09,35,26,9,0.25714
MTY CARRETERA NACIONAL,2023-03-10,33,26,7,0.21212
MTY CARRETERA NACIONAL,2023-03-11,49,38,11,0.22449
MTY CARRETERA NACIONAL,2023-03-12,25,16,9,0.36
MTY CARRETERA NACIONAL,2023-03-13,29,24,5,0.17241
MTY CARRETERA NACIONAL,2023-03-14,33,27,6,0.18182
MTY CARRETERA NACIONAL,2023-03-15,38,31,7,0.18421
MTY CARRETERA NACIONAL,2023-03-16,43,40,3,0.06977
MTY CARRETERA NACIONAL,2023-03-17,50,46,4,0.08
MTY CARRETERA NACIONAL,2023-03-18,60,50,10,0.16667
MTY CARRETERA NACIONAL,2023-03-19,43,41,2,0.04651
MTY CARRETERA NACIONAL,2023-03-20,96,25,71,0.73958
MTY CERRO DE LA SILLA,2023-01-02,28,23,5,0.17857
MTY CERRO DE LA SILLA,2023-01-03,48,43,5,0.10417
MTY CERRO DE LA SILLA,2023-01-04,35,31,4,0.11429
MTY CERRO DE LA SILLA,2023-01-05,47,43,4,0.08511
MTY CERRO DE LA SILLA,2023-01-06,61,56,5,0.08197
MTY CERRO DE LA SILLA,2023-01-07,47,45,2,0.04255
MTY CERRO DE LA SILLA,2023-01-08,27,25,2,0.07407
MTY CERRO DE LA SILLA,2023-01-09,37,29,8,0.21622
MTY CERRO DE LA SILLA,2023-01-10,36,36,0,0
MTY CERRO DE LA SILLA,2023-01-11,39,38,1,0.02564
MTY CERRO DE LA SILLA,2023-01-12,36,34,2,0.05556
MTY CERRO DE LA SILLA,2023-01-13,42,39,3,0.07143
MTY CERRO DE LA SILLA,2023-01-14,72,62,10,0.13889
MTY CERRO DE LA SILLA,2023-01-15,71,62,9,0.12676
MTY CERRO DE LA SILLA,2023-01-16,41,32,9,0.21951
MTY CERRO DE LA SILLA,2023-01-17,39,33,6,0.15385
MTY CERRO DE LA SILLA,2023-01-18,37,33,4,0.10811
MTY CERRO DE LA SILLA,2023-01-19,22,15,7,0.31818
MTY CERRO DE LA SILLA,2023-01-20,37,29,8,0.21622
MTY CERRO DE LA SILLA,2023-01-21,56,40,16,0.28571
MTY CERRO DE LA SILLA,2023-01-22,29,25,4,0.13793
MTY CERRO DE LA SILLA,2023-01-23,43,38,5,0.11628
MTY CERRO DE LA SILLA,2023-01-24,41,32,9,0.21951
MTY CERRO DE LA SILLA,2023-01-25,48,41,7,0.14583
MTY CERRO DE LA SILLA,2023-01-26,29,21,8,0.27586
MTY CERRO DE LA SILLA,2023-01-27,51,37,14,0.27451
MTY CERRO DE LA SILLA,2023-01-28,48,44,4,0.08333
MTY CERRO DE LA SILLA,2023-01-29,37,22,15,0.40541
MTY CERRO DE LA SILLA,2023-01-30,28,26,2,0.07143
MTY CERRO DE LA SILLA,2023-01-31,33,24,9,0.27273
MTY CERRO DE LA SILLA,2023-02-02,36,28,8,0.22222
MTY CERRO DE LA SILLA,2023-02-03,37,31,6,0.16216
MTY CERRO DE LA SILLA,2023-02-04,64,47,17,0.26562
MTY CERRO DE LA SILLA,2023-02-05,26,23,3,0.11538
MTY CERRO DE LA SILLA,2023-02-06,28,15,13,0.46429
MTY CERRO DE LA SILLA,2023-02-07,53,46,7,0.13208
MTY CERRO DE LA SILLA,2023-02-08,26,24,2,0.07692
MTY CERRO DE LA SILLA,2023-02-09,29,23,6,0.2069
MTY CERRO DE LA SILLA,2023-02-10,31,28,3,0.09677
MTY CERRO DE LA SILLA,2023-02-11,48,47,1,0.02083
MTY CERRO DE LA SILLA,2023-02-12,23,5,18,0.78261
MTY CERRO DE LA SILLA,2023-02-13,28,23,5,0.17857
MTY CERRO DE LA SILLA,2023-02-14,34,25,9,0.26471
MTY CERRO DE LA SILLA,2023-02-15,53,41,12,0.22642
MTY CERRO DE LA SILLA,2023-02-16,35,29,6,0.17143
MTY CERRO DE LA SILLA,2023-02-17,35,19,16,0.45714
MTY CERRO DE LA SILLA,2023-02-18,74,37,37,0.5
MTY CERRO DE LA SILLA,2023-02-19,24,20,4,0.16667
MTY CERRO DE LA SILLA,2023-02-20,38,23,15,0.39474
MTY CERRO DE LA SILLA,2023-02-21,36,28,8,0.22222
MTY CERRO DE LA SILLA,2023-02-22,33,27,6,0.18182
MTY CERRO DE LA SILLA,2023-02-23,48,28,20,0.41667
MTY CERRO DE LA SILLA,2023-02-24,23,10,13,0.56522
MTY CERRO DE LA SILLA,2023-02-25,47,36,11,0.23404
MTY CERRO DE LA SILLA,2023-02-26,22,9,13,0.59091
MTY CERRO DE LA SILLA,2023-02-27,44,29,15,0.34091
MTY CERRO DE LA SILLA,2023-02-28,32,24,8,0.25
MTY CERRO DE LA SILLA,2023-03-01,43,24,19,0.44186
MTY CERRO DE LA SILLA,2023-03-02,35,18,17,0.48571
MTY CERRO DE LA SILLA,2023-03-03,32,24,8,0.25
MTY CERRO DE LA SILLA,2023-03-04,47,34,13,0.2766
MTY CERRO DE LA SILLA,2023-03-05,20,9,11,0.55
MTY CERRO DE LA SILLA,2023-03-07,31,16,15,0.48387
MTY CERRO DE LA SILLA,2023-03-08,30,20,10,0.33333
MTY CERRO DE LA SILLA,2023-03-11,1,0,1,1
MTY GARCIA,2023-01-01,6,4,2,0.33333
MTY GARCIA,2023-01-02,35,23,12,0.34286
MTY GARCIA,2023-01-03,45,20,25,0.55556
MTY GARCIA,2023-01-04,66,22,44,0.66667
MTY GARCIA,2023-01-05,44,23,21,0.47727
MTY GARCIA,2023-01-06,43,25,18,0.4186
MTY GARCIA,2023-01-07,80,40,40,0.5
MTY GARCIA,2023-01-08,38,20,18,0.47368
MTY GARCIA,2023-01-09,47,23,24,0.51064
MTY GARCIA,2023-01-10,53,24,29,0.54717
MTY GARCIA,2023-01-11,42,20,22,0.52381
MTY GARCIA,2023-01-12,45,30,15,0.33333
MTY GARCIA,2023-01-13,54,34,20,0.37037
MTY GARCIA,2023-01-14,62,27,35,0.56452
MTY GARCIA,2023-01-15,49,21,28,0.57143
MTY GARCIA,2023-01-16,45,26,19,0.42222
MTY GARCIA,2023-01-17,54,35,19,0.35185
MTY GARCIA,2023-01-18,33,21,12,0.36364
MTY GARCIA,2023-01-19,51,34,17,0.33333
MTY GARCIA,2023-01-20,47,27,20,0.42553
MTY GARCIA,2023-01-21,61,35,26,0.42623
MTY GARCIA,2023-01-22,22,17,5,0.22727
MTY GARCIA,2023-01-23,46,34,12,0.26087
MTY GARCIA,2023-01-24,38,31,7,0.18421
MTY GARCIA,2023-01-25,46,34,12,0.26087
MTY GARCIA,2023-01-26,41,31,10,0.2439
MTY GARCIA,2023-01-27,42,26,16,0.38095
MTY GARCIA,2023-01-28,59,45,14,0.23729
MTY GARCIA,2023-01-29,27,13,14,0.51852
MTY GARCIA,2023-01-30,45,32,13,0.28889
MTY GARCIA,2023-01-31,38,32,6,0.15789
MTY GARCIA,2023-02-02,39,29,10,0.25641
MTY GARCIA,2023-02-03,42,30,12,0.28571
MTY GARCIA,2023-02-04,61,45,16,0.2623
MTY GARCIA,2023-02-05,46,32,14,0.30435
MTY GARCIA,2023-02-06,28,9,19,0.67857
MTY GARCIA,2023-02-07,48,30,18,0.375
MTY GARCIA,2023-02-08,44,31,13,0.29545
MTY GARCIA,2023-02-09,49,36,13,0.26531
MTY GARCIA,2023-02-10,40,14,26,0.65
MTY GARCIA,2023-02-11,76,22,54,0.71053
MTY GARCIA,2023-02-12,43,23,20,0.46512
MTY GARCIA,2023-02-13,48,34,14,0.29167
MTY GARCIA,2023-02-14,46,11,35,0.76087
MTY GARCIA,2023-02-15,45,20,25,0.55556
MTY GARCIA,2023-02-16,30,19,11,0.36667
MTY GARCIA,2023-02-17,62,34,28,0.45161
MTY GARCIA,2023-02-18,73,27,46,0.63014
MTY GARCIA,2023-02-19,27,14,13,0.48148
MTY GARCIA,2023-02-20,30,21,9,0.3
MTY GARCIA,2023-02-21,39,16,23,0.58974
MTY GARCIA,2023-02-22,30,18,12,0.4
MTY GARCIA,2023-02-23,29,10,19,0.65517
MTY GARCIA,2023-02-24,37,14,23,0.62162
MTY GARCIA,2023-02-25,63,27,36,0.57143
MTY GARCIA,2023-02-26,30,26,4,0.13333
MTY GARCIA,2023-02-27,35,21,14,0.4
MTY GARCIA,2023-02-28,45,26,19,0.42222
MTY GARCIA,2023-03-01,48,23,25,0.52083
MTY GARCIA,2023-03-02,47,23,24,0.51064
MTY GARCIA,2023-03-03,41,23,18,0.43902
MTY GARCIA,2023-03-04,47,29,18,0.38298
MTY GARCIA,2023-03-05,14,5,9,0.64286
MTY GARCIA,2023-03-07,44,28,16,0.36364
MTY GARCIA,2023-03-08,53,23,30,0.56604
MTY GARCIA,2023-03-09,51,31,20,0.39216
MTY GARCIA,2023-03-10,63,28,35,0.55556
MTY GARCIA,2023-03-11,68,41,27,0.39706
MTY GARCIA,2023-03-12,44,33,11,0.25
MTY GARCIA,2023-03-13,35,25,10,0.28571
MTY GARCIA,2023-03-14,39,28,11,0.28205
MTY GARCIA,2023-03-15,52,36,16,0.30769
MTY GARCIA,2023-03-16,38,28,10,0.26316
MTY GARCIA,2023-03-17,41,36,5,0.12195
MTY GARCIA,2023-03-18,62,54,8,0.12903
MTY GARCIA,2023-03-19,28,23,5,0.17857
MTY GARCIA,2023-03-20,31,25,6,0.19355
MTY MITRAS,2023-01-02,40,39,1,0.025
MTY MITRAS,2023-01-03,57,40,17,0.29825
MTY MITRAS,2023-01-04,52,17,35,0.67308
MTY MITRAS,2023-01-05,49,26,23,0.46939
MTY MITRAS,2023-01-06,82,58,24,0.29268
MTY MITRAS,2023-01-07,84,78,6,0.07143
MTY MITRAS,2023-01-08,49,27,22,0.44898
MTY MITRAS,2023-01-09,75,37,38,0.50667
MTY MITRAS,2023-01-10,45,25,20,0.44444
MTY MITRAS,2023-01-11,99,64,35,0.35354
MTY MITRAS,2023-01-12,46,29,17,0.36957
MTY MITRAS,2023-01-13,89,73,16,0.17978
MTY MITRAS,2023-01-14,61,43,18,0.29508
MTY MITRAS,2023-01-15,52,28,24,0.46154
MTY MITRAS,2023-01-16,59,25,34,0.57627
MTY MITRAS,2023-01-17,75,39,36,0.48
MTY MITRAS,2023-01-18,56,34,22,0.39286
MTY MITRAS,2023-01-19,93,53,40,0.43011
MTY MITRAS,2023-01-20,63,50,13,0.20635
MTY MITRAS,2023-01-21,76,55,21,0.27632
MTY MITRAS,2023-01-22,56,33,23,0.41071
MTY MITRAS,2023-01-23,76,43,33,0.43421
MTY MITRAS,2023-01-24,69,30,39,0.56522
MTY MITRAS,2023-01-25,112,33,79,0.70536
MTY MITRAS,2023-01-26,52,32,20,0.38462
MTY MITRAS,2023-01-27,86,48,38,0.44186
MTY MITRAS,2023-01-28,98,56,42,0.42857
MTY MITRAS,2023-01-29,44,25,19,0.43182
MTY MITRAS,2023-01-30,91,42,49,0.53846
MTY MITRAS,2023-01-31,96,57,39,0.40625
MTY MITRAS,2023-02-02,62,24,38,0.6129
MTY MITRAS,2023-02-03,47,12,35,0.74468
MTY MITRAS,2023-02-04,88,44,44,0.5
MTY MITRAS,2023-02-05,49,20,29,0.59184
MTY MITRAS,2023-02-06,61,34,27,0.44262
MTY MITRAS,2023-02-07,82,55,27,0.32927
MTY MITRAS,2023-02-08,60,35,25,0.41667
MTY MITRAS,2023-02-09,63,25,38,0.60317
MTY MITRAS,2023-02-10,86,39,47,0.54651
MTY MITRAS,2023-02-11,96,33,63,0.65625
MTY MITRAS,2023-02-12,39,30,9,0.23077
MTY MITRAS,2023-02-13,57,16,41,0.7193
MTY MITRAS,2023-02-14,99,35,64,0.64646
MTY MITRAS,2023-02-15,59,26,33,0.55932
MTY MITRAS,2023-02-16,125,32,93,0.744
MTY MITRAS,2023-02-17,83,15,68,0.81928
MTY MITRAS,2023-02-18,65,14,51,0.78462
MTY MITRAS,2023-02-19,62,10,52,0.83871
MTY MITRAS,2023-02-20,61,17,44,0.72131
MTY MITRAS,2023-02-21,160,35,125,0.78125
MTY MITRAS,2023-02-22,112,32,80,0.71429
MTY MITRAS,2023-02-23,80,18,62,0.775
MTY MITRAS,2023-02-24,63,20,43,0.68254
MTY MITRAS,2023-02-25,142,33,109,0.76761
MTY MITRAS,2023-02-26,69,18,51,0.73913
MTY MITRAS,2023-02-27,86,36,50,0.5814
MTY MITRAS,2023-02-28,90,34,56,0.62222
MTY MITRAS,2023-03-01,45,30,15,0.33333
MTY MITRAS,2023-03-02,80,44,36,0.45
MTY MITRAS,2023-03-03,121,50,71,0.58678
MTY MITRAS,2023-03-04,129,24,105,0.81395
MTY MITRAS,2023-03-05,48,22,26,0.54167
MTY MITRAS,2023-03-07,69,30,39,0.56522
MTY MITRAS,2023-03-08,68,26,42,0.61765
MTY MITRAS,2023-03-09,75,17,58,0.77333
MTY MITRAS,2023-03-10,88,34,54,0.61364
MTY MITRAS,2023-03-11,60,16,44,0.73333
MTY MITRAS,2023-03-12,37,10,27,0.72973
MTY MITRAS,2023-03-13,86,50,36,0.4186
MTY MITRAS,2023-03-14,50,14,36,0.72
MTY MITRAS,2023-03-15,58,35,23,0.39655
MTY MITRAS,2023-03-16,60,53,7,0.11667
MTY MITRAS,2023-03-17,63,52,11,0.1746
MTY MITRAS,2023-03-18,68,54,14,0.20588
MTY MITRAS,2023-03-19,32,25,7,0.21875
MTY MITRAS,2023-03-20,46,27,19,0.41304
MTY SANTA LUCIA,2023-01-01,7,5,2,0.28571
MTY SANTA LUCIA,2023-01-02,30,14,16,0.53333
MTY SANTA LUCIA,2023-01-03,44,19,25,0.56818
MTY SANTA LUCIA,2023-01-04,59,43,16,0.27119
MTY SANTA LUCIA,2023-01-05,38,24,14,0.36842
MTY SANTA LUCIA,2023-01-06,89,63,26,0.29213
MTY SANTA LUCIA,2023-01-07,74,55,19,0.25676
MTY SANTA LUCIA,2023-01-08,47,18,29,0.61702
MTY SANTA LUCIA,2023-01-09,73,42,31,0.42466
MTY SANTA LUCIA,2023-01-10,54,35,19,0.35185
MTY SANTA LUCIA,2023-01-11,32,26,6,0.1875
MTY SANTA LUCIA,2023-01-12,44,24,20,0.45455
MTY SANTA LUCIA,2023-01-13,42,32,10,0.2381
MTY SANTA LUCIA,2023-01-14,53,28,25,0.4717
MTY SANTA LUCIA,2023-01-15,46,23,23,0.5
MTY SANTA LUCIA,2023-01-16,56,38,18,0.32143
MTY SANTA LUCIA,2023-01-17,44,32,12,0.27273
MTY SANTA LUCIA,2023-01-18,63,37,26,0.4127
MTY SANTA LUCIA,2023-01-19,29,11,18,0.62069
MTY SANTA LUCIA,2023-01-20,32,4,28,0.875
MTY SANTA LUCIA,2023-01-21,74,40,34,0.45946
MTY SANTA LUCIA,2023-01-22,30,16,14,0.46667
MTY SANTA LUCIA,2023-01-23,34,21,13,0.38235
MTY SANTA LUCIA,2023-01-24,43,14,29,0.67442
MTY SANTA LUCIA,2023-01-25,95,54,41,0.43158
MTY SANTA LUCIA,2023-01-26,106,71,35,0.33019
MTY SANTA LUCIA,2023-01-27,72,40,32,0.44444
MTY SANTA LUCIA,2023-01-28,85,45,40,0.47059
MTY SANTA LUCIA,2023-01-29,48,21,27,0.5625
MTY SANTA LUCIA,2023-01-30,98,57,41,0.41837
MTY SANTA LUCIA,2023-01-31,53,35,18,0.33962
MTY SANTA LUCIA,2023-02-02,64,44,20,0.3125
MTY SANTA LUCIA,2023-02-03,81,51,30,0.37037
MTY SANTA LUCIA,2023-02-04,66,38,28,0.42424
MTY SANTA LUCIA,2023-02-05,40,22,18,0.45
MTY SANTA LUCIA,2023-02-06,36,33,3,0.08333
MTY SANTA LUCIA,2023-02-07,63,45,18,0.28571
MTY SANTA LUCIA,2023-02-08,30,17,13,0.43333
MTY SANTA LUCIA,2023-02-09,51,20,31,0.60784
MTY SANTA LUCIA,2023-02-10,54,13,41,0.75926
MTY SANTA LUCIA,2023-02-11,79,50,29,0.36709
MTY SANTA LUCIA,2023-02-12,56,30,26,0.46429
MTY SANTA LUCIA,2023-02-13,24,9,15,0.625
MTY SANTA LUCIA,2023-02-14,49,13,36,0.73469
MTY SANTA LUCIA,2023-02-15,29,10,19,0.65517
MTY SANTA LUCIA,2023-02-16,58,34,24,0.41379
MTY SANTA LUCIA,2023-02-17,35,24,11,0.31429
MTY SANTA LUCIA,2023-02-18,88,34,54,0.61364
MTY SANTA LUCIA,2023-02-19,60,20,40,0.66667
MTY SANTA LUCIA,2023-02-20,72,13,59,0.81944
MTY SANTA LUCIA,2023-02-21,63,23,40,0.63492
MTY SANTA LUCIA,2023-02-22,37,23,14,0.37838
MTY SANTA LUCIA,2023-02-23,39,10,29,0.74359
MTY SANTA LUCIA,2023-02-24,51,9,42,0.82353
MTY SANTA LUCIA,2023-02-25,109,45,64,0.58716
MTY SANTA LUCIA,2023-02-26,47,28,19,0.40426
MTY SANTA LUCIA,2023-02-27,23,21,2,0.08696
MTY SANTA LUCIA,2023-02-28,56,14,42,0.75
MTY SANTA LUCIA,2023-03-01,55,23,32,0.58182
MTY SANTA LUCIA,2023-03-02,46,34,12,0.26087
MTY SANTA LUCIA,2023-03-03,54,21,33,0.61111
MTY SANTA LUCIA,2023-03-04,86,36,50,0.5814
MTY SANTA LUCIA,2023-03-05,43,20,23,0.53488
MTY SANTA LUCIA,2023-03-07,37,14,23,0.62162
MTY SANTA LUCIA,2023-03-08,70,36,34,0.48571
MTY SANTA LUCIA,2023-03-09,66,26,40,0.60606
MTY SANTA LUCIA,2023-03-10,44,29,15,0.34091
MTY SANTA LUCIA,2023-03-11,46,27,19,0.41304
MTY SANTA LUCIA,2023-03-12,35,12,23,0.65714
MTY SANTA LUCIA,2023-03-13,54,17,37,0.68519
MTY SANTA LUCIA,2023-03-14,36,17,19,0.52778
MTY SANTA LUCIA,2023-03-15,37,25,12,0.32432
MTY SANTA LUCIA,2023-03-16,31,24,7,0.22581
MTY SANTA LUCIA,2023-03-17,46,31,15,0.32609
MTY SANTA LUCIA,2023-03-18,64,58,6,0.09375
MTY SANTA LUCIA,2023-03-19,32,28,4,0.125
MTY SANTA LUCIA,2023-03-20,27,19,8,0.2963
MTY SENDERO DIVISORIO,2023-01-02,42,10,32,0.7619
MTY SENDERO DIVISORIO,2023-01-03,74,17,57,0.77027
MTY SENDERO DIVISORIO,2023-01-04,67,39,28,0.41791
MTY SENDERO DIVISORIO,2023-01-05,64,24,40,0.625
MTY SENDERO DIVISORIO,2023-01-06,84,37,47,0.55952
MTY SENDERO DIVISORIO,2023-01-07,64,21,43,0.67188
MTY SENDERO DIVISORIO,2023-01-08,40,13,27,0.675
MTY SENDERO DIVISORIO,2023-01-09,36,15,21,0.58333
MTY SENDERO DIVISORIO,2023-01-10,40,28,12,0.3
MTY SENDERO DIVISORIO,2023-01-11,44,29,15,0.34091
MTY SENDERO DIVISORIO,2023-01-12,52,33,19,0.36538
MTY SENDERO DIVISORIO,2023-01-13,43,18,25,0.5814
MTY SENDERO DIVISORIO,2023-01-14,62,33,29,0.46774
MTY SENDERO DIVISORIO,2023-01-15,28,14,14,0.5
MTY SENDERO DIVISORIO,2023-01-16,57,36,21,0.36842
MTY SENDERO DIVISORIO,2023-01-17,45,17,28,0.62222
MTY SENDERO DIVISORIO,2023-01-18,37,16,21,0.56757
MTY SENDERO DIVISORIO,2023-01-19,34,18,16,0.47059
MTY SENDERO DIVISORIO,2023-01-20,51,26,25,0.4902
MTY SENDERO DIVISORIO,2023-01-21,67,29,38,0.56716
MTY SENDERO DIVISORIO,2023-01-22,29,16,13,0.44828
MTY SENDERO DIVISORIO,2023-01-23,56,32,24,0.42857
MTY SENDERO DIVISORIO,2023-01-24,52,16,36,0.69231
MTY SENDERO DIVISORIO,2023-01-25,44,25,19,0.43182
MTY SENDERO DIVISORIO,2023-01-26,35,25,10,0.28571
MTY SENDERO DIVISORIO,2023-01-27,59,42,17,0.28814
MTY SENDERO DIVISORIO,2023-01-28,252,92,160,0.63492
MTY SENDERO DIVISORIO,2023-01-29,113,27,86,0.76106
MTY SENDERO DIVISORIO,2023-01-30,60,23,37,0.61667
MTY SENDERO DIVISORIO,2023-01-31,28,17,11,0.39286
MTY SENDERO DIVISORIO,2023-02-02,70,25,45,0.64286
MTY SENDERO DIVISORIO,2023-02-03,49,21,28,0.57143
MTY SENDERO DIVISORIO,2023-02-04,116,41,75,0.64655
MTY SENDERO DIVISORIO,2023-02-05,46,12,34,0.73913
MTY SENDERO DIVISORIO,2023-02-06,53,28,25,0.4717
MTY SENDERO DIVISORIO,2023-02-07,81,36,45,0.55556
MTY SENDERO DIVISORIO,2023-02-08,64,41,23,0.35938
MTY SENDERO DIVISORIO,2023-02-09,39,18,21,0.53846
MTY SENDERO DIVISORIO,2023-02-10,71,41,30,0.42254
MTY SENDERO DIVISORIO,2023-02-11,37,20,17,0.45946
MTY SENDERO DIVISORIO,2023-02-12,41,18,23,0.56098
MTY SENDERO DIVISORIO,2023-02-13,44,22,22,0.5
MTY SENDERO DIVISORIO,2023-02-14,29,11,18,0.62069
MTY SENDERO DIVISORIO,2023-02-15,54,19,35,0.64815
MTY SENDERO DIVISORIO,2023-02-16,57,42,15,0.26316
MTY SENDERO DIVISORIO,2023-02-17,81,11,70,0.8642
MTY SENDERO DIVISORIO,2023-02-18,102,44,58,0.56863
MTY SENDERO DIVISORIO,2023-02-19,75,7,68,0.90667
MTY SENDERO DIVISORIO,2023-02-20,54,24,30,0.55556
MTY SENDERO DIVISORIO,2023-02-21,28,5,23,0.82143
MTY SENDERO DIVISORIO,2023-02-22,64,15,49,0.76562
MTY SENDERO DIVISORIO,2023-02-23,49,18,31,0.63265
MTY SENDERO DIVISORIO,2023-02-24,41,15,26,0.63415
MTY SENDERO DIVISORIO,2023-02-25,159,16,143,0.89937
MTY SENDERO DIVISORIO,2023-02-26,54,8,46,0.85185
MTY SENDERO DIVISORIO,2023-02-27,90,36,54,0.6
MTY SENDERO DIVISORIO,2023-02-28,61,21,40,0.65574
MTY SENDERO DIVISORIO,2023-03-01,81,30,51,0.62963
MTY SENDERO DIVISORIO,2023-03-02,54,17,37,0.68519
MTY SENDERO DIVISORIO,2023-03-03,73,13,60,0.82192
MTY SENDERO DIVISORIO,2023-03-04,94,14,80,0.85106
MTY SENDERO DIVISORIO,2023-03-05,36,10,26,0.72222
MTY SENDERO DIVISORIO,2023-03-07,66,38,28,0.42424
MTY SENDERO DIVISORIO,2023-03-08,84,35,49,0.58333
MTY SENDERO DIVISORIO,2023-03-09,48,25,23,0.47917
MTY SENDERO DIVISORIO,2023-03-10,54,11,43,0.7963
MTY SENDERO DIVISORIO,2023-03-11,80,14,66,0.825
MTY SENDERO DIVISORIO,2023-03-12,58,5,53,0.91379
MTY SENDERO DIVISORIO,2023-03-13,46,10,36,0.78261
MTY SENDERO DIVISORIO,2023-03-14,34,10,24,0.70588
MTY SENDERO DIVISORIO,2023-03-15,55,32,23,0.41818
MTY SENDERO DIVISORIO,2023-03-16,58,26,32,0.55172
MTY SENDERO DIVISORIO,2023-03-17,37,15,22,0.59459
MTY SENDERO DIVISORIO,2023-03-18,72,24,48,0.66667
MTY SENDERO DIVISORIO,2023-03-19,33,11,22,0.66667
MTY SENDERO DIVISORIO,2023-03-20,17,4,13,0.76471
MTY SIERRA MADRE,2023-01-01,3,3,0,0
MTY SIERRA MADRE,2023-01-02,19,14,5,0.26316
MTY SIERRA MADRE,2023-01-03,46,30,16,0.34783
MTY SIERRA MADRE,2023-01-04,51,36,15,0.29412
MTY SIERRA MADRE,2023-01-05,36,28,8,0.22222
MTY SIERRA MADRE,2023-01-06,43,38,5,0.11628
MTY SIERRA MADRE,2023-01-07,55,50,5,0.09091
MTY SIERRA MADRE,2023-01-08,15,12,3,0.2
MTY SIERRA MADRE,2023-01-09,31,26,5,0.16129
MTY SIERRA MADRE,2023-01-10,33,30,3,0.09091
MTY SIERRA MADRE,2023-01-11,35,16,19,0.54286
MTY SIERRA MADRE,2023-01-12,34,26,8,0.23529
MTY SIERRA MADRE,2023-01-13,46,41,5,0.1087
MTY SIERRA MADRE,2023-01-14,29,22,7,0.24138
MTY SIERRA MADRE,2023-01-15,23,16,7,0.30435
MTY SIERRA MADRE,2023-01-16,29,24,5,0.17241
MTY SIERRA MADRE,2023-01-17,28,24,4,0.14286
MTY SIERRA MADRE,2023-01-18,36,30,6,0.16667
MTY SIERRA MADRE,2023-01-19,36,23,13,0.36111
MTY SIERRA MADRE,2023-01-20,33,28,5,0.15152
MTY SIERRA MADRE,2023-01-21,40,33,7,0.175
MTY SIERRA MADRE,2023-01-22,23,14,9,0.3913
MTY SIERRA MADRE,2023-01-23,54,34,20,0.37037
MTY SIERRA MADRE,2023-01-24,40,32,8,0.2
MTY SIERRA MADRE,2023-01-25,30,27,3,0.1
MTY SIERRA MADRE,2023-01-26,37,28,9,0.24324
MTY SIERRA MADRE,2023-01-27,31,18,13,0.41935
MTY SIERRA MADRE,2023-01-28,64,52,12,0.1875
MTY SIERRA MADRE,2023-01-29,21,2,19,0.90476
MTY SIERRA MADRE,2023-01-30,39,29,10,0.25641
MTY SIERRA MADRE,2023-01-31,23,13,10,0.43478
MTY SIERRA MADRE,2023-02-02,36,17,19,0.52778
MTY SIERRA MADRE,2023-02-03,38,27,11,0.28947
MTY SIERRA MADRE,2023-02-04,46,29,17,0.36957
MTY SIERRA MADRE,2023-02-05,18,13,5,0.27778
MTY SIERRA MADRE,2023-02-06,10,6,4,0.4
MTY SIERRA MADRE,2023-02-07,10,7,3,0.3
MTY SIERRA MADRE,2023-02-08,30,20,10,0.33333
MTY SIERRA MADRE,2023-02-09,34,21,13,0.38235
MTY SIERRA MADRE,2023-02-10,44,37,7,0.15909
MTY SIERRA MADRE,2023-02-11,54,35,19,0.35185
MTY SIERRA MADRE,2023-02-12,24,7,17,0.70833
MTY SIERRA MADRE,2023-02-13,24,14,10,0.41667
MTY SIERRA MADRE,2023-02-14,38,29,9,0.23684
MTY SIERRA MADRE,2023-02-15,30,16,14,0.46667
MTY SIERRA MADRE,2023-02-16,37,27,10,0.27027
MTY SIERRA MADRE,2023-02-17,40,9,31,0.775
MTY SIERRA MADRE,2023-02-18,34,10,24,0.70588
MTY SIERRA MADRE,2023-02-19,13,10,3,0.23077
MTY SIERRA MADRE,2023-02-20,35,20,15,0.42857
MTY SIERRA MADRE,2023-02-21,29,12,17,0.58621
MTY SIERRA MADRE,2023-02-22,41,14,27,0.65854
MTY SIERRA MADRE,2023-02-23,29,12,17,0.58621
MTY SIERRA MADRE,2023-02-24,24,13,11,0.45833
MTY SIERRA MADRE,2023-02-25,29,11,18,0.62069
MTY SIERRA MADRE,2023-02-26,26,14,12,0.46154
MTY SIERRA MADRE,2023-02-27,29,28,1,0.03448
MTY SIERRA MADRE,2023-02-28,60,47,13,0.21667
MTY SIERRA MADRE,2023-03-01,30,11,19,0.63333
MTY SIERRA MADRE,2023-03-02,37,21,16,0.43243
MTY SIERRA MADRE,2023-03-03,44,25,19,0.43182
MTY SIERRA MADRE,2023-03-04,38,23,15,0.39474
MTY SIERRA MADRE,2023-03-05,19,11,8,0.42105
MTY SIERRA MADRE,2023-03-07,29,14,15,0.51724
MTY SIERRA MADRE,2023-03-08,20,11,9,0.45
MTY SIERRA MADRE,2023-03-09,37,21,16,0.43243
MTY SIERRA MADRE,2023-03-10,32,9,23,0.71875
MTY SIERRA MADRE,2023-03-11,52,28,24,0.46154
MTY SIERRA MADRE,2023-03-12,12,6,6,0.5
MTY SIERRA MADRE,2023-03-13,23,7,16,0.69565
MTY SIERRA MADRE,2023-03-14,46,41,5,0.1087
MTY SIERRA MADRE,2023-03-15,27,24,3,0.11111
MTY SIERRA MADRE,2023-03-16,33,31,2,0.06061
MTY SIERRA MADRE,2023-03-17,27,21,6,0.22222
MTY SIERRA MADRE,2023-03-18,38,36,2,0.05263
MTY SIERRA MADRE,2023-03-19,14,14,0,0
MTY SIERRA MADRE,2023-03-20,19,17,2,0.10526
NAUCALPAN,2023-01-01,9,9,0,0
NAUCALPAN,2023-01-02,43,43,0,0
NAUCALPAN,2023-01-03,44,41,3,0.06818
NAUCALPAN,2023-01-04,66,66,0,0
NAUCALPAN,2023-01-05,60,60,0,0
NAUCALPAN,2023-01-06,69,67,2,0.02899
NAUCALPAN,2023-01-07,82,82,0,0
NAUCALPAN,2023-01-08,85,83,2,0.02353
NAUCALPAN,2023-01-09,89,89,0,0
NAUCALPAN,2023-01-10,51,45,6,0.11765
NAUCALPAN,2023-01-11,94,93,1,0.01064
NAUCALPAN,2023-01-12,46,46,0,0
NAUCALPAN,2023-01-13,70,70,0,0
NAUCALPAN,2023-01-14,110,107,3,0.02727
NAUCALPAN,2023-01-15,81,77,4,0.04938
NAUCALPAN,2023-01-16,114,107,7,0.0614
NAUCALPAN,2023-01-17,117,92,25,0.21368
NAUCALPAN,2023-01-18,232,226,6,0.02586
NAUCALPAN,2023-01-19,122,121,1,0.0082
NAUCALPAN,2023-01-20,148,126,22,0.14865
NAUCALPAN,2023-01-21,220,188,32,0.14545
NAUCALPAN,2023-01-22,71,69,2,0.02817
NAUCALPAN,2023-01-23,96,90,6,0.0625
NAUCALPAN,2023-01-24,97,85,12,0.12371
NAUCALPAN,2023-01-25,32,32,0,0
NAUCALPAN,2023-01-26,73,59,14,0.19178
NAUCALPAN,2023-01-27,53,52,1,0.01887
NAUCALPAN,2023-01-28,89,58,31,0.34831
NAUCALPAN,2023-01-29,80,69,11,0.1375
NAUCALPAN,2023-01-30,66,60,6,0.09091
NAUCALPAN,2023-01-31,72,63,9,0.125
NAUCALPAN,2023-02-02,81,79,2,0.02469
NAUCALPAN,2023-02-03,71,68,3,0.04225
NAUCALPAN,2023-02-04,101,100,1,0.0099
NAUCALPAN,2023-02-05,74,74,0,0
NAUCALPAN,2023-02-06,47,46,1,0.02128
NAUCALPAN,2023-02-07,150,150,0,0
NAUCALPAN,2023-02-08,199,199,0,0
NAUCALPAN,2023-02-09,170,168,2,0.01176
NAUCALPAN,2023-02-10,65,63,2,0.03077
NAUCALPAN,2023-02-11,285,272,13,0.04561
NAUCALPAN,2023-02-12,208,200,8,0.03846
NAUCALPAN,2023-02-13,98,94,4,0.04082
NAUCALPAN,2023-02-14,83,78,5,0.06024
NAUCALPAN,2023-02-15,95,80,15,0.15789
NAUCALPAN,2023-02-16,77,76,1,0.01299
NAUCALPAN,2023-02-17,89,82,7,0.07865
NAUCALPAN,2023-02-18,205,200,5,0.02439
NAUCALPAN,2023-02-19,199,195,4,0.0201
NAUCALPAN,2023-02-20,153,153,0,0
NAUCALPAN,2023-02-21,97,97,0,0
NAUCALPAN,2023-02-22,59,57,2,0.0339
NAUCALPAN,2023-02-23,70,54,16,0.22857
NAUCALPAN,2023-02-24,81,62,19,0.23457
NAUCALPAN,2023-02-25,82,81,1,0.0122
NAUCALPAN,2023-02-26,61,61,0,0
NAUCALPAN,2023-02-27,87,87,0,0
NAUCALPAN,2023-02-28,72,62,10,0.13889
NAUCALPAN,2023-03-01,80,78,2,0.025
NAUCALPAN,2023-03-02,76,74,2,0.02632
NAUCALPAN,2023-03-03,64,64,0,0
NAUCALPAN,2023-03-04,128,121,7,0.05469
NAUCALPAN,2023-03-05,76,65,11,0.14474
NAUCALPAN,2023-03-07,60,53,7,0.11667
NAUCALPAN,2023-03-08,69,48,21,0.30435
NAUCALPAN,2023-03-09,57,52,5,0.08772
NAUCALPAN,2023-03-10,59,58,1,0.01695
NAUCALPAN,2023-03-11,93,88,5,0.05376
NAUCALPAN,2023-03-12,54,51,3,0.05556
NAUCALPAN,2023-03-13,52,51,1,0.01923
NAUCALPAN,2023-03-14,80,76,4,0.05
NAUCALPAN,2023-03-15,77,62,15,0.19481
NAUCALPAN,2023-03-16,101,93,8,0.07921
NAUCALPAN,2023-03-17,82,80,2,0.02439
NAUCALPAN,2023-03-18,108,103,5,0.0463
NAUCALPAN,2023-03-19,115,107,8,0.06957
NAUCALPAN,2023-03-20,85,76,9,0.10588
NEZA 1,2023-01-01,18,18,0,0
NEZA 1,2023-01-02,28,28,0,0
NEZA 1,2023-01-03,32,32,0,0
NEZA 1,2023-01-04,45,45,0,0
NEZA 1,2023-01-05,43,43,0,0
NEZA 1,2023-01-06,50,50,0,0
NEZA 1,2023-01-07,56,54,2,0.03571
NEZA 1,2023-01-08,39,37,2,0.05128
NEZA 1,2023-01-09,33,32,1,0.0303
NEZA 1,2023-01-10,47,46,1,0.02128
NEZA 1,2023-01-11,48,48,0,0
NEZA 1,2023-01-12,44,44,0,0
NEZA 1,2023-01-13,60,59,1,0.01667
NEZA 1,2023-01-14,63,63,0,0
NEZA 1,2023-01-15,52,51,1,0.01923
NEZA 1,2023-01-16,43,43,0,0
NEZA 1,2023-01-17,64,61,3,0.04688
NEZA 1,2023-01-18,67,66,1,0.01493
NEZA 1,2023-01-19,58,58,0,0
NEZA 1,2023-01-20,57,57,0,0
NEZA 1,2023-01-21,92,92,0,0
NEZA 1,2023-01-22,76,76,0,0
NEZA 1,2023-01-23,46,46,0,0
NEZA 1,2023-01-24,57,57,0,0
NEZA 1,2023-01-25,58,58,0,0
NEZA 1,2023-01-26,139,139,0,0
NEZA 1,2023-01-27,50,50,0,0
NEZA 1,2023-01-28,107,107,0,0
NEZA 1,2023-01-29,135,135,0,0
NEZA 1,2023-01-30,182,182,0,0
NEZA 1,2023-01-31,200,200,0,0
NEZA 1,2023-02-02,127,124,3,0.02362
NEZA 1,2023-02-03,64,64,0,0
NEZA 1,2023-02-04,91,80,11,0.12088
NEZA 1,2023-02-05,104,104,0,0
NEZA 1,2023-02-06,80,80,0,0
NEZA 1,2023-02-07,112,112,0,0
NEZA 1,2023-02-08,84,84,0,0
NEZA 1,2023-02-09,54,54,0,0
NEZA 1,2023-02-10,70,70,0,0
NEZA 1,2023-02-11,43,43,0,0
NEZA 1,2023-02-12,72,33,39,0.54167
NEZA 1,2023-02-13,37,37,0,0
NEZA 1,2023-02-14,120,120,0,0
NEZA 1,2023-02-15,152,152,0,0
NEZA 1,2023-02-16,168,161,7,0.04167
NEZA 1,2023-02-17,126,114,12,0.09524
NEZA 1,2023-02-18,114,110,4,0.03509
NEZA 1,2023-02-19,123,123,0,0
NEZA 1,2023-02-20,138,64,74,0.53623
NEZA 1,2023-02-21,64,64,0,0
NEZA 1,2023-02-22,60,50,10,0.16667
NEZA 1,2023-02-23,37,36,1,0.02703
NEZA 1,2023-02-24,74,74,0,0
NEZA 1,2023-02-25,55,55,0,0
NEZA 1,2023-02-26,72,67,5,0.06944
NEZA 1,2023-02-27,51,51,0,0
NEZA 1,2023-02-28,70,69,1,0.01429
NEZA 1,2023-03-01,52,52,0,0
NEZA 1,2023-03-02,45,45,0,0
NEZA 1,2023-03-03,66,66,0,0
NEZA 1,2023-03-04,70,68,2,0.02857
NEZA 1,2023-03-05,49,47,2,0.04082
NEZA 1,2023-03-07,43,41,2,0.04651
NEZA 1,2023-03-08,49,47,2,0.04082
NEZA 1,2023-03-09,42,40,2,0.04762
NEZA 1,2023-03-10,39,34,5,0.12821
NEZA 1,2023-03-11,63,63,0,0
NEZA 1,2023-03-12,40,39,1,0.025
NEZA 1,2023-03-13,47,47,0,0
NEZA 1,2023-03-14,41,41,0,0
NEZA 1,2023-03-15,42,42,0,0
NEZA 1,2023-03-16,81,81,0,0
NEZA 1,2023-03-17,81,81,0,0
NEZA 1,2023-03-18,71,71,0,0
NEZA 1,2023-03-19,62,60,2,0.03226
NEZA 1,2023-03-20,73,73,0,0
NEZA 2,2023-01-01,2,2,0,0
NEZA 2,2023-01-02,44,44,0,0
NEZA 2,2023-01-03,52,52,0,0
NEZA 2,2023-01-04,52,50,2,0.03846
NEZA 2,2023-01-05,47,47,0,0
NEZA 2,2023-01-06,29,28,1,0.03448
NEZA 2,2023-01-07,46,43,3,0.06522
NEZA 2,2023-01-08,74,69,5,0.06757
NEZA 2,2023-01-09,39,39,0,0
NEZA 2,2023-01-10,62,62,0,0
NEZA 2,2023-01-11,54,54,0,0
NEZA 2,2023-01-12,35,33,2,0.05714
NEZA 2,2023-01-13,70,70,0,0
NEZA 2,2023-01-14,64,64,0,0
NEZA 2,2023-01-15,69,69,0,0
NEZA 2,2023-01-16,43,42,1,0.02326
NEZA 2,2023-01-17,75,65,10,0.13333
NEZA 2,2023-01-18,77,77,0,0
NEZA 2,2023-01-19,119,35,84,0.70588
NEZA 2,2023-01-20,101,93,8,0.07921
NEZA 2,2023-01-21,199,196,3,0.01508
NEZA 2,2023-01-22,111,98,13,0.11712
NEZA 2,2023-01-23,46,46,0,0
NEZA 2,2023-01-24,203,191,12,0.05911
NEZA 2,2023-01-25,63,60,3,0.04762
NEZA 2,2023-01-26,50,44,6,0.12
NEZA 2,2023-01-27,127,88,39,0.30709
NEZA 2,2023-01-28,634,630,4,0.00631
NEZA 2,2023-01-29,169,161,8,0.04734
NEZA 2,2023-01-30,234,233,1,0.00427
NEZA 2,2023-01-31,204,201,3,0.01471
NEZA 2,2023-02-02,209,203,6,0.02871
NEZA 2,2023-02-03,152,152,0,0
NEZA 2,2023-02-04,217,214,3,0.01382
NEZA 2,2023-02-05,64,62,2,0.03125
NEZA 2,2023-02-06,162,153,9,0.05556
NEZA 2,2023-02-07,183,128,55,0.30055
NEZA 2,2023-02-08,111,104,7,0.06306
NEZA 2,2023-02-09,293,289,4,0.01365
NEZA 2,2023-02-10,182,154,28,0.15385
NEZA 2,2023-02-11,191,175,16,0.08377
NEZA 2,2023-02-12,76,70,6,0.07895
NEZA 2,2023-02-13,158,153,5,0.03165
NEZA 2,2023-02-14,437,423,14,0.03204
NEZA 2,2023-02-15,290,282,8,0.02759
NEZA 2,2023-02-16,95,93,2,0.02105
NEZA 2,2023-02-17,150,146,4,0.02667
NEZA 2,2023-02-18,446,269,177,0.39686
NEZA 2,2023-02-19,125,84,41,0.328
NEZA 2,2023-02-20,104,75,29,0.27885
NEZA 2,2023-02-21,100,100,0,0
NEZA 2,2023-02-22,75,67,8,0.10667
NEZA 2,2023-02-23,232,210,22,0.09483
NEZA 2,2023-02-24,219,213,6,0.0274
NEZA 2,2023-02-25,88,49,39,0.44318
NEZA 2,2023-02-26,65,51,14,0.21538
NEZA 2,2023-02-27,141,130,11,0.07801
NEZA 2,2023-02-28,67,62,5,0.07463
NEZA 2,2023-03-01,99,85,14,0.14141
NEZA 2,2023-03-02,40,36,4,0.1
NEZA 2,2023-03-03,81,81,0,0
NEZA 2,2023-03-04,106,96,10,0.09434
NEZA 2,2023-03-05,78,63,15,0.19231
NEZA 2,2023-03-07,87,73,14,0.16092
NEZA 2,2023-03-08,71,69,2,0.02817
NEZA 2,2023-03-09,55,50,5,0.09091
NEZA 2,2023-03-10,58,58,0,0
NEZA 2,2023-03-11,47,46,1,0.02128
NEZA 2,2023-03-12,50,42,8,0.16
NEZA 2,2023-03-13,52,48,4,0.07692
NEZA 2,2023-03-14,61,55,6,0.09836
NEZA 2,2023-03-15,87,80,7,0.08046
NEZA 2,2023-03-16,84,84,0,0
NEZA 2,2023-03-17,83,83,0,0
NEZA 2,2023-03-18,87,86,1,0.01149
NEZA 2,2023-03-19,92,90,2,0.02174
NEZA 2,2023-03-20,94,94,0,0
NICOLAS ROMERO,2023-01-01,17,17,0,0
NICOLAS ROMERO,2023-01-02,36,34,2,0.05556
NICOLAS ROMERO,2023-01-03,50,49,1,0.02
NICOLAS ROMERO,2023-01-04,49,46,3,0.06122
NICOLAS ROMERO,2023-01-05,32,32,0,0
NICOLAS ROMERO,2023-01-06,52,52,0,0
NICOLAS ROMERO,2023-01-07,72,72,0,0
NICOLAS ROMERO,2023-01-08,55,55,0,0
NICOLAS ROMERO,2023-01-09,29,28,1,0.03448
NICOLAS ROMERO,2023-01-10,52,52,0,0
NICOLAS ROMERO,2023-01-11,41,40,1,0.02439
NICOLAS ROMERO,2023-01-12,21,21,0,0
NICOLAS ROMERO,2023-01-13,73,71,2,0.0274
NICOLAS ROMERO,2023-01-14,67,65,2,0.02985
NICOLAS ROMERO,2023-01-15,100,97,3,0.03
NICOLAS ROMERO,2023-01-16,58,58,0,0
NICOLAS ROMERO,2023-01-17,99,99,0,0
NICOLAS ROMERO,2023-01-18,73,69,4,0.05479
NICOLAS ROMERO,2023-01-19,139,134,5,0.03597
NICOLAS ROMERO,2023-01-20,160,160,0,0
NICOLAS ROMERO,2023-01-21,195,195,0,0
NICOLAS ROMERO,2023-01-22,121,121,0,0
NICOLAS ROMERO,2023-01-23,111,111,0,0
NICOLAS ROMERO,2023-01-24,51,51,0,0
NICOLAS ROMERO,2023-01-25,89,88,1,0.01124
NICOLAS ROMERO,2023-01-26,73,70,3,0.0411
NICOLAS ROMERO,2023-01-27,77,76,1,0.01299
NICOLAS ROMERO,2023-01-28,152,152,0,0
NICOLAS ROMERO,2023-01-29,68,67,1,0.01471
NICOLAS ROMERO,2023-01-30,99,99,0,0
NICOLAS ROMERO,2023-01-31,75,73,2,0.02667
NICOLAS ROMERO,2023-02-02,58,54,4,0.06897
NICOLAS ROMERO,2023-02-03,67,67,0,0
NICOLAS ROMERO,2023-02-04,93,90,3,0.03226
NICOLAS ROMERO,2023-02-05,59,50,9,0.15254
NICOLAS ROMERO,2023-02-06,97,57,40,0.41237
NICOLAS ROMERO,2023-02-07,145,145,0,0
NICOLAS ROMERO,2023-02-08,60,60,0,0
NICOLAS ROMERO,2023-02-09,91,83,8,0.08791
NICOLAS ROMERO,2023-02-10,218,217,1,0.00459
NICOLAS ROMERO,2023-02-11,207,205,2,0.00966
NICOLAS ROMERO,2023-02-12,125,122,3,0.024
NICOLAS ROMERO,2023-02-13,124,124,0,0
NICOLAS ROMERO,2023-02-14,50,50,0,0
NICOLAS ROMERO,2023-02-15,48,48,0,0
NICOLAS ROMERO,2023-02-16,128,114,14,0.10938
NICOLAS ROMERO,2023-02-17,73,65,8,0.10959
NICOLAS ROMERO,2023-02-18,146,146,0,0
NICOLAS ROMERO,2023-02-19,114,114,0,0
NICOLAS ROMERO,2023-02-20,190,190,0,0
NICOLAS ROMERO,2023-02-21,97,97,0,0
NICOLAS ROMERO,2023-02-22,102,102,0,0
NICOLAS ROMERO,2023-02-23,244,166,78,0.31967
NICOLAS ROMERO,2023-02-24,119,110,9,0.07563
NICOLAS ROMERO,2023-02-25,81,81,0,0
NICOLAS ROMERO,2023-02-26,67,67,0,0
NICOLAS ROMERO,2023-02-27,146,136,10,0.06849
NICOLAS ROMERO,2023-02-28,143,143,0,0
NICOLAS ROMERO,2023-03-01,104,92,12,0.11538
NICOLAS ROMERO,2023-03-02,60,60,0,0
NICOLAS ROMERO,2023-03-03,108,108,0,0
NICOLAS ROMERO,2023-03-04,249,249,0,0
NICOLAS ROMERO,2023-03-05,31,30,1,0.03226
NICOLAS ROMERO,2023-03-07,47,46,1,0.02128
NICOLAS ROMERO,2023-03-08,90,90,0,0
NICOLAS ROMERO,2023-03-09,40,38,2,0.05
NICOLAS ROMERO,2023-03-10,86,80,6,0.06977
NICOLAS ROMERO,2023-03-11,73,73,0,0
NICOLAS ROMERO,2023-03-12,85,85,0,0
NICOLAS ROMERO,2023-03-13,32,32,0,0
NICOLAS ROMERO,2023-03-14,113,112,1,0.00885
NICOLAS ROMERO,2023-03-15,144,143,1,0.00694
NICOLAS ROMERO,2023-03-16,304,303,1,0.00329
NICOLAS ROMERO,2023-03-17,74,72,2,0.02703
NICOLAS ROMERO,2023-03-18,93,93,0,0
NICOLAS ROMERO,2023-03-19,80,76,4,0.05
NICOLAS ROMERO,2023-03-20,156,155,1,0.00641
NUEVO LAREDO,2023-02-03,3,1,2,0.66667
NUEVO LAREDO,2023-02-04,6,3,3,0.5
NUEVO LAREDO,2023-02-05,10,8,2,0.2
NUEVO LAREDO,2023-02-06,14,7,7,0.5
NUEVO LAREDO,2023-02-07,1,1,0,0
NUEVO LAREDO,2023-02-08,10,9,1,0.1
NUEVO LAREDO,2023-02-09,22,22,0,0
NUEVO LAREDO,2023-02-10,3,2,1,0.33333
NUEVO LAREDO,2023-02-11,1,1,0,0
NUEVO LAREDO,2023-02-12,3,3,0,0
NUEVO LAREDO,2023-02-13,7,7,0,0
NUEVO LAREDO,2023-02-14,227,125,102,0.44934
NUEVO LAREDO,2023-02-15,97,63,34,0.35052
NUEVO LAREDO,2023-02-16,82,27,55,0.67073
NUEVO LAREDO,2023-02-17,56,43,13,0.23214
NUEVO LAREDO,2023-02-18,42,35,7,0.16667
NUEVO LAREDO,2023-02-19,44,36,8,0.18182
NUEVO LAREDO,2023-02-20,112,33,79,0.70536
NUEVO LAREDO,2023-02-21,233,118,115,0.49356
NUEVO LAREDO,2023-02-22,113,57,56,0.49558
NUEVO LAREDO,2023-02-23,97,66,31,0.31959
NUEVO LAREDO,2023-02-24,177,92,85,0.48023
NUEVO LAREDO,2023-02-25,129,65,64,0.49612
NUEVO LAREDO,2023-02-26,90,46,44,0.48889
NUEVO LAREDO,2023-02-27,107,100,7,0.06542
NUEVO LAREDO,2023-02-28,133,63,70,0.52632
NUEVO LAREDO,2023-03-01,99,91,8,0.08081
NUEVO LAREDO,2023-03-02,118,100,18,0.15254
NUEVO LAREDO,2023-03-03,85,53,32,0.37647
NUEVO LAREDO,2023-03-04,108,81,27,0.25
NUEVO LAREDO,2023-03-05,65,60,5,0.07692
NUEVO LAREDO,2023-03-07,158,113,45,0.28481
NUEVO LAREDO,2023-03-08,174,95,79,0.45402
NUEVO LAREDO,2023-03-09,74,33,41,0.55405
NUEVO LAREDO,2023-03-10,123,107,16,0.13008
NUEVO LAREDO,2023-03-11,128,77,51,0.39844
NUEVO LAREDO,2023-03-12,87,70,17,0.1954
NUEVO LAREDO,2023-03-13,111,84,27,0.24324
NUEVO LAREDO,2023-03-14,85,38,47,0.55294
NUEVO LAREDO,2023-03-15,71,62,9,0.12676
NUEVO LAREDO,2023-03-16,81,76,5,0.06173
NUEVO LAREDO,2023-03-17,65,57,8,0.12308
NUEVO LAREDO,2023-03-18,60,46,14,0.23333
NUEVO LAREDO,2023-03-19,41,36,5,0.12195
NUEVO LAREDO,2023-03-20,71,61,10,0.14085
OJO DE AGUA,2023-01-01,16,16,0,0
OJO DE AGUA,2023-01-02,55,55,0,0
OJO DE AGUA,2023-01-03,57,57,0,0
OJO DE AGUA,2023-01-04,99,98,1,0.0101
OJO DE AGUA,2023-01-05,86,86,0,0
OJO DE AGUA,2023-01-06,80,78,2,0.025
OJO DE AGUA,2023-01-07,70,69,1,0.01429
OJO DE AGUA,2023-01-08,41,41,0,0
OJO DE AGUA,2023-01-09,92,92,0,0
OJO DE AGUA,2023-01-10,87,87,0,0
OJO DE AGUA,2023-01-11,129,129,0,0
OJO DE AGUA,2023-01-12,115,109,6,0.05217
OJO DE AGUA,2023-01-13,77,77,0,0
OJO DE AGUA,2023-01-14,49,48,1,0.02041
OJO DE AGUA,2023-01-15,143,143,0,0
OJO DE AGUA,2023-01-16,72,69,3,0.04167
OJO DE AGUA,2023-01-17,63,61,2,0.03175
OJO DE AGUA,2023-01-18,53,43,10,0.18868
OJO DE AGUA,2023-01-19,56,56,0,0
OJO DE AGUA,2023-01-20,42,42,0,0
OJO DE AGUA,2023-01-21,135,120,15,0.11111
OJO DE AGUA,2023-01-22,116,112,4,0.03448
OJO DE AGUA,2023-01-23,115,115,0,0
OJO DE AGUA,2023-01-24,27,27,0,0
OJO DE AGUA,2023-01-25,80,80,0,0
OJO DE AGUA,2023-01-26,90,90,0,0
OJO DE AGUA,2023-01-27,76,76,0,0
OJO DE AGUA,2023-01-28,75,68,7,0.09333
OJO DE AGUA,2023-01-29,65,65,0,0
OJO DE AGUA,2023-01-30,47,47,0,0
OJO DE AGUA,2023-01-31,133,133,0,0
OJO DE AGUA,2023-02-02,135,129,6,0.04444
OJO DE AGUA,2023-02-03,106,102,4,0.03774
OJO DE AGUA,2023-02-04,134,134,0,0
OJO DE AGUA,2023-02-05,56,55,1,0.01786
OJO DE AGUA,2023-02-06,136,136,0,0
OJO DE AGUA,2023-02-07,96,96,0,0
OJO DE AGUA,2023-02-08,106,104,2,0.01887
OJO DE AGUA,2023-02-09,136,136,0,0
OJO DE AGUA,2023-02-10,157,157,0,0
OJO DE AGUA,2023-02-11,174,174,0,0
OJO DE AGUA,2023-02-12,101,101,0,0
OJO DE AGUA,2023-02-13,165,165,0,0
OJO DE AGUA,2023-02-14,154,154,0,0
OJO DE AGUA,2023-02-15,84,77,7,0.08333
OJO DE AGUA,2023-02-16,97,97,0,0
OJO DE AGUA,2023-02-17,126,118,8,0.06349
OJO DE AGUA,2023-02-18,132,132,0,0
OJO DE AGUA,2023-02-19,127,127,0,0
OJO DE AGUA,2023-02-20,114,114,0,0
OJO DE AGUA,2023-02-21,163,163,0,0
OJO DE AGUA,2023-02-22,141,140,1,0.00709
OJO DE AGUA,2023-02-23,50,50,0,0
OJO DE AGUA,2023-02-24,114,111,3,0.02632
OJO DE AGUA,2023-02-25,134,133,1,0.00746
OJO DE AGUA,2023-02-26,107,107,0,0
OJO DE AGUA,2023-02-27,118,117,1,0.00847
OJO DE AGUA,2023-02-28,105,104,1,0.00952
OJO DE AGUA,2023-03-01,89,88,1,0.01124
OJO DE AGUA,2023-03-02,82,82,0,0
OJO DE AGUA,2023-03-03,101,97,4,0.0396
OJO DE AGUA,2023-03-04,89,88,1,0.01124
OJO DE AGUA,2023-03-05,114,110,4,0.03509
OJO DE AGUA,2023-03-07,74,74,0,0
OJO DE AGUA,2023-03-08,71,70,1,0.01408
OJO DE AGUA,2023-03-09,51,48,3,0.05882
OJO DE AGUA,2023-03-10,47,47,0,0
OJO DE AGUA,2023-03-11,62,62,0,0
OJO DE AGUA,2023-03-12,70,69,1,0.01429
OJO DE AGUA,2023-03-13,61,60,1,0.01639
OJO DE AGUA,2023-03-14,96,94,2,0.02083
OJO DE AGUA,2023-03-15,58,58,0,0
OJO DE AGUA,2023-03-16,104,104,0,0
OJO DE AGUA,2023-03-17,83,83,0,0
OJO DE AGUA,2023-03-18,76,76,0,0
OJO DE AGUA,2023-03-19,153,151,2,0.01307
OJO DE AGUA,2023-03-20,107,105,2,0.01869
PACHUCA,2023-01-01,6,4,2,0.33333
PACHUCA,2023-01-02,30,23,7,0.23333
PACHUCA,2023-01-03,67,25,42,0.62687
PACHUCA,2023-01-04,89,50,39,0.4382
PACHUCA,2023-01-05,128,75,53,0.41406
PACHUCA,2023-01-06,113,71,42,0.37168
PACHUCA,2023-01-07,48,29,19,0.39583
PACHUCA,2023-01-08,55,33,22,0.4
PACHUCA,2023-01-09,74,51,23,0.31081
PACHUCA,2023-01-10,89,57,32,0.35955
PACHUCA,2023-01-11,100,43,57,0.57
PACHUCA,2023-01-12,78,26,52,0.66667
PACHUCA,2023-01-13,75,30,45,0.6
PACHUCA,2023-01-14,82,48,34,0.41463
PACHUCA,2023-01-15,60,24,36,0.6
PACHUCA,2023-01-16,145,37,108,0.74483
PACHUCA,2023-01-17,114,33,81,0.71053
PACHUCA,2023-01-18,143,64,79,0.55245
PACHUCA,2023-01-19,94,32,62,0.65957
PACHUCA,2023-01-20,174,136,38,0.21839
PACHUCA,2023-01-21,148,82,66,0.44595
PACHUCA,2023-01-22,94,63,31,0.32979
PACHUCA,2023-01-23,232,146,86,0.37069
PACHUCA,2023-01-24,303,146,157,0.51815
PACHUCA,2023-01-25,251,146,105,0.41833
PACHUCA,2023-01-26,290,162,128,0.44138
PACHUCA,2023-01-27,241,152,89,0.36929
PACHUCA,2023-01-28,219,154,65,0.2968
PACHUCA,2023-01-29,97,73,24,0.24742
PACHUCA,2023-01-30,283,175,108,0.38163
PACHUCA,2023-01-31,222,120,102,0.45946
PACHUCA,2023-02-02,281,144,137,0.48754
PACHUCA,2023-02-03,297,165,132,0.44444
PACHUCA,2023-02-04,452,199,253,0.55973
PACHUCA,2023-02-05,195,121,74,0.37949
PACHUCA,2023-02-06,402,245,157,0.39055
PACHUCA,2023-02-07,281,209,72,0.25623
PACHUCA,2023-02-08,332,178,154,0.46386
PACHUCA,2023-02-09,412,221,191,0.46359
PACHUCA,2023-02-10,185,87,98,0.52973
PACHUCA,2023-02-11,338,206,132,0.39053
PACHUCA,2023-02-12,153,126,27,0.17647
PACHUCA,2023-02-13,304,295,9,0.02961
PACHUCA,2023-02-14,168,37,131,0.77976
PACHUCA,2023-02-15,225,81,144,0.64
PACHUCA,2023-02-16,264,126,138,0.52273
PACHUCA,2023-02-17,151,75,76,0.50331
PACHUCA,2023-02-18,323,227,96,0.29721
PACHUCA,2023-02-19,60,31,29,0.48333
PACHUCA,2023-02-20,286,138,148,0.51748
PACHUCA,2023-02-21,172,77,95,0.55233
PACHUCA,2023-02-22,175,129,46,0.26286
PACHUCA,2023-02-23,233,83,150,0.64378
PACHUCA,2023-02-24,203,115,88,0.4335
PACHUCA,2023-02-25,230,72,158,0.68696
PACHUCA,2023-02-26,96,78,18,0.1875
PACHUCA,2023-02-27,140,72,68,0.48571
PACHUCA,2023-02-28,340,251,89,0.26176
PACHUCA,2023-03-01,231,181,50,0.21645
PACHUCA,2023-03-02,86,49,37,0.43023
PACHUCA,2023-03-03,111,67,44,0.3964
PACHUCA,2023-03-04,286,226,60,0.20979
PACHUCA,2023-03-05,68,35,33,0.48529
PACHUCA,2023-03-07,168,96,72,0.42857
PACHUCA,2023-03-08,150,51,99,0.66
PACHUCA,2023-03-09,91,76,15,0.16484
PACHUCA,2023-03-10,61,46,15,0.2459
PACHUCA,2023-03-11,124,48,76,0.6129
PACHUCA,2023-03-12,51,44,7,0.13725
PACHUCA,2023-03-13,70,58,12,0.17143
PACHUCA,2023-03-14,120,107,13,0.10833
PACHUCA,2023-03-15,84,50,34,0.40476
PACHUCA,2023-03-16,90,64,26,0.28889
PACHUCA,2023-03-17,140,121,19,0.13571
PACHUCA,2023-03-18,141,96,45,0.31915
PACHUCA,2023-03-19,132,35,97,0.73485
PACHUCA,2023-03-20,90,84,6,0.06667
PEDREGAL,2023-01-01,9,9,0,0
PEDREGAL,2023-01-02,50,50,0,0
PEDREGAL,2023-01-03,38,37,1,0.02632
PEDREGAL,2023-01-04,37,37,0,0
PEDREGAL,2023-01-05,31,31,0,0
PEDREGAL,2023-01-06,34,33,1,0.02941
PEDREGAL,2023-01-07,51,50,1,0.01961
PEDREGAL,2023-01-08,16,14,2,0.125
PEDREGAL,2023-01-09,36,35,1,0.02778
PEDREGAL,2023-01-10,40,40,0,0
PEDREGAL,2023-01-11,62,60,2,0.03226
PEDREGAL,2023-01-12,48,48,0,0
PEDREGAL,2023-01-13,22,22,0,0
PEDREGAL,2023-01-14,25,24,1,0.04
PEDREGAL,2023-01-15,27,27,0,0
PEDREGAL,2023-01-16,97,97,0,0
PEDREGAL,2023-01-17,90,90,0,0
PEDREGAL,2023-01-18,45,45,0,0
PEDREGAL,2023-01-19,64,62,2,0.03125
PEDREGAL,2023-01-20,127,126,1,0.00787
PEDREGAL,2023-01-21,147,147,0,0
PEDREGAL,2023-01-22,64,64,0,0
PEDREGAL,2023-01-23,36,36,0,0
PEDREGAL,2023-01-24,102,102,0,0
PEDREGAL,2023-01-25,45,45,0,0
PEDREGAL,2023-01-26,93,91,2,0.02151
PEDREGAL,2023-01-27,61,58,3,0.04918
PEDREGAL,2023-01-28,34,34,0,0
PEDREGAL,2023-01-29,44,42,2,0.04545
PEDREGAL,2023-01-30,47,44,3,0.06383
PEDREGAL,2023-01-31,88,75,13,0.14773
PEDREGAL,2023-02-02,70,63,7,0.1
PEDREGAL,2023-02-03,71,69,2,0.02817
PEDREGAL,2023-02-04,98,79,19,0.19388
PEDREGAL,2023-02-05,52,50,2,0.03846
PEDREGAL,2023-02-06,73,48,25,0.34247
PEDREGAL,2023-02-07,47,35,12,0.25532
PEDREGAL,2023-02-08,71,71,0,0
PEDREGAL,2023-02-09,40,35,5,0.125
PEDREGAL,2023-02-10,62,60,2,0.03226
PEDREGAL,2023-02-11,61,58,3,0.04918
PEDREGAL,2023-02-12,23,23,0,0
PEDREGAL,2023-02-13,88,85,3,0.03409
PEDREGAL,2023-02-14,35,35,0,0
PEDREGAL,2023-02-15,23,22,1,0.04348
PEDREGAL,2023-02-16,32,32,0,0
PEDREGAL,2023-02-17,51,51,0,0
PEDREGAL,2023-02-18,121,121,0,0
PEDREGAL,2023-02-19,42,32,10,0.2381
PEDREGAL,2023-02-20,79,75,4,0.05063
PEDREGAL,2023-02-21,36,34,2,0.05556
PEDREGAL,2023-02-22,74,69,5,0.06757
PEDREGAL,2023-02-23,62,61,1,0.01613
PEDREGAL,2023-02-24,64,58,6,0.09375
PEDREGAL,2023-02-25,95,80,15,0.15789
PEDREGAL,2023-02-26,53,48,5,0.09434
PEDREGAL,2023-02-27,69,69,0,0
PEDREGAL,2023-02-28,77,77,0,0
PEDREGAL,2023-03-01,46,45,1,0.02174
PEDREGAL,2023-03-02,46,45,1,0.02174
PEDREGAL,2023-03-03,65,65,0,0
PEDREGAL,2023-03-04,50,45,5,0.1
PEDREGAL,2023-03-05,48,47,1,0.02083
PEDREGAL,2023-03-07,45,45,0,0
PEDREGAL,2023-03-08,47,47,0,0
PEDREGAL,2023-03-09,32,32,0,0
PEDREGAL,2023-03-10,40,40,0,0
PEDREGAL,2023-03-11,33,33,0,0
PEDREGAL,2023-03-12,30,29,1,0.03333
PEDREGAL,2023-03-13,42,42,0,0
PEDREGAL,2023-03-14,39,39,0,0
PEDREGAL,2023-03-15,41,41,0,0
PEDREGAL,2023-03-16,93,88,5,0.05376
PEDREGAL,2023-03-17,70,67,3,0.04286
PEDREGAL,2023-03-18,56,53,3,0.05357
PEDREGAL,2023-03-19,60,57,3,0.05
PEDREGAL,2023-03-20,61,59,2,0.03279
PIEDRAS NEGRAS / MONCLOVA,2023-01-01,8,8,0,0
PIEDRAS NEGRAS / MONCLOVA,2023-01-02,40,33,7,0.175
PIEDRAS NEGRAS / MONCLOVA,2023-01-03,34,31,3,0.08824
PIEDRAS NEGRAS / MONCLOVA,2023-01-04,25,20,5,0.2
PIEDRAS NEGRAS / MONCLOVA,2023-01-05,45,45,0,0
PIEDRAS NEGRAS / MONCLOVA,2023-01-06,41,38,3,0.07317
PIEDRAS NEGRAS / MONCLOVA,2023-01-07,39,36,3,0.07692
PIEDRAS NEGRAS / MONCLOVA,2023-01-08,51,50,1,0.01961
PIEDRAS NEGRAS / MONCLOVA,2023-01-09,24,21,3,0.125
PIEDRAS NEGRAS / MONCLOVA,2023-01-10,48,46,2,0.04167
PIEDRAS NEGRAS / MONCLOVA,2023-01-11,33,33,0,0
PIEDRAS NEGRAS / MONCLOVA,2023-01-12,42,42,0,0
PIEDRAS NEGRAS / MONCLOVA,2023-01-13,77,75,2,0.02597
PIEDRAS NEGRAS / MONCLOVA,2023-01-14,88,79,9,0.10227
PIEDRAS NEGRAS / MONCLOVA,2023-01-15,75,66,9,0.12
PIEDRAS NEGRAS / MONCLOVA,2023-01-16,56,53,3,0.05357
PIEDRAS NEGRAS / MONCLOVA,2023-01-17,72,67,5,0.06944
PIEDRAS NEGRAS / MONCLOVA,2023-01-18,84,80,4,0.04762
PIEDRAS NEGRAS / MONCLOVA,2023-01-19,65,57,8,0.12308
PIEDRAS NEGRAS / MONCLOVA,2023-01-20,72,58,14,0.19444
PIEDRAS NEGRAS / MONCLOVA,2023-01-21,74,58,16,0.21622
PIEDRAS NEGRAS / MONCLOVA,2023-01-22,33,27,6,0.18182
PIEDRAS NEGRAS / MONCLOVA,2023-01-23,53,45,8,0.15094
PIEDRAS NEGRAS / MONCLOVA,2023-01-24,63,62,1,0.01587
PIEDRAS NEGRAS / MONCLOVA,2023-01-25,65,62,3,0.04615
PIEDRAS NEGRAS / MONCLOVA,2023-01-26,48,41,7,0.14583
PIEDRAS NEGRAS / MONCLOVA,2023-01-27,62,57,5,0.08065
PIEDRAS NEGRAS / MONCLOVA,2023-01-28,62,59,3,0.04839
PIEDRAS NEGRAS / MONCLOVA,2023-01-29,33,32,1,0.0303
PIEDRAS NEGRAS / MONCLOVA,2023-01-30,59,54,5,0.08475
PIEDRAS NEGRAS / MONCLOVA,2023-01-31,48,47,1,0.02083
PIEDRAS NEGRAS / MONCLOVA,2023-02-02,52,47,5,0.09615
PIEDRAS NEGRAS / MONCLOVA,2023-02-03,56,49,7,0.125
PIEDRAS NEGRAS / MONCLOVA,2023-02-04,84,79,5,0.05952
PIEDRAS NEGRAS / MONCLOVA,2023-02-05,54,47,7,0.12963
PIEDRAS NEGRAS / MONCLOVA,2023-02-06,61,56,5,0.08197
PIEDRAS NEGRAS / MONCLOVA,2023-02-07,43,42,1,0.02326
PIEDRAS NEGRAS / MONCLOVA,2023-02-08,56,54,2,0.03571
PIEDRAS NEGRAS / MONCLOVA,2023-02-09,54,47,7,0.12963
PIEDRAS NEGRAS / MONCLOVA,2023-02-10,77,67,10,0.12987
PIEDRAS NEGRAS / MONCLOVA,2023-02-11,73,59,14,0.19178
PIEDRAS NEGRAS / MONCLOVA,2023-02-12,75,73,2,0.02667
PIEDRAS NEGRAS / MONCLOVA,2023-02-13,73,60,13,0.17808
PIEDRAS NEGRAS / MONCLOVA,2023-02-14,59,53,6,0.10169
PIEDRAS NEGRAS / MONCLOVA,2023-02-15,57,44,13,0.22807
PIEDRAS NEGRAS / MONCLOVA,2023-02-16,48,41,7,0.14583
PIEDRAS NEGRAS / MONCLOVA,2023-02-17,88,77,11,0.125
PIEDRAS NEGRAS / MONCLOVA,2023-02-18,65,55,10,0.15385
PIEDRAS NEGRAS / MONCLOVA,2023-02-19,53,47,6,0.11321
PIEDRAS NEGRAS / MONCLOVA,2023-02-20,44,40,4,0.09091
PIEDRAS NEGRAS / MONCLOVA,2023-02-21,75,72,3,0.04
PIEDRAS NEGRAS / MONCLOVA,2023-02-22,101,97,4,0.0396
PIEDRAS NEGRAS / MONCLOVA,2023-02-23,54,51,3,0.05556
PIEDRAS NEGRAS / MONCLOVA,2023-02-24,46,44,2,0.04348
PIEDRAS NEGRAS / MONCLOVA,2023-02-25,104,63,41,0.39423
PIEDRAS NEGRAS / MONCLOVA,2023-02-26,52,45,7,0.13462
PIEDRAS NEGRAS / MONCLOVA,2023-02-27,75,69,6,0.08
PIEDRAS NEGRAS / MONCLOVA,2023-02-28,55,51,4,0.07273
PIEDRAS NEGRAS / MONCLOVA,2023-03-01,97,86,11,0.1134
PIEDRAS NEGRAS / MONCLOVA,2023-03-02,146,142,4,0.0274
PIEDRAS NEGRAS / MONCLOVA,2023-03-03,135,118,17,0.12593
PIEDRAS NEGRAS / MONCLOVA,2023-03-04,174,141,33,0.18966
PIEDRAS NEGRAS / MONCLOVA,2023-03-05,68,57,11,0.16176
PIEDRAS NEGRAS / MONCLOVA,2023-03-07,109,99,10,0.09174
PIEDRAS NEGRAS / MONCLOVA,2023-03-08,65,60,5,0.07692
PIEDRAS NEGRAS / MONCLOVA,2023-03-09,78,63,15,0.19231
PIEDRAS NEGRAS / MONCLOVA,2023-03-10,109,84,25,0.22936
PIEDRAS NEGRAS / MONCLOVA,2023-03-11,136,124,12,0.08824
PIEDRAS NEGRAS / MONCLOVA,2023-03-12,66,46,20,0.30303
PIEDRAS NEGRAS / MONCLOVA,2023-03-13,91,74,17,0.18681
PIEDRAS NEGRAS / MONCLOVA,2023-03-14,75,66,9,0.12
PIEDRAS NEGRAS / MONCLOVA,2023-03-15,116,108,8,0.06897
PIEDRAS NEGRAS / MONCLOVA,2023-03-16,142,132,10,0.07042
PIEDRAS NEGRAS / MONCLOVA,2023-03-17,61,58,3,0.04918
PIEDRAS NEGRAS / MONCLOVA,2023-03-18,196,189,7,0.03571
PIEDRAS NEGRAS / MONCLOVA,2023-03-19,101,92,9,0.08911
PIEDRAS NEGRAS / MONCLOVA,2023-03-20,73,72,1,0.0137
POLANCO,2023-01-01,5,3,2,0.4
POLANCO,2023-01-02,25,25,0,0
POLANCO,2023-01-03,19,19,0,0
POLANCO,2023-01-04,25,25,0,0
POLANCO,2023-01-05,31,29,2,0.06452
POLANCO,2023-01-06,27,26,1,0.03704
POLANCO,2023-01-07,14,12,2,0.14286
POLANCO,2023-01-08,17,12,5,0.29412
POLANCO,2023-01-09,36,36,0,0
POLANCO,2023-01-10,29,27,2,0.06897
POLANCO,2023-01-11,30,30,0,0
POLANCO,2023-01-12,20,20,0,0
POLANCO,2023-01-13,19,19,0,0
POLANCO,2023-01-14,13,13,0,0
POLANCO,2023-01-15,9,9,0,0
POLANCO,2023-01-16,83,83,0,0
POLANCO,2023-01-17,101,101,0,0
POLANCO,2023-01-18,64,64,0,0
POLANCO,2023-01-19,123,123,0,0
POLANCO,2023-01-20,56,51,5,0.08929
POLANCO,2023-01-21,73,73,0,0
POLANCO,2023-01-22,37,37,0,0
POLANCO,2023-01-23,42,38,4,0.09524
POLANCO,2023-01-24,43,43,0,0
POLANCO,2023-01-25,49,49,0,0
POLANCO,2023-01-26,74,74,0,0
POLANCO,2023-01-27,67,67,0,0
POLANCO,2023-01-28,52,52,0,0
POLANCO,2023-01-29,15,12,3,0.2
POLANCO,2023-01-30,61,57,4,0.06557
POLANCO,2023-01-31,94,85,9,0.09574
POLANCO,2023-02-02,168,168,0,0
POLANCO,2023-02-03,133,128,5,0.03759
POLANCO,2023-02-04,93,93,0,0
POLANCO,2023-02-05,19,15,4,0.21053
POLANCO,2023-02-06,78,55,23,0.29487
POLANCO,2023-02-07,151,138,13,0.08609
POLANCO,2023-02-08,93,87,6,0.06452
POLANCO,2023-02-09,61,58,3,0.04918
POLANCO,2023-02-10,66,64,2,0.0303
POLANCO,2023-02-11,125,123,2,0.016
POLANCO,2023-02-12,10,10,0,0
POLANCO,2023-02-13,289,274,15,0.0519
POLANCO,2023-02-14,53,51,2,0.03774
POLANCO,2023-02-15,44,44,0,0
POLANCO,2023-02-16,66,65,1,0.01515
POLANCO,2023-02-17,33,30,3,0.09091
POLANCO,2023-02-18,80,80,0,0
POLANCO,2023-02-19,17,15,2,0.11765
POLANCO,2023-02-20,98,82,16,0.16327
POLANCO,2023-02-21,101,100,1,0.0099
POLANCO,2023-02-22,80,75,5,0.0625
POLANCO,2023-02-23,53,52,1,0.01887
POLANCO,2023-02-24,57,55,2,0.03509
POLANCO,2023-02-25,37,26,11,0.2973
POLANCO,2023-02-26,5,5,0,0
POLANCO,2023-02-27,93,42,51,0.54839
POLANCO,2023-02-28,51,47,4,0.07843
POLANCO,2023-03-01,68,64,4,0.05882
POLANCO,2023-03-02,164,88,76,0.46341
POLANCO,2023-03-03,65,57,8,0.12308
POLANCO,2023-03-04,111,99,12,0.10811
POLANCO,2023-03-05,33,31,2,0.06061
POLANCO,2023-03-07,51,51,0,0
POLANCO,2023-03-08,94,94,0,0
POLANCO,2023-03-09,60,60,0,0
POLANCO,2023-03-10,44,33,11,0.25
POLANCO,2023-03-11,67,67,0,0
POLANCO,2023-03-12,18,18,0,0
POLANCO,2023-03-13,60,60,0,0
POLANCO,2023-03-14,36,36,0,0
POLANCO,2023-03-15,39,39,0,0
POLANCO,2023-03-16,36,36,0,0
POLANCO,2023-03-17,48,48,0,0
POLANCO,2023-03-18,64,64,0,0
POLANCO,2023-03-19,9,9,0,0
POLANCO,2023-03-20,35,35,0,0
PORTALES,2023-01-01,12,12,0,0
PORTALES,2023-01-02,32,31,1,0.03125
PORTALES,2023-01-03,18,18,0,0
PORTALES,2023-01-04,43,43,0,0
PORTALES,2023-01-05,36,36,0,0
PORTALES,2023-01-06,48,48,0,0
PORTALES,2023-01-07,49,49,0,0
PORTALES,2023-01-08,54,54,0,0
PORTALES,2023-01-09,41,41,0,0
PORTALES,2023-01-10,35,35,0,0
PORTALES,2023-01-11,89,89,0,0
PORTALES,2023-01-12,83,83,0,0
PORTALES,2023-01-13,65,65,0,0
PORTALES,2023-01-14,118,116,2,0.01695
PORTALES,2023-01-15,74,74,0,0
PORTALES,2023-01-16,106,106,0,0
PORTALES,2023-01-17,82,82,0,0
PORTALES,2023-01-18,285,285,0,0
PORTALES,2023-01-19,163,163,0,0
PORTALES,2023-01-20,104,104,0,0
PORTALES,2023-01-21,251,250,1,0.00398
PORTALES,2023-01-22,252,252,0,0
PORTALES,2023-01-23,175,175,0,0
PORTALES,2023-01-24,129,129,0,0
PORTALES,2023-01-25,70,70,0,0
PORTALES,2023-01-26,107,107,0,0
PORTALES,2023-01-27,85,85,0,0
PORTALES,2023-01-28,148,146,2,0.01351
PORTALES,2023-01-29,166,166,0,0
PORTALES,2023-01-30,171,171,0,0
PORTALES,2023-01-31,107,107,0,0
PORTALES,2023-02-02,262,245,17,0.06489
PORTALES,2023-02-03,270,270,0,0
PORTALES,2023-02-04,219,219,0,0
PORTALES,2023-02-05,183,183,0,0
PORTALES,2023-02-06,192,192,0,0
PORTALES,2023-02-07,125,125,0,0
PORTALES,2023-02-08,206,206,0,0
PORTALES,2023-02-09,239,239,0,0
PORTALES,2023-02-10,166,166,0,0
PORTALES,2023-02-11,153,142,11,0.0719
PORTALES,2023-02-12,297,297,0,0
PORTALES,2023-02-13,216,216,0,0
PORTALES,2023-02-14,193,193,0,0
PORTALES,2023-02-15,156,156,0,0
PORTALES,2023-02-16,240,240,0,0
PORTALES,2023-02-17,159,159,0,0
PORTALES,2023-02-18,164,164,0,0
PORTALES,2023-02-19,170,155,15,0.08824
PORTALES,2023-02-20,113,107,6,0.0531
PORTALES,2023-02-21,134,134,0,0
PORTALES,2023-02-22,122,122,0,0
PORTALES,2023-02-23,73,73,0,0
PORTALES,2023-02-24,185,185,0,0
PORTALES,2023-02-25,108,108,0,0
PORTALES,2023-02-26,103,103,0,0
PORTALES,2023-02-27,118,118,0,0
PORTALES,2023-02-28,60,60,0,0
PORTALES,2023-03-01,161,161,0,0
PORTALES,2023-03-02,134,133,1,0.00746
PORTALES,2023-03-03,182,182,0,0
PORTALES,2023-03-04,185,185,0,0
PORTALES,2023-03-05,147,147,0,0
PORTALES,2023-03-07,219,218,1,0.00457
PORTALES,2023-03-08,73,73,0,0
PORTALES,2023-03-09,93,93,0,0
PORTALES,2023-03-10,52,52,0,0
PORTALES,2023-03-11,139,139,0,0
PORTALES,2023-03-12,49,49,0,0
PORTALES,2023-03-13,47,47,0,0
PORTALES,2023-03-14,74,74,0,0
PORTALES,2023-03-15,100,100,0,0
PORTALES,2023-03-16,150,148,2,0.01333
PORTALES,2023-03-17,73,73,0,0
PORTALES,2023-03-18,73,73,0,0
PORTALES,2023-03-19,78,78,0,0
PORTALES,2023-03-20,64,64,0,0
POZA RICA / TUXPAN,2023-01-01,8,8,0,0
POZA RICA / TUXPAN,2023-01-02,30,29,1,0.03333
POZA RICA / TUXPAN,2023-01-03,51,51,0,0
POZA RICA / TUXPAN,2023-01-04,33,31,2,0.06061
POZA RICA / TUXPAN,2023-01-05,38,37,1,0.02632
POZA RICA / TUXPAN,2023-01-06,39,39,0,0
POZA RICA / TUXPAN,2023-01-07,35,35,0,0
POZA RICA / TUXPAN,2023-01-08,16,16,0,0
POZA RICA / TUXPAN,2023-01-09,17,17,0,0
POZA RICA / TUXPAN,2023-01-10,52,52,0,0
POZA RICA / TUXPAN,2023-01-11,20,20,0,0
POZA RICA / TUXPAN,2023-01-12,40,31,9,0.225
POZA RICA / TUXPAN,2023-01-13,52,52,0,0
POZA RICA / TUXPAN,2023-01-14,20,19,1,0.05
POZA RICA / TUXPAN,2023-01-15,18,17,1,0.05556
POZA RICA / TUXPAN,2023-01-16,34,34,0,0
POZA RICA / TUXPAN,2023-01-17,71,70,1,0.01408
POZA RICA / TUXPAN,2023-01-18,106,102,4,0.03774
POZA RICA / TUXPAN,2023-01-19,100,94,6,0.06
POZA RICA / TUXPAN,2023-01-20,106,105,1,0.00943
POZA RICA / TUXPAN,2023-01-21,101,76,25,0.24752
POZA RICA / TUXPAN,2023-01-22,96,95,1,0.01042
POZA RICA / TUXPAN,2023-01-23,64,43,21,0.32812
POZA RICA / TUXPAN,2023-01-24,177,112,65,0.36723
POZA RICA / TUXPAN,2023-01-25,104,91,13,0.125
POZA RICA / TUXPAN,2023-01-26,150,150,0,0
POZA RICA / TUXPAN,2023-01-27,204,196,8,0.03922
POZA RICA / TUXPAN,2023-01-28,104,95,9,0.08654
POZA RICA / TUXPAN,2023-01-29,74,44,30,0.40541
POZA RICA / TUXPAN,2023-01-30,152,152,0,0
POZA RICA / TUXPAN,2023-01-31,176,175,1,0.00568
POZA RICA / TUXPAN,2023-02-02,102,84,18,0.17647
POZA RICA / TUXPAN,2023-02-03,117,115,2,0.01709
POZA RICA / TUXPAN,2023-02-04,197,188,9,0.04569
POZA RICA / TUXPAN,2023-02-05,68,68,0,0
POZA RICA / TUXPAN,2023-02-06,203,179,24,0.11823
POZA RICA / TUXPAN,2023-02-07,216,214,2,0.00926
POZA RICA / TUXPAN,2023-02-08,196,195,1,0.0051
POZA RICA / TUXPAN,2023-02-09,166,165,1,0.00602
POZA RICA / TUXPAN,2023-02-10,97,86,11,0.1134
POZA RICA / TUXPAN,2023-02-11,153,153,0,0
POZA RICA / TUXPAN,2023-02-12,67,66,1,0.01493
POZA RICA / TUXPAN,2023-02-13,150,150,0,0
POZA RICA / TUXPAN,2023-02-14,57,57,0,0
POZA RICA / TUXPAN,2023-02-15,48,48,0,0
POZA RICA / TUXPAN,2023-02-16,121,114,7,0.05785
POZA RICA / TUXPAN,2023-02-17,88,81,7,0.07955
POZA RICA / TUXPAN,2023-02-18,113,113,0,0
POZA RICA / TUXPAN,2023-02-19,51,37,14,0.27451
POZA RICA / TUXPAN,2023-02-20,52,52,0,0
POZA RICA / TUXPAN,2023-02-21,84,79,5,0.05952
POZA RICA / TUXPAN,2023-02-22,57,48,9,0.15789
POZA RICA / TUXPAN,2023-02-23,83,83,0,0
POZA RICA / TUXPAN,2023-02-24,101,81,20,0.19802
POZA RICA / TUXPAN,2023-02-25,20,19,1,0.05
POZA RICA / TUXPAN,2023-02-26,13,13,0,0
POZA RICA / TUXPAN,2023-02-27,93,91,2,0.02151
POZA RICA / TUXPAN,2023-02-28,84,83,1,0.0119
POZA RICA / TUXPAN,2023-03-01,167,162,5,0.02994
POZA RICA / TUXPAN,2023-03-02,45,45,0,0
POZA RICA / TUXPAN,2023-03-03,50,28,22,0.44
POZA RICA / TUXPAN,2023-03-04,25,19,6,0.24
POZA RICA / TUXPAN,2023-03-05,15,10,5,0.33333
POZA RICA / TUXPAN,2023-03-07,74,73,1,0.01351
POZA RICA / TUXPAN,2023-03-08,32,29,3,0.09375
POZA RICA / TUXPAN,2023-03-09,31,24,7,0.22581
POZA RICA / TUXPAN,2023-03-10,69,66,3,0.04348
POZA RICA / TUXPAN,2023-03-11,25,24,1,0.04
POZA RICA / TUXPAN,2023-03-12,17,15,2,0.11765
POZA RICA / TUXPAN,2023-03-13,56,53,3,0.05357
POZA RICA / TUXPAN,2023-03-14,44,44,0,0
POZA RICA / TUXPAN,2023-03-15,32,32,0,0
POZA RICA / TUXPAN,2023-03-16,158,158,0,0
POZA RICA / TUXPAN,2023-03-17,29,29,0,0
POZA RICA / TUXPAN,2023-03-18,96,96,0,0
POZA RICA / TUXPAN,2023-03-19,84,84,0,0
POZA RICA / TUXPAN,2023-03-20,32,32,0,0
PUE ANGELOPOLIS,2023-01-01,13,13,0,0
PUE ANGELOPOLIS,2023-01-02,30,30,0,0
PUE ANGELOPOLIS,2023-01-03,61,60,1,0.01639
PUE ANGELOPOLIS,2023-01-04,75,72,3,0.04
PUE ANGELOPOLIS,2023-01-05,63,58,5,0.07937
PUE ANGELOPOLIS,2023-01-06,51,50,1,0.01961
PUE ANGELOPOLIS,2023-01-07,54,51,3,0.05556
PUE ANGELOPOLIS,2023-01-08,52,52,0,0
PUE ANGELOPOLIS,2023-01-09,51,48,3,0.05882
PUE ANGELOPOLIS,2023-01-10,79,79,0,0
PUE ANGELOPOLIS,2023-01-11,93,93,0,0
PUE ANGELOPOLIS,2023-01-12,64,64,0,0
PUE ANGELOPOLIS,2023-01-13,77,77,0,0
PUE ANGELOPOLIS,2023-01-14,72,72,0,0
PUE ANGELOPOLIS,2023-01-15,57,57,0,0
PUE ANGELOPOLIS,2023-01-16,56,54,2,0.03571
PUE ANGELOPOLIS,2023-01-17,246,205,41,0.16667
PUE ANGELOPOLIS,2023-01-18,172,170,2,0.01163
PUE ANGELOPOLIS,2023-01-19,99,95,4,0.0404
PUE ANGELOPOLIS,2023-01-20,219,214,5,0.02283
PUE ANGELOPOLIS,2023-01-21,177,158,19,0.10734
PUE ANGELOPOLIS,2023-01-22,84,81,3,0.03571
PUE ANGELOPOLIS,2023-01-23,207,207,0,0
PUE ANGELOPOLIS,2023-01-24,198,194,4,0.0202
PUE ANGELOPOLIS,2023-01-25,134,123,11,0.08209
PUE ANGELOPOLIS,2023-01-26,212,209,3,0.01415
PUE ANGELOPOLIS,2023-01-27,178,172,6,0.03371
PUE ANGELOPOLIS,2023-01-28,223,203,20,0.08969
PUE ANGELOPOLIS,2023-01-29,126,106,20,0.15873
PUE ANGELOPOLIS,2023-01-30,254,210,44,0.17323
PUE ANGELOPOLIS,2023-01-31,209,195,14,0.06699
PUE ANGELOPOLIS,2023-02-02,124,115,9,0.07258
PUE ANGELOPOLIS,2023-02-03,154,151,3,0.01948
PUE ANGELOPOLIS,2023-02-04,220,213,7,0.03182
PUE ANGELOPOLIS,2023-02-05,93,90,3,0.03226
PUE ANGELOPOLIS,2023-02-06,145,145,0,0
PUE ANGELOPOLIS,2023-02-07,183,181,2,0.01093
PUE ANGELOPOLIS,2023-02-08,245,231,14,0.05714
PUE ANGELOPOLIS,2023-02-09,140,130,10,0.07143
PUE ANGELOPOLIS,2023-02-10,261,235,26,0.09962
PUE ANGELOPOLIS,2023-02-11,206,193,13,0.06311
PUE ANGELOPOLIS,2023-02-12,74,59,15,0.2027
PUE ANGELOPOLIS,2023-02-13,234,228,6,0.02564
PUE ANGELOPOLIS,2023-02-14,195,182,13,0.06667
PUE ANGELOPOLIS,2023-02-15,255,247,8,0.03137
PUE ANGELOPOLIS,2023-02-16,373,364,9,0.02413
PUE ANGELOPOLIS,2023-02-17,305,303,2,0.00656
PUE ANGELOPOLIS,2023-02-18,347,341,6,0.01729
PUE ANGELOPOLIS,2023-02-19,143,135,8,0.05594
PUE ANGELOPOLIS,2023-02-20,199,172,27,0.13568
PUE ANGELOPOLIS,2023-02-21,177,171,6,0.0339
PUE ANGELOPOLIS,2023-02-22,157,151,6,0.03822
PUE ANGELOPOLIS,2023-02-23,164,157,7,0.04268
PUE ANGELOPOLIS,2023-02-24,173,170,3,0.01734
PUE ANGELOPOLIS,2023-02-25,226,216,10,0.04425
PUE ANGELOPOLIS,2023-02-26,125,119,6,0.048
PUE ANGELOPOLIS,2023-02-27,130,123,7,0.05385
PUE ANGELOPOLIS,2023-02-28,216,206,10,0.0463
PUE ANGELOPOLIS,2023-03-01,124,121,3,0.02419
PUE ANGELOPOLIS,2023-03-02,111,107,4,0.03604
PUE ANGELOPOLIS,2023-03-03,155,137,18,0.11613
PUE ANGELOPOLIS,2023-03-04,220,217,3,0.01364
PUE ANGELOPOLIS,2023-03-05,209,209,0,0
PUE LA NORIA,2023-01-01,6,6,0,0
PUE LA NORIA,2023-01-02,59,59,0,0
PUE LA NORIA,2023-01-03,123,122,1,0.00813
PUE LA NORIA,2023-01-04,73,71,2,0.0274
PUE LA NORIA,2023-01-05,83,74,9,0.10843
PUE LA NORIA,2023-01-06,98,96,2,0.02041
PUE LA NORIA,2023-01-07,93,80,13,0.13978
PUE LA NORIA,2023-01-08,125,108,17,0.136
PUE LA NORIA,2023-01-09,83,81,2,0.0241
PUE LA NORIA,2023-01-10,176,176,0,0
PUE LA NORIA,2023-01-11,108,107,1,0.00926
PUE LA NORIA,2023-01-12,123,119,4,0.03252
PUE LA NORIA,2023-01-13,90,88,2,0.02222
PUE LA NORIA,2023-01-14,153,135,18,0.11765
PUE LA NORIA,2023-01-15,96,95,1,0.01042
PUE LA NORIA,2023-01-16,211,207,4,0.01896
PUE LA NORIA,2023-01-17,226,217,9,0.03982
PUE LA NORIA,2023-01-18,281,275,6,0.02135
PUE LA NORIA,2023-01-19,236,233,3,0.01271
PUE LA NORIA,2023-01-20,377,372,5,0.01326
PUE LA NORIA,2023-01-21,563,549,14,0.02487
PUE LA NORIA,2023-01-22,215,186,29,0.13488
PUE LA NORIA,2023-01-23,371,355,16,0.04313
PUE LA NORIA,2023-01-24,321,321,0,0
PUE LA NORIA,2023-01-25,351,351,0,0
PUE LA NORIA,2023-01-26,392,392,0,0
PUE LA NORIA,2023-01-27,391,385,6,0.01535
PUE LA NORIA,2023-01-28,467,464,3,0.00642
PUE LA NORIA,2023-01-29,284,232,52,0.1831
PUE LA NORIA,2023-01-30,190,163,27,0.14211
PUE LA NORIA,2023-01-31,218,213,5,0.02294
PUE LA NORIA,2023-02-02,320,273,47,0.14688
PUE LA NORIA,2023-02-03,435,420,15,0.03448
PUE LA NORIA,2023-02-04,287,264,23,0.08014
PUE LA NORIA,2023-02-05,249,217,32,0.12851
PUE LA NORIA,2023-02-06,247,247,0,0
PUE LA NORIA,2023-02-07,299,279,20,0.06689
PUE LA NORIA,2023-02-08,369,364,5,0.01355
PUE LA NORIA,2023-02-09,462,436,26,0.05628
PUE LA NORIA,2023-02-10,455,430,25,0.05495
PUE LA NORIA,2023-02-11,408,359,49,0.1201
PUE LA NORIA,2023-02-12,168,127,41,0.24405
PUE LA NORIA,2023-02-13,279,274,5,0.01792
PUE LA NORIA,2023-02-14,396,370,26,0.06566
PUE LA NORIA,2023-02-15,619,509,110,0.17771
PUE LA NORIA,2023-02-16,385,367,18,0.04675
PUE LA NORIA,2023-02-17,197,196,1,0.00508
PUE LA NORIA,2023-02-18,607,556,51,0.08402
PUE LA NORIA,2023-02-19,416,377,39,0.09375
PUE LA NORIA,2023-02-20,324,240,84,0.25926
PUE LA NORIA,2023-02-21,345,295,50,0.14493
PUE LA NORIA,2023-02-22,173,173,0,0
PUE LA NORIA,2023-02-23,294,294,0,0
PUE LA NORIA,2023-02-24,362,359,3,0.00829
PUE LA NORIA,2023-02-25,487,487,0,0
PUE LA NORIA,2023-02-26,120,107,13,0.10833
PUE LA NORIA,2023-02-27,297,279,18,0.06061
PUE LA NORIA,2023-02-28,361,328,33,0.09141
PUE LA NORIA,2023-03-01,196,183,13,0.06633
PUE LA NORIA,2023-03-02,224,170,54,0.24107
PUE LA NORIA,2023-03-03,265,249,16,0.06038
PUE LA NORIA,2023-03-04,211,129,82,0.38863
PUE LA NORIA,2023-03-05,149,148,1,0.00671
PUE LA NORIA,2023-03-07,249,249,0,0
PUE LA NORIA,2023-03-08,341,327,14,0.04106
PUE LA NORIA,2023-03-09,248,247,1,0.00403
PUE LA NORIA,2023-03-10,146,141,5,0.03425
PUE LA NORIA,2023-03-11,180,102,78,0.43333
PUE LA NORIA,2023-03-12,168,152,16,0.09524
PUE LA NORIA,2023-03-13,343,257,86,0.25073
PUE LA NORIA,2023-03-14,121,115,6,0.04959
PUE LA NORIA,2023-03-15,252,252,0,0
PUE LA NORIA,2023-03-16,173,173,0,0
PUE LA NORIA,2023-03-17,418,410,8,0.01914
PUE LA NORIA,2023-03-18,254,228,26,0.10236
PUE LA NORIA,2023-03-19,259,259,0,0
PUE LA NORIA,2023-03-20,266,266,0,0
PUE LORETO,2023-01-01,17,17,0,0
PUE LORETO,2023-01-02,24,21,3,0.125
PUE LORETO,2023-01-03,41,41,0,0
PUE LORETO,2023-01-04,78,69,9,0.11538
PUE LORETO,2023-01-05,38,38,0,0
PUE LORETO,2023-01-06,65,65,0,0
PUE LORETO,2023-01-07,58,54,4,0.06897
PUE LORETO,2023-01-08,34,32,2,0.05882
PUE LORETO,2023-01-09,59,58,1,0.01695
PUE LORETO,2023-01-10,52,51,1,0.01923
PUE LORETO,2023-01-11,76,55,21,0.27632
PUE LORETO,2023-01-12,108,107,1,0.00926
PUE LORETO,2023-01-13,70,70,0,0
PUE LORETO,2023-01-14,53,52,1,0.01887
PUE LORETO,2023-01-15,78,78,0,0
PUE LORETO,2023-01-16,94,93,1,0.01064
PUE LORETO,2023-01-17,151,147,4,0.02649
PUE LORETO,2023-01-18,100,96,4,0.04
PUE LORETO,2023-01-19,122,105,17,0.13934
PUE LORETO,2023-01-20,145,145,0,0
PUE LORETO,2023-01-21,162,161,1,0.00617
PUE LORETO,2023-01-22,336,311,25,0.0744
PUE LORETO,2023-01-23,123,121,2,0.01626
PUE LORETO,2023-01-24,228,228,0,0
PUE LORETO,2023-01-25,122,121,1,0.0082
PUE LORETO,2023-01-26,274,274,0,0
PUE LORETO,2023-01-27,206,206,0,0
PUE LORETO,2023-01-28,300,300,0,0
PUE LORETO,2023-01-29,198,182,16,0.08081
PUE LORETO,2023-01-30,177,177,0,0
PUE LORETO,2023-01-31,193,193,0,0
PUE LORETO,2023-02-02,93,93,0,0
PUE LORETO,2023-02-03,230,230,0,0
PUE LORETO,2023-02-04,146,146,0,0
PUE LORETO,2023-02-05,199,195,4,0.0201
PUE LORETO,2023-02-06,77,77,0,0
PUE LORETO,2023-02-07,201,197,4,0.0199
PUE LORETO,2023-02-08,270,270,0,0
PUE LORETO,2023-02-09,233,233,0,0
PUE LORETO,2023-02-10,250,250,0,0
PUE LORETO,2023-02-11,404,404,0,0
PUE LORETO,2023-02-12,73,73,0,0
PUE LORETO,2023-02-13,172,172,0,0
PUE LORETO,2023-02-14,220,220,0,0
PUE LORETO,2023-02-15,241,240,1,0.00415
PUE LORETO,2023-02-16,419,417,2,0.00477
PUE LORETO,2023-02-17,320,315,5,0.01562
PUE LORETO,2023-02-18,210,208,2,0.00952
PUE LORETO,2023-02-19,476,438,38,0.07983
PUE LORETO,2023-02-20,360,360,0,0
PUE LORETO,2023-02-21,241,153,88,0.36515
PUE LORETO,2023-02-22,144,144,0,0
PUE LORETO,2023-02-23,261,259,2,0.00766
PUE LORETO,2023-02-24,76,74,2,0.02632
PUE LORETO,2023-02-25,219,213,6,0.0274
PUE LORETO,2023-02-26,154,151,3,0.01948
PUE LORETO,2023-02-27,248,245,3,0.0121
PUE LORETO,2023-02-28,244,243,1,0.0041
PUE LORETO,2023-03-01,42,42,0,0
PUE LORETO,2023-03-02,161,105,56,0.34783
PUE LORETO,2023-03-03,142,137,5,0.03521
PUE LORETO,2023-03-04,116,115,1,0.00862
PUE LORETO,2023-03-05,59,59,0,0
PUE LORETO,2023-03-07,240,239,1,0.00417
PUE LORETO,2023-03-08,491,491,0,0
PUE LORETO,2023-03-09,110,110,0,0
PUE LORETO,2023-03-10,47,44,3,0.06383
PUE LORETO,2023-03-11,126,69,57,0.45238
PUE LORETO,2023-03-12,105,98,7,0.06667
PUE LORETO,2023-03-13,35,35,0,0
PUE LORETO,2023-03-14,65,65,0,0
PUE LORETO,2023-03-15,76,76,0,0
PUE LORETO,2023-03-16,77,77,0,0
PUE LORETO,2023-03-17,87,87,0,0
PUE LORETO,2023-03-18,74,74,0,0
PUE LORETO,2023-03-19,103,102,1,0.00971
PUE LORETO,2023-03-20,113,113,0,0
PUERTO VALLARTA,2023-01-01,4,4,0,0
PUERTO VALLARTA,2023-01-02,38,37,1,0.02632
PUERTO VALLARTA,2023-01-03,60,58,2,0.03333
PUERTO VALLARTA,2023-01-04,42,42,0,0
PUERTO VALLARTA,2023-01-05,31,31,0,0
PUERTO VALLARTA,2023-01-06,58,55,3,0.05172
PUERTO VALLARTA,2023-01-07,46,44,2,0.04348
PUERTO VALLARTA,2023-01-08,39,39,0,0
PUERTO VALLARTA,2023-01-09,57,57,0,0
PUERTO VALLARTA,2023-01-10,42,42,0,0
PUERTO VALLARTA,2023-01-11,45,44,1,0.02222
PUERTO VALLARTA,2023-01-12,42,37,5,0.11905
PUERTO VALLARTA,2023-01-13,52,52,0,0
PUERTO VALLARTA,2023-01-14,61,56,5,0.08197
PUERTO VALLARTA,2023-01-15,38,37,1,0.02632
PUERTO VALLARTA,2023-01-16,61,60,1,0.01639
PUERTO VALLARTA,2023-01-17,66,63,3,0.04545
PUERTO VALLARTA,2023-01-18,65,64,1,0.01538
PUERTO VALLARTA,2023-01-19,48,36,12,0.25
PUERTO VALLARTA,2023-01-20,56,48,8,0.14286
PUERTO VALLARTA,2023-01-21,97,82,15,0.15464
PUERTO VALLARTA,2023-01-22,75,67,8,0.10667
PUERTO VALLARTA,2023-01-23,105,97,8,0.07619
PUERTO VALLARTA,2023-01-24,132,126,6,0.04545
PUERTO VALLARTA,2023-01-25,77,73,4,0.05195
PUERTO VALLARTA,2023-01-26,75,70,5,0.06667
PUERTO VALLARTA,2023-01-27,121,116,5,0.04132
PUERTO VALLARTA,2023-01-28,87,66,21,0.24138
PUERTO VALLARTA,2023-01-29,58,55,3,0.05172
PUERTO VALLARTA,2023-01-30,67,55,12,0.1791
PUERTO VALLARTA,2023-01-31,68,48,20,0.29412
PUERTO VALLARTA,2023-02-02,149,82,67,0.44966
PUERTO VALLARTA,2023-02-03,133,83,50,0.37594
PUERTO VALLARTA,2023-02-04,65,36,29,0.44615
PUERTO VALLARTA,2023-02-05,90,21,69,0.76667
PUERTO VALLARTA,2023-02-06,92,68,24,0.26087
PUERTO VALLARTA,2023-02-07,118,88,30,0.25424
PUERTO VALLARTA,2023-02-08,38,22,16,0.42105
PUERTO VALLARTA,2023-02-09,86,68,18,0.2093
PUERTO VALLARTA,2023-02-10,56,32,24,0.42857
PUERTO VALLARTA,2023-02-11,54,28,26,0.48148
PUERTO VALLARTA,2023-02-12,55,40,15,0.27273
PUERTO VALLARTA,2023-02-13,60,45,15,0.25
PUERTO VALLARTA,2023-02-14,61,40,21,0.34426
PUERTO VALLARTA,2023-02-15,24,19,5,0.20833
PUERTO VALLARTA,2023-02-16,71,60,11,0.15493
PUERTO VALLARTA,2023-02-17,50,36,14,0.28
PUERTO VALLARTA,2023-02-18,67,39,28,0.41791
PUERTO VALLARTA,2023-02-19,61,53,8,0.13115
PUERTO VALLARTA,2023-02-20,104,67,37,0.35577
PUERTO VALLARTA,2023-02-21,38,34,4,0.10526
PUERTO VALLARTA,2023-02-22,67,53,14,0.20896
PUERTO VALLARTA,2023-02-23,51,28,23,0.45098
PUERTO VALLARTA,2023-02-24,83,60,23,0.27711
PUERTO VALLARTA,2023-02-25,64,51,13,0.20312
PUERTO VALLARTA,2023-02-26,29,19,10,0.34483
PUERTO VALLARTA,2023-02-27,102,62,40,0.39216
PUERTO VALLARTA,2023-02-28,49,30,19,0.38776
PUERTO VALLARTA,2023-03-01,47,24,23,0.48936
PUERTO VALLARTA,2023-03-02,63,38,25,0.39683
PUERTO VALLARTA,2023-03-03,61,24,37,0.60656
PUERTO VALLARTA,2023-03-04,78,43,35,0.44872
PUERTO VALLARTA,2023-03-05,35,19,16,0.45714
PUERTO VALLARTA,2023-03-07,89,62,27,0.30337
PUERTO VALLARTA,2023-03-08,42,21,21,0.5
PUERTO VALLARTA,2023-03-09,57,48,9,0.15789
PUERTO VALLARTA,2023-03-10,61,40,21,0.34426
PUERTO VALLARTA,2023-03-11,46,29,17,0.36957
PUERTO VALLARTA,2023-03-12,43,23,20,0.46512
PUERTO VALLARTA,2023-03-13,34,19,15,0.44118
PUERTO VALLARTA,2023-03-14,66,40,26,0.39394
PUERTO VALLARTA,2023-03-15,70,43,27,0.38571
PUERTO VALLARTA,2023-03-16,57,57,0,0
PUERTO VALLARTA,2023-03-17,56,44,12,0.21429
PUERTO VALLARTA,2023-03-18,61,59,2,0.03279
PUERTO VALLARTA,2023-03-19,33,25,8,0.24242
PUERTO VALLARTA,2023-03-20,71,68,3,0.04225
QUERETARO CORREGIDORA,2023-01-01,4,4,0,0
QUERETARO CORREGIDORA,2023-01-02,37,37,0,0
QUERETARO CORREGIDORA,2023-01-03,49,48,1,0.02041
QUERETARO CORREGIDORA,2023-01-04,60,54,6,0.1
QUERETARO CORREGIDORA,2023-01-05,40,35,5,0.125
QUERETARO CORREGIDORA,2023-01-06,31,30,1,0.03226
QUERETARO CORREGIDORA,2023-01-07,41,35,6,0.14634
QUERETARO CORREGIDORA,2023-01-08,29,25,4,0.13793
QUERETARO CORREGIDORA,2023-01-09,59,58,1,0.01695
QUERETARO CORREGIDORA,2023-01-10,67,61,6,0.08955
QUERETARO CORREGIDORA,2023-01-11,39,30,9,0.23077
QUERETARO CORREGIDORA,2023-01-12,139,132,7,0.05036
QUERETARO CORREGIDORA,2023-01-13,61,52,9,0.14754
QUERETARO CORREGIDORA,2023-01-14,48,47,1,0.02083
QUERETARO CORREGIDORA,2023-01-15,41,41,0,0
QUERETARO CORREGIDORA,2023-01-16,93,91,2,0.02151
QUERETARO CORREGIDORA,2023-01-17,74,72,2,0.02703
QUERETARO CORREGIDORA,2023-01-18,62,45,17,0.27419
QUERETARO CORREGIDORA,2023-01-19,24,24,0,0
QUERETARO CORREGIDORA,2023-01-20,106,65,41,0.38679
QUERETARO CORREGIDORA,2023-01-21,82,37,45,0.54878
QUERETARO CORREGIDORA,2023-01-22,17,15,2,0.11765
QUERETARO CORREGIDORA,2023-01-23,125,125,0,0
QUERETARO CORREGIDORA,2023-01-24,60,60,0,0
QUERETARO CORREGIDORA,2023-01-25,75,69,6,0.08
QUERETARO CORREGIDORA,2023-01-26,63,47,16,0.25397
QUERETARO CORREGIDORA,2023-01-27,103,102,1,0.00971
QUERETARO CORREGIDORA,2023-01-28,114,90,24,0.21053
QUERETARO CORREGIDORA,2023-01-29,60,49,11,0.18333
QUERETARO CORREGIDORA,2023-01-30,179,179,0,0
QUERETARO CORREGIDORA,2023-01-31,144,144,0,0
QUERETARO CORREGIDORA,2023-02-02,101,101,0,0
QUERETARO CORREGIDORA,2023-02-03,98,81,17,0.17347
QUERETARO CORREGIDORA,2023-02-04,93,89,4,0.04301
QUERETARO CORREGIDORA,2023-02-05,62,47,15,0.24194
QUERETARO CORREGIDORA,2023-02-06,92,40,52,0.56522
QUERETARO CORREGIDORA,2023-02-07,107,107,0,0
QUERETARO CORREGIDORA,2023-02-08,203,174,29,0.14286
QUERETARO CORREGIDORA,2023-02-09,103,103,0,0
QUERETARO CORREGIDORA,2023-02-10,78,74,4,0.05128
QUERETARO CORREGIDORA,2023-02-11,75,73,2,0.02667
QUERETARO CORREGIDORA,2023-02-12,104,100,4,0.03846
QUERETARO CORREGIDORA,2023-02-13,142,115,27,0.19014
QUERETARO CORREGIDORA,2023-02-14,83,69,14,0.16867
QUERETARO CORREGIDORA,2023-02-15,208,184,24,0.11538
QUERETARO CORREGIDORA,2023-02-16,88,87,1,0.01136
QUERETARO CORREGIDORA,2023-02-17,216,198,18,0.08333
QUERETARO CORREGIDORA,2023-02-18,173,146,27,0.15607
QUERETARO CORREGIDORA,2023-02-19,31,29,2,0.06452
QUERETARO CORREGIDORA,2023-02-20,72,72,0,0
QUERETARO CORREGIDORA,2023-02-21,178,169,9,0.05056
QUERETARO CORREGIDORA,2023-02-22,117,114,3,0.02564
QUERETARO CORREGIDORA,2023-02-23,125,50,75,0.6
QUERETARO CORREGIDORA,2023-02-24,57,51,6,0.10526
QUERETARO CORREGIDORA,2023-02-25,57,53,4,0.07018
QUERETARO CORREGIDORA,2023-02-26,17,15,2,0.11765
QUERETARO CORREGIDORA,2023-02-27,108,106,2,0.01852
QUERETARO CORREGIDORA,2023-02-28,97,92,5,0.05155
QUERETARO CORREGIDORA,2023-03-01,52,42,10,0.19231
QUERETARO CORREGIDORA,2023-03-02,55,37,18,0.32727
QUERETARO CORREGIDORA,2023-03-03,33,33,0,0
QUERETARO CORREGIDORA,2023-03-04,163,158,5,0.03067
QUERETARO CORREGIDORA,2023-03-05,24,23,1,0.04167
QUERETARO CORREGIDORA,2023-03-07,39,27,12,0.30769
QUERETARO CORREGIDORA,2023-03-08,81,73,8,0.09877
QUERETARO CORREGIDORA,2023-03-09,50,40,10,0.2
QUERETARO CORREGIDORA,2023-03-10,65,61,4,0.06154
QUERETARO CORREGIDORA,2023-03-11,30,23,7,0.23333
QUERETARO CORREGIDORA,2023-03-12,35,31,4,0.11429
QUERETARO CORREGIDORA,2023-03-13,81,75,6,0.07407
QUERETARO CORREGIDORA,2023-03-14,76,75,1,0.01316
QUERETARO CORREGIDORA,2023-03-15,36,36,0,0
QUERETARO CORREGIDORA,2023-03-16,59,54,5,0.08475
QUERETARO CORREGIDORA,2023-03-17,87,85,2,0.02299
QUERETARO CORREGIDORA,2023-03-18,39,38,1,0.02564
QUERETARO CORREGIDORA,2023-03-19,24,24,0,0
QUERETARO CORREGIDORA,2023-03-20,30,29,1,0.03333
QUERETARO SANTIAGO,2023-01-01,15,15,0,0
QUERETARO SANTIAGO,2023-01-02,54,54,0,0
QUERETARO SANTIAGO,2023-01-03,136,132,4,0.02941
QUERETARO SANTIAGO,2023-01-04,78,76,2,0.02564
QUERETARO SANTIAGO,2023-01-05,79,67,12,0.1519
QUERETARO SANTIAGO,2023-01-06,90,81,9,0.1
QUERETARO SANTIAGO,2023-01-07,62,58,4,0.06452
QUERETARO SANTIAGO,2023-01-08,46,42,4,0.08696
QUERETARO SANTIAGO,2023-01-09,51,49,2,0.03922
QUERETARO SANTIAGO,2023-01-10,74,74,0,0
QUERETARO SANTIAGO,2023-01-11,161,103,58,0.36025
QUERETARO SANTIAGO,2023-01-12,91,42,49,0.53846
QUERETARO SANTIAGO,2023-01-13,54,50,4,0.07407
QUERETARO SANTIAGO,2023-01-14,135,119,16,0.11852
QUERETARO SANTIAGO,2023-01-15,149,149,0,0
QUERETARO SANTIAGO,2023-01-16,133,89,44,0.33083
QUERETARO SANTIAGO,2023-01-17,117,112,5,0.04274
QUERETARO SANTIAGO,2023-01-18,173,173,0,0
QUERETARO SANTIAGO,2023-01-19,61,61,0,0
QUERETARO SANTIAGO,2023-01-20,99,99,0,0
QUERETARO SANTIAGO,2023-01-21,124,99,25,0.20161
QUERETARO SANTIAGO,2023-01-22,58,58,0,0
QUERETARO SANTIAGO,2023-01-23,228,225,3,0.01316
QUERETARO SANTIAGO,2023-01-24,85,78,7,0.08235
QUERETARO SANTIAGO,2023-01-25,100,89,11,0.11
QUERETARO SANTIAGO,2023-01-26,93,69,24,0.25806
QUERETARO SANTIAGO,2023-01-27,106,90,16,0.15094
QUERETARO SANTIAGO,2023-01-28,223,178,45,0.20179
QUERETARO SANTIAGO,2023-01-29,134,133,1,0.00746
QUERETARO SANTIAGO,2023-01-30,165,162,3,0.01818
QUERETARO SANTIAGO,2023-01-31,98,70,28,0.28571
QUERETARO SANTIAGO,2023-02-02,48,39,9,0.1875
QUERETARO SANTIAGO,2023-02-03,93,67,26,0.27957
QUERETARO SANTIAGO,2023-02-04,109,99,10,0.09174
QUERETARO SANTIAGO,2023-02-05,59,59,0,0
QUERETARO SANTIAGO,2023-02-06,89,88,1,0.01124
QUERETARO SANTIAGO,2023-02-07,110,94,16,0.14545
QUERETARO SANTIAGO,2023-02-08,150,114,36,0.24
QUERETARO SANTIAGO,2023-02-09,315,312,3,0.00952
QUERETARO SANTIAGO,2023-02-10,136,134,2,0.01471
QUERETARO SANTIAGO,2023-02-11,159,153,6,0.03774
QUERETARO SANTIAGO,2023-02-12,273,271,2,0.00733
QUERETARO SANTIAGO,2023-02-13,51,49,2,0.03922
QUERETARO SANTIAGO,2023-02-14,228,213,15,0.06579
QUERETARO SANTIAGO,2023-02-15,87,84,3,0.03448
QUERETARO SANTIAGO,2023-02-16,98,97,1,0.0102
QUERETARO SANTIAGO,2023-02-17,109,109,0,0
QUERETARO SANTIAGO,2023-02-18,38,32,6,0.15789
QUERETARO SANTIAGO,2023-02-19,70,70,0,0
QUERETARO SANTIAGO,2023-02-20,54,53,1,0.01852
QUERETARO SANTIAGO,2023-02-21,63,50,13,0.20635
QUERETARO SANTIAGO,2023-02-22,69,50,19,0.27536
QUERETARO SANTIAGO,2023-02-23,66,56,10,0.15152
QUERETARO SANTIAGO,2023-02-24,39,37,2,0.05128
QUERETARO SANTIAGO,2023-02-25,65,53,12,0.18462
QUERETARO SANTIAGO,2023-02-26,47,47,0,0
QUERETARO SANTIAGO,2023-02-27,100,72,28,0.28
QUERETARO SANTIAGO,2023-02-28,109,96,13,0.11927
QUERETARO SANTIAGO,2023-03-01,57,40,17,0.29825
QUERETARO SANTIAGO,2023-03-02,86,65,21,0.24419
QUERETARO SANTIAGO,2023-03-03,78,49,29,0.37179
QUERETARO SANTIAGO,2023-03-04,64,60,4,0.0625
QUERETARO SANTIAGO,2023-03-05,21,17,4,0.19048
QUERETARO SANTIAGO,2023-03-07,74,32,42,0.56757
QUERETARO SANTIAGO,2023-03-08,37,37,0,0
QUERETARO SANTIAGO,2023-03-09,54,47,7,0.12963
QUERETARO SANTIAGO,2023-03-10,81,72,9,0.11111
QUERETARO SANTIAGO,2023-03-11,51,33,18,0.35294
QUERETARO SANTIAGO,2023-03-12,81,81,0,0
QUERETARO SANTIAGO,2023-03-13,64,63,1,0.01562
QUERETARO SANTIAGO,2023-03-14,44,27,17,0.38636
QUERETARO SANTIAGO,2023-03-15,34,24,10,0.29412
QUERETARO SANTIAGO,2023-03-16,24,18,6,0.25
QUERETARO SANTIAGO,2023-03-17,49,39,10,0.20408
QUERETARO SANTIAGO,2023-03-18,81,80,1,0.01235
QUERETARO SANTIAGO,2023-03-19,41,39,2,0.04878
QUERETARO SANTIAGO,2023-03-20,48,45,3,0.0625
REYNOSA,2023-01-01,19,19,0,0
REYNOSA,2023-01-02,88,77,11,0.125
REYNOSA,2023-01-03,84,77,7,0.08333
REYNOSA,2023-01-04,69,62,7,0.10145
REYNOSA,2023-01-05,108,85,23,0.21296
REYNOSA,2023-01-06,102,77,25,0.2451
REYNOSA,2023-01-07,119,83,36,0.30252
REYNOSA,2023-01-08,74,57,17,0.22973
REYNOSA,2023-01-09,102,51,51,0.5
REYNOSA,2023-01-10,121,90,31,0.2562
REYNOSA,2023-01-11,114,76,38,0.33333
REYNOSA,2023-01-12,103,68,35,0.33981
REYNOSA,2023-01-13,105,82,23,0.21905
REYNOSA,2023-01-14,126,84,42,0.33333
REYNOSA,2023-01-15,73,60,13,0.17808
REYNOSA,2023-01-16,142,114,28,0.19718
REYNOSA,2023-01-17,95,77,18,0.18947
REYNOSA,2023-01-18,102,77,25,0.2451
REYNOSA,2023-01-19,82,55,27,0.32927
REYNOSA,2023-01-20,119,79,40,0.33613
REYNOSA,2023-01-21,95,77,18,0.18947
REYNOSA,2023-01-22,63,41,22,0.34921
REYNOSA,2023-01-23,96,36,60,0.625
REYNOSA,2023-01-24,96,75,21,0.21875
REYNOSA,2023-01-25,108,65,43,0.39815
REYNOSA,2023-01-26,93,65,28,0.30108
REYNOSA,2023-01-27,78,52,26,0.33333
REYNOSA,2023-01-28,111,85,26,0.23423
REYNOSA,2023-01-29,72,48,24,0.33333
REYNOSA,2023-01-30,96,65,31,0.32292
REYNOSA,2023-01-31,116,84,32,0.27586
REYNOSA,2023-02-02,74,41,33,0.44595
REYNOSA,2023-02-03,91,47,44,0.48352
REYNOSA,2023-02-04,100,57,43,0.43
REYNOSA,2023-02-05,63,33,30,0.47619
REYNOSA,2023-02-06,82,65,17,0.20732
REYNOSA,2023-02-07,87,43,44,0.50575
REYNOSA,2023-02-08,76,52,24,0.31579
REYNOSA,2023-02-09,86,61,25,0.2907
REYNOSA,2023-02-10,78,67,11,0.14103
REYNOSA,2023-02-11,77,48,29,0.37662
REYNOSA,2023-02-12,99,59,40,0.40404
REYNOSA,2023-02-13,85,46,39,0.45882
REYNOSA,2023-02-14,73,32,41,0.56164
REYNOSA,2023-02-15,77,50,27,0.35065
REYNOSA,2023-02-16,114,59,55,0.48246
REYNOSA,2023-02-17,86,58,28,0.32558
REYNOSA,2023-02-18,109,62,47,0.43119
REYNOSA,2023-02-19,87,53,34,0.3908
REYNOSA,2023-02-20,96,50,46,0.47917
REYNOSA,2023-02-21,70,45,25,0.35714
REYNOSA,2023-02-22,48,24,24,0.5
REYNOSA,2023-02-23,111,43,68,0.61261
REYNOSA,2023-02-24,96,44,52,0.54167
REYNOSA,2023-02-25,133,67,66,0.49624
REYNOSA,2023-02-26,104,44,60,0.57692
REYNOSA,2023-02-27,82,24,58,0.70732
REYNOSA,2023-02-28,84,37,47,0.55952
REYNOSA,2023-03-01,73,34,39,0.53425
REYNOSA,2023-03-02,77,46,31,0.4026
REYNOSA,2023-03-03,122,63,59,0.48361
REYNOSA,2023-03-04,118,50,68,0.57627
REYNOSA,2023-03-05,69,20,49,0.71014
REYNOSA,2023-03-07,73,33,40,0.54795
REYNOSA,2023-03-08,59,27,32,0.54237
REYNOSA,2023-03-09,56,31,25,0.44643
REYNOSA,2023-03-10,78,41,37,0.47436
REYNOSA,2023-03-11,108,50,58,0.53704
REYNOSA,2023-03-12,68,24,44,0.64706
REYNOSA,2023-03-13,104,45,59,0.56731
REYNOSA,2023-03-14,153,38,115,0.75163
REYNOSA,2023-03-15,69,57,12,0.17391
REYNOSA,2023-03-16,89,57,32,0.35955
REYNOSA,2023-03-17,133,107,26,0.19549
REYNOSA,2023-03-18,148,124,24,0.16216
REYNOSA,2023-03-19,96,75,21,0.21875
REYNOSA,2023-03-20,91,78,13,0.14286
SALTILLO,2023-01-01,20,19,1,0.05
SALTILLO,2023-01-02,66,61,5,0.07576
SALTILLO,2023-01-03,72,66,6,0.08333
SALTILLO,2023-01-04,69,62,7,0.10145
SALTILLO,2023-01-05,118,90,28,0.23729
SALTILLO,2023-01-06,77,69,8,0.1039
SALTILLO,2023-01-07,106,92,14,0.13208
SALTILLO,2023-01-08,52,33,19,0.36538
SALTILLO,2023-01-09,87,79,8,0.09195
SALTILLO,2023-01-10,64,59,5,0.07812
SALTILLO,2023-01-11,91,79,12,0.13187
SALTILLO,2023-01-12,79,73,6,0.07595
SALTILLO,2023-01-13,102,78,24,0.23529
SALTILLO,2023-01-14,81,65,16,0.19753
SALTILLO,2023-01-15,46,41,5,0.1087
SALTILLO,2023-01-16,51,41,10,0.19608
SALTILLO,2023-01-17,95,84,11,0.11579
SALTILLO,2023-01-18,60,46,14,0.23333
SALTILLO,2023-01-19,52,43,9,0.17308
SALTILLO,2023-01-20,98,90,8,0.08163
SALTILLO,2023-01-21,88,69,19,0.21591
SALTILLO,2023-01-22,50,43,7,0.14
SALTILLO,2023-01-23,44,40,4,0.09091
SALTILLO,2023-01-24,64,59,5,0.07812
SALTILLO,2023-01-25,56,54,2,0.03571
SALTILLO,2023-01-26,59,52,7,0.11864
SALTILLO,2023-01-27,50,43,7,0.14
SALTILLO,2023-01-28,88,72,16,0.18182
SALTILLO,2023-01-29,30,26,4,0.13333
SALTILLO,2023-01-30,60,51,9,0.15
SALTILLO,2023-01-31,82,79,3,0.03659
SALTILLO,2023-02-02,57,44,13,0.22807
SALTILLO,2023-02-03,78,57,21,0.26923
SALTILLO,2023-02-04,78,70,8,0.10256
SALTILLO,2023-02-05,40,35,5,0.125
SALTILLO,2023-02-06,59,44,15,0.25424
SALTILLO,2023-02-07,44,43,1,0.02273
SALTILLO,2023-02-08,61,53,8,0.13115
SALTILLO,2023-02-09,66,55,11,0.16667
SALTILLO,2023-02-10,57,35,22,0.38596
SALTILLO,2023-02-11,82,59,23,0.28049
SALTILLO,2023-02-12,52,37,15,0.28846
SALTILLO,2023-02-13,46,33,13,0.28261
SALTILLO,2023-02-14,51,44,7,0.13725
SALTILLO,2023-02-15,44,34,10,0.22727
SALTILLO,2023-02-16,71,57,14,0.19718
SALTILLO,2023-02-17,63,59,4,0.06349
SALTILLO,2023-02-18,91,75,16,0.17582
SALTILLO,2023-02-19,42,20,22,0.52381
SALTILLO,2023-02-20,54,39,15,0.27778
SALTILLO,2023-02-21,54,42,12,0.22222
SALTILLO,2023-02-22,67,40,27,0.40299
SALTILLO,2023-02-23,64,54,10,0.15625
SALTILLO,2023-02-24,69,46,23,0.33333
SALTILLO,2023-02-25,96,51,45,0.46875
SALTILLO,2023-02-26,59,21,38,0.64407
SALTILLO,2023-02-27,53,35,18,0.33962
SALTILLO,2023-02-28,88,58,30,0.34091
SALTILLO,2023-03-01,67,30,37,0.55224
SALTILLO,2023-03-02,66,33,33,0.5
SALTILLO,2023-03-03,82,58,24,0.29268
SALTILLO,2023-03-04,74,33,41,0.55405
SALTILLO,2023-03-05,52,24,28,0.53846
SALTILLO,2023-03-07,63,29,34,0.53968
SALTILLO,2023-03-08,72,44,28,0.38889
SALTILLO,2023-03-09,70,30,40,0.57143
SALTILLO,2023-03-10,77,48,29,0.37662
SALTILLO,2023-03-11,85,58,27,0.31765
SALTILLO,2023-03-12,65,20,45,0.69231
SALTILLO,2023-03-13,43,23,20,0.46512
SALTILLO,2023-03-14,77,43,34,0.44156
SALTILLO,2023-03-15,74,61,13,0.17568
SALTILLO,2023-03-16,95,81,14,0.14737
SALTILLO,2023-03-17,72,65,7,0.09722
SALTILLO,2023-03-18,123,114,9,0.07317
SALTILLO,2023-03-19,48,44,4,0.08333
SALTILLO,2023-03-20,76,71,5,0.06579
SAN LUIS POTOSI ORIENTE,2023-01-01,4,2,2,0.5
SAN LUIS POTOSI ORIENTE,2023-01-02,43,36,7,0.16279
SAN LUIS POTOSI ORIENTE,2023-01-03,28,28,0,0
SAN LUIS POTOSI ORIENTE,2023-01-04,62,62,0,0
SAN LUIS POTOSI ORIENTE,2023-01-05,56,46,10,0.17857
SAN LUIS POTOSI ORIENTE,2023-01-06,68,66,2,0.02941
SAN LUIS POTOSI ORIENTE,2023-01-07,78,78,0,0
SAN LUIS POTOSI ORIENTE,2023-01-08,42,41,1,0.02381
SAN LUIS POTOSI ORIENTE,2023-01-09,63,63,0,0
SAN LUIS POTOSI ORIENTE,2023-01-10,83,83,0,0
SAN LUIS POTOSI ORIENTE,2023-01-11,57,56,1,0.01754
SAN LUIS POTOSI ORIENTE,2023-01-12,86,86,0,0
SAN LUIS POTOSI ORIENTE,2023-01-13,57,57,0,0
SAN LUIS POTOSI ORIENTE,2023-01-14,44,44,0,0
SAN LUIS POTOSI ORIENTE,2023-01-15,38,33,5,0.13158
SAN LUIS POTOSI ORIENTE,2023-01-16,51,51,0,0
SAN LUIS POTOSI ORIENTE,2023-01-17,69,69,0,0
SAN LUIS POTOSI ORIENTE,2023-01-18,40,40,0,0
SAN LUIS POTOSI ORIENTE,2023-01-19,43,43,0,0
SAN LUIS POTOSI ORIENTE,2023-01-20,49,49,0,0
SAN LUIS POTOSI ORIENTE,2023-01-21,122,122,0,0
SAN LUIS POTOSI ORIENTE,2023-01-22,27,26,1,0.03704
SAN LUIS POTOSI ORIENTE,2023-01-23,43,41,2,0.04651
SAN LUIS POTOSI ORIENTE,2023-01-24,79,78,1,0.01266
SAN LUIS POTOSI ORIENTE,2023-01-25,70,70,0,0
SAN LUIS POTOSI ORIENTE,2023-01-26,70,70,0,0
SAN LUIS POTOSI ORIENTE,2023-01-27,82,81,1,0.0122
SAN LUIS POTOSI ORIENTE,2023-01-28,78,77,1,0.01282
SAN LUIS POTOSI ORIENTE,2023-01-29,42,42,0,0
SAN LUIS POTOSI ORIENTE,2023-01-30,96,94,2,0.02083
SAN LUIS POTOSI ORIENTE,2023-01-31,60,60,0,0
SAN LUIS POTOSI ORIENTE,2023-02-02,43,40,3,0.06977
SAN LUIS POTOSI ORIENTE,2023-02-03,42,42,0,0
SAN LUIS POTOSI ORIENTE,2023-02-04,61,61,0,0
SAN LUIS POTOSI ORIENTE,2023-02-05,23,23,0,0
SAN LUIS POTOSI ORIENTE,2023-02-06,43,43,0,0
SAN LUIS POTOSI ORIENTE,2023-02-07,30,30,0,0
SAN LUIS POTOSI ORIENTE,2023-02-08,42,42,0,0
SAN LUIS POTOSI ORIENTE,2023-02-09,33,33,0,0
SAN LUIS POTOSI ORIENTE,2023-02-10,36,36,0,0
SAN LUIS POTOSI ORIENTE,2023-02-11,39,39,0,0
SAN LUIS POTOSI ORIENTE,2023-02-12,51,51,0,0
SAN LUIS POTOSI ORIENTE,2023-02-13,27,27,0,0
SAN LUIS POTOSI ORIENTE,2023-02-14,35,35,0,0
SAN LUIS POTOSI ORIENTE,2023-02-15,57,57,0,0
SAN LUIS POTOSI ORIENTE,2023-02-16,83,81,2,0.0241
SAN LUIS POTOSI ORIENTE,2023-02-17,51,51,0,0
SAN LUIS POTOSI ORIENTE,2023-02-18,55,53,2,0.03636
SAN LUIS POTOSI ORIENTE,2023-02-19,12,12,0,0
SAN LUIS POTOSI ORIENTE,2023-02-20,61,58,3,0.04918
SAN LUIS POTOSI ORIENTE,2023-02-21,66,60,6,0.09091
SAN LUIS POTOSI ORIENTE,2023-02-22,43,43,0,0
SAN LUIS POTOSI ORIENTE,2023-02-23,41,41,0,0
SAN LUIS POTOSI ORIENTE,2023-02-24,44,44,0,0
SAN LUIS POTOSI ORIENTE,2023-02-25,75,75,0,0
SAN LUIS POTOSI ORIENTE,2023-02-26,14,14,0,0
SAN LUIS POTOSI ORIENTE,2023-02-27,36,36,0,0
SAN LUIS POTOSI ORIENTE,2023-02-28,54,54,0,0
SAN LUIS POTOSI ORIENTE,2023-03-01,68,66,2,0.02941
SAN LUIS POTOSI ORIENTE,2023-03-02,57,57,0,0
SAN LUIS POTOSI ORIENTE,2023-03-03,62,62,0,0
SAN LUIS POTOSI ORIENTE,2023-03-04,48,48,0,0
SAN LUIS POTOSI ORIENTE,2023-03-05,20,20,0,0
SAN LUIS POTOSI ORIENTE,2023-03-07,58,58,0,0
SAN LUIS POTOSI ORIENTE,2023-03-08,49,49,0,0
SAN LUIS POTOSI ORIENTE,2023-03-09,28,28,0,0
SAN LUIS POTOSI ORIENTE,2023-03-10,52,52,0,0
SAN LUIS POTOSI ORIENTE,2023-03-11,61,61,0,0
SAN LUIS POTOSI ORIENTE,2023-03-12,24,23,1,0.04167
SAN LUIS POTOSI ORIENTE,2023-03-13,34,33,1,0.02941
SAN LUIS POTOSI ORIENTE,2023-03-14,39,38,1,0.02564
SAN LUIS POTOSI ORIENTE,2023-03-15,39,39,0,0
SAN LUIS POTOSI ORIENTE,2023-03-16,25,25,0,0
SAN LUIS POTOSI ORIENTE,2023-03-17,65,65,0,0
SAN LUIS POTOSI ORIENTE,2023-03-18,86,82,4,0.04651
SAN LUIS POTOSI ORIENTE,2023-03-19,28,28,0,0
SAN LUIS POTOSI ORIENTE,2023-03-20,42,42,0,0
SAN LUIS POTOSI PONIENTE,2023-01-01,9,9,0,0
SAN LUIS POTOSI PONIENTE,2023-01-02,30,30,0,0
SAN LUIS POTOSI PONIENTE,2023-01-03,36,24,12,0.33333
SAN LUIS POTOSI PONIENTE,2023-01-04,33,3,30,0.90909
SAN LUIS POTOSI PONIENTE,2023-01-05,21,9,12,0.57143
SAN LUIS POTOSI PONIENTE,2023-01-06,32,13,19,0.59375
SAN LUIS POTOSI PONIENTE,2023-01-07,27,2,25,0.92593
SAN LUIS POTOSI PONIENTE,2023-01-08,23,8,15,0.65217
SAN LUIS POTOSI PONIENTE,2023-01-09,48,39,9,0.1875
SAN LUIS POTOSI PONIENTE,2023-01-10,24,19,5,0.20833
SAN LUIS POTOSI PONIENTE,2023-01-11,37,12,25,0.67568
SAN LUIS POTOSI PONIENTE,2023-01-12,63,22,41,0.65079
SAN LUIS POTOSI PONIENTE,2023-01-13,51,13,38,0.7451
SAN LUIS POTOSI PONIENTE,2023-01-14,56,17,39,0.69643
SAN LUIS POTOSI PONIENTE,2023-01-15,22,14,8,0.36364
SAN LUIS POTOSI PONIENTE,2023-01-16,38,19,19,0.5
SAN LUIS POTOSI PONIENTE,2023-01-17,45,34,11,0.24444
SAN LUIS POTOSI PONIENTE,2023-01-18,9,5,4,0.44444
SAN LUIS POTOSI PONIENTE,2023-01-19,30,15,15,0.5
SAN LUIS POTOSI PONIENTE,2023-01-20,30,21,9,0.3
SAN LUIS POTOSI PONIENTE,2023-01-21,42,36,6,0.14286
SAN LUIS POTOSI PONIENTE,2023-01-22,20,8,12,0.6
SAN LUIS POTOSI PONIENTE,2023-01-23,57,44,13,0.22807
SAN LUIS POTOSI PONIENTE,2023-01-24,42,18,24,0.57143
SAN LUIS POTOSI PONIENTE,2023-01-25,63,17,46,0.73016
SAN LUIS POTOSI PONIENTE,2023-01-26,25,3,22,0.88
SAN LUIS POTOSI PONIENTE,2023-01-27,36,14,22,0.61111
SAN LUIS POTOSI PONIENTE,2023-01-28,38,4,34,0.89474
SAN LUIS POTOSI PONIENTE,2023-01-29,37,18,19,0.51351
SAN LUIS POTOSI PONIENTE,2023-01-30,61,20,41,0.67213
SAN LUIS POTOSI PONIENTE,2023-01-31,46,21,25,0.54348
SAN LUIS POTOSI PONIENTE,2023-02-02,59,40,19,0.32203
SAN LUIS POTOSI PONIENTE,2023-02-03,65,29,36,0.55385
SAN LUIS POTOSI PONIENTE,2023-02-04,34,14,20,0.58824
SAN LUIS POTOSI PONIENTE,2023-02-05,19,12,7,0.36842
SAN LUIS POTOSI PONIENTE,2023-02-06,37,24,13,0.35135
SAN LUIS POTOSI PONIENTE,2023-02-07,42,28,14,0.33333
SAN LUIS POTOSI PONIENTE,2023-02-08,37,29,8,0.21622
SAN LUIS POTOSI PONIENTE,2023-02-09,39,38,1,0.02564
SAN LUIS POTOSI PONIENTE,2023-02-10,53,53,0,0
SAN LUIS POTOSI PONIENTE,2023-02-11,38,38,0,0
SAN LUIS POTOSI PONIENTE,2023-02-12,11,10,1,0.09091
SAN LUIS POTOSI PONIENTE,2023-02-13,74,74,0,0
SAN LUIS POTOSI PONIENTE,2023-02-14,51,45,6,0.11765
SAN LUIS POTOSI PONIENTE,2023-02-15,43,40,3,0.06977
SAN LUIS POTOSI PONIENTE,2023-02-16,85,85,0,0
SAN LUIS POTOSI PONIENTE,2023-02-17,66,61,5,0.07576
SAN LUIS POTOSI PONIENTE,2023-02-18,79,66,13,0.16456
SAN LUIS POTOSI PONIENTE,2023-02-19,52,40,12,0.23077
SAN LUIS POTOSI PONIENTE,2023-02-20,80,76,4,0.05
SAN LUIS POTOSI PONIENTE,2023-02-21,74,74,0,0
SAN LUIS POTOSI PONIENTE,2023-02-22,87,87,0,0
SAN LUIS POTOSI PONIENTE,2023-02-23,22,22,0,0
SAN LUIS POTOSI PONIENTE,2023-02-24,67,58,9,0.13433
SAN LUIS POTOSI PONIENTE,2023-02-25,62,38,24,0.3871
SAN LUIS POTOSI PONIENTE,2023-02-26,103,89,14,0.13592
SAN LUIS POTOSI PONIENTE,2023-02-27,59,41,18,0.30508
SAN LUIS POTOSI PONIENTE,2023-02-28,54,43,11,0.2037
SAN LUIS POTOSI PONIENTE,2023-03-01,37,34,3,0.08108
SAN LUIS POTOSI PONIENTE,2023-03-02,37,32,5,0.13514
SAN LUIS POTOSI PONIENTE,2023-03-03,46,45,1,0.02174
SAN LUIS POTOSI PONIENTE,2023-03-04,34,34,0,0
SAN LUIS POTOSI PONIENTE,2023-03-05,21,21,0,0
SAN LUIS POTOSI PONIENTE,2023-03-07,47,44,3,0.06383
SAN LUIS POTOSI PONIENTE,2023-03-08,78,56,22,0.28205
SAN LUIS POTOSI PONIENTE,2023-03-09,33,33,0,0
SAN LUIS POTOSI PONIENTE,2023-03-10,40,40,0,0
SAN LUIS POTOSI PONIENTE,2023-03-11,36,36,0,0
SAN LUIS POTOSI PONIENTE,2023-03-12,33,33,0,0
SAN LUIS POTOSI PONIENTE,2023-03-13,42,38,4,0.09524
SAN LUIS POTOSI PONIENTE,2023-03-14,17,17,0,0
SAN LUIS POTOSI PONIENTE,2023-03-15,35,35,0,0
SAN LUIS POTOSI PONIENTE,2023-03-16,40,40,0,0
SAN LUIS POTOSI PONIENTE,2023-03-17,29,29,0,0
SAN LUIS POTOSI PONIENTE,2023-03-18,37,37,0,0
SAN LUIS POTOSI PONIENTE,2023-03-19,17,15,2,0.11765
SAN LUIS POTOSI PONIENTE,2023-03-20,27,27,0,0
SANTA FE,2023-01-01,16,12,4,0.25
SANTA FE,2023-01-02,61,41,20,0.32787
SANTA FE,2023-01-03,68,55,13,0.19118
SANTA FE,2023-01-04,93,75,18,0.19355
SANTA FE,2023-01-05,97,75,22,0.2268
SANTA FE,2023-01-06,66,40,26,0.39394
SANTA FE,2023-01-07,72,37,35,0.48611
SANTA FE,2023-01-08,49,48,1,0.02041
SANTA FE,2023-01-09,81,60,21,0.25926
SANTA FE,2023-01-10,110,78,32,0.29091
SANTA FE,2023-01-11,78,42,36,0.46154
SANTA FE,2023-01-12,98,60,38,0.38776
SANTA FE,2023-01-13,85,44,41,0.48235
SANTA FE,2023-01-14,93,70,23,0.24731
SANTA FE,2023-01-15,52,42,10,0.19231
SANTA FE,2023-01-16,170,145,25,0.14706
SANTA FE,2023-01-17,246,238,8,0.03252
SANTA FE,2023-01-18,124,74,50,0.40323
SANTA FE,2023-01-19,161,105,56,0.34783
SANTA FE,2023-01-20,147,106,41,0.27891
SANTA FE,2023-01-21,204,188,16,0.07843
SANTA FE,2023-01-22,20,13,7,0.35
SANTA FE,2023-01-23,164,141,23,0.14024
SANTA FE,2023-01-24,194,145,49,0.25258
SANTA FE,2023-01-25,153,120,33,0.21569
SANTA FE,2023-01-26,239,223,16,0.06695
SANTA FE,2023-01-27,151,136,15,0.09934
SANTA FE,2023-01-28,176,130,46,0.26136
SANTA FE,2023-01-29,51,43,8,0.15686
SANTA FE,2023-01-30,156,137,19,0.12179
SANTA FE,2023-01-31,199,192,7,0.03518
SANTA FE,2023-02-02,214,154,60,0.28037
SANTA FE,2023-02-03,145,92,53,0.36552
SANTA FE,2023-02-04,215,159,56,0.26047
SANTA FE,2023-02-05,98,95,3,0.03061
SANTA FE,2023-02-06,131,98,33,0.25191
SANTA FE,2023-02-07,147,113,34,0.23129
SANTA FE,2023-02-08,167,147,20,0.11976
SANTA FE,2023-02-09,166,96,70,0.42169
SANTA FE,2023-02-10,170,144,26,0.15294
SANTA FE,2023-02-11,116,74,42,0.36207
SANTA FE,2023-02-12,55,36,19,0.34545
SANTA FE,2023-02-13,243,184,59,0.2428
SANTA FE,2023-02-14,249,237,12,0.04819
SANTA FE,2023-02-15,301,161,140,0.46512
SANTA FE,2023-02-16,248,205,43,0.17339
SANTA FE,2023-02-17,240,200,40,0.16667
SANTA FE,2023-02-18,240,187,53,0.22083
SANTA FE,2023-02-19,129,118,11,0.08527
SANTA FE,2023-02-20,354,317,37,0.10452
SANTA FE,2023-02-21,144,84,60,0.41667
SANTA FE,2023-02-22,199,166,33,0.16583
SANTA FE,2023-02-23,108,95,13,0.12037
SANTA FE,2023-02-24,290,245,45,0.15517
SANTA FE,2023-02-25,222,158,64,0.28829
SANTA FE,2023-02-26,128,77,51,0.39844
SANTA FE,2023-02-27,135,106,29,0.21481
SANTA FE,2023-02-28,303,187,116,0.38284
SANTA FE,2023-03-01,150,130,20,0.13333
SANTA FE,2023-03-02,160,81,79,0.49375
SANTA FE,2023-03-03,220,159,61,0.27727
SANTA FE,2023-03-04,200,83,117,0.585
SANTA FE,2023-03-05,66,51,15,0.22727
SANTA FE,2023-03-07,163,64,99,0.60736
SANTA FE,2023-03-08,141,84,57,0.40426
SANTA FE,2023-03-09,135,81,54,0.4
SANTA FE,2023-03-10,77,18,59,0.76623
SANTA FE,2023-03-11,114,61,53,0.46491
SANTA FE,2023-03-12,40,29,11,0.275
SANTA FE,2023-03-13,148,120,28,0.18919
SANTA FE,2023-03-14,106,64,42,0.39623
SANTA FE,2023-03-15,123,98,25,0.20325
SANTA FE,2023-03-16,87,77,10,0.11494
SANTA FE,2023-03-17,112,97,15,0.13393
SANTA FE,2023-03-18,249,242,7,0.02811
SANTA FE,2023-03-19,117,58,59,0.50427
SANTA FE,2023-03-20,97,74,23,0.23711
SATELITE,2023-01-01,3,3,0,0
SATELITE,2023-01-02,31,31,0,0
SATELITE,2023-01-03,32,30,2,0.0625
SATELITE,2023-01-04,26,26,0,0
SATELITE,2023-01-05,60,42,18,0.3
SATELITE,2023-01-06,30,30,0,0
SATELITE,2023-01-07,20,20,0,0
SATELITE,2023-01-08,29,20,9,0.31034
SATELITE,2023-01-09,38,36,2,0.05263
SATELITE,2023-01-10,49,49,0,0
SATELITE,2023-01-11,75,74,1,0.01333
SATELITE,2023-01-12,51,51,0,0
SATELITE,2023-01-13,89,78,11,0.1236
SATELITE,2023-01-14,40,40,0,0
SATELITE,2023-01-15,67,66,1,0.01493
SATELITE,2023-01-16,72,69,3,0.04167
SATELITE,2023-01-17,82,82,0,0
SATELITE,2023-01-18,40,40,0,0
SATELITE,2023-01-19,80,80,0,0
SATELITE,2023-01-20,70,65,5,0.07143
SATELITE,2023-01-21,49,46,3,0.06122
SATELITE,2023-01-22,17,16,1,0.05882
SATELITE,2023-01-23,53,53,0,0
SATELITE,2023-01-24,76,61,15,0.19737
SATELITE,2023-01-25,65,63,2,0.03077
SATELITE,2023-01-26,102,102,0,0
SATELITE,2023-01-27,57,55,2,0.03509
SATELITE,2023-01-28,177,173,4,0.0226
SATELITE,2023-01-29,61,59,2,0.03279
SATELITE,2023-01-30,96,95,1,0.01042
SATELITE,2023-01-31,86,86,0,0
SATELITE,2023-02-02,34,33,1,0.02941
SATELITE,2023-02-03,23,21,2,0.08696
SATELITE,2023-02-04,63,60,3,0.04762
SATELITE,2023-02-05,22,22,0,0
SATELITE,2023-02-06,35,35,0,0
SATELITE,2023-02-07,47,47,0,0
SATELITE,2023-02-08,66,66,0,0
SATELITE,2023-02-09,41,40,1,0.02439
SATELITE,2023-02-10,51,45,6,0.11765
SATELITE,2023-02-11,54,54,0,0
SATELITE,2023-02-12,31,31,0,0
SATELITE,2023-02-13,38,38,0,0
SATELITE,2023-02-14,54,54,0,0
SATELITE,2023-02-15,36,36,0,0
SATELITE,2023-02-16,167,113,54,0.32335
SATELITE,2023-02-17,38,38,0,0
SATELITE,2023-02-18,89,89,0,0
SATELITE,2023-02-19,40,39,1,0.025
SATELITE,2023-02-20,38,38,0,0
SATELITE,2023-02-21,122,120,2,0.01639
SATELITE,2023-02-22,101,101,0,0
SATELITE,2023-02-23,38,36,2,0.05263
SATELITE,2023-02-24,54,54,0,0
SATELITE,2023-02-25,56,55,1,0.01786
SATELITE,2023-02-26,85,84,1,0.01176
SATELITE,2023-02-27,41,39,2,0.04878
SATELITE,2023-02-28,69,64,5,0.07246
SATELITE,2023-03-01,49,48,1,0.02041
SATELITE,2023-03-02,26,24,2,0.07692
SATELITE,2023-03-03,50,50,0,0
SATELITE,2023-03-04,34,34,0,0
SATELITE,2023-03-05,18,18,0,0
SATELITE,2023-03-07,35,35,0,0
SATELITE,2023-03-08,31,31,0,0
SATELITE,2023-03-09,26,24,2,0.07692
SATELITE,2023-03-10,38,37,1,0.02632
SATELITE,2023-03-11,50,48,2,0.04
SATELITE,2023-03-12,31,31,0,0
SATELITE,2023-03-13,35,35,0,0
SATELITE,2023-03-14,42,41,1,0.02381
SATELITE,2023-03-15,37,37,0,0
SATELITE,2023-03-16,35,35,0,0
SATELITE,2023-03-17,64,51,13,0.20312
SATELITE,2023-03-18,73,71,2,0.0274
SATELITE,2023-03-19,35,35,0,0
SATELITE,2023-03-20,34,34,0,0
TAMPICO,2023-01-01,6,5,1,0.16667
TAMPICO,2023-01-02,34,19,15,0.44118
TAMPICO,2023-01-03,46,33,13,0.28261
TAMPICO,2023-01-04,64,50,14,0.21875
TAMPICO,2023-01-05,54,44,10,0.18519
TAMPICO,2023-01-06,84,64,20,0.2381
TAMPICO,2023-01-07,63,53,10,0.15873
TAMPICO,2023-01-08,58,42,16,0.27586
TAMPICO,2023-01-09,71,50,21,0.29577
TAMPICO,2023-01-10,63,53,10,0.15873
TAMPICO,2023-01-11,48,35,13,0.27083
TAMPICO,2023-01-12,57,47,10,0.17544
TAMPICO,2023-01-13,50,46,4,0.08
TAMPICO,2023-01-14,78,68,10,0.12821
TAMPICO,2023-01-15,33,30,3,0.09091
TAMPICO,2023-01-16,66,53,13,0.19697
TAMPICO,2023-01-17,73,61,12,0.16438
TAMPICO,2023-01-18,61,48,13,0.21311
TAMPICO,2023-01-19,62,53,9,0.14516
TAMPICO,2023-01-20,62,50,12,0.19355
TAMPICO,2023-01-21,60,41,19,0.31667
TAMPICO,2023-01-22,41,29,12,0.29268
TAMPICO,2023-01-23,56,21,35,0.625
TAMPICO,2023-01-24,60,57,3,0.05
TAMPICO,2023-01-25,68,57,11,0.16176
TAMPICO,2023-01-26,50,42,8,0.16
TAMPICO,2023-01-27,46,40,6,0.13043
TAMPICO,2023-01-28,65,56,9,0.13846
TAMPICO,2023-01-29,47,43,4,0.08511
TAMPICO,2023-01-30,54,44,10,0.18519
TAMPICO,2023-01-31,83,72,11,0.13253
TAMPICO,2023-02-02,60,53,7,0.11667
TAMPICO,2023-02-03,59,51,8,0.13559
TAMPICO,2023-02-04,70,61,9,0.12857
TAMPICO,2023-02-05,33,29,4,0.12121
TAMPICO,2023-02-06,42,33,9,0.21429
TAMPICO,2023-02-07,60,52,8,0.13333
TAMPICO,2023-02-08,48,42,6,0.125
TAMPICO,2023-02-09,69,56,13,0.18841
TAMPICO,2023-02-10,55,50,5,0.09091
TAMPICO,2023-02-11,55,51,4,0.07273
TAMPICO,2023-02-12,41,39,2,0.04878
TAMPICO,2023-02-13,47,41,6,0.12766
TAMPICO,2023-02-14,45,40,5,0.11111
TAMPICO,2023-02-15,46,36,10,0.21739
TAMPICO,2023-02-16,49,44,5,0.10204
TAMPICO,2023-02-17,61,58,3,0.04918
TAMPICO,2023-02-18,47,45,2,0.04255
TAMPICO,2023-02-19,39,34,5,0.12821
TAMPICO,2023-02-20,33,26,7,0.21212
TAMPICO,2023-02-21,44,42,2,0.04545
TAMPICO,2023-02-22,61,43,18,0.29508
TAMPICO,2023-02-23,52,45,7,0.13462
TAMPICO,2023-02-24,58,52,6,0.10345
TAMPICO,2023-02-25,54,40,14,0.25926
TAMPICO,2023-02-26,38,38,0,0
TAMPICO,2023-02-27,50,44,6,0.12
TAMPICO,2023-02-28,66,57,9,0.13636
TAMPICO,2023-03-01,65,58,7,0.10769
TAMPICO,2023-03-02,63,50,13,0.20635
TAMPICO,2023-03-03,88,81,7,0.07955
TAMPICO,2023-03-04,47,43,4,0.08511
TAMPICO,2023-03-05,26,25,1,0.03846
TAMPICO,2023-03-07,58,52,6,0.10345
TAMPICO,2023-03-08,67,58,9,0.13433
TAMPICO,2023-03-09,46,36,10,0.21739
TAMPICO,2023-03-10,60,40,20,0.33333
TAMPICO,2023-03-11,88,85,3,0.03409
TAMPICO,2023-03-12,48,29,19,0.39583
TAMPICO,2023-03-13,52,41,11,0.21154
TAMPICO,2023-03-14,116,95,21,0.18103
TAMPICO,2023-03-15,149,69,80,0.53691
TAMPICO,2023-03-16,74,66,8,0.10811
TAMPICO,2023-03-17,155,141,14,0.09032
TAMPICO,2023-03-18,169,83,86,0.50888
TAMPICO,2023-03-19,130,116,14,0.10769
TAMPICO,2023-03-20,67,57,10,0.14925
TECAMAC,2023-01-01,13,12,1,0.07692
TECAMAC,2023-01-02,35,31,4,0.11429
TECAMAC,2023-01-03,36,34,2,0.05556
TECAMAC,2023-01-04,37,34,3,0.08108
TECAMAC,2023-01-05,41,40,1,0.02439
TECAMAC,2023-01-06,37,30,7,0.18919
TECAMAC,2023-01-07,79,74,5,0.06329
TECAMAC,2023-01-08,57,56,1,0.01754
TECAMAC,2023-01-09,68,67,1,0.01471
TECAMAC,2023-01-10,53,51,2,0.03774
TECAMAC,2023-01-11,75,70,5,0.06667
TECAMAC,2023-01-12,66,62,4,0.06061
TECAMAC,2023-01-13,46,46,0,0
TECAMAC,2023-01-14,55,53,2,0.03636
TECAMAC,2023-01-15,82,64,18,0.21951
TECAMAC,2023-01-16,81,68,13,0.16049
TECAMAC,2023-01-17,60,57,3,0.05
TECAMAC,2023-01-18,81,79,2,0.02469
TECAMAC,2023-01-19,82,82,0,0
TECAMAC,2023-01-20,125,91,34,0.272
TECAMAC,2023-01-21,205,182,23,0.1122
TECAMAC,2023-01-22,247,241,6,0.02429
TECAMAC,2023-01-23,211,136,75,0.35545
TECAMAC,2023-01-24,303,300,3,0.0099
TECAMAC,2023-01-25,136,134,2,0.01471
TECAMAC,2023-01-26,352,352,0,0
TECAMAC,2023-01-27,381,381,0,0
TECAMAC,2023-01-28,474,383,91,0.19198
TECAMAC,2023-01-29,187,187,0,0
TECAMAC,2023-01-30,410,395,15,0.03659
TECAMAC,2023-01-31,245,245,0,0
TECAMAC,2023-02-02,215,211,4,0.0186
TECAMAC,2023-02-03,171,151,20,0.11696
TECAMAC,2023-02-04,329,273,56,0.17021
TECAMAC,2023-02-05,300,300,0,0
TECAMAC,2023-02-06,375,325,50,0.13333
TECAMAC,2023-02-07,283,215,68,0.24028
TECAMAC,2023-02-08,242,242,0,0
TECAMAC,2023-02-09,227,219,8,0.03524
TECAMAC,2023-02-10,355,355,0,0
TECAMAC,2023-02-11,448,331,117,0.26116
TECAMAC,2023-02-12,212,150,62,0.29245
TECAMAC,2023-02-13,260,260,0,0
TECAMAC,2023-02-14,376,282,94,0.25
TECAMAC,2023-02-15,373,283,90,0.24129
TECAMAC,2023-02-16,319,317,2,0.00627
TECAMAC,2023-02-17,409,390,19,0.04645
TECAMAC,2023-02-18,241,240,1,0.00415
TECAMAC,2023-02-19,373,346,27,0.07239
TECAMAC,2023-02-20,253,247,6,0.02372
TECAMAC,2023-02-21,188,188,0,0
TECAMAC,2023-02-22,187,184,3,0.01604
TECAMAC,2023-02-23,212,212,0,0
TECAMAC,2023-02-24,266,257,9,0.03383
TECAMAC,2023-02-25,268,218,50,0.18657
TECAMAC,2023-02-26,156,155,1,0.00641
TECAMAC,2023-02-27,274,274,0,0
TECAMAC,2023-02-28,329,289,40,0.12158
TECAMAC,2023-03-01,239,238,1,0.00418
TECAMAC,2023-03-02,135,131,4,0.02963
TECAMAC,2023-03-03,200,179,21,0.105
TECAMAC,2023-03-04,148,146,2,0.01351
TECAMAC,2023-03-05,149,120,29,0.19463
TECAMAC,2023-03-07,245,217,28,0.11429
TECAMAC,2023-03-08,144,127,17,0.11806
TECAMAC,2023-03-09,188,186,2,0.01064
TECAMAC,2023-03-10,49,44,5,0.10204
TECAMAC,2023-03-11,160,154,6,0.0375
TECAMAC,2023-03-12,121,118,3,0.02479
TECAMAC,2023-03-13,68,67,1,0.01471
TECAMAC,2023-03-14,88,85,3,0.03409
TECAMAC,2023-03-15,49,45,4,0.08163
TECAMAC,2023-03-16,189,189,0,0
TECAMAC,2023-03-17,107,107,0,0
TECAMAC,2023-03-18,109,109,0,0
TECAMAC,2023-03-19,222,222,0,0
TECAMAC,2023-03-20,93,93,0,0
TEPIC,2023-01-01,5,5,0,0
TEPIC,2023-01-02,19,19,0,0
TEPIC,2023-01-03,27,27,0,0
TEPIC,2023-01-04,44,44,0,0
TEPIC,2023-01-05,21,21,0,0
TEPIC,2023-01-06,33,33,0,0
TEPIC,2023-01-07,31,31,0,0
TEPIC,2023-01-08,20,20,0,0
TEPIC,2023-01-09,27,27,0,0
TEPIC,2023-01-10,37,37,0,0
TEPIC,2023-01-11,26,22,4,0.15385
TEPIC,2023-01-12,34,32,2,0.05882
TEPIC,2023-01-13,18,16,2,0.11111
TEPIC,2023-01-14,25,20,5,0.2
TEPIC,2023-01-15,16,16,0,0
TEPIC,2023-01-16,32,30,2,0.0625
TEPIC,2023-01-17,34,34,0,0
TEPIC,2023-01-18,29,29,0,0
TEPIC,2023-01-19,35,35,0,0
TEPIC,2023-01-20,25,25,0,0
TEPIC,2023-01-21,69,61,8,0.11594
TEPIC,2023-01-22,28,28,0,0
TEPIC,2023-01-23,46,44,2,0.04348
TEPIC,2023-01-24,20,20,0,0
TEPIC,2023-01-25,47,47,0,0
TEPIC,2023-01-26,30,30,0,0
TEPIC,2023-01-27,50,50,0,0
TEPIC,2023-01-28,41,39,2,0.04878
TEPIC,2023-01-29,19,19,0,0
TEPIC,2023-01-30,61,61,0,0
TEPIC,2023-01-31,41,41,0,0
TEPIC,2023-02-02,57,52,5,0.08772
TEPIC,2023-02-03,24,20,4,0.16667
TEPIC,2023-02-04,40,34,6,0.15
TEPIC,2023-02-05,11,11,0,0
TEPIC,2023-02-06,34,34,0,0
TEPIC,2023-02-07,48,48,0,0
TEPIC,2023-02-08,16,16,0,0
TEPIC,2023-02-09,44,31,13,0.29545
TEPIC,2023-02-10,19,19,0,0
TEPIC,2023-02-11,60,60,0,0
TEPIC,2023-02-12,9,9,0,0
TEPIC,2023-02-13,23,22,1,0.04348
TEPIC,2023-02-14,24,24,0,0
TEPIC,2023-02-15,25,25,0,0
TEPIC,2023-02-16,59,59,0,0
TEPIC,2023-02-17,58,58,0,0
TEPIC,2023-02-18,28,28,0,0
TEPIC,2023-02-19,6,6,0,0
TEPIC,2023-02-20,41,41,0,0
TEPIC,2023-02-21,37,37,0,0
TEPIC,2023-02-22,36,36,0,0
TEPIC,2023-02-23,55,55,0,0
TEPIC,2023-02-24,19,19,0,0
TEPIC,2023-02-25,31,31,0,0
TEPIC,2023-02-26,7,7,0,0
TEPIC,2023-02-27,21,21,0,0
TEPIC,2023-02-28,53,53,0,0
TEPIC,2023-03-01,36,23,13,0.36111
TEPIC,2023-03-02,33,33,0,0
TEPIC,2023-03-03,18,18,0,0
TEPIC,2023-03-04,36,29,7,0.19444
TEPIC,2023-03-05,19,19,0,0
TEPIC,2023-03-07,72,72,0,0
TEPIC,2023-03-08,28,28,0,0
TEPIC,2023-03-09,48,48,0,0
TEPIC,2023-03-10,31,25,6,0.19355
TEPIC,2023-03-11,35,21,14,0.4
TEPIC,2023-03-12,37,37,0,0
TEPIC,2023-03-13,41,30,11,0.26829
TEPIC,2023-03-14,20,20,0,0
TEPIC,2023-03-15,32,32,0,0
TEPIC,2023-03-16,33,33,0,0
TEPIC,2023-03-17,19,19,0,0
TEPIC,2023-03-18,40,39,1,0.025
TEPIC,2023-03-19,68,68,0,0
TEPIC,2023-03-20,35,35,0,0
TEXCOCO,2023-01-01,9,9,0,0
TEXCOCO,2023-01-02,73,68,5,0.06849
TEXCOCO,2023-01-03,108,104,4,0.03704
TEXCOCO,2023-01-04,134,134,0,0
TEXCOCO,2023-01-05,122,116,6,0.04918
TEXCOCO,2023-01-06,116,91,25,0.21552
TEXCOCO,2023-01-07,62,53,9,0.14516
TEXCOCO,2023-01-08,95,82,13,0.13684
TEXCOCO,2023-01-09,87,72,15,0.17241
TEXCOCO,2023-01-10,94,87,7,0.07447
TEXCOCO,2023-01-11,105,91,14,0.13333
TEXCOCO,2023-01-12,121,111,10,0.08264
TEXCOCO,2023-01-13,132,112,20,0.15152
TEXCOCO,2023-01-14,99,99,0,0
TEXCOCO,2023-01-15,91,84,7,0.07692
TEXCOCO,2023-01-16,81,79,2,0.02469
TEXCOCO,2023-01-17,130,113,17,0.13077
TEXCOCO,2023-01-18,87,85,2,0.02299
TEXCOCO,2023-01-19,157,152,5,0.03185
TEXCOCO,2023-01-20,194,166,28,0.14433
TEXCOCO,2023-01-21,71,69,2,0.02817
TEXCOCO,2023-01-22,56,55,1,0.01786
TEXCOCO,2023-01-23,132,126,6,0.04545
TEXCOCO,2023-01-24,157,143,14,0.08917
TEXCOCO,2023-01-25,212,196,16,0.07547
TEXCOCO,2023-01-26,108,105,3,0.02778
TEXCOCO,2023-01-27,110,96,14,0.12727
TEXCOCO,2023-01-28,164,155,9,0.05488
TEXCOCO,2023-01-29,64,59,5,0.07812
TEXCOCO,2023-01-30,179,173,6,0.03352
TEXCOCO,2023-01-31,129,126,3,0.02326
TEXCOCO,2023-02-02,106,101,5,0.04717
TEXCOCO,2023-02-03,192,192,0,0
TEXCOCO,2023-02-04,93,92,1,0.01075
TEXCOCO,2023-02-05,104,103,1,0.00962
TEXCOCO,2023-02-06,155,155,0,0
TEXCOCO,2023-02-07,122,114,8,0.06557
TEXCOCO,2023-02-08,142,139,3,0.02113
TEXCOCO,2023-02-09,96,96,0,0
TEXCOCO,2023-02-10,140,127,13,0.09286
TEXCOCO,2023-02-11,117,115,2,0.01709
TEXCOCO,2023-02-12,94,93,1,0.01064
TEXCOCO,2023-02-13,157,155,2,0.01274
TEXCOCO,2023-02-14,144,144,0,0
TEXCOCO,2023-02-15,175,171,4,0.02286
TEXCOCO,2023-02-16,176,171,5,0.02841
TEXCOCO,2023-02-17,172,169,3,0.01744
TEXCOCO,2023-02-18,148,143,5,0.03378
TEXCOCO,2023-02-19,192,189,3,0.01562
TEXCOCO,2023-02-20,148,147,1,0.00676
TEXCOCO,2023-02-21,133,133,0,0
TEXCOCO,2023-02-22,222,205,17,0.07658
TEXCOCO,2023-02-23,120,120,0,0
TEXCOCO,2023-02-24,208,207,1,0.00481
TEXCOCO,2023-02-25,190,177,13,0.06842
TEXCOCO,2023-02-26,222,215,7,0.03153
TIJ FRONTERA,2023-01-01,2,2,0,0
TIJ FRONTERA,2023-01-02,52,15,37,0.71154
TIJ FRONTERA,2023-01-03,61,34,27,0.44262
TIJ FRONTERA,2023-01-04,78,31,47,0.60256
TIJ FRONTERA,2023-01-05,150,86,64,0.42667
TIJ FRONTERA,2023-01-06,100,48,52,0.52
TIJ FRONTERA,2023-01-07,86,39,47,0.54651
TIJ FRONTERA,2023-01-08,53,23,30,0.56604
TIJ FRONTERA,2023-01-09,75,25,50,0.66667
TIJ FRONTERA,2023-01-10,69,18,51,0.73913
TIJ FRONTERA,2023-01-11,73,20,53,0.72603
TIJ FRONTERA,2023-01-12,87,26,61,0.70115
TIJ FRONTERA,2023-01-13,90,29,61,0.67778
TIJ FRONTERA,2023-01-14,56,26,30,0.53571
TIJ FRONTERA,2023-01-15,59,17,42,0.71186
TIJ FRONTERA,2023-01-16,8,7,1,0.125
TIJ FRONTERA,2023-01-17,56,47,9,0.16071
TIJ FRONTERA,2023-01-18,174,90,84,0.48276
TIJ FRONTERA,2023-01-19,92,30,62,0.67391
TIJ FRONTERA,2023-01-20,74,27,47,0.63514
TIJ FRONTERA,2023-01-21,82,42,40,0.4878
TIJ FRONTERA,2023-01-22,73,48,25,0.34247
TIJ FRONTERA,2023-01-23,83,37,46,0.55422
TIJ FRONTERA,2023-01-24,86,59,27,0.31395
TIJ FRONTERA,2023-01-25,102,49,53,0.51961
TIJ FRONTERA,2023-01-26,112,45,67,0.59821
TIJ FRONTERA,2023-01-27,96,34,62,0.64583
TIJ FRONTERA,2023-01-28,127,57,70,0.55118
TIJ FRONTERA,2023-01-29,81,40,41,0.50617
TIJ FRONTERA,2023-01-30,76,50,26,0.34211
TIJ FRONTERA,2023-01-31,91,42,49,0.53846
TIJ FRONTERA,2023-02-02,117,50,67,0.57265
TIJ FRONTERA,2023-02-03,77,53,24,0.31169
TIJ FRONTERA,2023-02-04,70,26,44,0.62857
TIJ FRONTERA,2023-02-05,58,38,20,0.34483
TIJ FRONTERA,2023-02-06,83,42,41,0.49398
TIJ FRONTERA,2023-02-07,119,72,47,0.39496
TIJ FRONTERA,2023-02-08,107,45,62,0.57944
TIJ FRONTERA,2023-02-09,46,16,30,0.65217
TIJ FRONTERA,2023-02-10,130,35,95,0.73077
TIJ FRONTERA,2023-02-11,92,26,66,0.71739
TIJ FRONTERA,2023-02-12,85,28,57,0.67059
TIJ FRONTERA,2023-02-13,99,48,51,0.51515
TIJ FRONTERA,2023-02-14,97,70,27,0.27835
TIJ FRONTERA,2023-02-15,90,58,32,0.35556
TIJ FRONTERA,2023-02-16,87,33,54,0.62069
TIJ FRONTERA,2023-02-17,102,50,52,0.5098
TIJ FRONTERA,2023-02-18,68,28,40,0.58824
TIJ FRONTERA,2023-02-19,71,34,37,0.52113
TIJ FRONTERA,2023-02-20,87,27,60,0.68966
TIJ FRONTERA,2023-02-21,98,36,62,0.63265
TIJ FRONTERA,2023-02-22,96,49,47,0.48958
TIJ FRONTERA,2023-02-23,49,19,30,0.61224
TIJ FRONTERA,2023-02-24,57,1,56,0.98246
TIJ FRONTERA,2023-02-25,8,4,4,0.5
TIJ FRONTERA,2023-02-26,55,25,30,0.54545
TIJ FRONTERA,2023-02-27,87,16,71,0.81609
TIJ FRONTERA,2023-02-28,79,7,72,0.91139
TIJ FRONTERA,2023-03-01,35,19,16,0.45714
TIJ FRONTERA,2023-03-02,47,27,20,0.42553
TIJ FRONTERA,2023-03-03,102,66,36,0.35294
TIJ FRONTERA,2023-03-04,133,26,107,0.80451
TIJ FRONTERA,2023-03-05,84,26,58,0.69048
TIJ FRONTERA,2023-03-07,5,3,2,0.4
TIJ FRONTERA,2023-03-08,110,71,39,0.35455
TIJ FRONTERA,2023-03-09,97,47,50,0.51546
TIJ FRONTERA,2023-03-10,99,47,52,0.52525
TIJ FRONTERA,2023-03-11,99,39,60,0.60606
TIJ FRONTERA,2023-03-12,107,70,37,0.34579
TIJ FRONTERA,2023-03-13,54,28,26,0.48148
TIJ FRONTERA,2023-03-14,28,5,23,0.82143
TIJ FRONTERA,2023-03-15,34,28,6,0.17647
TIJ FRONTERA,2023-03-16,72,43,29,0.40278
TIJ FRONTERA,2023-03-17,127,101,26,0.20472
TIJ FRONTERA,2023-03-18,84,64,20,0.2381
TIJ FRONTERA,2023-03-19,67,58,9,0.13433
TIJ FRONTERA,2023-03-20,21,18,3,0.14286
TIJ PLAYAS,2023-01-01,2,0,2,1
TIJ PLAYAS,2023-01-02,72,65,7,0.09722
TIJ PLAYAS,2023-01-03,74,49,25,0.33784
TIJ PLAYAS,2023-01-04,72,47,25,0.34722
TIJ PLAYAS,2023-01-05,63,56,7,0.11111
TIJ PLAYAS,2023-01-06,80,54,26,0.325
TIJ PLAYAS,2023-01-07,84,64,20,0.2381
TIJ PLAYAS,2023-01-08,76,64,12,0.15789
TIJ PLAYAS,2023-01-09,45,34,11,0.24444
TIJ PLAYAS,2023-01-10,128,66,62,0.48438
TIJ PLAYAS,2023-01-11,66,65,1,0.01515
TIJ PLAYAS,2023-01-12,105,76,29,0.27619
TIJ PLAYAS,2023-01-13,90,60,30,0.33333
TIJ PLAYAS,2023-01-14,44,32,12,0.27273
TIJ PLAYAS,2023-01-15,79,69,10,0.12658
TIJ PLAYAS,2023-01-16,23,17,6,0.26087
TIJ PLAYAS,2023-01-17,67,40,27,0.40299
TIJ PLAYAS,2023-01-18,80,69,11,0.1375
TIJ PLAYAS,2023-01-19,67,45,22,0.32836
TIJ PLAYAS,2023-01-20,98,73,25,0.2551
TIJ PLAYAS,2023-01-21,128,68,60,0.46875
TIJ PLAYAS,2023-01-22,65,47,18,0.27692
TIJ PLAYAS,2023-01-23,84,81,3,0.03571
TIJ PLAYAS,2023-01-24,101,84,17,0.16832
TIJ PLAYAS,2023-01-25,82,48,34,0.41463
TIJ PLAYAS,2023-01-26,106,32,74,0.69811
TIJ PLAYAS,2023-01-27,86,54,32,0.37209
TIJ PLAYAS,2023-01-28,94,82,12,0.12766
TIJ PLAYAS,2023-01-29,89,77,12,0.13483
TIJ PLAYAS,2023-01-30,34,27,7,0.20588
TIJ PLAYAS,2023-01-31,87,58,29,0.33333
TIJ PLAYAS,2023-02-02,106,56,50,0.4717
TIJ PLAYAS,2023-02-03,106,71,35,0.33019
TIJ PLAYAS,2023-02-04,108,64,44,0.40741
TIJ PLAYAS,2023-02-05,79,53,26,0.32911
TIJ PLAYAS,2023-02-06,120,92,28,0.23333
TIJ PLAYAS,2023-02-07,136,101,35,0.25735
TIJ PLAYAS,2023-02-08,150,104,46,0.30667
TIJ PLAYAS,2023-02-09,85,48,37,0.43529
TIJ PLAYAS,2023-02-10,168,61,107,0.6369
TIJ PLAYAS,2023-02-11,106,79,27,0.25472
TIJ PLAYAS,2023-02-12,69,45,24,0.34783
TIJ PLAYAS,2023-02-13,111,54,57,0.51351
TIJ PLAYAS,2023-02-14,85,54,31,0.36471
TIJ PLAYAS,2023-02-15,105,75,30,0.28571
TIJ PLAYAS,2023-02-16,72,54,18,0.25
TIJ PLAYAS,2023-02-17,101,55,46,0.45545
TIJ PLAYAS,2023-02-18,127,71,56,0.44094
TIJ PLAYAS,2023-02-19,97,36,61,0.62887
TIJ PLAYAS,2023-02-20,107,79,28,0.26168
TIJ PLAYAS,2023-02-21,113,56,57,0.50442
TIJ PLAYAS,2023-02-22,94,47,47,0.5
TIJ PLAYAS,2023-02-23,76,55,21,0.27632
TIJ PLAYAS,2023-02-24,89,76,13,0.14607
TIJ PLAYAS,2023-02-25,23,4,19,0.82609
TIJ PLAYAS,2023-02-26,118,80,38,0.32203
TIJ PLAYAS,2023-02-27,105,57,48,0.45714
TIJ PLAYAS,2023-02-28,79,35,44,0.55696
TIJ PLAYAS,2023-03-01,67,16,51,0.76119
TIJ PLAYAS,2023-03-02,70,38,32,0.45714
TIJ PLAYAS,2023-03-03,91,40,51,0.56044
TIJ PLAYAS,2023-03-04,127,54,73,0.5748
TIJ PLAYAS,2023-03-05,119,31,88,0.7395
TIJ PLAYAS,2023-03-07,98,70,28,0.28571
TIJ PLAYAS,2023-03-08,130,76,54,0.41538
TIJ PLAYAS,2023-03-09,62,39,23,0.37097
TIJ PLAYAS,2023-03-10,74,24,50,0.67568
TIJ PLAYAS,2023-03-11,96,48,48,0.5
TIJ PLAYAS,2023-03-12,114,57,57,0.5
TIJ PLAYAS,2023-03-13,82,62,20,0.2439
TIJ PLAYAS,2023-03-14,76,63,13,0.17105
TIJ PLAYAS,2023-03-15,46,39,7,0.15217
TIJ PLAYAS,2023-03-16,93,51,42,0.45161
TIJ PLAYAS,2023-03-17,87,76,11,0.12644
TIJ PLAYAS,2023-03-18,101,89,12,0.11881
TIJ PLAYAS,2023-03-19,100,82,18,0.18
TIJ PLAYAS,2023-03-20,51,48,3,0.05882
TIJ RIO,2023-01-01,8,2,6,0.75
TIJ RIO,2023-01-02,39,19,20,0.51282
TIJ RIO,2023-01-03,36,6,30,0.83333
TIJ RIO,2023-01-04,34,22,12,0.35294
TIJ RIO,2023-01-05,34,16,18,0.52941
TIJ RIO,2023-01-06,46,27,19,0.41304
TIJ RIO,2023-01-07,79,33,46,0.58228
TIJ RIO,2023-01-08,73,29,44,0.60274
TIJ RIO,2023-01-09,18,4,14,0.77778
TIJ RIO,2023-01-10,49,14,35,0.71429
TIJ RIO,2023-01-11,40,16,24,0.6
TIJ RIO,2023-01-12,47,24,23,0.48936
TIJ RIO,2023-01-13,56,32,24,0.42857
TIJ RIO,2023-01-14,36,23,13,0.36111
TIJ RIO,2023-01-15,68,28,40,0.58824
TIJ RIO,2023-01-16,39,26,13,0.33333
TIJ RIO,2023-01-17,48,10,38,0.79167
TIJ RIO,2023-01-18,51,21,30,0.58824
TIJ RIO,2023-01-19,65,4,61,0.93846
TIJ RIO,2023-01-20,71,7,64,0.90141
TIJ RIO,2023-01-21,80,10,70,0.875
TIJ RIO,2023-01-22,55,19,36,0.65455
TIJ RIO,2023-01-23,42,15,27,0.64286
TIJ RIO,2023-01-24,72,16,56,0.77778
TIJ RIO,2023-01-25,65,14,51,0.78462
TIJ RIO,2023-01-26,51,33,18,0.35294
TIJ RIO,2023-01-27,55,24,31,0.56364
TIJ RIO,2023-01-28,70,10,60,0.85714
TIJ RIO,2023-01-29,45,0,45,1
TIJ RIO,2023-01-30,52,19,33,0.63462
TIJ RIO,2023-01-31,75,10,65,0.86667
TIJ RIO,2023-02-02,52,27,25,0.48077
TIJ RIO,2023-02-03,46,30,16,0.34783
TIJ RIO,2023-02-04,43,12,31,0.72093
TIJ RIO,2023-02-05,52,30,22,0.42308
TIJ RIO,2023-02-06,57,36,21,0.36842
TIJ RIO,2023-02-07,46,23,23,0.5
TIJ RIO,2023-02-08,72,30,42,0.58333
TIJ RIO,2023-02-09,47,24,23,0.48936
TIJ RIO,2023-02-10,74,35,39,0.52703
TIJ RIO,2023-02-11,91,16,75,0.82418
TIJ RIO,2023-02-12,40,22,18,0.45
TIJ RIO,2023-02-13,62,18,44,0.70968
TIJ RIO,2023-02-14,64,11,53,0.82812
TIJ RIO,2023-02-15,72,26,46,0.63889
TIJ RIO,2023-02-16,28,4,24,0.85714
TIJ RIO,2023-02-17,48,17,31,0.64583
TIJ RIO,2023-02-18,53,32,21,0.39623
TIJ RIO,2023-02-19,46,6,40,0.86957
TIJ RIO,2023-02-20,65,13,52,0.8
TIJ RIO,2023-02-21,38,16,22,0.57895
TIJ RIO,2023-02-22,42,12,30,0.71429
TIJ RIO,2023-02-23,48,17,31,0.64583
TIJ RIO,2023-02-24,35,15,20,0.57143
TIJ RIO,2023-02-25,44,12,32,0.72727
TIJ RIO,2023-02-26,65,12,53,0.81538
TIJ RIO,2023-02-27,66,14,52,0.78788
TIJ RIO,2023-02-28,48,3,45,0.9375
TIJ RIO,2023-03-01,55,9,46,0.83636
TIJ RIO,2023-03-02,51,23,28,0.54902
TIJ RIO,2023-03-03,76,30,46,0.60526
TIJ RIO,2023-03-04,43,21,22,0.51163
TIJ RIO,2023-03-05,68,21,47,0.69118
TIJ RIO,2023-03-07,41,14,27,0.65854
TIJ RIO,2023-03-08,57,30,27,0.47368
TIJ RIO,2023-03-09,56,11,45,0.80357
TIJ RIO,2023-03-10,53,18,35,0.66038
TIJ RIO,2023-03-11,82,49,33,0.40244
TIJ RIO,2023-03-12,42,23,19,0.45238
TIJ RIO,2023-03-13,42,19,23,0.54762
TIJ RIO,2023-03-14,45,23,22,0.48889
TIJ RIO,2023-03-15,33,19,14,0.42424
TIJ RIO,2023-03-16,18,12,6,0.33333
TIJ RIO,2023-03-17,35,11,24,0.68571
TIJ RIO,2023-03-18,33,20,13,0.39394
TIJ RIO,2023-03-19,19,8,11,0.57895
TIJ RIO,2023-03-20,37,18,19,0.51351
TIJ TECATE,2023-01-02,60,33,27,0.45
TIJ TECATE,2023-01-03,66,36,30,0.45455
TIJ TECATE,2023-01-04,86,31,55,0.63953
TIJ TECATE,2023-01-05,73,42,31,0.42466
TIJ TECATE,2023-01-06,100,36,64,0.64
TIJ TECATE,2023-01-07,90,37,53,0.58889
TIJ TECATE,2023-01-08,137,50,87,0.63504
TIJ TECATE,2023-01-09,101,32,69,0.68317
TIJ TECATE,2023-01-10,149,49,100,0.67114
TIJ TECATE,2023-01-11,111,41,70,0.63063
TIJ TECATE,2023-01-12,78,25,53,0.67949
TIJ TECATE,2023-01-13,91,47,44,0.48352
TIJ TECATE,2023-01-14,72,23,49,0.68056
TIJ TECATE,2023-01-15,37,16,21,0.56757
TIJ TECATE,2023-01-16,80,58,22,0.275
TIJ TECATE,2023-01-17,85,45,40,0.47059
TIJ TECATE,2023-01-18,70,40,30,0.42857
TIJ TECATE,2023-01-19,53,20,33,0.62264
TIJ TECATE,2023-01-20,75,40,35,0.46667
TIJ TECATE,2023-01-21,90,30,60,0.66667
TIJ TECATE,2023-01-22,78,46,32,0.41026
TIJ TECATE,2023-01-23,92,34,58,0.63043
TIJ TECATE,2023-01-24,81,22,59,0.7284
TIJ TECATE,2023-01-25,109,44,65,0.59633
TIJ TECATE,2023-01-26,117,57,60,0.51282
TIJ TECATE,2023-01-27,108,51,57,0.52778
TIJ TECATE,2023-01-28,120,66,54,0.45
TIJ TECATE,2023-01-29,112,48,64,0.57143
TIJ TECATE,2023-01-30,111,62,49,0.44144
TIJ TECATE,2023-01-31,66,35,31,0.4697
TIJ TECATE,2023-02-02,76,65,11,0.14474
TIJ TECATE,2023-02-03,79,56,23,0.29114
TIJ TECATE,2023-02-04,51,27,24,0.47059
TIJ TECATE,2023-02-05,91,43,48,0.52747
TIJ TECATE,2023-02-06,78,42,36,0.46154
TIJ TECATE,2023-02-07,70,38,32,0.45714
TIJ TECATE,2023-02-08,61,28,33,0.54098
TIJ TECATE,2023-02-09,117,66,51,0.4359
TIJ TECATE,2023-02-10,184,79,105,0.57065
TIJ TECATE,2023-02-11,136,79,57,0.41912
TIJ TECATE,2023-02-12,51,21,30,0.58824
TIJ TECATE,2023-02-13,78,39,39,0.5
TIJ TECATE,2023-02-14,86,49,37,0.43023
TIJ TECATE,2023-02-15,156,87,69,0.44231
TIJ TECATE,2023-02-16,72,13,59,0.81944
TIJ TECATE,2023-02-17,128,30,98,0.76562
TIJ TECATE,2023-02-18,139,80,59,0.42446
TIJ TECATE,2023-02-19,112,32,80,0.71429
TIJ TECATE,2023-02-20,112,59,53,0.47321
TIJ TECATE,2023-02-21,119,58,61,0.51261
TIJ TECATE,2023-02-22,98,73,25,0.2551
TIJ TECATE,2023-02-23,63,20,43,0.68254
TIJ TECATE,2023-02-24,98,37,61,0.62245
TIJ TECATE,2023-02-25,68,21,47,0.69118
TIJ TECATE,2023-02-26,93,44,49,0.52688
TIJ TECATE,2023-02-27,88,23,65,0.73864
TIJ TECATE,2023-02-28,63,12,51,0.80952
TIJ TECATE,2023-03-01,39,6,33,0.84615
TIJ TECATE,2023-03-02,77,14,63,0.81818
TIJ TECATE,2023-03-03,100,18,82,0.82
TIJ TECATE,2023-03-04,148,36,112,0.75676
TIJ TECATE,2023-03-05,142,31,111,0.78169
TIJ TECATE,2023-03-07,48,13,35,0.72917
TIJ TECATE,2023-03-08,109,72,37,0.33945
TIJ TECATE,2023-03-09,85,23,62,0.72941
TIJ TECATE,2023-03-10,14,8,6,0.42857
TIJ TECATE,2023-03-11,141,30,111,0.78723
TIJ TECATE,2023-03-12,101,42,59,0.58416
TIJ TECATE,2023-03-13,48,16,32,0.66667
TIJ TECATE,2023-03-14,78,51,27,0.34615
TIJ TECATE,2023-03-15,31,7,24,0.77419
TIJ TECATE,2023-03-16,12,5,7,0.58333
TIJ TECATE,2023-03-17,26,24,2,0.07692
TIJ TECATE,2023-03-18,20,12,8,0.4
TIJ TECATE,2023-03-19,28,27,1,0.03571
TIJ TECATE,2023-03-20,21,14,7,0.33333
TLALNEPANTLA,2023-01-01,7,7,0,0
TLALNEPANTLA,2023-01-02,33,33,0,0
TLALNEPANTLA,2023-01-03,38,38,0,0
TLALNEPANTLA,2023-01-04,43,40,3,0.06977
TLALNEPANTLA,2023-01-05,38,38,0,0
TLALNEPANTLA,2023-01-06,37,34,3,0.08108
TLALNEPANTLA,2023-01-07,46,45,1,0.02174
TLALNEPANTLA,2023-01-08,33,32,1,0.0303
TLALNEPANTLA,2023-01-09,119,109,10,0.08403
TLALNEPANTLA,2023-01-10,45,45,0,0
TLALNEPANTLA,2023-01-11,44,43,1,0.02273
TLALNEPANTLA,2023-01-12,37,37,0,0
TLALNEPANTLA,2023-01-13,63,63,0,0
TLALNEPANTLA,2023-01-14,53,53,0,0
TLALNEPANTLA,2023-01-15,64,64,0,0
TLALNEPANTLA,2023-01-16,60,54,6,0.1
TLALNEPANTLA,2023-01-17,102,102,0,0
TLALNEPANTLA,2023-01-18,69,53,16,0.23188
TLALNEPANTLA,2023-01-19,91,90,1,0.01099
TLALNEPANTLA,2023-01-20,127,123,4,0.0315
TLALNEPANTLA,2023-01-21,113,110,3,0.02655
TLALNEPANTLA,2023-01-22,233,232,1,0.00429
TLALNEPANTLA,2023-01-23,99,99,0,0
TLALNEPANTLA,2023-01-24,166,166,0,0
TLALNEPANTLA,2023-01-25,86,86,0,0
TLALNEPANTLA,2023-01-26,158,158,0,0
TLALNEPANTLA,2023-01-27,118,113,5,0.04237
TLALNEPANTLA,2023-01-28,217,205,12,0.0553
TLALNEPANTLA,2023-01-29,195,195,0,0
TLALNEPANTLA,2023-01-30,174,173,1,0.00575
TLALNEPANTLA,2023-01-31,211,210,1,0.00474
TLALNEPANTLA,2023-02-02,117,117,0,0
TLALNEPANTLA,2023-02-03,157,157,0,0
TLALNEPANTLA,2023-02-04,153,152,1,0.00654
TLALNEPANTLA,2023-02-05,52,50,2,0.03846
TLALNEPANTLA,2023-02-06,98,90,8,0.08163
TLALNEPANTLA,2023-02-07,128,128,0,0
TLALNEPANTLA,2023-02-08,130,127,3,0.02308
TLALNEPANTLA,2023-02-09,230,230,0,0
TLALNEPANTLA,2023-02-10,221,220,1,0.00452
TLALNEPANTLA,2023-02-11,91,80,11,0.12088
TLALNEPANTLA,2023-02-12,120,113,7,0.05833
TLALNEPANTLA,2023-02-13,234,231,3,0.01282
TLALNEPANTLA,2023-02-14,139,137,2,0.01439
TLALNEPANTLA,2023-02-15,284,282,2,0.00704
TLALNEPANTLA,2023-02-16,106,70,36,0.33962
TLALNEPANTLA,2023-02-17,124,124,0,0
TLALNEPANTLA,2023-02-18,230,222,8,0.03478
TLALNEPANTLA,2023-02-19,183,183,0,0
TLALNEPANTLA,2023-02-20,44,41,3,0.06818
TLALNEPANTLA,2023-02-21,59,57,2,0.0339
TLALNEPANTLA,2023-02-22,67,64,3,0.04478
TLALNEPANTLA,2023-02-23,68,68,0,0
TLALNEPANTLA,2023-02-24,110,110,0,0
TLALNEPANTLA,2023-02-25,240,240,0,0
TLALNEPANTLA,2023-02-26,122,121,1,0.0082
TLALNEPANTLA,2023-02-27,45,42,3,0.06667
TLALNEPANTLA,2023-02-28,97,96,1,0.01031
TLALNEPANTLA,2023-03-01,54,50,4,0.07407
TLALNEPANTLA,2023-03-02,81,80,1,0.01235
TLALNEPANTLA,2023-03-03,159,147,12,0.07547
TLALNEPANTLA,2023-03-04,96,95,1,0.01042
TLALNEPANTLA,2023-03-05,73,72,1,0.0137
TLALNEPANTLA,2023-03-07,70,69,1,0.01429
TLALNEPANTLA,2023-03-08,94,84,10,0.10638
TLALNEPANTLA,2023-03-09,41,41,0,0
TLALNEPANTLA,2023-03-10,43,43,0,0
TLALNEPANTLA,2023-03-11,37,33,4,0.10811
TLALNEPANTLA,2023-03-12,70,70,0,0
TLALNEPANTLA,2023-03-13,53,52,1,0.01887
TLALNEPANTLA,2023-03-14,133,131,2,0.01504
TLALNEPANTLA,2023-03-15,73,69,4,0.05479
TLALNEPANTLA,2023-03-16,66,66,0,0
TLALNEPANTLA,2023-03-17,60,60,0,0
TLALNEPANTLA,2023-03-18,62,62,0,0
TLALNEPANTLA,2023-03-19,83,77,6,0.07229
TLALNEPANTLA,2023-03-20,89,77,12,0.13483
TLALPAN,2023-01-01,3,2,1,0.33333
TLALPAN,2023-01-02,31,18,13,0.41935
TLALPAN,2023-01-03,50,30,20,0.4
TLALPAN,2023-01-04,51,24,27,0.52941
TLALPAN,2023-01-05,82,61,21,0.2561
TLALPAN,2023-01-06,62,31,31,0.5
TLALPAN,2023-01-07,95,58,37,0.38947
TLALPAN,2023-01-08,92,58,34,0.36957
TLALPAN,2023-01-09,71,37,34,0.47887
TLALPAN,2023-01-10,80,53,27,0.3375
TLALPAN,2023-01-11,70,28,42,0.6
TLALPAN,2023-01-12,85,50,35,0.41176
TLALPAN,2023-01-13,141,64,77,0.5461
TLALPAN,2023-01-14,78,62,16,0.20513
TLALPAN,2023-01-15,55,32,23,0.41818
TLALPAN,2023-01-16,102,57,45,0.44118
TLALPAN,2023-01-17,82,46,36,0.43902
TLALPAN,2023-01-18,129,127,2,0.0155
TLALPAN,2023-01-19,114,71,43,0.37719
TLALPAN,2023-01-20,96,88,8,0.08333
TLALPAN,2023-01-21,75,59,16,0.21333
TLALPAN,2023-01-22,103,64,39,0.37864
TLALPAN,2023-01-23,139,78,61,0.43885
TLALPAN,2023-01-24,105,75,30,0.28571
TLALPAN,2023-01-25,67,40,27,0.40299
TLALPAN,2023-01-26,158,123,35,0.22152
TLALPAN,2023-01-27,87,55,32,0.36782
TLALPAN,2023-01-28,97,57,40,0.41237
TLALPAN,2023-01-29,160,121,39,0.24375
TLALPAN,2023-01-30,62,32,30,0.48387
TLALPAN,2023-01-31,90,52,38,0.42222
TLALPAN,2023-02-02,114,49,65,0.57018
TLALPAN,2023-02-03,80,62,18,0.225
TLALPAN,2023-02-04,147,119,28,0.19048
TLALPAN,2023-02-05,148,117,31,0.20946
TLALPAN,2023-02-06,63,39,24,0.38095
TLALPAN,2023-02-07,127,87,40,0.31496
TLALPAN,2023-02-08,87,45,42,0.48276
TLALPAN,2023-02-09,83,55,28,0.33735
TLALPAN,2023-02-10,72,64,8,0.11111
TLALPAN,2023-02-11,103,71,32,0.31068
TLALPAN,2023-02-12,56,34,22,0.39286
TLALPAN,2023-02-13,62,38,24,0.3871
TLALPAN,2023-02-14,44,35,9,0.20455
TLALPAN,2023-02-15,41,19,22,0.53659
TLALPAN,2023-02-16,35,22,13,0.37143
TLALPAN,2023-02-17,30,21,9,0.3
TLALPAN,2023-02-18,89,48,41,0.46067
TLALPAN,2023-02-19,70,43,27,0.38571
TLALPAN,2023-02-20,62,49,13,0.20968
TLALPAN,2023-02-21,29,21,8,0.27586
TLALPAN,2023-02-22,84,47,37,0.44048
TLALPAN,2023-02-23,38,12,26,0.68421
TLALPAN,2023-02-24,44,35,9,0.20455
TLALPAN,2023-02-25,70,46,24,0.34286
TLALPAN,2023-02-26,85,53,32,0.37647
TLALPAN,2023-02-27,50,33,17,0.34
TLALPAN,2023-02-28,52,33,19,0.36538
TLALPAN,2023-03-01,63,40,23,0.36508
TLALPAN,2023-03-02,38,28,10,0.26316
TLALPAN,2023-03-03,52,33,19,0.36538
TLALPAN,2023-03-04,106,86,20,0.18868
TLALPAN,2023-03-05,78,68,10,0.12821
TLALPAN,2023-03-07,49,42,7,0.14286
TLALPAN,2023-03-08,62,41,21,0.33871
TLALPAN,2023-03-09,44,26,18,0.40909
TLALPAN,2023-03-10,58,52,6,0.10345
TLALPAN,2023-03-11,53,48,5,0.09434
TLALPAN,2023-03-12,61,42,19,0.31148
TLALPAN,2023-03-13,54,43,11,0.2037
TLALPAN,2023-03-14,43,36,7,0.16279
TLALPAN,2023-03-15,32,29,3,0.09375
TLALPAN,2023-03-16,47,47,0,0
TLALPAN,2023-03-17,50,48,2,0.04
TLALPAN,2023-03-18,84,81,3,0.03571
TLALPAN,2023-03-19,48,48,0,0
TLALPAN,2023-03-20,55,53,2,0.03636
TOL LERMA SAN MATEO,2023-01-01,19,18,1,0.05263
TOL LERMA SAN MATEO,2023-01-02,44,44,0,0
TOL LERMA SAN MATEO,2023-01-03,77,73,4,0.05195
TOL LERMA SAN MATEO,2023-01-04,112,104,8,0.07143
TOL LERMA SAN MATEO,2023-01-05,73,71,2,0.0274
TOL LERMA SAN MATEO,2023-01-06,66,64,2,0.0303
TOL LERMA SAN MATEO,2023-01-07,98,98,0,0
TOL LERMA SAN MATEO,2023-01-08,37,35,2,0.05405
TOL LERMA SAN MATEO,2023-01-09,77,77,0,0
TOL LERMA SAN MATEO,2023-01-10,110,73,37,0.33636
TOL LERMA SAN MATEO,2023-01-11,73,73,0,0
TOL LERMA SAN MATEO,2023-01-12,115,112,3,0.02609
TOL LERMA SAN MATEO,2023-01-13,105,94,11,0.10476
TOL LERMA SAN MATEO,2023-01-14,121,103,18,0.14876
TOL LERMA SAN MATEO,2023-01-15,84,75,9,0.10714
TOL LERMA SAN MATEO,2023-01-16,105,94,11,0.10476
TOL LERMA SAN MATEO,2023-01-17,63,62,1,0.01587
TOL LERMA SAN MATEO,2023-01-18,100,99,1,0.01
TOL LERMA SAN MATEO,2023-01-19,171,156,15,0.08772
TOL LERMA SAN MATEO,2023-01-20,117,116,1,0.00855
TOL LERMA SAN MATEO,2023-01-21,116,114,2,0.01724
TOL LERMA SAN MATEO,2023-01-22,59,52,7,0.11864
TOL LERMA SAN MATEO,2023-01-23,78,78,0,0
TOL LERMA SAN MATEO,2023-01-24,65,64,1,0.01538
TOL LERMA SAN MATEO,2023-01-25,101,101,0,0
TOL LERMA SAN MATEO,2023-01-26,98,94,4,0.04082
TOL LERMA SAN MATEO,2023-01-27,92,79,13,0.1413
TOL LERMA SAN MATEO,2023-01-28,132,118,14,0.10606
TOL LERMA SAN MATEO,2023-01-29,99,84,15,0.15152
TOL LERMA SAN MATEO,2023-01-30,107,97,10,0.09346
TOL LERMA SAN MATEO,2023-01-31,133,122,11,0.08271
TOL LERMA SAN MATEO,2023-02-02,90,83,7,0.07778
TOL LERMA SAN MATEO,2023-02-03,107,100,7,0.06542
TOL LERMA SAN MATEO,2023-02-04,97,97,0,0
TOL LERMA SAN MATEO,2023-02-05,73,70,3,0.0411
TOL LERMA SAN MATEO,2023-02-06,117,115,2,0.01709
TOL LERMA SAN MATEO,2023-02-07,150,148,2,0.01333
TOL LERMA SAN MATEO,2023-02-08,135,128,7,0.05185
TOL LERMA SAN MATEO,2023-02-09,143,141,2,0.01399
TOL LERMA SAN MATEO,2023-02-10,72,64,8,0.11111
TOL LERMA SAN MATEO,2023-02-11,90,82,8,0.08889
TOL LERMA SAN MATEO,2023-02-12,77,69,8,0.1039
TOL LERMA SAN MATEO,2023-02-13,71,71,0,0
TOL LERMA SAN MATEO,2023-02-14,123,121,2,0.01626
TOL LERMA SAN MATEO,2023-02-15,67,65,2,0.02985
TOL LERMA SAN MATEO,2023-02-16,103,95,8,0.07767
TOL LERMA SAN MATEO,2023-02-17,76,73,3,0.03947
TOL LERMA SAN MATEO,2023-02-18,94,84,10,0.10638
TOL LERMA SAN MATEO,2023-02-19,111,98,13,0.11712
TOL LERMA SAN MATEO,2023-02-20,82,80,2,0.02439
TOL LERMA SAN MATEO,2023-02-21,94,91,3,0.03191
TOL LERMA SAN MATEO,2023-02-22,77,70,7,0.09091
TOL LERMA SAN MATEO,2023-02-23,87,81,6,0.06897
TOL LERMA SAN MATEO,2023-02-24,150,140,10,0.06667
TOL LERMA SAN MATEO,2023-02-25,128,124,4,0.03125
TOL LERMA SAN MATEO,2023-02-26,97,90,7,0.07216
TOL LERMA SAN MATEO,2023-02-27,81,73,8,0.09877
TOL LERMA SAN MATEO,2023-02-28,71,70,1,0.01408
TOL LERMA SAN MATEO,2023-03-01,116,113,3,0.02586
TOL LERMA SAN MATEO,2023-03-02,147,138,9,0.06122
TOL LERMA SAN MATEO,2023-03-03,76,60,16,0.21053
TOL LERMA SAN MATEO,2023-03-04,114,97,17,0.14912
TOL LERMA SAN MATEO,2023-03-05,81,74,7,0.08642
TOL LERMA SAN MATEO,2023-03-07,138,128,10,0.07246
TOL LERMA SAN MATEO,2023-03-08,93,86,7,0.07527
TOL LERMA SAN MATEO,2023-03-09,118,100,18,0.15254
TOL LERMA SAN MATEO,2023-03-10,71,66,5,0.07042
TOL LERMA SAN MATEO,2023-03-11,78,77,1,0.01282
TOL LERMA SAN MATEO,2023-03-12,64,59,5,0.07812
TOL LERMA SAN MATEO,2023-03-13,93,88,5,0.05376
TOL LERMA SAN MATEO,2023-03-14,66,61,5,0.07576
TOL LERMA SAN MATEO,2023-03-15,50,45,5,0.1
TOL LERMA SAN MATEO,2023-03-16,95,84,11,0.11579
TOL LERMA SAN MATEO,2023-03-17,76,60,16,0.21053
TOL LERMA SAN MATEO,2023-03-18,104,96,8,0.07692
TOL LERMA SAN MATEO,2023-03-19,61,58,3,0.04918
TOL LERMA SAN MATEO,2023-03-20,95,92,3,0.03158
TOL SAN CARLOS,2023-01-01,12,12,0,0
TOL SAN CARLOS,2023-01-02,83,83,0,0
TOL SAN CARLOS,2023-01-03,126,118,8,0.06349
TOL SAN CARLOS,2023-01-04,140,117,23,0.16429
TOL SAN CARLOS,2023-01-05,129,116,13,0.10078
TOL SAN CARLOS,2023-01-06,88,81,7,0.07955
TOL SAN CARLOS,2023-01-07,78,71,7,0.08974
TOL SAN CARLOS,2023-01-08,95,93,2,0.02105
TOL SAN CARLOS,2023-01-09,85,75,10,0.11765
TOL SAN CARLOS,2023-01-10,113,92,21,0.18584
TOL SAN CARLOS,2023-01-11,108,104,4,0.03704
TOL SAN CARLOS,2023-01-12,76,76,0,0
TOL SAN CARLOS,2023-01-13,78,64,14,0.17949
TOL SAN CARLOS,2023-01-14,111,111,0,0
TOL SAN CARLOS,2023-01-15,76,71,5,0.06579
TOL SAN CARLOS,2023-01-16,76,73,3,0.03947
TOL SAN CARLOS,2023-01-17,95,95,0,0
TOL SAN CARLOS,2023-01-18,154,154,0,0
TOL SAN CARLOS,2023-01-19,98,98,0,0
TOL SAN CARLOS,2023-01-20,144,126,18,0.125
TOL SAN CARLOS,2023-01-21,235,235,0,0
TOL SAN CARLOS,2023-01-22,106,106,0,0
TOL SAN CARLOS,2023-01-23,101,101,0,0
TOL SAN CARLOS,2023-01-24,86,86,0,0
TOL SAN CARLOS,2023-01-25,157,151,6,0.03822
TOL SAN CARLOS,2023-01-26,90,86,4,0.04444
TOL SAN CARLOS,2023-01-27,148,137,11,0.07432
TOL SAN CARLOS,2023-01-28,99,99,0,0
TOL SAN CARLOS,2023-01-29,99,99,0,0
TOL SAN CARLOS,2023-01-30,111,111,0,0
TOL SAN CARLOS,2023-01-31,121,121,0,0
TOL SAN CARLOS,2023-02-02,117,111,6,0.05128
TOL SAN CARLOS,2023-02-03,116,116,0,0
TOL SAN CARLOS,2023-02-04,111,111,0,0
TOL SAN CARLOS,2023-02-05,45,45,0,0
TOL SAN CARLOS,2023-02-06,122,122,0,0
TOL SAN CARLOS,2023-02-07,88,88,0,0
TOL SAN CARLOS,2023-02-08,69,68,1,0.01449
TOL SAN CARLOS,2023-02-09,92,90,2,0.02174
TOL SAN CARLOS,2023-02-10,138,138,0,0
TOL SAN CARLOS,2023-02-11,66,65,1,0.01515
TOL SAN CARLOS,2023-02-12,59,58,1,0.01695
TOL SAN CARLOS,2023-02-13,99,99,0,0
TOL SAN CARLOS,2023-02-14,177,177,0,0
TOL SAN CARLOS,2023-02-15,139,137,2,0.01439
TOL SAN CARLOS,2023-02-16,85,85,0,0
TOL SAN CARLOS,2023-02-17,87,87,0,0
TOL SAN CARLOS,2023-02-18,239,239,0,0
TOL SAN CARLOS,2023-02-19,118,118,0,0
TOL SAN CARLOS,2023-02-20,205,199,6,0.02927
TOL SAN CARLOS,2023-02-21,96,95,1,0.01042
TOL SAN CARLOS,2023-02-22,72,72,0,0
TOL SAN CARLOS,2023-02-23,175,175,0,0
TOL SAN CARLOS,2023-02-24,249,249,0,0
TOL SAN CARLOS,2023-02-25,76,76,0,0
TOL SAN CARLOS,2023-02-26,67,65,2,0.02985
TOL SAN CARLOS,2023-02-27,127,126,1,0.00787
TOL SAN CARLOS,2023-02-28,156,153,3,0.01923
TOL SAN CARLOS,2023-03-01,134,125,9,0.06716
TOL SAN CARLOS,2023-03-02,85,85,0,0
TOL SAN CARLOS,2023-03-03,84,83,1,0.0119
TOL SAN CARLOS,2023-03-04,103,99,4,0.03883
TOL SAN CARLOS,2023-03-05,94,94,0,0
TOL SAN CARLOS,2023-03-07,101,101,0,0
TOL SAN CARLOS,2023-03-08,112,112,0,0
TOL SAN CARLOS,2023-03-09,57,57,0,0
TOL SAN CARLOS,2023-03-10,62,62,0,0
TOL SAN CARLOS,2023-03-11,81,81,0,0
TOL SAN CARLOS,2023-03-12,59,59,0,0
TOL SAN CARLOS,2023-03-13,100,98,2,0.02
TOL SAN CARLOS,2023-03-14,70,70,0,0
TOL SAN CARLOS,2023-03-15,69,67,2,0.02899
TOL SAN CARLOS,2023-03-16,40,38,2,0.05
TOL SAN CARLOS,2023-03-17,94,90,4,0.04255
TOL SAN CARLOS,2023-03-18,83,81,2,0.0241
TOL SAN CARLOS,2023-03-19,51,49,2,0.03922
TOL SAN CARLOS,2023-03-20,85,84,1,0.01176
TOL ZONA CONURBADA,2023-01-01,5,5,0,0
TOL ZONA CONURBADA,2023-01-02,62,62,0,0
TOL ZONA CONURBADA,2023-01-03,57,57,0,0
TOL ZONA CONURBADA,2023-01-04,42,42,0,0
TOL ZONA CONURBADA,2023-01-05,32,32,0,0
TOL ZONA CONURBADA,2023-01-06,41,41,0,0
TOL ZONA CONURBADA,2023-01-07,46,46,0,0
TOL ZONA CONURBADA,2023-01-08,37,37,0,0
TOL ZONA CONURBADA,2023-01-09,47,46,1,0.02128
TOL ZONA CONURBADA,2023-01-10,30,30,0,0
TOL ZONA CONURBADA,2023-01-11,32,32,0,0
TOL ZONA CONURBADA,2023-01-12,50,50,0,0
TOL ZONA CONURBADA,2023-01-13,26,26,0,0
TOL ZONA CONURBADA,2023-01-14,74,73,1,0.01351
TOL ZONA CONURBADA,2023-01-15,37,37,0,0
TOL ZONA CONURBADA,2023-01-16,56,56,0,0
TOL ZONA CONURBADA,2023-01-17,42,42,0,0
TOL ZONA CONURBADA,2023-01-18,22,22,0,0
TOL ZONA CONURBADA,2023-01-19,79,79,0,0
TOL ZONA CONURBADA,2023-01-20,63,63,0,0
TOL ZONA CONURBADA,2023-01-21,45,45,0,0
TOL ZONA CONURBADA,2023-01-22,21,21,0,0
TOL ZONA CONURBADA,2023-01-23,35,35,0,0
TOL ZONA CONURBADA,2023-01-24,40,40,0,0
TOL ZONA CONURBADA,2023-01-25,46,46,0,0
TOL ZONA CONURBADA,2023-01-26,43,43,0,0
TOL ZONA CONURBADA,2023-01-27,68,68,0,0
TOL ZONA CONURBADA,2023-01-28,67,66,1,0.01493
TOL ZONA CONURBADA,2023-01-29,15,15,0,0
TOL ZONA CONURBADA,2023-01-30,49,49,0,0
TOL ZONA CONURBADA,2023-01-31,37,37,0,0
TOL ZONA CONURBADA,2023-02-02,29,26,3,0.10345
TOL ZONA CONURBADA,2023-02-03,27,27,0,0
TOL ZONA CONURBADA,2023-02-04,45,45,0,0
TOL ZONA CONURBADA,2023-02-05,37,37,0,0
TOL ZONA CONURBADA,2023-02-06,26,26,0,0
TOL ZONA CONURBADA,2023-02-07,69,69,0,0
TOL ZONA CONURBADA,2023-02-08,30,30,0,0
TOL ZONA CONURBADA,2023-02-09,51,51,0,0
TOL ZONA CONURBADA,2023-02-10,30,30,0,0
TOL ZONA CONURBADA,2023-02-11,44,44,0,0
TOL ZONA CONURBADA,2023-02-12,43,43,0,0
TOL ZONA CONURBADA,2023-02-13,29,29,0,0
TOL ZONA CONURBADA,2023-02-14,48,48,0,0
TOL ZONA CONURBADA,2023-02-15,54,54,0,0
TOL ZONA CONURBADA,2023-02-16,18,18,0,0
TOL ZONA CONURBADA,2023-02-17,38,38,0,0
TOL ZONA CONURBADA,2023-02-18,48,48,0,0
TOL ZONA CONURBADA,2023-02-19,33,33,0,0
TOL ZONA CONURBADA,2023-02-20,42,42,0,0
TOL ZONA CONURBADA,2023-02-21,58,58,0,0
TOL ZONA CONURBADA,2023-02-22,46,46,0,0
TOL ZONA CONURBADA,2023-02-23,41,41,0,0
TOL ZONA CONURBADA,2023-02-24,38,38,0,0
TOL ZONA CONURBADA,2023-02-25,77,77,0,0
TOL ZONA CONURBADA,2023-02-26,21,21,0,0
TOL ZONA CONURBADA,2023-02-27,43,43,0,0
TOL ZONA CONURBADA,2023-02-28,40,40,0,0
TOL ZONA CONURBADA,2023-03-01,26,26,0,0
TOL ZONA CONURBADA,2023-03-02,21,21,0,0
TOL ZONA CONURBADA,2023-03-03,18,18,0,0
TOL ZONA CONURBADA,2023-03-04,34,34,0,0
TOL ZONA CONURBADA,2023-03-05,31,31,0,0
TOL ZONA CONURBADA,2023-03-07,32,32,0,0
TOL ZONA CONURBADA,2023-03-08,36,36,0,0
TOL ZONA CONURBADA,2023-03-09,29,29,0,0
TOL ZONA CONURBADA,2023-03-10,31,31,0,0
TOL ZONA CONURBADA,2023-03-11,49,49,0,0
TOL ZONA CONURBADA,2023-03-12,11,11,0,0
TOL ZONA CONURBADA,2023-03-13,33,33,0,0
TOL ZONA CONURBADA,2023-03-14,39,39,0,0
TOL ZONA CONURBADA,2023-03-15,55,55,0,0
TOL ZONA CONURBADA,2023-03-16,80,80,0,0
TOL ZONA CONURBADA,2023-03-17,112,111,1,0.00893
TOL ZONA CONURBADA,2023-03-18,163,161,2,0.01227
TOL ZONA CONURBADA,2023-03-19,94,94,0,0
TOL ZONA CONURBADA,2023-03-20,98,98,0,0
TULTEPEC,2023-01-01,8,5,3,0.375
TULTEPEC,2023-01-02,41,32,9,0.21951
TULTEPEC,2023-01-03,66,47,19,0.28788
TULTEPEC,2023-01-04,42,33,9,0.21429
TULTEPEC,2023-01-05,63,51,12,0.19048
TULTEPEC,2023-01-06,53,48,5,0.09434
TULTEPEC,2023-01-07,85,73,12,0.14118
TULTEPEC,2023-01-08,47,40,7,0.14894
TULTEPEC,2023-01-09,65,60,5,0.07692
TULTEPEC,2023-01-10,51,42,9,0.17647
TULTEPEC,2023-01-11,95,92,3,0.03158
TULTEPEC,2023-01-12,100,88,12,0.12
TULTEPEC,2023-01-13,66,66,0,0
TULTEPEC,2023-01-14,103,90,13,0.12621
TULTEPEC,2023-01-15,62,55,7,0.1129
TULTEPEC,2023-01-16,65,59,6,0.09231
TULTEPEC,2023-01-17,61,49,12,0.19672
TULTEPEC,2023-01-18,62,52,10,0.16129
TULTEPEC,2023-01-19,47,45,2,0.04255
TULTEPEC,2023-01-20,70,66,4,0.05714
TULTEPEC,2023-01-21,119,117,2,0.01681
TULTEPEC,2023-01-22,61,53,8,0.13115
TULTEPEC,2023-01-23,53,52,1,0.01887
TULTEPEC,2023-01-24,41,36,5,0.12195
TULTEPEC,2023-01-25,55,48,7,0.12727
TULTEPEC,2023-01-26,65,65,0,0
TULTEPEC,2023-01-27,72,70,2,0.02778
TULTEPEC,2023-01-28,127,104,23,0.1811
TULTEPEC,2023-01-29,62,56,6,0.09677
TULTEPEC,2023-01-30,68,66,2,0.02941
TULTEPEC,2023-01-31,70,53,17,0.24286
TULTEPEC,2023-02-02,85,80,5,0.05882
TULTEPEC,2023-02-03,45,43,2,0.04444
TULTEPEC,2023-02-04,121,115,6,0.04959
TULTEPEC,2023-02-05,91,89,2,0.02198
TULTEPEC,2023-02-06,81,65,16,0.19753
TULTEPEC,2023-02-07,129,113,16,0.12403
TULTEPEC,2023-02-08,64,53,11,0.17188
TULTEPEC,2023-02-09,77,67,10,0.12987
TULTEPEC,2023-02-10,82,75,7,0.08537
TULTEPEC,2023-02-11,113,111,2,0.0177
TULTEPEC,2023-02-12,75,74,1,0.01333
TULTEPEC,2023-02-13,58,45,13,0.22414
TULTEPEC,2023-02-14,42,37,5,0.11905
TULTEPEC,2023-02-15,57,51,6,0.10526
TULTEPEC,2023-02-16,87,81,6,0.06897
TULTEPEC,2023-02-17,46,39,7,0.15217
TULTEPEC,2023-02-18,98,81,17,0.17347
TULTEPEC,2023-02-19,66,62,4,0.06061
TULTEPEC,2023-02-20,46,46,0,0
TULTEPEC,2023-02-21,100,94,6,0.06
TULTEPEC,2023-02-22,108,97,11,0.10185
TULTEPEC,2023-02-23,104,90,14,0.13462
TULTEPEC,2023-02-24,75,70,5,0.06667
TULTEPEC,2023-02-25,86,78,8,0.09302
TULTEPEC,2023-02-26,81,76,5,0.06173
TULTEPEC,2023-02-27,62,54,8,0.12903
TULTEPEC,2023-02-28,56,52,4,0.07143
TULTEPEC,2023-03-01,73,67,6,0.08219
TULTEPEC,2023-03-02,48,43,5,0.10417
TULTEPEC,2023-03-03,111,85,26,0.23423
TULTEPEC,2023-03-04,99,86,13,0.13131
TULTEPEC,2023-03-05,77,66,11,0.14286
TULTEPEC,2023-03-07,47,47,0,0
TULTEPEC,2023-03-08,69,67,2,0.02899
TULTEPEC,2023-03-09,47,37,10,0.21277
TULTEPEC,2023-03-10,38,30,8,0.21053
TULTEPEC,2023-03-11,63,61,2,0.03175
TULTEPEC,2023-03-12,40,32,8,0.2
TULTEPEC,2023-03-13,42,38,4,0.09524
TULTEPEC,2023-03-14,40,31,9,0.225
TULTEPEC,2023-03-15,68,67,1,0.01471
TULTEPEC,2023-03-16,82,82,0,0
TULTEPEC,2023-03-17,174,172,2,0.01149
TULTEPEC,2023-03-18,104,104,0,0
TULTEPEC,2023-03-19,89,88,1,0.01124
TULTEPEC,2023-03-20,99,99,0,0
TULTITLAN,2023-01-01,4,4,0,0
TULTITLAN,2023-01-02,52,52,0,0
TULTITLAN,2023-01-03,46,46,0,0
TULTITLAN,2023-01-04,63,63,0,0
TULTITLAN,2023-01-05,59,59,0,0
TULTITLAN,2023-01-06,58,58,0,0
TULTITLAN,2023-01-07,88,88,0,0
TULTITLAN,2023-01-08,41,41,0,0
TULTITLAN,2023-01-09,57,57,0,0
TULTITLAN,2023-01-10,86,86,0,0
TULTITLAN,2023-01-11,79,79,0,0
TULTITLAN,2023-01-12,62,62,0,0
TULTITLAN,2023-01-13,54,54,0,0
TULTITLAN,2023-01-14,89,89,0,0
TULTITLAN,2023-01-15,55,55,0,0
TULTITLAN,2023-01-16,126,126,0,0
TULTITLAN,2023-01-17,168,168,0,0
TULTITLAN,2023-01-18,140,140,0,0
TULTITLAN,2023-01-19,71,71,0,0
TULTITLAN,2023-01-20,264,264,0,0
TULTITLAN,2023-01-21,168,168,0,0
TULTITLAN,2023-01-22,132,132,0,0
TULTITLAN,2023-01-23,165,165,0,0
TULTITLAN,2023-01-24,106,106,0,0
TULTITLAN,2023-01-25,141,141,0,0
TULTITLAN,2023-01-26,82,82,0,0
TULTITLAN,2023-01-27,87,87,0,0
TULTITLAN,2023-01-28,251,251,0,0
TULTITLAN,2023-01-29,114,114,0,0
TULTITLAN,2023-01-30,93,93,0,0
TULTITLAN,2023-01-31,167,167,0,0
TULTITLAN,2023-02-02,122,122,0,0
TULTITLAN,2023-02-03,151,151,0,0
TULTITLAN,2023-02-04,232,232,0,0
TULTITLAN,2023-02-05,195,195,0,0
TULTITLAN,2023-02-06,128,128,0,0
TULTITLAN,2023-02-07,146,146,0,0
TULTITLAN,2023-02-08,269,269,0,0
TULTITLAN,2023-02-09,304,304,0,0
TULTITLAN,2023-02-10,162,162,0,0
TULTITLAN,2023-02-11,358,358,0,0
TULTITLAN,2023-02-12,148,148,0,0
TULTITLAN,2023-02-13,123,123,0,0
TULTITLAN,2023-02-14,92,92,0,0
TULTITLAN,2023-02-15,119,115,4,0.03361
TULTITLAN,2023-02-16,284,284,0,0
TULTITLAN,2023-02-17,252,252,0,0
TULTITLAN,2023-02-18,228,219,9,0.03947
TULTITLAN,2023-02-19,40,40,0,0
TULTITLAN,2023-02-20,284,284,0,0
TULTITLAN,2023-02-21,67,67,0,0
TULTITLAN,2023-02-22,103,103,0,0
TULTITLAN,2023-02-23,71,71,0,0
TULTITLAN,2023-02-24,178,178,0,0
TULTITLAN,2023-02-25,128,127,1,0.00781
TULTITLAN,2023-02-26,156,156,0,0
TULTITLAN,2023-02-27,58,58,0,0
TULTITLAN,2023-02-28,122,122,0,0
TULTITLAN,2023-03-01,192,192,0,0
TULTITLAN,2023-03-02,121,121,0,0
TULTITLAN,2023-03-03,90,87,3,0.03333
TULTITLAN,2023-03-04,135,132,3,0.02222
TULTITLAN,2023-03-05,86,86,0,0
TULTITLAN,2023-03-07,96,72,24,0.25
TULTITLAN,2023-03-08,61,58,3,0.04918
TULTITLAN,2023-03-09,49,49,0,0
TULTITLAN,2023-03-10,39,37,2,0.05128
TULTITLAN,2023-03-11,64,64,0,0
TULTITLAN,2023-03-12,109,76,33,0.30275
TULTITLAN,2023-03-13,57,55,2,0.03509
TULTITLAN,2023-03-14,102,99,3,0.02941
TULTITLAN,2023-03-15,52,47,5,0.09615
TULTITLAN,2023-03-16,76,76,0,0
TULTITLAN,2023-03-17,99,91,8,0.08081
TULTITLAN,2023-03-18,92,92,0,0
TULTITLAN,2023-03-19,93,93,0,0
TULTITLAN,2023-03-20,106,106,0,0
TUXTLA,2023-01-01,7,7,0,0
TUXTLA,2023-01-02,44,43,1,0.02273
TUXTLA,2023-01-03,84,80,4,0.04762
TUXTLA,2023-01-04,58,55,3,0.05172
TUXTLA,2023-01-05,101,101,0,0
TUXTLA,2023-01-06,61,61,0,0
TUXTLA,2023-01-07,70,63,7,0.1
TUXTLA,2023-01-08,60,59,1,0.01667
TUXTLA,2023-01-09,34,34,0,0
TUXTLA,2023-01-10,74,74,0,0
TUXTLA,2023-01-11,64,61,3,0.04688
TUXTLA,2023-01-12,77,76,1,0.01299
TUXTLA,2023-01-13,41,40,1,0.02439
TUXTLA,2023-01-14,76,76,0,0
TUXTLA,2023-01-15,69,65,4,0.05797
TUXTLA,2023-01-16,73,71,2,0.0274
TUXTLA,2023-01-17,150,141,9,0.06
TUXTLA,2023-01-18,144,83,61,0.42361
TUXTLA,2023-01-19,162,112,50,0.30864
TUXTLA,2023-01-20,161,156,5,0.03106
TUXTLA,2023-01-21,129,128,1,0.00775
TUXTLA,2023-01-22,101,86,15,0.14851
TUXTLA,2023-01-23,193,193,0,0
TUXTLA,2023-01-24,141,140,1,0.00709
TUXTLA,2023-01-25,173,173,0,0
TUXTLA,2023-01-26,138,129,9,0.06522
TUXTLA,2023-01-27,185,183,2,0.01081
TUXTLA,2023-01-28,164,156,8,0.04878
TUXTLA,2023-01-29,144,128,16,0.11111
TUXTLA,2023-01-30,150,148,2,0.01333
TUXTLA,2023-01-31,178,171,7,0.03933
TUXTLA,2023-02-02,181,162,19,0.10497
TUXTLA,2023-02-03,169,147,22,0.13018
TUXTLA,2023-02-04,180,168,12,0.06667
TUXTLA,2023-02-05,152,146,6,0.03947
TUXTLA,2023-02-06,132,108,24,0.18182
TUXTLA,2023-02-07,165,146,19,0.11515
TUXTLA,2023-02-08,191,160,31,0.1623
TUXTLA,2023-02-09,159,136,23,0.14465
TUXTLA,2023-02-10,167,141,26,0.15569
TUXTLA,2023-02-11,254,223,31,0.12205
TUXTLA,2023-02-12,289,278,11,0.03806
TUXTLA,2023-02-13,319,317,2,0.00627
TUXTLA,2023-02-14,372,353,19,0.05108
TUXTLA,2023-02-15,206,203,3,0.01456
TUXTLA,2023-02-16,227,219,8,0.03524
TUXTLA,2023-02-17,205,191,14,0.06829
TUXTLA,2023-02-18,167,153,14,0.08383
TUXTLA,2023-02-19,148,142,6,0.04054
TUXTLA,2023-02-20,180,167,13,0.07222
TUXTLA,2023-02-21,229,223,6,0.0262
TUXTLA,2023-02-22,242,221,21,0.08678
TUXTLA,2023-02-23,136,87,49,0.36029
TUXTLA,2023-02-24,198,175,23,0.11616
TUXTLA,2023-02-25,153,136,17,0.11111
TUXTLA,2023-02-26,191,151,40,0.20942
TUXTLA,2023-02-27,204,183,21,0.10294
TUXTLA,2023-02-28,109,75,34,0.31193
TUXTLA,2023-03-01,128,128,0,0
TUXTLA,2023-03-02,188,131,57,0.30319
TUXTLA,2023-03-03,140,110,30,0.21429
TUXTLA,2023-03-04,159,139,20,0.12579
TUXTLA,2023-03-05,164,159,5,0.03049
TUXTLA,2023-03-07,84,70,14,0.16667
TUXTLA,2023-03-08,90,80,10,0.11111
TUXTLA,2023-03-09,74,69,5,0.06757
TUXTLA,2023-03-10,65,65,0,0
TUXTLA,2023-03-11,58,44,14,0.24138
TUXTLA,2023-03-12,116,75,41,0.35345
TUXTLA,2023-03-13,60,55,5,0.08333
TUXTLA,2023-03-14,82,67,15,0.18293
TUXTLA,2023-03-15,83,81,2,0.0241
TUXTLA,2023-03-16,56,52,4,0.07143
TUXTLA,2023-03-17,76,75,1,0.01316
TUXTLA,2023-03-18,153,151,2,0.01307
TUXTLA,2023-03-19,115,114,1,0.0087
TUXTLA,2023-03-20,114,113,1,0.00877
VERACRUZ,2023-01-01,17,8,9,0.52941
VERACRUZ,2023-01-02,57,51,6,0.10526
VERACRUZ,2023-01-03,53,36,17,0.32075
VERACRUZ,2023-01-04,118,68,50,0.42373
VERACRUZ,2023-01-05,77,47,30,0.38961
VERACRUZ,2023-01-06,74,39,35,0.47297
VERACRUZ,2023-01-07,82,65,17,0.20732
VERACRUZ,2023-01-08,124,68,56,0.45161
VERACRUZ,2023-01-09,148,111,37,0.25
VERACRUZ,2023-01-10,56,38,18,0.32143
VERACRUZ,2023-01-11,117,79,38,0.32479
VERACRUZ,2023-01-12,81,74,7,0.08642
VERACRUZ,2023-01-13,229,65,164,0.71616
VERACRUZ,2023-01-14,92,69,23,0.25
VERACRUZ,2023-01-15,54,43,11,0.2037
VERACRUZ,2023-01-16,67,29,38,0.56716
VERACRUZ,2023-01-17,212,101,111,0.52358
VERACRUZ,2023-01-18,146,64,82,0.56164
VERACRUZ,2023-01-19,215,103,112,0.52093
VERACRUZ,2023-01-20,160,90,70,0.4375
VERACRUZ,2023-01-21,304,191,113,0.37171
VERACRUZ,2023-01-22,179,94,85,0.47486
VERACRUZ,2023-01-23,227,160,67,0.29515
VERACRUZ,2023-01-24,339,247,92,0.27139
VERACRUZ,2023-01-25,200,130,70,0.35
VERACRUZ,2023-01-26,178,113,65,0.36517
VERACRUZ,2023-01-27,240,148,92,0.38333
VERACRUZ,2023-01-28,97,55,42,0.43299
VERACRUZ,2023-01-29,136,71,65,0.47794
VERACRUZ,2023-01-30,175,125,50,0.28571
VERACRUZ,2023-01-31,200,163,37,0.185
VERACRUZ,2023-02-02,207,131,76,0.36715
VERACRUZ,2023-02-03,120,66,54,0.45
VERACRUZ,2023-02-04,267,153,114,0.42697
VERACRUZ,2023-02-05,192,85,107,0.55729
VERACRUZ,2023-02-06,135,64,71,0.52593
VERACRUZ,2023-02-07,127,83,44,0.34646
VERACRUZ,2023-02-08,144,131,13,0.09028
VERACRUZ,2023-02-09,246,176,70,0.28455
VERACRUZ,2023-02-10,124,86,38,0.30645
VERACRUZ,2023-02-11,307,285,22,0.07166
VERACRUZ,2023-02-12,251,194,57,0.22709
VERACRUZ,2023-02-13,238,168,70,0.29412
VERACRUZ,2023-02-14,248,183,65,0.2621
VERACRUZ,2023-02-15,357,225,132,0.36975
VERACRUZ,2023-02-16,412,309,103,0.25
VERACRUZ,2023-02-17,286,149,137,0.47902
VERACRUZ,2023-02-18,249,129,120,0.48193
VERACRUZ,2023-02-19,149,80,69,0.46309
VERACRUZ,2023-02-20,425,211,214,0.50353
VERACRUZ,2023-02-21,238,136,102,0.42857
VERACRUZ,2023-02-22,230,87,143,0.62174
VERACRUZ,2023-02-23,260,199,61,0.23462
VERACRUZ,2023-02-24,258,159,99,0.38372
VERACRUZ,2023-02-25,292,216,76,0.26027
VERACRUZ,2023-02-26,167,113,54,0.32335
VERACRUZ,2023-02-27,244,201,43,0.17623
VERACRUZ,2023-02-28,374,321,53,0.14171
VERACRUZ,2023-03-01,93,64,29,0.31183
VERACRUZ,2023-03-02,100,80,20,0.2
VERACRUZ,2023-03-03,255,104,151,0.59216
VERACRUZ,2023-03-04,192,186,6,0.03125
VERACRUZ,2023-03-05,125,112,13,0.104
VERACRUZ,2023-03-07,175,170,5,0.02857
VERACRUZ,2023-03-08,121,86,35,0.28926
VERACRUZ,2023-03-09,142,80,62,0.43662
VERACRUZ,2023-03-10,125,114,11,0.088
VERACRUZ,2023-03-11,117,96,21,0.17949
VERACRUZ,2023-03-12,64,54,10,0.15625
VERACRUZ,2023-03-13,100,86,14,0.14
VERACRUZ,2023-03-14,87,43,44,0.50575
VERACRUZ,2023-03-15,92,68,24,0.26087
VERACRUZ,2023-03-16,111,93,18,0.16216
VERACRUZ,2023-03-17,77,62,15,0.19481
VERACRUZ,2023-03-18,97,92,5,0.05155
VERACRUZ,2023-03-19,74,52,22,0.2973
VERACRUZ,2023-03-20,69,61,8,0.11594
VILLAHERMOSA,2023-01-01,19,14,5,0.26316
VILLAHERMOSA,2023-01-02,57,53,4,0.07018
VILLAHERMOSA,2023-01-03,51,50,1,0.01961
VILLAHERMOSA,2023-01-04,86,68,18,0.2093
VILLAHERMOSA,2023-01-05,34,33,1,0.02941
VILLAHERMOSA,2023-01-06,70,66,4,0.05714
VILLAHERMOSA,2023-01-07,59,46,13,0.22034
VILLAHERMOSA,2023-01-08,53,52,1,0.01887
VILLAHERMOSA,2023-01-09,70,68,2,0.02857
VILLAHERMOSA,2023-01-10,60,60,0,0
VILLAHERMOSA,2023-01-11,77,77,0,0
VILLAHERMOSA,2023-01-12,55,55,0,0
VILLAHERMOSA,2023-01-13,49,48,1,0.02041
VILLAHERMOSA,2023-01-14,54,54,0,0
VILLAHERMOSA,2023-01-15,46,46,0,0
VILLAHERMOSA,2023-01-16,101,89,12,0.11881
VILLAHERMOSA,2023-01-17,158,148,10,0.06329
VILLAHERMOSA,2023-01-18,78,77,1,0.01282
VILLAHERMOSA,2023-01-19,212,210,2,0.00943
VILLAHERMOSA,2023-01-20,82,66,16,0.19512
VILLAHERMOSA,2023-01-21,236,155,81,0.34322
VILLAHERMOSA,2023-01-22,160,139,21,0.13125
VILLAHERMOSA,2023-01-23,187,175,12,0.06417
VILLAHERMOSA,2023-01-24,143,111,32,0.22378
VILLAHERMOSA,2023-01-25,148,144,4,0.02703
VILLAHERMOSA,2023-01-26,105,85,20,0.19048
VILLAHERMOSA,2023-01-27,152,150,2,0.01316
VILLAHERMOSA,2023-01-28,130,89,41,0.31538
VILLAHERMOSA,2023-01-29,93,75,18,0.19355
VILLAHERMOSA,2023-01-30,146,91,55,0.37671
VILLAHERMOSA,2023-01-31,132,125,7,0.05303
VILLAHERMOSA,2023-02-02,146,113,33,0.22603
VILLAHERMOSA,2023-02-03,119,40,79,0.66387
VILLAHERMOSA,2023-02-04,62,40,22,0.35484
VILLAHERMOSA,2023-02-05,200,149,51,0.255
VILLAHERMOSA,2023-02-06,188,107,81,0.43085
VILLAHERMOSA,2023-02-07,166,146,20,0.12048
VILLAHERMOSA,2023-02-08,110,86,24,0.21818
VILLAHERMOSA,2023-02-09,161,95,66,0.40994
VILLAHERMOSA,2023-02-10,296,245,51,0.1723
VILLAHERMOSA,2023-02-11,284,132,152,0.53521
VILLAHERMOSA,2023-02-12,411,315,96,0.23358
VILLAHERMOSA,2023-02-13,327,319,8,0.02446
VILLAHERMOSA,2023-02-14,303,289,14,0.0462
VILLAHERMOSA,2023-02-15,287,182,105,0.36585
VILLAHERMOSA,2023-02-16,376,316,60,0.15957
VILLAHERMOSA,2023-02-17,279,206,73,0.26165
VILLAHERMOSA,2023-02-18,197,75,122,0.61929
VILLAHERMOSA,2023-02-19,289,214,75,0.25952
VILLAHERMOSA,2023-02-20,359,259,100,0.27855
VILLAHERMOSA,2023-02-21,142,117,25,0.17606
VILLAHERMOSA,2023-02-22,234,128,106,0.45299
VILLAHERMOSA,2023-02-23,113,103,10,0.0885
VILLAHERMOSA,2023-02-24,102,68,34,0.33333
VILLAHERMOSA,2023-02-25,185,174,11,0.05946
VILLAHERMOSA,2023-02-26,108,89,19,0.17593
VILLAHERMOSA,2023-02-27,209,162,47,0.22488
VILLAHERMOSA,2023-02-28,174,112,62,0.35632
VILLAHERMOSA,2023-03-01,120,26,94,0.78333
VILLAHERMOSA,2023-03-02,227,163,64,0.28194
VILLAHERMOSA,2023-03-03,93,81,12,0.12903
VILLAHERMOSA,2023-03-04,171,151,20,0.11696
VILLAHERMOSA,2023-03-05,144,118,26,0.18056
VILLAHERMOSA,2023-03-07,197,193,4,0.0203
XALAPA,2023-01-01,3,3,0,0
XALAPA,2023-01-02,33,29,4,0.12121
XALAPA,2023-01-03,33,29,4,0.12121
XALAPA,2023-01-04,64,53,11,0.17188
XALAPA,2023-01-05,59,56,3,0.05085
XALAPA,2023-01-06,51,40,11,0.21569
XALAPA,2023-01-07,49,41,8,0.16327
XALAPA,2023-01-08,35,30,5,0.14286
XALAPA,2023-01-09,52,45,7,0.13462
XALAPA,2023-01-10,36,36,0,0
XALAPA,2023-01-11,64,61,3,0.04688
XALAPA,2023-01-12,53,38,15,0.28302
XALAPA,2023-01-13,36,33,3,0.08333
XALAPA,2023-01-14,55,41,14,0.25455
XALAPA,2023-01-15,57,53,4,0.07018
XALAPA,2023-01-16,84,60,24,0.28571
XALAPA,2023-01-17,73,52,21,0.28767
XALAPA,2023-01-18,100,81,19,0.19
XALAPA,2023-01-19,126,67,59,0.46825
XALAPA,2023-01-20,138,113,25,0.18116
XALAPA,2023-01-21,123,118,5,0.04065
XALAPA,2023-01-22,42,40,2,0.04762
XALAPA,2023-01-23,115,96,19,0.16522
XALAPA,2023-01-24,110,110,0,0
XALAPA,2023-01-25,110,104,6,0.05455
XALAPA,2023-01-26,121,116,5,0.04132
XALAPA,2023-01-27,84,81,3,0.03571
XALAPA,2023-01-28,105,95,10,0.09524
XALAPA,2023-01-29,49,46,3,0.06122
XALAPA,2023-01-30,72,70,2,0.02778
XALAPA,2023-01-31,144,129,15,0.10417
XALAPA,2023-02-01,2,0,2,1
XALAPA,2023-02-02,100,96,4,0.04
XALAPA,2023-02-03,82,79,3,0.03659
XALAPA,2023-02-04,173,120,53,0.30636
XALAPA,2023-02-05,95,68,27,0.28421
XALAPA,2023-02-06,110,82,28,0.25455
XALAPA,2023-02-07,52,46,6,0.11538
XALAPA,2023-02-08,148,137,11,0.07432
XALAPA,2023-02-09,132,101,31,0.23485
XALAPA,2023-02-10,68,62,6,0.08824
XALAPA,2023-02-11,79,60,19,0.24051
XALAPA,2023-02-12,48,33,15,0.3125
XALAPA,2023-02-13,134,129,5,0.03731
XALAPA,2023-02-14,151,124,27,0.17881
XALAPA,2023-02-15,128,126,2,0.01562
XALAPA,2023-02-16,109,77,32,0.29358
XALAPA,2023-02-17,86,83,3,0.03488
XALAPA,2023-02-18,149,145,4,0.02685
XALAPA,2023-02-19,96,90,6,0.0625
XALAPA,2023-02-20,166,79,87,0.5241
XALAPA,2023-02-21,94,89,5,0.05319
XALAPA,2023-02-22,140,127,13,0.09286
XALAPA,2023-02-23,52,31,21,0.40385
XALAPA,2023-02-24,77,52,25,0.32468
XALAPA,2023-02-25,81,66,15,0.18519
XALAPA,2023-02-26,36,34,2,0.05556
XALAPA,2023-02-27,61,52,9,0.14754
XALAPA,2023-02-28,93,85,8,0.08602
XALAPA,2023-03-01,76,50,26,0.34211
XALAPA,2023-03-02,61,51,10,0.16393
XALAPA,2023-03-03,73,59,14,0.19178
XALAPA,2023-03-04,88,77,11,0.125
XALAPA,2023-03-05,29,29,0,0
XALAPA,2023-03-07,93,89,4,0.04301
XALAPA,2023-03-08,49,38,11,0.22449
XALAPA,2023-03-09,115,111,4,0.03478
XALAPA,2023-03-10,90,84,6,0.06667
XALAPA,2023-03-11,152,142,10,0.06579
XALAPA,2023-03-12,100,97,3,0.03
XALAPA,2023-03-13,139,114,25,0.17986
XALAPA,2023-03-14,46,38,8,0.17391
XALAPA,2023-03-15,85,81,4,0.04706
XALAPA,2023-03-16,88,73,15,0.17045
XALAPA,2023-03-17,65,63,2,0.03077
XALAPA,2023-03-18,163,58,105,0.64417
XALAPA,2023-03-19,56,56,0,0
XALAPA,2023-03-20,242,241,1,0.00413
XOCHIMILCO,2023-01-02,28,22,6,0.21429
XOCHIMILCO,2023-01-03,32,28,4,0.125
XOCHIMILCO,2023-01-04,32,15,17,0.53125
XOCHIMILCO,2023-01-05,15,12,3,0.2
XOCHIMILCO,2023-01-06,31,20,11,0.35484
XOCHIMILCO,2023-01-07,22,19,3,0.13636
XOCHIMILCO,2023-01-08,32,24,8,0.25
XOCHIMILCO,2023-01-09,37,30,7,0.18919
XOCHIMILCO,2023-01-10,29,23,6,0.2069
XOCHIMILCO,2023-01-11,28,17,11,0.39286
XOCHIMILCO,2023-01-12,39,36,3,0.07692
XOCHIMILCO,2023-01-13,63,18,45,0.71429
XOCHIMILCO,2023-01-14,22,13,9,0.40909
XOCHIMILCO,2023-01-15,29,24,5,0.17241
XOCHIMILCO,2023-01-16,40,18,22,0.55
XOCHIMILCO,2023-01-17,51,40,11,0.21569
XOCHIMILCO,2023-01-18,100,27,73,0.73
XOCHIMILCO,2023-01-19,90,40,50,0.55556
XOCHIMILCO,2023-01-20,113,69,44,0.38938
XOCHIMILCO,2023-01-21,85,56,29,0.34118
XOCHIMILCO,2023-01-22,133,55,78,0.58647
XOCHIMILCO,2023-01-23,162,71,91,0.56173
XOCHIMILCO,2023-01-24,176,106,70,0.39773
XOCHIMILCO,2023-01-25,94,50,44,0.46809
XOCHIMILCO,2023-01-26,163,81,82,0.50307
XOCHIMILCO,2023-01-27,107,54,53,0.49533
XOCHIMILCO,2023-01-28,81,53,28,0.34568
XOCHIMILCO,2023-01-29,57,33,24,0.42105
XOCHIMILCO,2023-01-30,220,149,71,0.32273
XOCHIMILCO,2023-01-31,168,124,44,0.2619
XOCHIMILCO,2023-02-02,193,139,54,0.27979
XOCHIMILCO,2023-02-03,207,71,136,0.657
XOCHIMILCO,2023-02-04,167,131,36,0.21557
XOCHIMILCO,2023-02-05,143,105,38,0.26573
XOCHIMILCO,2023-02-06,132,89,43,0.32576
XOCHIMILCO,2023-02-07,159,97,62,0.38994
XOCHIMILCO,2023-02-08,163,94,69,0.42331
XOCHIMILCO,2023-02-09,145,111,34,0.23448
XOCHIMILCO,2023-02-10,211,134,77,0.36493
XOCHIMILCO,2023-02-11,174,103,71,0.40805
XOCHIMILCO,2023-02-12,56,45,11,0.19643
XOCHIMILCO,2023-02-13,278,180,98,0.35252
XOCHIMILCO,2023-02-14,160,67,93,0.58125
XOCHIMILCO,2023-02-15,224,87,137,0.61161
XOCHIMILCO,2023-02-16,244,150,94,0.38525
XOCHIMILCO,2023-02-17,135,87,48,0.35556
XOCHIMILCO,2023-02-18,191,176,15,0.07853
XOCHIMILCO,2023-02-19,141,131,10,0.07092
XOCHIMILCO,2023-02-20,102,88,14,0.13725
XOCHIMILCO,2023-02-21,96,51,45,0.46875
XOCHIMILCO,2023-02-22,148,128,20,0.13514
XOCHIMILCO,2023-02-23,93,81,12,0.12903
XOCHIMILCO,2023-02-24,89,78,11,0.1236
XOCHIMILCO,2023-02-25,67,54,13,0.19403
XOCHIMILCO,2023-02-26,98,89,9,0.09184
XOCHIMILCO,2023-02-27,101,41,60,0.59406
XOCHIMILCO,2023-02-28,96,62,34,0.35417
XOCHIMILCO,2023-03-01,62,43,19,0.30645
XOCHIMILCO,2023-03-02,105,48,57,0.54286
XOCHIMILCO,2023-03-03,125,44,81,0.648
XOCHIMILCO,2023-03-04,75,18,57,0.76
XOCHIMILCO,2023-03-05,125,72,53,0.424
XOCHIMILCO,2023-03-07,113,68,45,0.39823
XOCHIMILCO,2023-03-08,91,74,17,0.18681
XOCHIMILCO,2023-03-09,119,14,105,0.88235
XOCHIMILCO,2023-03-10,27,23,4,0.14815
XOCHIMILCO,2023-03-11,47,40,7,0.14894
XOCHIMILCO,2023-03-12,33,29,4,0.12121
XOCHIMILCO,2023-03-13,73,67,6,0.08219
XOCHIMILCO,2023-03-14,77,48,29,0.37662
XOCHIMILCO,2023-03-15,46,21,25,0.54348
XOCHIMILCO,2023-03-16,87,77,10,0.11494
XOCHIMILCO,2023-03-17,48,27,21,0.4375
XOCHIMILCO,2023-03-18,78,55,23,0.29487
XOCHIMILCO,2023-03-19,67,37,30,0.44776
XOCHIMILCO,2023-03-20,71,61,10,0.14085