DIRECCION,Fecha,Instalaciones,Activaciones_automaticas,Activaciones_manuales,PorcAM
CENTRO 1,2023-01-02,266,188,78,0.293233082706767
CENTRO 1,2023-01-03,326,229,97,0.297546012269939
CENTRO 1,2023-01-04,343,239,104,0.303206997084548
CENTRO 1,2023-01-05,358,238,120,0.335195530726257
CENTRO 1,2023-01-06,322,237,85,0.263975155279503
CENTRO 1,2023-01-07,448,316,132,0.294642857142857
CENTRO 1,2023-01-08,388,278,110,0.283505154639175
CENTRO 1,2023-01-09,348,247,101,0.290229885057471
CENTRO 1,2023-01-10,383,280,103,0.268929503916449
CENTRO 1,2023-01-11,397,268,129,0.324937027707809
CENTRO 1,2023-01-12,385,266,119,0.309090909090909
CENTRO 1,2023-01-13,376,261,115,0.305851063829787
CENTRO 1,2023-01-14,423,305,118,0.278959810874705
CENTRO 1,2023-01-15,383,263,120,0.31331592689295
CENTRO 1,2023-01-16,367,254,113,0.307901907356948
CENTRO 1,2023-01-17,357,240,117,0.327731092436975
CENTRO 1,2023-01-18,392,234,158,0.403061224489796
CENTRO 1,2023-01-19,344,214,130,0.377906976744186
CENTRO 1,2023-01-20,341,223,118,0.346041055718475
CENTRO 1,2023-01-21,409,244,165,0.403422982885086
CENTRO 1,2023-01-22,369,223,146,0.395663956639566
CENTRO 1,2023-01-23,368,234,134,0.364130434782609
CENTRO 1,2023-01-24,367,233,134,0.365122615803815
CENTRO 1,2023-01-25,375,228,147,0.392
CENTRO 1,2023-01-26,374,211,163,0.435828877005348
CENTRO 1,2023-01-27,374,211,163,0.435828877005348
CENTRO 1,2023-01-28,448,256,192,0.428571428571429
CENTRO 1,2023-01-29,409,250,159,0.388753056234719
CENTRO 1,2023-01-30,407,249,158,0.388206388206388
CENTRO 1,2023-01-31,422,252,170,0.402843601895735
CENTRO 1,2023-02-01,354,231,123,0.347457627118644
CENTRO 1,2023-02-02,392,239,153,0.39030612244898
CENTRO 1,2023-02-03,352,217,135,0.383522727272727
CENTRO 1,2023-02-04,427,242,185,0.433255269320843
CENTRO 1,2023-02-05,375,231,144,0.384
CENTRO 1,2023-02-06,413,246,167,0.404358353510896
CENTRO 1,2023-02-07,391,182,209,0.534526854219949
CENTRO 1,2023-02-08,313,157,156,0.498402555910543
CENTRO 1,2023-02-09,335,157,178,0.53134328358209
CENTRO 1,2023-02-10,338,155,183,0.541420118343195
CENTRO 1,2023-02-11,412,201,211,0.512135922330097
CENTRO 1,2023-02-12,382,185,197,0.515706806282722
CENTRO 1,2023-02-13,334,154,180,0.538922155688623
CENTRO 1,2023-02-14,324,156,168,0.518518518518518
CENTRO 1,2023-02-15,375,179,196,0.522666666666667
CENTRO 1,2023-02-16,347,168,179,0.515850144092219
CENTRO 1,2023-02-17,351,173,178,0.507122507122507
CENTRO 1,2023-02-18,445,215,230,0.51685393258427
CENTRO 1,2023-02-19,421,216,205,0.486935866983373
CENTRO 1,2023-02-20,396,210,186,0.46969696969697
CENTRO 1,2023-02-21,361,253,108,0.299168975069252
CENTRO 1,2023-02-22,320,242,78,0.24375
CENTRO 1,2023-02-23,335,273,62,0.185074626865672
CENTRO 1,2023-02-24,340,286,54,0.158823529411765
CENTRO 1,2023-02-25,451,364,87,0.19290465631929
CENTRO 1,2023-02-26,388,287,101,0.260309278350515
CENTRO 1,2023-02-27,390,302,88,0.225641025641026
CENTRO 1,2023-02-28,429,336,93,0.216783216783217
CENTRO 1,2023-03-01,323,266,57,0.176470588235294
CENTRO 1,2023-03-02,347,288,59,0.170028818443804
CENTRO 1,2023-03-03,384,329,55,0.143229166666667
CENTRO 1,2023-03-04,441,359,82,0.1859410430839
CENTRO 1,2023-03-05,400,298,102,0.255
CENTRO 1,2023-03-06,359,302,57,0.158774373259053
CENTRO 1,2023-03-07,364,310,54,0.148351648351648
CENTRO 1,2023-03-08,414,371,43,0.103864734299517
CENTRO 1,2023-03-09,405,364,41,0.101234567901235
CENTRO 1,2023-03-10,339,308,31,0.0914454277286136
CENTRO 1,2023-03-11,454,418,36,0.079295154185022
CENTRO 1,2023-03-12,365,324,41,0.112328767123288
CENTRO 1,2023-03-13,383,341,42,0.109660574412533
CENTRO 1,2023-03-14,414,374,40,0.0966183574879227
CENTRO 1,2023-03-15,400,386,14,0.035
CENTRO 1,2023-03-16,457,447,10,0.0218818380743982
CENTRO 1,2023-03-17,606,594,12,0.0198019801980198
CENTRO 1,2023-03-18,672,652,20,0.0297619047619048
CENTRO 1,2023-03-19,628,612,16,0.0254777070063694
CENTRO 1,2023-03-20,683,673,10,0.0146412884333821
CENTRO 1,2023-03-21,527,522,5,0.0094876660341556
CENTRO 1,2023-03-22,463,453,10,0.0215982721382289
CENTRO 1,2023-03-23,403,399,4,0.00992555831265509
CENTRO 1,2023-03-24,443,441,2,0.00451467268623025
CENTRO 1,2023-03-25,518,517,1,0.00193050193050193
CENTRO 1,2023-03-26,514,513,1,0.00194552529182879
CENTRO 1,2023-03-27,398,397,1,0.00251256281407035
CENTRO 1,2023-03-28,341,340,1,0.00293255131964809
CENTRO 1,2023-03-29,385,382,3,0.00779220779220779
CENTRO 1,2023-03-30,502,499,3,0.00597609561752988
CENTRO 1,2023-03-31,596,590,6,0.0100671140939597
CENTRO 1,2023-04-01,544,538,6,0.0110294117647059
CENTRO 1,2023-04-02,494,490,4,0.00809716599190283
CENTRO 1,2023-04-03,539,533,6,0.0111317254174397
CENTRO 1,2023-04-04,286,286,0,0
CENTRO 1,2023-04-05,407,407,0,0
CENTRO 1,2023-04-06,386,386,0,0
CENTRO 1,2023-04-07,354,354,0,0
CENTRO 1,2023-04-08,323,323,0,0
CENTRO 1,2023-04-09,275,275,0,0
CENTRO 1,2023-04-10,311,311,0,0
CENTRO 1,2023-04-11,340,340,0,0
CENTRO 1,2023-04-12,388,388,0,0
CENTRO 1,2023-04-13,357,357,0,0
CENTRO 1,2023-04-14,457,457,0,0
CENTRO 1,2023-04-15,575,575,0,0
CENTRO 1,2023-04-16,574,574,0,0
CENTRO 1,2023-04-17,520,520,0,0
CENTRO 1,2023-04-18,416,416,0,0
CENTRO 1,2023-04-19,386,386,0,0
CENTRO 1,2023-04-20,355,355,0,0
CENTRO 1,2023-04-21,413,413,0,0
CENTRO 1,2023-04-22,469,469,0,0
CENTRO 1,2023-04-23,434,434,0,0
CENTRO 1,2023-04-24,469,469,0,0
CENTRO 1,2023-04-25,536,536,0,0
CENTRO 1,2023-04-26,467,467,0,0
CENTRO 1,2023-04-27,351,351,0,0
CENTRO 1,2023-04-28,457,457,0,0
CENTRO 1,2023-04-29,572,572,0,0
CENTRO 1,2023-04-30,507,507,0,0
CENTRO 1,2023-05-01,479,479,0,0
CENTRO 1,2023-05-02,476,476,0,0
CENTRO 1,2023-05-03,352,352,0,0
CENTRO 1,2023-05-04,340,340,0,0
CENTRO 1,2023-05-05,429,429,0,0
CENTRO 1,2023-05-06,412,412,0,0
CENTRO 1,2023-05-07,355,355,0,0
CENTRO 1,2023-05-08,369,369,0,0
CENTRO 1,2023-05-09,351,351,0,0
CENTRO 1,2023-05-10,357,357,0,0
CENTRO 1,2023-05-11,343,343,0,0
CENTRO 1,2023-05-12,335,335,0,0
CENTRO 1,2023-05-13,534,534,0,0
CENTRO 1,2023-05-14,613,613,0,0
CENTRO 1,2023-05-15,698,698,0,0
CENTRO 1,2023-05-16,727,727,0,0
CENTRO 1,2023-05-17,561,561,0,0
CENTRO 1,2023-05-18,434,434,0,0
CENTRO 1,2023-05-19,437,437,0,0
CENTRO 1,2023-05-20,538,538,0,0
CENTRO 1,2023-05-21,469,469,0,0
CENTRO 1,2023-05-22,496,496,0,0
CENTRO 1,2023-05-23,452,452,0,0
CENTRO 1,2023-05-24,420,420,0,0
CENTRO 1,2023-05-25,420,420,0,0
CENTRO 1,2023-05-26,570,559,11,0.0192982456140351
CENTRO 1,2023-05-27,541,528,13,0.0240295748613678
CENTRO 1,2023-05-28,506,503,3,0.00592885375494071
CENTRO 1,2023-05-29,448,442,6,0.0133928571428571
CENTRO 1,2023-05-30,553,541,12,0.0216998191681736
CENTRO 1,2023-05-31,619,611,8,0.012924071082391
CENTRO 1,2023-06-01,953,933,20,0.0209863588667366
CENTRO 1,2023-06-02,531,517,14,0.0263653483992467
CENTRO 1,2023-06-03,731,721,10,0.0136798905608755
CENTRO 1,2023-06-04,818,807,11,0.0134474327628362
CENTRO 1,2023-06-05,553,541,12,0.0216998191681736
CENTRO 1,2023-06-06,454,450,4,0.00881057268722467
CENTRO 1,2023-06-07,509,495,14,0.0275049115913556
CENTRO 1,2023-06-08,475,467,8,0.0168421052631579
CENTRO 1,2023-06-09,517,508,9,0.0174081237911025
CENTRO 1,2023-06-10,675,660,15,0.0222222222222222
CENTRO 1,2023-06-11,599,589,10,0.01669449081803
CENTRO 1,2023-06-12,603,590,13,0.021558872305141
CENTRO 1,2023-06-13,562,555,7,0.0124555160142349
CENTRO 1,2023-06-14,606,596,10,0.0165016501650165
CENTRO 1,2023-06-15,572,559,13,0.0227272727272727
CENTRO 1,2023-06-16,588,578,10,0.0170068027210884
CENTRO 1,2023-06-17,727,711,16,0.0220082530949106
CENTRO 1,2023-06-18,529,520,9,0.0170132325141777
CENTRO 1,2023-06-19,613,607,6,0.00978792822185971
CENTRO 1,2023-06-20,609,601,8,0.013136288998358
CENTRO 1,2023-06-21,520,507,13,0.025
CENTRO 1,2023-06-22,504,495,9,0.0178571428571429
CENTRO 1,2023-06-23,556,541,15,0.026978417266187
CENTRO 1,2023-06-24,628,613,15,0.0238853503184713
CENTRO 1,2023-06-25,528,515,13,0.0246212121212121
CENTRO 1,2023-06-26,562,554,8,0.0142348754448399
CENTRO 1,2023-06-27,480,470,10,0.0208333333333333
CENTRO 1,2023-06-28,541,531,10,0.0184842883548983
CENTRO 1,2023-06-29,561,548,13,0.0231729055258467
CENTRO 1,2023-06-30,439,405,34,0.0774487471526196
CENTRO 1,2023-07-01,665,657,8,0.0120300751879699
CENTRO 1,2023-07-02,530,519,11,0.0207547169811321
CENTRO 1,2023-07-03,558,546,12,0.021505376344086
CENTRO 1,2023-07-04,672,656,16,0.0238095238095238
CENTRO 1,2023-07-05,731,720,11,0.0150478796169631
CENTRO 1,2023-07-06,601,584,17,0.0282861896838602
CENTRO 1,2023-07-07,763,746,17,0.0222804718217562
CENTRO 1,2023-07-08,797,776,21,0.0263488080301129
CENTRO 1,2023-07-09,697,684,13,0.0186513629842181
CENTRO 1,2023-07-10,715,700,15,0.020979020979021
CENTRO 1,2023-07-11,712,694,18,0.0252808988764045
CENTRO 1,2023-07-12,732,712,20,0.0273224043715847
CENTRO 1,2023-07-13,655,633,22,0.033587786259542
CENTRO 1,2023-07-14,733,712,21,0.0286493860845839
CENTRO 1,2023-07-15,873,858,15,0.0171821305841924
CENTRO 1,2023-07-16,733,715,18,0.0245566166439291
CENTRO 1,2023-07-17,754,735,19,0.0251989389920424
CENTRO 1,2023-07-18,787,773,14,0.0177890724269377
CENTRO 1,2023-07-19,686,662,24,0.0349854227405248
CENTRO 1,2023-07-20,791,778,13,0.0164348925410872
CENTRO 1,2023-07-21,694,683,11,0.015850144092219
CENTRO 1,2023-07-22,836,820,16,0.0191387559808612
CENTRO 1,2023-07-23,757,740,17,0.0224570673712021
CENTRO 1,2023-07-24,701,688,13,0.0185449358059914
CENTRO 1,2023-07-25,789,767,22,0.0278833967046895
CENTRO 1,2023-07-26,901,885,16,0.0177580466148724
CENTRO 1,2023-07-27,827,813,14,0.0169286577992745
CENTRO 1,2023-07-28,832,818,14,0.0168269230769231
CENTRO 1,2023-07-29,894,886,8,0.00894854586129754
CENTRO 1,2023-07-30,927,908,19,0.0204962243797195
CENTRO 1,2023-07-31,991,975,16,0.0161453077699294
CENTRO 1,2023-08-01,807,783,24,0.0297397769516729
CENTRO 1,2023-08-02,737,719,18,0.0244233378561737
CENTRO 1,2023-08-03,709,660,49,0.0691114245416079
CENTRO 1,2023-08-04,818,796,22,0.0268948655256724
CENTRO 1,2023-08-05,879,855,24,0.0273037542662116
CENTRO 1,2023-08-06,769,746,23,0.0299089726918075
CENTRO 1,2023-08-07,762,747,15,0.0196850393700787
CENTRO 1,2023-08-08,742,721,21,0.0283018867924528
CENTRO 1,2023-08-09,782,754,28,0.0358056265984655
CENTRO 1,2023-08-10,732,710,22,0.0300546448087432
CENTRO 1,2023-08-11,802,788,14,0.0174563591022444
CENTRO 1,2023-08-12,819,796,23,0.0280830280830281
CENTRO 1,2023-08-13,874,832,42,0.0480549199084668
CENTRO 1,2023-08-14,791,768,23,0.0290771175726928
CENTRO 1,2023-08-15,934,914,20,0.0214132762312634
CENTRO 1,2023-08-16,839,819,20,0.0238379022646007
CENTRO 1,2023-08-17,739,722,17,0.0230040595399188
CENTRO 1,2023-08-18,793,779,14,0.0176544766708701
CENTRO 1,2023-08-19,829,811,18,0.0217129071170084
CENTRO 1,2023-08-20,766,747,19,0.0248041775456919
CENTRO 1,2023-08-21,710,709,1,0.00140845070422535
CENTRO 1,2023-08-22,746,745,1,0.00134048257372654
CENTRO 1,2023-08-23,751,749,2,0.00266311584553928
CENTRO 1,2023-08-24,762,760,2,0.0026246719160105
CENTRO 1,2023-08-25,829,829,0,0
CENTRO 1,2023-08-26,1009,1007,2,0.00198216055500496
CENTRO 1,2023-08-27,952,951,1,0.00105042016806723
CENTRO 1,2023-08-28,894,892,2,0.00223713646532438
CENTRO 1,2023-08-29,913,911,2,0.00219058050383352
CENTRO 1,2023-08-30,862,860,2,0.00232018561484919
CENTRO 1,2023-08-31,775,768,7,0.00903225806451613
CENTRO 1,2023-09-01,736,734,2,0.00271739130434783
CENTRO 1,2023-09-02,795,792,3,0.00377358490566038
CENTRO 1,2023-09-03,743,740,3,0.00403768506056528
CENTRO 1,2023-09-04,726,725,1,0.00137741046831956
CENTRO 1,2023-09-05,704,702,2,0.00284090909090909
CENTRO 1,2023-09-06,716,715,1,0.00139664804469274
CENTRO 1,2023-09-07,793,789,4,0.00504413619167718
CENTRO 1,2023-09-08,650,649,1,0.00153846153846154
CENTRO 1,2023-09-09,804,804,0,0
CENTRO 1,2023-09-10,768,766,2,0.00260416666666667
CENTRO 1,2023-09-11,670,669,1,0.00149253731343284
CENTRO 1,2023-09-12,619,616,3,0.00484652665589661
CENTRO 1,2023-09-13,625,624,1,0.0016
CENTRO 1,2023-09-14,647,645,2,0.00309119010819165
CENTRO 1,2023-09-15,575,569,6,0.0104347826086957
CENTRO 1,2023-09-16,622,618,4,0.00643086816720257
CENTRO 1,2023-09-17,695,693,2,0.00287769784172662
CENTRO 1,2023-09-18,686,685,1,0.00145772594752187
CENTRO 1,2023-09-19,647,643,4,0.00618238021638331
CENTRO 1,2023-09-20,518,516,2,0.00386100386100386
CENTRO 1,2023-09-21,702,698,4,0.0056980056980057
CENTRO 1,2023-09-22,866,864,2,0.0023094688221709
CENTRO 1,2023-09-23,851,850,1,0.00117508813160987
CENTRO 1,2023-09-24,875,873,2,0.00228571428571429
CENTRO 1,2023-09-25,743,741,2,0.00269179004037685
CENTRO 1,2023-09-26,731,728,3,0.00410396716826265
CENTRO 1,2023-09-27,694,691,3,0.00432276657060519
CENTRO 1,2023-09-28,817,811,6,0.00734394124847001
CENTRO 1,2023-09-29,896,893,3,0.00334821428571429
CENTRO 1,2023-09-30,1088,1081,7,0.00643382352941176
CENTRO 1,2023-10-01,745,741,4,0.00536912751677852
CENTRO 1,2023-10-02,718,716,2,0.00278551532033426
CENTRO 1,2023-10-03,663,643,20,0.0301659125188537
CENTRO 1,2023-10-04,660,645,15,0.0227272727272727
CENTRO 1,2023-10-05,656,634,22,0.0335365853658537
CENTRO 1,2023-10-06,731,702,29,0.039671682626539
CENTRO 1,2023-10-07,848,823,25,0.0294811320754717
CENTRO 1,2023-10-08,764,742,22,0.0287958115183246
CENTRO 1,2023-10-09,727,704,23,0.031636863823934
CENTRO 1,2023-10-10,603,586,17,0.0281923714759536
CENTRO 1,2023-10-11,619,604,15,0.024232633279483
CENTRO 1,2023-10-12,583,568,15,0.0257289879931389
CENTRO 1,2023-10-13,675,657,18,0.0266666666666667
CENTRO 1,2023-10-14,864,845,19,0.0219907407407407
CENTRO 1,2023-10-15,862,836,26,0.0301624129930394
CENTRO 1,2023-10-16,820,802,18,0.0219512195121951
CENTRO 1,2023-10-17,762,737,25,0.0328083989501312
CENTRO 1,2023-10-18,678,655,23,0.0339233038348083
CENTRO 1,2023-10-19,709,690,19,0.0267983074753173
CENTRO 1,2023-10-20,734,718,16,0.0217983651226158
CENTRO 1,2023-10-21,916,893,23,0.0251091703056769
CENTRO 1,2023-10-22,806,777,29,0.0359801488833747
CENTRO 1,2023-10-23,785,764,21,0.0267515923566879
CENTRO 1,2023-10-24,726,702,24,0.0330578512396694
CENTRO 1,2023-10-25,626,605,21,0.0335463258785942
CENTRO 1,2023-10-26,599,582,17,0.0283806343906511
CENTRO 1,2023-10-27,650,630,20,0.0307692307692308
CENTRO 1,2023-10-28,796,777,19,0.0238693467336683
CENTRO 1,2023-10-29,756,737,19,0.0251322751322751
CENTRO 1,2023-10-30,729,692,37,0.0507544581618656
CENTRO 1,2023-10-31,958,931,27,0.0281837160751566
CENTRO 1,2023-11-01,725,700,25,0.0344827586206897
CENTRO 1,2023-11-02,676,659,17,0.0251479289940828
CENTRO 1,2023-11-03,650,629,21,0.0323076923076923
CENTRO 1,2023-11-04,898,876,22,0.0244988864142539
CENTRO 1,2023-11-05,937,905,32,0.0341515474919957
CENTRO 1,2023-11-06,897,875,22,0.0245261984392419
CENTRO 1,2023-11-07,929,901,28,0.0301399354144241
CENTRO 1,2023-11-08,875,852,23,0.0262857142857143
CENTRO 1,2023-11-09,786,760,26,0.0330788804071247
CENTRO 1,2023-11-10,807,793,14,0.0173482032218092
CENTRO 1,2023-11-11,1003,981,22,0.0219341974077767
CENTRO 1,2023-11-12,893,875,18,0.0201567749160134
CENTRO 1,2023-11-13,902,859,43,0.0476718403547672
CENTRO 1,2023-11-14,935,906,29,0.0310160427807487
CENTRO 1,2023-11-15,985,961,24,0.0243654822335025
CENTRO 1,2023-11-16,1085,1055,30,0.0276497695852535
CENTRO 1,2023-11-17,1139,1121,18,0.0158033362598771
CENTRO 1,2023-11-18,1287,1252,35,0.0271950271950272
CENTRO 1,2023-11-19,1301,1267,34,0.0261337432744043
CENTRO 1,2023-11-20,1290,1263,27,0.0209302325581395
CENTRO 1,2023-11-21,1078,1050,28,0.025974025974026
CENTRO 1,2023-11-22,919,893,26,0.0282916213275299
CENTRO 1,2023-11-23,883,859,24,0.0271800679501699
CENTRO 1,2023-11-24,916,886,30,0.0327510917030568
CENTRO 1,2023-11-25,1046,1027,19,0.0181644359464627
CENTRO 1,2023-11-26,943,917,26,0.0275715800636267
CENTRO 1,2023-11-27,978,942,36,0.0368098159509202
CENTRO 1,2023-11-28,1007,982,25,0.0248262164846077
CENTRO 1,2023-11-29,998,964,34,0.0340681362725451
CENTRO 1,2023-11-30,1201,1151,50,0.0416319733555371
CENTRO 1,2023-12-01,907,867,40,0.0441014332965821
CENTRO 1,2023-12-02,1044,997,47,0.0450191570881226
CENTRO 1,2023-12-03,1039,1002,37,0.0356111645813282
CENTRO 1,2023-12-04,947,913,34,0.0359028511087645
CENTRO 1,2023-12-05,853,816,37,0.0433763188745604
CENTRO 1,2023-12-06,856,825,31,0.036214953271028
CENTRO 1,2023-12-07,901,872,29,0.0321864594894562
CENTRO 1,2023-12-08,790,773,17,0.0215189873417722
CENTRO 1,2023-12-09,996,964,32,0.0321285140562249
CENTRO 1,2023-12-10,980,945,35,0.0357142857142857
CENTRO 1,2023-12-11,841,820,21,0.0249702734839477
CENTRO 1,2023-12-12,896,873,23,0.0256696428571429
CENTRO 1,2023-12-13,804,773,31,0.0385572139303483
CENTRO 1,2023-12-14,709,685,24,0.0338504936530324
CENTRO 1,2023-12-15,945,916,29,0.0306878306878307
CENTRO 1,2023-12-16,1075,1044,31,0.0288372093023256
CENTRO 1,2023-12-17,924,888,36,0.038961038961039
CENTRO 2-ORIENTE,2023-01-02,472,315,157,0.332627118644068
CENTRO 2-ORIENTE,2023-01-03,614,408,206,0.335504885993485
CENTRO 2-ORIENTE,2023-01-04,667,461,206,0.308845577211394
CENTRO 2-ORIENTE,2023-01-05,616,423,193,0.313311688311688
CENTRO 2-ORIENTE,2023-01-06,617,438,179,0.290113452188006
CENTRO 2-ORIENTE,2023-01-07,699,501,198,0.283261802575107
CENTRO 2-ORIENTE,2023-01-08,521,379,142,0.272552783109405
CENTRO 2-ORIENTE,2023-01-09,627,423,204,0.325358851674641
CENTRO 2-ORIENTE,2023-01-10,643,423,220,0.342146189735614
CENTRO 2-ORIENTE,2023-01-11,663,429,234,0.352941176470588
CENTRO 2-ORIENTE,2023-01-12,622,392,230,0.369774919614148
CENTRO 2-ORIENTE,2023-01-13,639,400,239,0.374021909233177
CENTRO 2-ORIENTE,2023-01-14,766,471,295,0.385117493472585
CENTRO 2-ORIENTE,2023-01-15,683,422,261,0.382137628111274
CENTRO 2-ORIENTE,2023-01-16,671,259,412,0.614008941877794
CENTRO 2-ORIENTE,2023-01-17,646,246,400,0.619195046439629
CENTRO 2-ORIENTE,2023-01-18,631,281,350,0.554675118858954
CENTRO 2-ORIENTE,2023-01-19,612,336,276,0.450980392156863
CENTRO 2-ORIENTE,2023-01-20,680,374,306,0.45
CENTRO 2-ORIENTE,2023-01-21,740,379,361,0.487837837837838
CENTRO 2-ORIENTE,2023-01-22,580,317,263,0.453448275862069
CENTRO 2-ORIENTE,2023-01-23,583,311,272,0.466552315608919
CENTRO 2-ORIENTE,2023-01-24,629,310,319,0.507154213036566
CENTRO 2-ORIENTE,2023-01-25,601,332,269,0.447587354409318
CENTRO 2-ORIENTE,2023-01-26,625,315,310,0.496
CENTRO 2-ORIENTE,2023-01-27,601,327,274,0.455906821963394
CENTRO 2-ORIENTE,2023-01-28,715,353,362,0.506293706293706
CENTRO 2-ORIENTE,2023-01-29,560,291,269,0.480357142857143
CENTRO 2-ORIENTE,2023-01-30,658,329,329,0.5
CENTRO 2-ORIENTE,2023-01-31,740,395,345,0.466216216216216
CENTRO 2-ORIENTE,2023-02-01,696,352,344,0.494252873563218
CENTRO 2-ORIENTE,2023-02-02,636,344,292,0.459119496855346
CENTRO 2-ORIENTE,2023-02-03,651,323,328,0.50384024577573
CENTRO 2-ORIENTE,2023-02-04,836,446,390,0.466507177033493
CENTRO 2-ORIENTE,2023-02-05,562,290,272,0.483985765124555
CENTRO 2-ORIENTE,2023-02-06,638,325,313,0.490595611285266
CENTRO 2-ORIENTE,2023-02-07,634,339,295,0.465299684542587
CENTRO 2-ORIENTE,2023-02-08,649,340,311,0.479198767334361
CENTRO 2-ORIENTE,2023-02-09,620,341,279,0.45
CENTRO 2-ORIENTE,2023-02-10,630,322,309,0.49047619047619
CENTRO 2-ORIENTE,2023-02-11,687,346,341,0.496360989810771
CENTRO 2-ORIENTE,2023-02-12,497,244,253,0.509054325955734
CENTRO 2-ORIENTE,2023-02-13,594,308,286,0.481481481481481
CENTRO 2-ORIENTE,2023-02-14,566,292,274,0.484098939929329
CENTRO 2-ORIENTE,2023-02-15,629,334,295,0.468998410174881
CENTRO 2-ORIENTE,2023-02-16,650,347,303,0.466153846153846
CENTRO 2-ORIENTE,2023-02-17,599,315,284,0.474123539232053
CENTRO 2-ORIENTE,2023-02-18,762,403,359,0.471128608923885
CENTRO 2-ORIENTE,2023-02-19,536,272,264,0.492537313432836
CENTRO 2-ORIENTE,2023-02-20,594,323,271,0.456228956228956
CENTRO 2-ORIENTE,2023-02-21,583,334,249,0.427101200686106
CENTRO 2-ORIENTE,2023-02-22,594,345,249,0.419191919191919
CENTRO 2-ORIENTE,2023-02-23,595,349,246,0.41344537815126
CENTRO 2-ORIENTE,2023-02-24,636,360,276,0.433962264150943
CENTRO 2-ORIENTE,2023-02-25,693,394,299,0.431457431457431
CENTRO 2-ORIENTE,2023-02-26,534,333,201,0.376404494382022
CENTRO 2-ORIENTE,2023-02-27,666,353,313,0.46996996996997
CENTRO 2-ORIENTE,2023-02-28,722,425,297,0.411357340720222
CENTRO 2-ORIENTE,2023-03-01,681,366,315,0.462555066079295
CENTRO 2-ORIENTE,2023-03-02,543,295,248,0.456721915285451
CENTRO 2-ORIENTE,2023-03-03,670,412,258,0.385074626865672
CENTRO 2-ORIENTE,2023-03-04,769,438,331,0.430429128738622
CENTRO 2-ORIENTE,2023-03-05,555,311,244,0.43963963963964
CENTRO 2-ORIENTE,2023-03-06,621,356,265,0.426731078904992
CENTRO 2-ORIENTE,2023-03-07,663,406,257,0.38763197586727
CENTRO 2-ORIENTE,2023-03-08,645,420,225,0.348837209302326
CENTRO 2-ORIENTE,2023-03-09,596,431,165,0.276845637583893
CENTRO 2-ORIENTE,2023-03-10,561,452,109,0.194295900178253
CENTRO 2-ORIENTE,2023-03-11,688,534,154,0.223837209302326
CENTRO 2-ORIENTE,2023-03-12,539,430,109,0.202226345083488
CENTRO 2-ORIENTE,2023-03-13,589,454,135,0.229202037351443
CENTRO 2-ORIENTE,2023-03-14,634,511,123,0.194006309148265
CENTRO 2-ORIENTE,2023-03-15,677,574,103,0.152141802067947
CENTRO 2-ORIENTE,2023-03-16,773,670,103,0.133247089262613
CENTRO 2-ORIENTE,2023-03-17,847,730,117,0.138134592680047
CENTRO 2-ORIENTE,2023-03-18,991,869,122,0.123107971745711
CENTRO 2-ORIENTE,2023-03-19,773,680,93,0.120310478654593
CENTRO 2-ORIENTE,2023-03-20,903,799,104,0.115171650055371
CENTRO 2-ORIENTE,2023-03-21,732,682,50,0.0683060109289618
CENTRO 2-ORIENTE,2023-03-22,662,624,38,0.0574018126888218
CENTRO 2-ORIENTE,2023-03-23,688,652,36,0.0523255813953488
CENTRO 2-ORIENTE,2023-03-24,676,635,41,0.0606508875739645
CENTRO 2-ORIENTE,2023-03-25,787,747,40,0.0508259212198221
CENTRO 2-ORIENTE,2023-03-26,656,629,27,0.0411585365853659
CENTRO 2-ORIENTE,2023-03-27,554,530,24,0.0433212996389892
CENTRO 2-ORIENTE,2023-03-28,545,518,27,0.0495412844036697
CENTRO 2-ORIENTE,2023-03-29,589,576,13,0.0220713073005093
CENTRO 2-ORIENTE,2023-03-30,737,703,34,0.0461329715061058
CENTRO 2-ORIENTE,2023-03-31,1042,988,54,0.0518234165067179
CENTRO 2-ORIENTE,2023-04-01,842,814,28,0.0332541567695962
CENTRO 2-ORIENTE,2023-04-02,533,501,32,0.0600375234521576
CENTRO 2-ORIENTE,2023-04-03,759,729,30,0.0395256916996047
CENTRO 2-ORIENTE,2023-04-04,720,688,32,0.0444444444444444
CENTRO 2-ORIENTE,2023-04-05,601,540,61,0.101497504159734
CENTRO 2-ORIENTE,2023-04-06,669,645,24,0.0358744394618834
CENTRO 2-ORIENTE,2023-04-07,489,475,14,0.0286298568507157
CENTRO 2-ORIENTE,2023-04-08,396,383,13,0.0328282828282828
CENTRO 2-ORIENTE,2023-04-09,349,336,13,0.0372492836676218
CENTRO 2-ORIENTE,2023-04-10,523,499,24,0.0458891013384321
CENTRO 2-ORIENTE,2023-04-11,587,543,44,0.0749574105621806
CENTRO 2-ORIENTE,2023-04-12,585,550,35,0.0598290598290598
CENTRO 2-ORIENTE,2023-04-13,571,543,28,0.0490367775831874
CENTRO 2-ORIENTE,2023-04-14,706,654,52,0.0736543909348442
CENTRO 2-ORIENTE,2023-04-15,968,880,88,0.0909090909090909
CENTRO 2-ORIENTE,2023-04-16,814,778,36,0.0442260442260442
CENTRO 2-ORIENTE,2023-04-17,726,692,34,0.046831955922865
CENTRO 2-ORIENTE,2023-04-18,655,602,53,0.0809160305343511
CENTRO 2-ORIENTE,2023-04-19,601,566,35,0.0582362728785358
CENTRO 2-ORIENTE,2023-04-20,599,555,44,0.0734557595993322
CENTRO 2-ORIENTE,2023-04-21,670,636,34,0.0507462686567164
CENTRO 2-ORIENTE,2023-04-22,762,726,36,0.047244094488189
CENTRO 2-ORIENTE,2023-04-23,648,610,38,0.058641975308642
CENTRO 2-ORIENTE,2023-04-24,701,662,39,0.0556348074179743
CENTRO 2-ORIENTE,2023-04-25,850,781,69,0.0811764705882353
CENTRO 2-ORIENTE,2023-04-26,685,649,36,0.0525547445255474
CENTRO 2-ORIENTE,2023-04-27,578,535,43,0.0743944636678201
CENTRO 2-ORIENTE,2023-04-28,772,710,62,0.0803108808290155
CENTRO 2-ORIENTE,2023-04-29,1014,950,64,0.0631163708086785
CENTRO 2-ORIENTE,2023-04-30,764,711,53,0.0693717277486911
CENTRO 2-ORIENTE,2023-05-01,591,544,47,0.0795262267343486
CENTRO 2-ORIENTE,2023-05-02,714,658,56,0.0784313725490196
CENTRO 2-ORIENTE,2023-05-03,607,568,39,0.0642504118616145
CENTRO 2-ORIENTE,2023-05-04,649,610,39,0.0600924499229584
CENTRO 2-ORIENTE,2023-05-05,709,665,44,0.0620592383638928
CENTRO 2-ORIENTE,2023-05-06,699,653,46,0.0658082975679542
CENTRO 2-ORIENTE,2023-05-07,508,477,31,0.0610236220472441
CENTRO 2-ORIENTE,2023-05-08,608,565,43,0.0707236842105263
CENTRO 2-ORIENTE,2023-05-09,647,606,41,0.0633693972179289
CENTRO 2-ORIENTE,2023-05-10,578,538,40,0.069204152249135
CENTRO 2-ORIENTE,2023-05-11,571,524,47,0.0823117338003503
CENTRO 2-ORIENTE,2023-05-12,616,574,42,0.0681818181818182
CENTRO 2-ORIENTE,2023-05-13,873,828,45,0.0515463917525773
CENTRO 2-ORIENTE,2023-05-14,852,801,51,0.0598591549295775
CENTRO 2-ORIENTE,2023-05-15,1028,965,63,0.061284046692607
CENTRO 2-ORIENTE,2023-05-16,1034,969,65,0.062862669245648
CENTRO 2-ORIENTE,2023-05-17,920,844,76,0.0826086956521739
CENTRO 2-ORIENTE,2023-05-18,672,635,37,0.0550595238095238
CENTRO 2-ORIENTE,2023-05-19,587,543,44,0.0749574105621806
CENTRO 2-ORIENTE,2023-05-20,829,776,53,0.0639324487334137
CENTRO 2-ORIENTE,2023-05-21,706,657,49,0.0694050991501416
CENTRO 2-ORIENTE,2023-05-22,777,728,49,0.0630630630630631
CENTRO 2-ORIENTE,2023-05-23,671,636,35,0.0521609538002981
CENTRO 2-ORIENTE,2023-05-24,673,634,39,0.0579494799405646
CENTRO 2-ORIENTE,2023-05-25,702,654,48,0.0683760683760684
CENTRO 2-ORIENTE,2023-05-26,785,734,51,0.064968152866242
CENTRO 2-ORIENTE,2023-05-27,920,857,63,0.0684782608695652
CENTRO 2-ORIENTE,2023-05-28,629,579,50,0.0794912559618442
CENTRO 2-ORIENTE,2023-05-29,814,746,68,0.0835380835380835
CENTRO 2-ORIENTE,2023-05-30,911,822,89,0.0976948408342481
CENTRO 2-ORIENTE,2023-05-31,1001,930,71,0.0709290709290709
CENTRO 2-ORIENTE,2023-06-01,1596,1521,75,0.0469924812030075
CENTRO 2-ORIENTE,2023-06-02,1086,1003,83,0.076427255985267
CENTRO 2-ORIENTE,2023-06-03,1266,1166,100,0.0789889415481833
CENTRO 2-ORIENTE,2023-06-04,1266,1166,100,0.0789889415481833
CENTRO 2-ORIENTE,2023-06-05,733,668,65,0.0886766712141883
CENTRO 2-ORIENTE,2023-06-06,694,653,41,0.0590778097982709
CENTRO 2-ORIENTE,2023-06-07,678,628,50,0.0737463126843658
CENTRO 2-ORIENTE,2023-06-08,715,662,53,0.0741258741258741
CENTRO 2-ORIENTE,2023-06-09,717,662,55,0.0767085076708508
CENTRO 2-ORIENTE,2023-06-10,850,793,57,0.0670588235294118
CENTRO 2-ORIENTE,2023-06-11,707,665,42,0.0594059405940594
CENTRO 2-ORIENTE,2023-06-12,732,685,47,0.064207650273224
CENTRO 2-ORIENTE,2023-06-13,673,627,46,0.0683506686478455
CENTRO 2-ORIENTE,2023-06-14,834,780,54,0.0647482014388489
CENTRO 2-ORIENTE,2023-06-15,847,802,45,0.0531286894923259
CENTRO 2-ORIENTE,2023-06-16,822,773,49,0.0596107055961071
CENTRO 2-ORIENTE,2023-06-17,876,825,51,0.0582191780821918
CENTRO 2-ORIENTE,2023-06-18,681,648,33,0.0484581497797357
CENTRO 2-ORIENTE,2023-06-19,820,772,48,0.0585365853658537
CENTRO 2-ORIENTE,2023-06-20,802,761,41,0.0511221945137157
CENTRO 2-ORIENTE,2023-06-21,775,730,45,0.0580645161290323
CENTRO 2-ORIENTE,2023-06-22,686,645,41,0.0597667638483965
CENTRO 2-ORIENTE,2023-06-23,741,692,49,0.0661268556005398
CENTRO 2-ORIENTE,2023-06-24,841,801,40,0.0475624256837099
CENTRO 2-ORIENTE,2023-06-25,668,640,28,0.0419161676646707
CENTRO 2-ORIENTE,2023-06-26,721,682,39,0.0540915395284327
CENTRO 2-ORIENTE,2023-06-27,759,733,26,0.0342555994729908
CENTRO 2-ORIENTE,2023-06-28,711,681,30,0.0421940928270042
CENTRO 2-ORIENTE,2023-06-29,796,750,46,0.0577889447236181
CENTRO 2-ORIENTE,2023-06-30,634,557,77,0.121451104100946
CENTRO 2-ORIENTE,2023-07-01,928,887,41,0.0441810344827586
CENTRO 2-ORIENTE,2023-07-02,528,513,15,0.0284090909090909
CENTRO 2-ORIENTE,2023-07-03,762,740,22,0.0288713910761155
CENTRO 2-ORIENTE,2023-07-04,861,826,35,0.040650406504065
CENTRO 2-ORIENTE,2023-07-05,769,733,36,0.046814044213264
CENTRO 2-ORIENTE,2023-07-06,771,733,38,0.0492866407263294
CENTRO 2-ORIENTE,2023-07-07,1007,971,36,0.0357497517378352
CENTRO 2-ORIENTE,2023-07-08,1158,1124,34,0.0293609671848014
CENTRO 2-ORIENTE,2023-07-09,850,820,30,0.0352941176470588
CENTRO 2-ORIENTE,2023-07-10,916,881,35,0.0382096069868996
CENTRO 2-ORIENTE,2023-07-11,983,941,42,0.0427263479145473
CENTRO 2-ORIENTE,2023-07-12,892,854,38,0.0426008968609865
CENTRO 2-ORIENTE,2023-07-13,860,815,45,0.0523255813953488
CENTRO 2-ORIENTE,2023-07-14,890,855,35,0.0393258426966292
CENTRO 2-ORIENTE,2023-07-15,1109,1076,33,0.0297565374211001
CENTRO 2-ORIENTE,2023-07-16,879,855,24,0.0273037542662116
CENTRO 2-ORIENTE,2023-07-17,933,898,35,0.037513397642015
CENTRO 2-ORIENTE,2023-07-18,906,877,29,0.0320088300220751
CENTRO 2-ORIENTE,2023-07-19,939,910,29,0.0308839190628328
CENTRO 2-ORIENTE,2023-07-20,1064,1021,43,0.0404135338345865
CENTRO 2-ORIENTE,2023-07-21,952,922,30,0.0315126050420168
CENTRO 2-ORIENTE,2023-07-22,1045,1015,30,0.0287081339712919
CENTRO 2-ORIENTE,2023-07-23,794,769,25,0.0314861460957179
CENTRO 2-ORIENTE,2023-07-24,956,921,35,0.0366108786610879
CENTRO 2-ORIENTE,2023-07-25,1004,973,31,0.0308764940239044
CENTRO 2-ORIENTE,2023-07-26,970,934,36,0.0371134020618557
CENTRO 2-ORIENTE,2023-07-27,1019,986,33,0.0323846908734053
CENTRO 2-ORIENTE,2023-07-28,1132,1098,34,0.0300353356890459
CENTRO 2-ORIENTE,2023-07-29,1221,1182,39,0.0319410319410319
CENTRO 2-ORIENTE,2023-07-30,980,958,22,0.0224489795918367
CENTRO 2-ORIENTE,2023-07-31,1187,1156,31,0.0261162594776748
CENTRO 2-ORIENTE,2023-08-01,1124,1075,49,0.0435943060498221
CENTRO 2-ORIENTE,2023-08-02,1069,1028,41,0.0383536014967259
CENTRO 2-ORIENTE,2023-08-03,1083,917,166,0.153277931671283
CENTRO 2-ORIENTE,2023-08-04,959,921,38,0.0396246089676747
CENTRO 2-ORIENTE,2023-08-05,1150,1108,42,0.0365217391304348
CENTRO 2-ORIENTE,2023-08-06,915,892,23,0.0251366120218579
CENTRO 2-ORIENTE,2023-08-07,1011,983,28,0.0276953511374876
CENTRO 2-ORIENTE,2023-08-08,1023,989,34,0.0332355816226784
CENTRO 2-ORIENTE,2023-08-09,1066,1022,44,0.0412757973733583
CENTRO 2-ORIENTE,2023-08-10,1032,1002,30,0.0290697674418605
CENTRO 2-ORIENTE,2023-08-11,1082,1044,38,0.0351201478743068
CENTRO 2-ORIENTE,2023-08-12,1136,1105,31,0.0272887323943662
CENTRO 2-ORIENTE,2023-08-13,925,894,31,0.0335135135135135
CENTRO 2-ORIENTE,2023-08-14,958,922,36,0.0375782881002088
CENTRO 2-ORIENTE,2023-08-15,1179,1148,31,0.0262934690415606
CENTRO 2-ORIENTE,2023-08-16,1058,1025,33,0.0311909262759924
CENTRO 2-ORIENTE,2023-08-17,1041,988,53,0.0509125840537944
CENTRO 2-ORIENTE,2023-08-18,1118,1075,43,0.0384615384615385
CENTRO 2-ORIENTE,2023-08-19,1182,1146,36,0.0304568527918782
CENTRO 2-ORIENTE,2023-08-20,876,844,32,0.0365296803652968
CENTRO 2-ORIENTE,2023-08-21,949,940,9,0.00948366701791359
CENTRO 2-ORIENTE,2023-08-22,947,944,3,0.00316789862724393
CENTRO 2-ORIENTE,2023-08-23,958,945,13,0.0135699373695198
CENTRO 2-ORIENTE,2023-08-24,1040,1022,18,0.0173076923076923
CENTRO 2-ORIENTE,2023-08-25,1116,1100,16,0.014336917562724
CENTRO 2-ORIENTE,2023-08-26,1210,1200,10,0.00826446280991736
CENTRO 2-ORIENTE,2023-08-27,989,981,8,0.00808897876643074
CENTRO 2-ORIENTE,2023-08-28,1043,1033,10,0.00958772770853308
CENTRO 2-ORIENTE,2023-08-29,1023,1011,12,0.0117302052785924
CENTRO 2-ORIENTE,2023-08-30,1053,1044,9,0.00854700854700855
CENTRO 2-ORIENTE,2023-08-31,1000,990,10,0.01
CENTRO 2-ORIENTE,2023-09-01,957,945,12,0.0125391849529781
CENTRO 2-ORIENTE,2023-09-02,1075,1069,6,0.00558139534883721
CENTRO 2-ORIENTE,2023-09-03,851,848,3,0.00352526439482961
CENTRO 2-ORIENTE,2023-09-04,928,924,4,0.00431034482758621
CENTRO 2-ORIENTE,2023-09-05,1041,1038,3,0.00288184438040346
CENTRO 2-ORIENTE,2023-09-06,926,918,8,0.00863930885529158
CENTRO 2-ORIENTE,2023-09-07,854,849,5,0.00585480093676815
CENTRO 2-ORIENTE,2023-09-08,838,830,8,0.00954653937947494
CENTRO 2-ORIENTE,2023-09-09,1093,1089,4,0.00365965233302836
CENTRO 2-ORIENTE,2023-09-10,829,827,2,0.00241254523522316
CENTRO 2-ORIENTE,2023-09-11,880,869,11,0.0125
CENTRO 2-ORIENTE,2023-09-12,984,974,10,0.0101626016260163
CENTRO 2-ORIENTE,2023-09-13,791,775,16,0.0202275600505689
CENTRO 2-ORIENTE,2023-09-14,885,871,14,0.015819209039548
CENTRO 2-ORIENTE,2023-09-15,1065,1050,15,0.0140845070422535
CENTRO 2-ORIENTE,2023-09-16,797,788,9,0.0112923462986198
CENTRO 2-ORIENTE,2023-09-17,810,801,9,0.0111111111111111
CENTRO 2-ORIENTE,2023-09-18,960,956,4,0.00416666666666667
CENTRO 2-ORIENTE,2023-09-19,945,935,10,0.0105820105820106
CENTRO 2-ORIENTE,2023-09-20,871,861,10,0.0114810562571757
CENTRO 2-ORIENTE,2023-09-21,966,948,18,0.0186335403726708
CENTRO 2-ORIENTE,2023-09-22,981,965,16,0.0163098878695209
CENTRO 2-ORIENTE,2023-09-23,1146,1135,11,0.00959860383944154
CENTRO 2-ORIENTE,2023-09-24,877,867,10,0.0114025085518814
CENTRO 2-ORIENTE,2023-09-25,955,941,14,0.0146596858638743
CENTRO 2-ORIENTE,2023-09-26,1011,1002,9,0.00890207715133531
CENTRO 2-ORIENTE,2023-09-27,895,890,5,0.00558659217877095
CENTRO 2-ORIENTE,2023-09-28,990,980,10,0.0101010101010101
CENTRO 2-ORIENTE,2023-09-29,1132,1113,19,0.0167844522968198
CENTRO 2-ORIENTE,2023-09-30,1387,1361,26,0.0187454938716655
CENTRO 2-ORIENTE,2023-10-01,850,839,11,0.0129411764705882
CENTRO 2-ORIENTE,2023-10-02,882,871,11,0.0124716553287982
CENTRO 2-ORIENTE,2023-10-03,901,876,25,0.0277469478357381
CENTRO 2-ORIENTE,2023-10-04,851,825,26,0.0305522914218566
CENTRO 2-ORIENTE,2023-10-05,826,800,26,0.0314769975786925
CENTRO 2-ORIENTE,2023-10-06,946,912,34,0.0359408033826638
CENTRO 2-ORIENTE,2023-10-07,986,967,19,0.0192697768762677
CENTRO 2-ORIENTE,2023-10-08,733,701,32,0.043656207366985
CENTRO 2-ORIENTE,2023-10-09,807,779,28,0.0346964064436183
CENTRO 2-ORIENTE,2023-10-10,794,773,21,0.026448362720403
CENTRO 2-ORIENTE,2023-10-11,832,792,40,0.0480769230769231
CENTRO 2-ORIENTE,2023-10-12,744,722,22,0.0295698924731183
CENTRO 2-ORIENTE,2023-10-13,790,759,31,0.0392405063291139
CENTRO 2-ORIENTE,2023-10-14,1073,1037,36,0.0335507921714818
CENTRO 2-ORIENTE,2023-10-15,848,832,16,0.0188679245283019
CENTRO 2-ORIENTE,2023-10-16,981,958,23,0.0234454638124363
CENTRO 2-ORIENTE,2023-10-17,888,867,21,0.0236486486486486
CENTRO 2-ORIENTE,2023-10-18,887,855,32,0.0360766629086809
CENTRO 2-ORIENTE,2023-10-19,888,860,28,0.0315315315315315
CENTRO 2-ORIENTE,2023-10-20,858,831,27,0.0314685314685315
CENTRO 2-ORIENTE,2023-10-21,1051,1023,28,0.0266412940057088
CENTRO 2-ORIENTE,2023-10-22,814,795,19,0.0233415233415233
CENTRO 2-ORIENTE,2023-10-23,875,843,32,0.0365714285714286
CENTRO 2-ORIENTE,2023-10-24,864,842,22,0.025462962962963
CENTRO 2-ORIENTE,2023-10-25,802,780,22,0.027431421446384
CENTRO 2-ORIENTE,2023-10-26,885,860,25,0.0282485875706215
CENTRO 2-ORIENTE,2023-10-27,874,849,25,0.028604118993135
CENTRO 2-ORIENTE,2023-10-28,1043,1011,32,0.0306807286673058
CENTRO 2-ORIENTE,2023-10-29,803,779,24,0.0298879202988792
CENTRO 2-ORIENTE,2023-10-30,861,839,22,0.0255516840882695
CENTRO 2-ORIENTE,2023-10-31,1078,1048,30,0.0278293135435993
CENTRO 2-ORIENTE,2023-11-01,938,910,28,0.0298507462686567
CENTRO 2-ORIENTE,2023-11-02,805,785,20,0.0248447204968944
CENTRO 2-ORIENTE,2023-11-03,839,818,21,0.0250297973778308
CENTRO 2-ORIENTE,2023-11-04,955,934,21,0.0219895287958115
CENTRO 2-ORIENTE,2023-11-05,849,831,18,0.0212014134275618
CENTRO 2-ORIENTE,2023-11-06,953,927,26,0.0272822665267576
CENTRO 2-ORIENTE,2023-11-07,967,934,33,0.0341261633919338
CENTRO 2-ORIENTE,2023-11-08,965,941,24,0.0248704663212435
CENTRO 2-ORIENTE,2023-11-09,929,905,24,0.0258342303552207
CENTRO 2-ORIENTE,2023-11-10,937,905,32,0.0341515474919957
CENTRO 2-ORIENTE,2023-11-11,1102,1074,28,0.0254083484573503
CENTRO 2-ORIENTE,2023-11-12,855,830,25,0.0292397660818713
CENTRO 2-ORIENTE,2023-11-13,926,892,34,0.0367170626349892
CENTRO 2-ORIENTE,2023-11-14,1044,1016,28,0.0268199233716475
CENTRO 2-ORIENTE,2023-11-15,1084,1057,27,0.0249077490774908
CENTRO 2-ORIENTE,2023-11-16,1035,1006,29,0.0280193236714976
CENTRO 2-ORIENTE,2023-11-17,1160,1123,37,0.0318965517241379
CENTRO 2-ORIENTE,2023-11-18,1325,1293,32,0.0241509433962264
CENTRO 2-ORIENTE,2023-11-19,985,960,25,0.0253807106598985
CENTRO 2-ORIENTE,2023-11-20,1120,1093,27,0.0241071428571429
CENTRO 2-ORIENTE,2023-11-21,1076,1046,30,0.0278810408921933
CENTRO 2-ORIENTE,2023-11-22,1017,991,26,0.0255653883972468
CENTRO 2-ORIENTE,2023-11-23,1032,1006,26,0.0251937984496124
CENTRO 2-ORIENTE,2023-11-24,991,963,28,0.0282542885973764
CENTRO 2-ORIENTE,2023-11-25,1172,1153,19,0.0162116040955631
CENTRO 2-ORIENTE,2023-11-26,891,866,25,0.0280583613916947
CENTRO 2-ORIENTE,2023-11-27,1041,1016,25,0.0240153698366955
CENTRO 2-ORIENTE,2023-11-28,1066,1035,31,0.0290806754221388
CENTRO 2-ORIENTE,2023-11-29,1059,987,72,0.0679886685552408
CENTRO 2-ORIENTE,2023-11-30,1314,1249,65,0.0494672754946728
CENTRO 2-ORIENTE,2023-12-01,1093,1051,42,0.0384263494967978
CENTRO 2-ORIENTE,2023-12-02,1133,1091,42,0.0370697263901147
CENTRO 2-ORIENTE,2023-12-03,974,931,43,0.0441478439425051
CENTRO 2-ORIENTE,2023-12-04,959,930,29,0.0302398331595412
CENTRO 2-ORIENTE,2023-12-05,1013,964,49,0.0483711747285291
CENTRO 2-ORIENTE,2023-12-06,1005,971,34,0.0338308457711443
CENTRO 2-ORIENTE,2023-12-07,952,918,34,0.0357142857142857
CENTRO 2-ORIENTE,2023-12-08,1042,1001,41,0.0393474088291747
CENTRO 2-ORIENTE,2023-12-09,1127,1093,34,0.0301685891748004
CENTRO 2-ORIENTE,2023-12-10,820,800,20,0.024390243902439
CENTRO 2-ORIENTE,2023-12-11,942,916,26,0.0276008492569002
CENTRO 2-ORIENTE,2023-12-12,1069,1027,42,0.039289055191768
CENTRO 2-ORIENTE,2023-12-13,876,854,22,0.0251141552511416
CENTRO 2-ORIENTE,2023-12-14,896,858,38,0.0424107142857143
CENTRO 2-ORIENTE,2023-12-15,962,938,24,0.0249480249480249
CENTRO 2-ORIENTE,2023-12-16,1089,1068,21,0.0192837465564738
CENTRO 2-ORIENTE,2023-12-17,892,868,24,0.0269058295964126
NORESTE-FRONTERA,2023-01-02,344,271,73,0.212209302325581
NORESTE-FRONTERA,2023-01-03,400,309,91,0.2275
NORESTE-FRONTERA,2023-01-04,426,321,105,0.246478873239437
NORESTE-FRONTERA,2023-01-05,426,351,75,0.176056338028169
NORESTE-FRONTERA,2023-01-06,454,350,104,0.229074889867841
NORESTE-FRONTERA,2023-01-07,513,404,109,0.212475633528265
NORESTE-FRONTERA,2023-01-08,293,229,64,0.218430034129693
NORESTE-FRONTERA,2023-01-09,410,323,87,0.21219512195122
NORESTE-FRONTERA,2023-01-10,422,335,87,0.206161137440758
NORESTE-FRONTERA,2023-01-11,413,339,74,0.179176755447942
NORESTE-FRONTERA,2023-01-12,378,304,74,0.195767195767196
NORESTE-FRONTERA,2023-01-13,458,375,83,0.181222707423581
NORESTE-FRONTERA,2023-01-14,482,393,89,0.184647302904564
NORESTE-FRONTERA,2023-01-15,305,249,56,0.183606557377049
NORESTE-FRONTERA,2023-01-16,408,319,89,0.218137254901961
NORESTE-FRONTERA,2023-01-17,411,333,78,0.18978102189781
NORESTE-FRONTERA,2023-01-18,378,308,70,0.185185185185185
NORESTE-FRONTERA,2023-01-19,382,309,73,0.191099476439791
NORESTE-FRONTERA,2023-01-20,430,361,69,0.16046511627907
NORESTE-FRONTERA,2023-01-21,495,403,92,0.185858585858586
NORESTE-FRONTERA,2023-01-22,259,208,51,0.196911196911197
NORESTE-FRONTERA,2023-01-23,358,287,71,0.198324022346369
NORESTE-FRONTERA,2023-01-24,386,328,58,0.150259067357513
NORESTE-FRONTERA,2023-01-25,379,305,74,0.195250659630607
NORESTE-FRONTERA,2023-01-26,359,281,78,0.217270194986072
NORESTE-FRONTERA,2023-01-27,396,326,70,0.176767676767677
NORESTE-FRONTERA,2023-01-28,538,373,165,0.306691449814126
NORESTE-FRONTERA,2023-01-29,313,233,80,0.255591054313099
NORESTE-FRONTERA,2023-01-30,395,317,78,0.19746835443038
NORESTE-FRONTERA,2023-01-31,399,334,65,0.162907268170426
NORESTE-FRONTERA,2023-02-01,344,287,57,0.165697674418605
NORESTE-FRONTERA,2023-02-02,400,318,82,0.205
NORESTE-FRONTERA,2023-02-03,418,336,82,0.196172248803828
NORESTE-FRONTERA,2023-02-04,547,447,100,0.182815356489945
NORESTE-FRONTERA,2023-02-05,338,281,57,0.168639053254438
NORESTE-FRONTERA,2023-02-06,343,296,47,0.137026239067055
NORESTE-FRONTERA,2023-02-07,402,343,59,0.146766169154229
NORESTE-FRONTERA,2023-02-08,402,335,67,0.166666666666667
NORESTE-FRONTERA,2023-02-09,422,355,67,0.158767772511848
NORESTE-FRONTERA,2023-02-10,404,338,66,0.163366336633663
NORESTE-FRONTERA,2023-02-11,479,366,113,0.235908141962422
NORESTE-FRONTERA,2023-02-12,364,296,68,0.186813186813187
NORESTE-FRONTERA,2023-02-13,375,305,70,0.186666666666667
NORESTE-FRONTERA,2023-02-14,388,321,67,0.172680412371134
NORESTE-FRONTERA,2023-02-15,426,353,73,0.171361502347418
NORESTE-FRONTERA,2023-02-16,418,351,67,0.160287081339713
NORESTE-FRONTERA,2023-02-17,455,366,89,0.195604395604396
NORESTE-FRONTERA,2023-02-18,562,457,105,0.186832740213523
NORESTE-FRONTERA,2023-02-19,343,276,67,0.19533527696793
NORESTE-FRONTERA,2023-02-20,375,306,69,0.184
NORESTE-FRONTERA,2023-02-21,376,308,68,0.180851063829787
NORESTE-FRONTERA,2023-02-22,400,321,79,0.1975
NORESTE-FRONTERA,2023-02-23,394,320,74,0.187817258883249
NORESTE-FRONTERA,2023-02-24,394,318,76,0.192893401015228
NORESTE-FRONTERA,2023-02-25,529,386,143,0.270321361058601
NORESTE-FRONTERA,2023-02-26,337,280,57,0.169139465875371
NORESTE-FRONTERA,2023-02-27,406,318,88,0.216748768472906
NORESTE-FRONTERA,2023-02-28,484,388,96,0.198347107438017
NORESTE-FRONTERA,2023-03-01,464,381,83,0.178879310344828
NORESTE-FRONTERA,2023-03-02,486,397,89,0.183127572016461
NORESTE-FRONTERA,2023-03-03,514,417,97,0.188715953307393
NORESTE-FRONTERA,2023-03-04,586,456,130,0.221843003412969
NORESTE-FRONTERA,2023-03-05,290,232,58,0.2
NORESTE-FRONTERA,2023-03-06,390,313,77,0.197435897435897
NORESTE-FRONTERA,2023-03-07,454,364,90,0.198237885462555
NORESTE-FRONTERA,2023-03-08,462,369,93,0.201298701298701
NORESTE-FRONTERA,2023-03-09,434,393,41,0.0944700460829493
NORESTE-FRONTERA,2023-03-10,490,425,65,0.13265306122449
NORESTE-FRONTERA,2023-03-11,628,541,87,0.138535031847134
NORESTE-FRONTERA,2023-03-12,411,355,56,0.13625304136253
NORESTE-FRONTERA,2023-03-13,414,373,41,0.0990338164251208
NORESTE-FRONTERA,2023-03-14,501,446,55,0.109780439121756
NORESTE-FRONTERA,2023-03-15,462,441,21,0.0454545454545455
NORESTE-FRONTERA,2023-03-16,523,504,19,0.0363288718929254
NORESTE-FRONTERA,2023-03-17,591,562,29,0.0490693739424704
NORESTE-FRONTERA,2023-03-18,753,724,29,0.0385126162018592
NORESTE-FRONTERA,2023-03-19,471,453,18,0.0382165605095541
NORESTE-FRONTERA,2023-03-20,525,499,26,0.0495238095238095
NORESTE-FRONTERA,2023-03-21,547,528,19,0.0347349177330896
NORESTE-FRONTERA,2023-03-22,538,518,20,0.0371747211895911
NORESTE-FRONTERA,2023-03-23,534,515,19,0.0355805243445693
NORESTE-FRONTERA,2023-03-24,561,538,23,0.0409982174688057
NORESTE-FRONTERA,2023-03-25,635,606,29,0.0456692913385827
NORESTE-FRONTERA,2023-03-26,399,374,25,0.06265664160401
NORESTE-FRONTERA,2023-03-27,507,488,19,0.0374753451676529
NORESTE-FRONTERA,2023-03-28,393,381,12,0.0305343511450382
NORESTE-FRONTERA,2023-03-29,499,471,28,0.0561122244488978
NORESTE-FRONTERA,2023-03-30,539,512,27,0.0500927643784787
NORESTE-FRONTERA,2023-03-31,764,742,22,0.0287958115183246
NORESTE-FRONTERA,2023-04-01,612,592,20,0.0326797385620915
NORESTE-FRONTERA,2023-04-02,350,337,13,0.0371428571428571
NORESTE-FRONTERA,2023-04-03,557,547,10,0.0179533213644524
NORESTE-FRONTERA,2023-04-04,482,478,4,0.00829875518672199
NORESTE-FRONTERA,2023-04-05,431,425,6,0.0139211136890951
NORESTE-FRONTERA,2023-04-06,487,482,5,0.0102669404517454
NORESTE-FRONTERA,2023-04-07,459,459,0,0
NORESTE-FRONTERA,2023-04-08,444,444,0,0
NORESTE-FRONTERA,2023-04-09,270,270,0,0
NORESTE-FRONTERA,2023-04-10,383,380,3,0.00783289817232376
NORESTE-FRONTERA,2023-04-11,449,449,0,0
NORESTE-FRONTERA,2023-04-12,430,427,3,0.00697674418604651
NORESTE-FRONTERA,2023-04-13,435,429,6,0.0137931034482759
NORESTE-FRONTERA,2023-04-14,550,547,3,0.00545454545454545
NORESTE-FRONTERA,2023-04-15,653,642,11,0.0168453292496172
NORESTE-FRONTERA,2023-04-16,410,407,3,0.00731707317073171
NORESTE-FRONTERA,2023-04-17,502,499,3,0.00597609561752988
NORESTE-FRONTERA,2023-04-18,496,489,7,0.0141129032258065
NORESTE-FRONTERA,2023-04-19,446,440,6,0.0134529147982063
NORESTE-FRONTERA,2023-04-20,440,431,9,0.0204545454545455
NORESTE-FRONTERA,2023-04-21,526,515,11,0.0209125475285171
NORESTE-FRONTERA,2023-04-22,571,563,8,0.0140105078809107
NORESTE-FRONTERA,2023-04-23,428,423,5,0.0116822429906542
NORESTE-FRONTERA,2023-04-24,481,472,9,0.0187110187110187
NORESTE-FRONTERA,2023-04-25,568,562,6,0.0105633802816901
NORESTE-FRONTERA,2023-04-26,536,529,7,0.0130597014925373
NORESTE-FRONTERA,2023-04-27,456,448,8,0.0175438596491228
NORESTE-FRONTERA,2023-04-28,540,529,11,0.0203703703703704
NORESTE-FRONTERA,2023-04-29,586,575,11,0.0187713310580205
NORESTE-FRONTERA,2023-04-30,461,455,6,0.0130151843817787
NORESTE-FRONTERA,2023-05-01,368,362,6,0.016304347826087
NORESTE-FRONTERA,2023-05-02,447,441,6,0.0134228187919463
NORESTE-FRONTERA,2023-05-03,427,419,8,0.0187353629976581
NORESTE-FRONTERA,2023-05-04,463,456,7,0.0151187904967603
NORESTE-FRONTERA,2023-05-05,535,529,6,0.011214953271028
NORESTE-FRONTERA,2023-05-06,534,524,10,0.0187265917602996
NORESTE-FRONTERA,2023-05-07,435,429,6,0.0137931034482759
NORESTE-FRONTERA,2023-05-08,457,444,13,0.0284463894967177
NORESTE-FRONTERA,2023-05-09,466,453,13,0.0278969957081545
NORESTE-FRONTERA,2023-05-10,429,415,14,0.0326340326340326
NORESTE-FRONTERA,2023-05-11,466,450,16,0.0343347639484979
NORESTE-FRONTERA,2023-05-12,471,454,17,0.0360934182590234
NORESTE-FRONTERA,2023-05-13,611,595,16,0.0261865793780687
NORESTE-FRONTERA,2023-05-14,572,563,9,0.0157342657342657
NORESTE-FRONTERA,2023-05-15,614,600,14,0.0228013029315961
NORESTE-FRONTERA,2023-05-16,703,686,17,0.0241820768136558
NORESTE-FRONTERA,2023-05-17,658,636,22,0.033434650455927
NORESTE-FRONTERA,2023-05-18,434,430,4,0.00921658986175115
NORESTE-FRONTERA,2023-05-19,565,545,20,0.0353982300884956
NORESTE-FRONTERA,2023-05-20,596,580,16,0.0268456375838926
NORESTE-FRONTERA,2023-05-21,519,501,18,0.0346820809248555
NORESTE-FRONTERA,2023-05-22,528,508,20,0.0378787878787879
NORESTE-FRONTERA,2023-05-23,515,508,7,0.0135922330097087
NORESTE-FRONTERA,2023-05-24,480,466,14,0.0291666666666667
NORESTE-FRONTERA,2023-05-25,495,474,21,0.0424242424242424
NORESTE-FRONTERA,2023-05-26,449,432,17,0.0378619153674833
NORESTE-FRONTERA,2023-05-27,545,512,33,0.0605504587155963
NORESTE-FRONTERA,2023-05-28,429,403,26,0.0606060606060606
NORESTE-FRONTERA,2023-05-29,504,485,19,0.0376984126984127
NORESTE-FRONTERA,2023-05-30,459,437,22,0.0479302832244009
NORESTE-FRONTERA,2023-05-31,499,477,22,0.0440881763527054
NORESTE-FRONTERA,2023-06-01,673,645,28,0.0416047548291233
NORESTE-FRONTERA,2023-06-02,739,701,38,0.0514208389715832
NORESTE-FRONTERA,2023-06-03,841,809,32,0.0380499405469679
NORESTE-FRONTERA,2023-06-04,598,575,23,0.0384615384615385
NORESTE-FRONTERA,2023-06-05,439,419,20,0.0455580865603645
NORESTE-FRONTERA,2023-06-06,475,460,15,0.0315789473684211
NORESTE-FRONTERA,2023-06-07,508,494,14,0.0275590551181102
NORESTE-FRONTERA,2023-06-08,455,436,19,0.0417582417582418
NORESTE-FRONTERA,2023-06-09,501,485,16,0.031936127744511
NORESTE-FRONTERA,2023-06-10,545,526,19,0.0348623853211009
NORESTE-FRONTERA,2023-06-11,444,429,15,0.0337837837837838
NORESTE-FRONTERA,2023-06-12,503,482,21,0.0417495029821074
NORESTE-FRONTERA,2023-06-13,478,462,16,0.0334728033472803
NORESTE-FRONTERA,2023-06-14,497,482,15,0.0301810865191147
NORESTE-FRONTERA,2023-06-15,490,469,21,0.0428571428571429
NORESTE-FRONTERA,2023-06-16,462,446,16,0.0346320346320346
NORESTE-FRONTERA,2023-06-17,517,508,9,0.0174081237911025
NORESTE-FRONTERA,2023-06-18,321,308,13,0.0404984423676012
NORESTE-FRONTERA,2023-06-19,449,435,14,0.0311804008908686
NORESTE-FRONTERA,2023-06-20,413,397,16,0.0387409200968523
NORESTE-FRONTERA,2023-06-21,438,420,18,0.0410958904109589
NORESTE-FRONTERA,2023-06-22,477,463,14,0.0293501048218029
NORESTE-FRONTERA,2023-06-23,492,469,23,0.0467479674796748
NORESTE-FRONTERA,2023-06-24,528,510,18,0.0340909090909091
NORESTE-FRONTERA,2023-06-25,420,407,13,0.030952380952381
NORESTE-FRONTERA,2023-06-26,484,470,14,0.0289256198347107
NORESTE-FRONTERA,2023-06-27,536,514,22,0.041044776119403
NORESTE-FRONTERA,2023-06-28,425,409,16,0.0376470588235294
NORESTE-FRONTERA,2023-06-29,490,474,16,0.0326530612244898
NORESTE-FRONTERA,2023-06-30,288,276,12,0.0416666666666667
NORESTE-FRONTERA,2023-07-01,489,484,5,0.0102249488752556
NORESTE-FRONTERA,2023-07-02,351,341,10,0.0284900284900285
NORESTE-FRONTERA,2023-07-03,444,433,11,0.0247747747747748
NORESTE-FRONTERA,2023-07-04,596,577,19,0.0318791946308725
NORESTE-FRONTERA,2023-07-05,388,378,10,0.0257731958762887
NORESTE-FRONTERA,2023-07-06,478,464,14,0.0292887029288703
NORESTE-FRONTERA,2023-07-07,576,565,11,0.0190972222222222
NORESTE-FRONTERA,2023-07-08,607,594,13,0.0214168039538715
NORESTE-FRONTERA,2023-07-09,523,521,2,0.00382409177820268
NORESTE-FRONTERA,2023-07-10,513,500,13,0.0253411306042885
NORESTE-FRONTERA,2023-07-11,574,559,15,0.0261324041811847
NORESTE-FRONTERA,2023-07-12,590,576,14,0.023728813559322
NORESTE-FRONTERA,2023-07-13,614,600,14,0.0228013029315961
NORESTE-FRONTERA,2023-07-14,595,582,13,0.0218487394957983
NORESTE-FRONTERA,2023-07-15,689,669,20,0.0290275761973875
NORESTE-FRONTERA,2023-07-16,437,435,2,0.0045766590389016
NORESTE-FRONTERA,2023-07-17,578,565,13,0.0224913494809689
NORESTE-FRONTERA,2023-07-18,592,585,7,0.0118243243243243
NORESTE-FRONTERA,2023-07-19,541,532,9,0.0166358595194085
NORESTE-FRONTERA,2023-07-20,598,585,13,0.0217391304347826
NORESTE-FRONTERA,2023-07-21,688,672,16,0.0232558139534884
NORESTE-FRONTERA,2023-07-22,736,723,13,0.0176630434782609
NORESTE-FRONTERA,2023-07-23,478,475,3,0.00627615062761506
NORESTE-FRONTERA,2023-07-24,538,523,15,0.0278810408921933
NORESTE-FRONTERA,2023-07-25,608,596,12,0.0197368421052632
NORESTE-FRONTERA,2023-07-26,640,627,13,0.0203125
NORESTE-FRONTERA,2023-07-27,642,633,9,0.014018691588785
NORESTE-FRONTERA,2023-07-28,688,674,14,0.0203488372093023
NORESTE-FRONTERA,2023-07-29,700,687,13,0.0185714285714286
NORESTE-FRONTERA,2023-07-30,485,479,6,0.0123711340206186
NORESTE-FRONTERA,2023-07-31,568,551,17,0.0299295774647887
NORESTE-FRONTERA,2023-08-01,563,543,20,0.0355239786856128
NORESTE-FRONTERA,2023-08-02,684,664,20,0.0292397660818713
NORESTE-FRONTERA,2023-08-03,606,519,87,0.143564356435644
NORESTE-FRONTERA,2023-08-04,607,586,21,0.0345963756177924
NORESTE-FRONTERA,2023-08-05,669,646,23,0.0343796711509716
NORESTE-FRONTERA,2023-08-06,449,433,16,0.0356347438752784
NORESTE-FRONTERA,2023-08-07,548,529,19,0.0346715328467153
NORESTE-FRONTERA,2023-08-08,558,539,19,0.0340501792114695
NORESTE-FRONTERA,2023-08-09,560,543,17,0.0303571428571429
NORESTE-FRONTERA,2023-08-10,536,517,19,0.0354477611940298
NORESTE-FRONTERA,2023-08-11,643,625,18,0.0279937791601866
NORESTE-FRONTERA,2023-08-12,586,562,24,0.0409556313993174
NORESTE-FRONTERA,2023-08-13,396,385,11,0.0277777777777778
NORESTE-FRONTERA,2023-08-14,515,500,15,0.029126213592233
NORESTE-FRONTERA,2023-08-15,620,606,14,0.0225806451612903
NORESTE-FRONTERA,2023-08-16,607,595,12,0.0197693574958814
NORESTE-FRONTERA,2023-08-17,662,637,25,0.0377643504531722
NORESTE-FRONTERA,2023-08-18,745,731,14,0.0187919463087248
NORESTE-FRONTERA,2023-08-19,844,793,51,0.0604265402843602
NORESTE-FRONTERA,2023-08-20,556,534,22,0.039568345323741
NORESTE-FRONTERA,2023-08-21,539,520,19,0.0352504638218924
NORESTE-FRONTERA,2023-08-22,548,529,19,0.0346715328467153
NORESTE-FRONTERA,2023-08-23,635,597,38,0.0598425196850394
NORESTE-FRONTERA,2023-08-24,604,570,34,0.0562913907284768
NORESTE-FRONTERA,2023-08-25,749,709,40,0.0534045393858478
NORESTE-FRONTERA,2023-08-26,856,823,33,0.0385514018691589
NORESTE-FRONTERA,2023-08-27,644,612,32,0.0496894409937888
NORESTE-FRONTERA,2023-08-28,610,583,27,0.0442622950819672
NORESTE-FRONTERA,2023-08-29,591,568,23,0.038917089678511
NORESTE-FRONTERA,2023-08-30,538,527,11,0.0204460966542751
NORESTE-FRONTERA,2023-08-31,587,577,10,0.0170357751277683
NORESTE-FRONTERA,2023-09-01,555,547,8,0.0144144144144144
NORESTE-FRONTERA,2023-09-02,607,600,7,0.0115321252059308
NORESTE-FRONTERA,2023-09-03,531,523,8,0.0150659133709981
NORESTE-FRONTERA,2023-09-04,559,554,5,0.00894454382826476
NORESTE-FRONTERA,2023-09-05,638,629,9,0.0141065830721003
NORESTE-FRONTERA,2023-09-06,629,626,3,0.00476947535771065
NORESTE-FRONTERA,2023-09-07,540,536,4,0.00740740740740741
NORESTE-FRONTERA,2023-09-08,573,568,5,0.0087260034904014
NORESTE-FRONTERA,2023-09-09,660,646,14,0.0212121212121212
NORESTE-FRONTERA,2023-09-10,485,482,3,0.00618556701030928
NORESTE-FRONTERA,2023-09-11,524,520,4,0.00763358778625954
NORESTE-FRONTERA,2023-09-12,590,581,9,0.0152542372881356
NORESTE-FRONTERA,2023-09-13,580,572,8,0.0137931034482759
NORESTE-FRONTERA,2023-09-14,477,473,4,0.00838574423480084
NORESTE-FRONTERA,2023-09-15,634,621,13,0.0205047318611987
NORESTE-FRONTERA,2023-09-16,457,452,5,0.0109409190371991
NORESTE-FRONTERA,2023-09-17,475,468,7,0.0147368421052632
NORESTE-FRONTERA,2023-09-18,541,534,7,0.0129390018484288
NORESTE-FRONTERA,2023-09-19,422,420,2,0.004739336492891
NORESTE-FRONTERA,2023-09-20,350,347,3,0.00857142857142857
NORESTE-FRONTERA,2023-09-21,359,345,14,0.0389972144846797
NORESTE-FRONTERA,2023-09-22,624,613,11,0.0176282051282051
NORESTE-FRONTERA,2023-09-23,693,681,12,0.0173160173160173
NORESTE-FRONTERA,2023-09-24,522,515,7,0.0134099616858238
NORESTE-FRONTERA,2023-09-25,570,560,10,0.0175438596491228
NORESTE-FRONTERA,2023-09-26,581,566,15,0.0258175559380379
NORESTE-FRONTERA,2023-09-27,580,567,13,0.0224137931034483
NORESTE-FRONTERA,2023-09-28,638,622,16,0.0250783699059561
NORESTE-FRONTERA,2023-09-29,641,615,26,0.0405616224648986
NORESTE-FRONTERA,2023-09-30,717,697,20,0.0278940027894003
NORESTE-FRONTERA,2023-10-01,480,462,18,0.0375
NORESTE-FRONTERA,2023-10-02,530,518,12,0.0226415094339623
NORESTE-FRONTERA,2023-10-03,425,412,13,0.0305882352941176
NORESTE-FRONTERA,2023-10-04,634,606,28,0.0441640378548896
NORESTE-FRONTERA,2023-10-05,496,478,18,0.0362903225806452
NORESTE-FRONTERA,2023-10-06,570,553,17,0.0298245614035088
NORESTE-FRONTERA,2023-10-07,651,626,25,0.0384024577572965
NORESTE-FRONTERA,2023-10-08,473,454,19,0.040169133192389
NORESTE-FRONTERA,2023-10-09,538,517,21,0.0390334572490706
NORESTE-FRONTERA,2023-10-10,473,465,8,0.0169133192389006
NORESTE-FRONTERA,2023-10-11,535,520,15,0.0280373831775701
NORESTE-FRONTERA,2023-10-12,448,432,16,0.0357142857142857
NORESTE-FRONTERA,2023-10-13,421,410,11,0.0261282660332542
NORESTE-FRONTERA,2023-10-14,571,555,16,0.0280210157618214
NORESTE-FRONTERA,2023-10-15,476,464,12,0.0252100840336134
NORESTE-FRONTERA,2023-10-16,567,553,14,0.0246913580246914
NORESTE-FRONTERA,2023-10-17,582,571,11,0.0189003436426117
NORESTE-FRONTERA,2023-10-18,640,623,17,0.0265625
NORESTE-FRONTERA,2023-10-19,588,577,11,0.0187074829931973
NORESTE-FRONTERA,2023-10-20,581,564,17,0.0292598967297762
NORESTE-FRONTERA,2023-10-21,682,667,15,0.0219941348973607
NORESTE-FRONTERA,2023-10-22,478,470,8,0.0167364016736402
NORESTE-FRONTERA,2023-10-23,544,523,21,0.0386029411764706
NORESTE-FRONTERA,2023-10-24,540,523,17,0.0314814814814815
NORESTE-FRONTERA,2023-10-25,563,550,13,0.0230905861456483
NORESTE-FRONTERA,2023-10-26,600,582,18,0.03
NORESTE-FRONTERA,2023-10-27,571,556,15,0.0262697022767075
NORESTE-FRONTERA,2023-10-28,686,674,12,0.0174927113702624
NORESTE-FRONTERA,2023-10-29,458,446,12,0.0262008733624454
NORESTE-FRONTERA,2023-10-30,459,450,9,0.0196078431372549
NORESTE-FRONTERA,2023-10-31,488,479,9,0.0184426229508197
NORESTE-FRONTERA,2023-11-01,555,541,14,0.0252252252252252
NORESTE-FRONTERA,2023-11-02,574,562,12,0.0209059233449477
NORESTE-FRONTERA,2023-11-03,641,627,14,0.0218408736349454
NORESTE-FRONTERA,2023-11-04,694,675,19,0.0273775216138329
NORESTE-FRONTERA,2023-11-05,522,511,11,0.0210727969348659
NORESTE-FRONTERA,2023-11-06,592,580,12,0.0202702702702703
NORESTE-FRONTERA,2023-11-07,634,620,14,0.0220820189274448
NORESTE-FRONTERA,2023-11-08,641,631,10,0.015600624024961
NORESTE-FRONTERA,2023-11-09,654,641,13,0.0198776758409786
NORESTE-FRONTERA,2023-11-10,615,609,6,0.00975609756097561
NORESTE-FRONTERA,2023-11-11,766,748,18,0.0234986945169713
NORESTE-FRONTERA,2023-11-12,414,404,10,0.0241545893719807
NORESTE-FRONTERA,2023-11-13,621,603,18,0.0289855072463768
NORESTE-FRONTERA,2023-11-14,679,665,14,0.0206185567010309
NORESTE-FRONTERA,2023-11-15,607,593,14,0.0230642504118616
NORESTE-FRONTERA,2023-11-16,598,576,22,0.0367892976588629
NORESTE-FRONTERA,2023-11-17,768,752,16,0.0208333333333333
NORESTE-FRONTERA,2023-11-18,878,864,14,0.0159453302961276
NORESTE-FRONTERA,2023-11-19,623,612,11,0.0176565008025682
NORESTE-FRONTERA,2023-11-20,605,591,14,0.0231404958677686
NORESTE-FRONTERA,2023-11-21,630,616,14,0.0222222222222222
NORESTE-FRONTERA,2023-11-22,614,598,16,0.0260586319218241
NORESTE-FRONTERA,2023-11-23,727,711,16,0.0220082530949106
NORESTE-FRONTERA,2023-11-24,749,730,19,0.0253671562082777
NORESTE-FRONTERA,2023-11-25,796,780,16,0.0201005025125628
NORESTE-FRONTERA,2023-11-26,745,727,18,0.0241610738255034
NORESTE-FRONTERA,2023-11-27,605,596,9,0.0148760330578512
NORESTE-FRONTERA,2023-11-28,714,706,8,0.0112044817927171
NORESTE-FRONTERA,2023-11-29,729,690,39,0.0534979423868313
NORESTE-FRONTERA,2023-11-30,752,719,33,0.0438829787234043
NORESTE-FRONTERA,2023-12-01,631,612,19,0.0301109350237718
NORESTE-FRONTERA,2023-12-02,830,802,28,0.0337349397590361
NORESTE-FRONTERA,2023-12-03,691,673,18,0.0260492040520984
NORESTE-FRONTERA,2023-12-04,662,634,28,0.0422960725075529
NORESTE-FRONTERA,2023-12-05,696,671,25,0.0359195402298851
NORESTE-FRONTERA,2023-12-06,678,651,27,0.0398230088495575
NORESTE-FRONTERA,2023-12-07,724,702,22,0.0303867403314917
NORESTE-FRONTERA,2023-12-08,800,779,21,0.02625
NORESTE-FRONTERA,2023-12-09,826,801,25,0.0302663438256659
NORESTE-FRONTERA,2023-12-10,675,649,26,0.0385185185185185
NORESTE-FRONTERA,2023-12-11,531,514,17,0.032015065913371
NORESTE-FRONTERA,2023-12-12,674,647,27,0.0400593471810089
NORESTE-FRONTERA,2023-12-13,602,589,13,0.0215946843853821
NORESTE-FRONTERA,2023-12-14,600,582,18,0.03
NORESTE-FRONTERA,2023-12-15,607,586,21,0.0345963756177924
NORESTE-FRONTERA,2023-12-16,715,693,22,0.0307692307692308
NORESTE-FRONTERA,2023-12-17,552,537,15,0.0271739130434783
NORTE-PACIFICO,2023-01-02,124,84,40,0.32258064516129
NORTE-PACIFICO,2023-01-03,140,99,41,0.292857142857143
NORTE-PACIFICO,2023-01-04,151,98,53,0.350993377483444
NORTE-PACIFICO,2023-01-05,82,54,28,0.341463414634146
NORTE-PACIFICO,2023-01-06,102,61,41,0.401960784313726
NORTE-PACIFICO,2023-01-07,177,131,46,0.259887005649718
NORTE-PACIFICO,2023-01-08,125,83,42,0.336
NORTE-PACIFICO,2023-01-09,132,95,37,0.28030303030303
NORTE-PACIFICO,2023-01-10,171,120,51,0.298245614035088
NORTE-PACIFICO,2023-01-11,145,100,45,0.310344827586207
NORTE-PACIFICO,2023-01-12,140,103,37,0.264285714285714
NORTE-PACIFICO,2023-01-13,142,100,42,0.295774647887324
NORTE-PACIFICO,2023-01-14,154,119,35,0.227272727272727
NORTE-PACIFICO,2023-01-15,127,93,34,0.267716535433071
NORTE-PACIFICO,2023-01-16,122,93,29,0.237704918032787
NORTE-PACIFICO,2023-01-17,126,92,34,0.26984126984127
NORTE-PACIFICO,2023-01-18,122,57,65,0.532786885245902
NORTE-PACIFICO,2023-01-19,149,66,83,0.557046979865772
NORTE-PACIFICO,2023-01-20,130,57,73,0.561538461538462
NORTE-PACIFICO,2023-01-21,161,66,95,0.590062111801242
NORTE-PACIFICO,2023-01-22,124,49,75,0.604838709677419
NORTE-PACIFICO,2023-01-23,131,60,71,0.541984732824427
NORTE-PACIFICO,2023-01-24,137,69,68,0.496350364963504
NORTE-PACIFICO,2023-01-25,133,67,66,0.496240601503759
NORTE-PACIFICO,2023-01-26,117,43,74,0.632478632478632
NORTE-PACIFICO,2023-01-27,151,59,92,0.609271523178808
NORTE-PACIFICO,2023-01-28,136,54,82,0.602941176470588
NORTE-PACIFICO,2023-01-29,133,61,72,0.541353383458647
NORTE-PACIFICO,2023-01-30,156,62,94,0.602564102564103
NORTE-PACIFICO,2023-01-31,165,71,94,0.56969696969697
NORTE-PACIFICO,2023-02-01,143,66,77,0.538461538461538
NORTE-PACIFICO,2023-02-02,134,71,63,0.470149253731343
NORTE-PACIFICO,2023-02-03,151,62,89,0.589403973509934
NORTE-PACIFICO,2023-02-04,165,62,103,0.624242424242424
NORTE-PACIFICO,2023-02-05,109,43,66,0.605504587155963
NORTE-PACIFICO,2023-02-06,137,59,78,0.569343065693431
NORTE-PACIFICO,2023-02-07,149,62,87,0.583892617449664
NORTE-PACIFICO,2023-02-08,141,67,74,0.524822695035461
NORTE-PACIFICO,2023-02-09,149,52,97,0.651006711409396
NORTE-PACIFICO,2023-02-10,148,62,86,0.581081081081081
NORTE-PACIFICO,2023-02-11,178,66,112,0.629213483146067
NORTE-PACIFICO,2023-02-12,94,30,64,0.680851063829787
NORTE-PACIFICO,2023-02-13,115,51,64,0.556521739130435
NORTE-PACIFICO,2023-02-14,121,41,80,0.661157024793388
NORTE-PACIFICO,2023-02-15,139,67,72,0.517985611510791
NORTE-PACIFICO,2023-02-16,137,56,81,0.591240875912409
NORTE-PACIFICO,2023-02-17,164,59,105,0.640243902439024
NORTE-PACIFICO,2023-02-18,170,63,107,0.629411764705882
NORTE-PACIFICO,2023-02-19,88,33,55,0.625
NORTE-PACIFICO,2023-02-20,128,47,81,0.6328125
NORTE-PACIFICO,2023-02-21,138,59,79,0.572463768115942
NORTE-PACIFICO,2023-02-22,141,57,84,0.595744680851064
NORTE-PACIFICO,2023-02-23,127,61,66,0.519685039370079
NORTE-PACIFICO,2023-02-24,145,70,75,0.517241379310345
NORTE-PACIFICO,2023-02-25,168,71,97,0.577380952380952
NORTE-PACIFICO,2023-02-26,109,50,59,0.541284403669725
NORTE-PACIFICO,2023-02-27,145,65,80,0.551724137931034
NORTE-PACIFICO,2023-02-28,168,72,96,0.571428571428571
NORTE-PACIFICO,2023-03-01,135,66,69,0.511111111111111
NORTE-PACIFICO,2023-03-02,144,73,71,0.493055555555556
NORTE-PACIFICO,2023-03-03,152,75,77,0.506578947368421
NORTE-PACIFICO,2023-03-04,176,77,99,0.5625
NORTE-PACIFICO,2023-03-05,112,50,62,0.553571428571429
NORTE-PACIFICO,2023-03-06,149,69,80,0.536912751677852
NORTE-PACIFICO,2023-03-07,178,75,103,0.578651685393258
NORTE-PACIFICO,2023-03-08,161,65,96,0.596273291925466
NORTE-PACIFICO,2023-03-09,145,79,66,0.455172413793103
NORTE-PACIFICO,2023-03-10,149,77,72,0.483221476510067
NORTE-PACIFICO,2023-03-11,176,88,88,0.5
NORTE-PACIFICO,2023-03-12,103,51,52,0.504854368932039
NORTE-PACIFICO,2023-03-13,129,72,57,0.441860465116279
NORTE-PACIFICO,2023-03-14,153,109,44,0.287581699346405
NORTE-PACIFICO,2023-03-15,129,118,11,0.0852713178294574
NORTE-PACIFICO,2023-03-16,141,125,16,0.113475177304965
NORTE-PACIFICO,2023-03-17,207,186,21,0.101449275362319
NORTE-PACIFICO,2023-03-18,230,199,31,0.134782608695652
NORTE-PACIFICO,2023-03-19,151,135,16,0.105960264900662
NORTE-PACIFICO,2023-03-20,163,140,23,0.141104294478528
NORTE-PACIFICO,2023-03-21,161,141,20,0.124223602484472
NORTE-PACIFICO,2023-03-22,165,150,15,0.0909090909090909
NORTE-PACIFICO,2023-03-23,152,141,11,0.0723684210526316
NORTE-PACIFICO,2023-03-24,177,159,18,0.101694915254237
NORTE-PACIFICO,2023-03-25,203,191,12,0.0591133004926108
NORTE-PACIFICO,2023-03-26,160,148,12,0.075
NORTE-PACIFICO,2023-03-27,98,93,5,0.0510204081632653
NORTE-PACIFICO,2023-03-28,136,123,13,0.0955882352941176
NORTE-PACIFICO,2023-03-29,170,155,15,0.0882352941176471
NORTE-PACIFICO,2023-03-30,188,173,15,0.0797872340425532
NORTE-PACIFICO,2023-03-31,213,196,17,0.07981220657277
NORTE-PACIFICO,2023-04-01,161,153,8,0.0496894409937888
NORTE-PACIFICO,2023-04-02,115,108,7,0.0608695652173913
NORTE-PACIFICO,2023-04-03,169,157,12,0.0710059171597633
NORTE-PACIFICO,2023-04-04,187,175,12,0.0641711229946524
NORTE-PACIFICO,2023-04-05,126,113,13,0.103174603174603
NORTE-PACIFICO,2023-04-06,134,129,5,0.0373134328358209
NORTE-PACIFICO,2023-04-07,87,82,5,0.0574712643678161
NORTE-PACIFICO,2023-04-08,84,80,4,0.0476190476190476
NORTE-PACIFICO,2023-04-09,63,58,5,0.0793650793650794
NORTE-PACIFICO,2023-04-10,118,100,18,0.152542372881356
NORTE-PACIFICO,2023-04-11,152,130,22,0.144736842105263
NORTE-PACIFICO,2023-04-12,131,117,14,0.106870229007634
NORTE-PACIFICO,2023-04-13,146,137,9,0.0616438356164384
NORTE-PACIFICO,2023-04-14,179,161,18,0.100558659217877
NORTE-PACIFICO,2023-04-15,252,230,22,0.0873015873015873
NORTE-PACIFICO,2023-04-16,197,186,11,0.0558375634517767
NORTE-PACIFICO,2023-04-17,148,137,11,0.0743243243243243
NORTE-PACIFICO,2023-04-18,159,153,6,0.0377358490566038
NORTE-PACIFICO,2023-04-19,150,138,12,0.08
NORTE-PACIFICO,2023-04-20,132,123,9,0.0681818181818182
NORTE-PACIFICO,2023-04-21,149,132,17,0.114093959731544
NORTE-PACIFICO,2023-04-22,164,150,14,0.0853658536585366
NORTE-PACIFICO,2023-04-23,126,118,8,0.0634920634920635
NORTE-PACIFICO,2023-04-24,149,145,4,0.0268456375838926
NORTE-PACIFICO,2023-04-25,201,190,11,0.054726368159204
NORTE-PACIFICO,2023-04-26,165,159,6,0.0363636363636364
NORTE-PACIFICO,2023-04-27,132,125,7,0.053030303030303
NORTE-PACIFICO,2023-04-28,186,171,15,0.0806451612903226
NORTE-PACIFICO,2023-04-29,215,198,17,0.0790697674418605
NORTE-PACIFICO,2023-04-30,154,145,9,0.0584415584415584
NORTE-PACIFICO,2023-05-01,127,118,9,0.0708661417322835
NORTE-PACIFICO,2023-05-02,144,138,6,0.0416666666666667
NORTE-PACIFICO,2023-05-03,158,154,4,0.0253164556962025
NORTE-PACIFICO,2023-05-04,157,149,8,0.0509554140127389
NORTE-PACIFICO,2023-05-05,158,146,12,0.0759493670886076
NORTE-PACIFICO,2023-05-06,158,147,11,0.069620253164557
NORTE-PACIFICO,2023-05-07,119,109,10,0.0840336134453782
NORTE-PACIFICO,2023-05-08,145,135,10,0.0689655172413793
NORTE-PACIFICO,2023-05-09,161,158,3,0.0186335403726708
NORTE-PACIFICO,2023-05-10,128,120,8,0.0625
NORTE-PACIFICO,2023-05-11,151,142,9,0.0596026490066225
NORTE-PACIFICO,2023-05-12,147,139,8,0.054421768707483
NORTE-PACIFICO,2023-05-13,206,193,13,0.0631067961165049
NORTE-PACIFICO,2023-05-14,161,148,13,0.0807453416149068
NORTE-PACIFICO,2023-05-15,202,185,17,0.0841584158415842
NORTE-PACIFICO,2023-05-16,193,183,10,0.0518134715025907
NORTE-PACIFICO,2023-05-17,152,143,9,0.0592105263157895
NORTE-PACIFICO,2023-05-18,143,140,3,0.020979020979021
NORTE-PACIFICO,2023-05-19,149,141,8,0.0536912751677852
NORTE-PACIFICO,2023-05-20,177,169,8,0.0451977401129944
NORTE-PACIFICO,2023-05-21,138,131,7,0.0507246376811594
NORTE-PACIFICO,2023-05-22,145,137,8,0.0551724137931034
NORTE-PACIFICO,2023-05-23,149,142,7,0.0469798657718121
NORTE-PACIFICO,2023-05-24,139,134,5,0.0359712230215827
NORTE-PACIFICO,2023-05-25,168,152,16,0.0952380952380952
NORTE-PACIFICO,2023-05-26,230,203,27,0.117391304347826
NORTE-PACIFICO,2023-05-27,252,227,25,0.0992063492063492
NORTE-PACIFICO,2023-05-28,139,128,11,0.079136690647482
NORTE-PACIFICO,2023-05-29,166,156,10,0.0602409638554217
NORTE-PACIFICO,2023-05-30,178,167,11,0.0617977528089888
NORTE-PACIFICO,2023-05-31,212,190,22,0.10377358490566
NORTE-PACIFICO,2023-06-01,359,345,14,0.0389972144846797
NORTE-PACIFICO,2023-06-02,230,208,22,0.0956521739130435
NORTE-PACIFICO,2023-06-03,283,259,24,0.0848056537102474
NORTE-PACIFICO,2023-06-04,285,252,33,0.115789473684211
NORTE-PACIFICO,2023-06-05,146,139,7,0.0479452054794521
NORTE-PACIFICO,2023-06-06,184,173,11,0.0597826086956522
NORTE-PACIFICO,2023-06-07,154,141,13,0.0844155844155844
NORTE-PACIFICO,2023-06-08,182,173,9,0.0494505494505494
NORTE-PACIFICO,2023-06-09,191,171,20,0.104712041884817
NORTE-PACIFICO,2023-06-10,210,196,14,0.0666666666666667
NORTE-PACIFICO,2023-06-11,151,140,11,0.0728476821192053
NORTE-PACIFICO,2023-06-12,162,154,8,0.0493827160493827
NORTE-PACIFICO,2023-06-13,195,180,15,0.0769230769230769
NORTE-PACIFICO,2023-06-14,194,185,9,0.0463917525773196
NORTE-PACIFICO,2023-06-15,210,198,12,0.0571428571428571
NORTE-PACIFICO,2023-06-16,189,173,16,0.0846560846560847
NORTE-PACIFICO,2023-06-17,238,224,14,0.0588235294117647
NORTE-PACIFICO,2023-06-18,167,156,11,0.0658682634730539
NORTE-PACIFICO,2023-06-19,213,202,11,0.0516431924882629
NORTE-PACIFICO,2023-06-20,187,178,9,0.0481283422459893
NORTE-PACIFICO,2023-06-21,222,207,15,0.0675675675675676
NORTE-PACIFICO,2023-06-22,184,168,16,0.0869565217391304
NORTE-PACIFICO,2023-06-23,186,177,9,0.0483870967741935
NORTE-PACIFICO,2023-06-24,208,197,11,0.0528846153846154
NORTE-PACIFICO,2023-06-25,154,145,9,0.0584415584415584
NORTE-PACIFICO,2023-06-26,155,148,7,0.0451612903225806
NORTE-PACIFICO,2023-06-27,211,197,14,0.0663507109004739
NORTE-PACIFICO,2023-06-28,198,194,4,0.0202020202020202
NORTE-PACIFICO,2023-06-29,178,171,7,0.0393258426966292
NORTE-PACIFICO,2023-06-30,125,109,16,0.128
NORTE-PACIFICO,2023-07-01,231,218,13,0.0562770562770563
NORTE-PACIFICO,2023-07-02,192,187,5,0.0260416666666667
NORTE-PACIFICO,2023-07-03,134,129,5,0.0373134328358209
NORTE-PACIFICO,2023-07-04,391,383,8,0.020460358056266
NORTE-PACIFICO,2023-07-05,297,287,10,0.0336700336700337
NORTE-PACIFICO,2023-07-06,292,281,11,0.0376712328767123
NORTE-PACIFICO,2023-07-07,288,286,2,0.00694444444444444
NORTE-PACIFICO,2023-07-08,465,458,7,0.0150537634408602
NORTE-PACIFICO,2023-07-09,419,414,5,0.0119331742243437
NORTE-PACIFICO,2023-07-10,462,442,20,0.0432900432900433
NORTE-PACIFICO,2023-07-11,377,366,11,0.0291777188328912
NORTE-PACIFICO,2023-07-12,443,428,15,0.0338600451467269
NORTE-PACIFICO,2023-07-13,381,369,12,0.031496062992126
NORTE-PACIFICO,2023-07-14,396,380,16,0.0404040404040404
NORTE-PACIFICO,2023-07-15,436,421,15,0.0344036697247706
NORTE-PACIFICO,2023-07-16,302,289,13,0.043046357615894
NORTE-PACIFICO,2023-07-17,429,418,11,0.0256410256410256
NORTE-PACIFICO,2023-07-18,413,401,12,0.0290556900726392
NORTE-PACIFICO,2023-07-19,428,411,17,0.0397196261682243
NORTE-PACIFICO,2023-07-20,491,481,10,0.0203665987780041
NORTE-PACIFICO,2023-07-21,484,473,11,0.0227272727272727
NORTE-PACIFICO,2023-07-22,522,509,13,0.024904214559387
NORTE-PACIFICO,2023-07-23,342,328,14,0.0409356725146199
NORTE-PACIFICO,2023-07-24,428,420,8,0.0186915887850467
NORTE-PACIFICO,2023-07-25,482,471,11,0.0228215767634855
NORTE-PACIFICO,2023-07-26,452,436,16,0.0353982300884956
NORTE-PACIFICO,2023-07-27,456,451,5,0.0109649122807018
NORTE-PACIFICO,2023-07-28,520,508,12,0.0230769230769231
NORTE-PACIFICO,2023-07-29,539,527,12,0.0222634508348794
NORTE-PACIFICO,2023-07-30,380,372,8,0.0210526315789474
NORTE-PACIFICO,2023-07-31,446,432,14,0.031390134529148
NORTE-PACIFICO,2023-08-01,471,452,19,0.0403397027600849
NORTE-PACIFICO,2023-08-02,460,438,22,0.0478260869565217
NORTE-PACIFICO,2023-08-03,477,402,75,0.157232704402516
NORTE-PACIFICO,2023-08-04,486,461,25,0.051440329218107
NORTE-PACIFICO,2023-08-05,499,480,19,0.0380761523046092
NORTE-PACIFICO,2023-08-06,393,371,22,0.0559796437659033
NORTE-PACIFICO,2023-08-07,426,411,15,0.0352112676056338
NORTE-PACIFICO,2023-08-08,453,438,15,0.033112582781457
NORTE-PACIFICO,2023-08-09,450,436,14,0.0311111111111111
NORTE-PACIFICO,2023-08-10,446,416,30,0.0672645739910314
NORTE-PACIFICO,2023-08-11,546,527,19,0.0347985347985348
NORTE-PACIFICO,2023-08-12,508,468,40,0.078740157480315
NORTE-PACIFICO,2023-08-13,413,387,26,0.062953995157385
NORTE-PACIFICO,2023-08-14,409,391,18,0.0440097799511002
NORTE-PACIFICO,2023-08-15,450,429,21,0.0466666666666667
NORTE-PACIFICO,2023-08-16,390,368,22,0.0564102564102564
NORTE-PACIFICO,2023-08-17,415,402,13,0.0313253012048193
NORTE-PACIFICO,2023-08-18,486,463,23,0.0473251028806584
NORTE-PACIFICO,2023-08-19,513,495,18,0.0350877192982456
NORTE-PACIFICO,2023-08-20,192,186,6,0.03125
NORTE-PACIFICO,2023-08-21,329,323,6,0.0182370820668693
NORTE-PACIFICO,2023-08-22,419,410,9,0.0214797136038186
NORTE-PACIFICO,2023-08-23,414,402,12,0.0289855072463768
NORTE-PACIFICO,2023-08-24,459,451,8,0.0174291938997821
NORTE-PACIFICO,2023-08-25,445,430,15,0.0337078651685393
NORTE-PACIFICO,2023-08-26,534,518,16,0.0299625468164794
NORTE-PACIFICO,2023-08-27,421,417,4,0.00950118764845606
NORTE-PACIFICO,2023-08-28,487,475,12,0.0246406570841889
NORTE-PACIFICO,2023-08-29,442,441,1,0.00226244343891403
NORTE-PACIFICO,2023-08-30,453,451,2,0.00441501103752759
NORTE-PACIFICO,2023-08-31,514,511,3,0.00583657587548638
NORTE-PACIFICO,2023-09-01,375,369,6,0.016
NORTE-PACIFICO,2023-09-02,531,527,4,0.00753295668549906
NORTE-PACIFICO,2023-09-03,393,390,3,0.00763358778625954
NORTE-PACIFICO,2023-09-04,441,440,1,0.00226757369614512
NORTE-PACIFICO,2023-09-05,468,464,4,0.00854700854700855
NORTE-PACIFICO,2023-09-06,466,462,4,0.00858369098712446
NORTE-PACIFICO,2023-09-07,433,433,0,0
NORTE-PACIFICO,2023-09-08,505,500,5,0.0099009900990099
NORTE-PACIFICO,2023-09-09,561,555,6,0.0106951871657754
NORTE-PACIFICO,2023-09-10,408,405,3,0.00735294117647059
NORTE-PACIFICO,2023-09-11,432,427,5,0.0115740740740741
NORTE-PACIFICO,2023-09-12,459,459,0,0
NORTE-PACIFICO,2023-09-13,432,429,3,0.00694444444444444
NORTE-PACIFICO,2023-09-14,409,405,4,0.0097799511002445
NORTE-PACIFICO,2023-09-15,442,440,2,0.00452488687782805
NORTE-PACIFICO,2023-09-16,368,364,4,0.0108695652173913
NORTE-PACIFICO,2023-09-17,401,399,2,0.00498753117206983
NORTE-PACIFICO,2023-09-18,493,492,1,0.00202839756592292
NORTE-PACIFICO,2023-09-19,477,473,4,0.00838574423480084
NORTE-PACIFICO,2023-09-20,420,417,3,0.00714285714285714
NORTE-PACIFICO,2023-09-21,478,472,6,0.0125523012552301
NORTE-PACIFICO,2023-09-22,491,482,9,0.0183299389002037
NORTE-PACIFICO,2023-09-23,573,562,11,0.0191972076788831
NORTE-PACIFICO,2023-09-24,413,408,5,0.0121065375302663
NORTE-PACIFICO,2023-09-25,417,411,6,0.0143884892086331
NORTE-PACIFICO,2023-09-26,460,454,6,0.0130434782608696
NORTE-PACIFICO,2023-09-27,446,442,4,0.00896860986547085
NORTE-PACIFICO,2023-09-28,474,471,3,0.00632911392405063
NORTE-PACIFICO,2023-09-29,489,484,5,0.0102249488752556
NORTE-PACIFICO,2023-09-30,562,559,3,0.00533807829181495
NORTE-PACIFICO,2023-10-01,368,365,3,0.00815217391304348
NORTE-PACIFICO,2023-10-02,371,368,3,0.00808625336927224
NORTE-PACIFICO,2023-10-03,458,447,11,0.0240174672489083
NORTE-PACIFICO,2023-10-04,449,439,10,0.022271714922049
NORTE-PACIFICO,2023-10-05,462,456,6,0.012987012987013
NORTE-PACIFICO,2023-10-06,522,502,20,0.0383141762452107
NORTE-PACIFICO,2023-10-07,546,532,14,0.0256410256410256
NORTE-PACIFICO,2023-10-08,417,405,12,0.0287769784172662
NORTE-PACIFICO,2023-10-09,425,418,7,0.0164705882352941
NORTE-PACIFICO,2023-10-10,426,415,11,0.0258215962441315
NORTE-PACIFICO,2023-10-11,390,382,8,0.0205128205128205
NORTE-PACIFICO,2023-10-12,423,413,10,0.0236406619385343
NORTE-PACIFICO,2023-10-13,436,420,16,0.036697247706422
NORTE-PACIFICO,2023-10-14,502,490,12,0.0239043824701195
NORTE-PACIFICO,2023-10-15,417,411,6,0.0143884892086331
NORTE-PACIFICO,2023-10-16,437,425,12,0.0274599542334096
NORTE-PACIFICO,2023-10-17,429,422,7,0.0163170163170163
NORTE-PACIFICO,2023-10-18,389,377,12,0.0308483290488432
NORTE-PACIFICO,2023-10-19,431,423,8,0.0185614849187935
NORTE-PACIFICO,2023-10-20,455,446,9,0.0197802197802198
NORTE-PACIFICO,2023-10-21,553,543,10,0.0180831826401447
NORTE-PACIFICO,2023-10-22,350,340,10,0.0285714285714286
NORTE-PACIFICO,2023-10-23,369,359,10,0.02710027100271
NORTE-PACIFICO,2023-10-24,435,424,11,0.0252873563218391
NORTE-PACIFICO,2023-10-25,424,406,18,0.0424528301886792
NORTE-PACIFICO,2023-10-26,441,435,6,0.0136054421768707
NORTE-PACIFICO,2023-10-27,463,453,10,0.0215982721382289
NORTE-PACIFICO,2023-10-28,483,479,4,0.0082815734989648
NORTE-PACIFICO,2023-10-29,343,334,9,0.0262390670553936
NORTE-PACIFICO,2023-10-30,388,377,11,0.0283505154639175
NORTE-PACIFICO,2023-10-31,425,419,6,0.0141176470588235
NORTE-PACIFICO,2023-11-01,453,447,6,0.0132450331125828
NORTE-PACIFICO,2023-11-02,491,480,11,0.0224032586558045
NORTE-PACIFICO,2023-11-03,436,423,13,0.0298165137614679
NORTE-PACIFICO,2023-11-04,569,557,12,0.0210896309314587
NORTE-PACIFICO,2023-11-05,427,421,6,0.0140515222482436
NORTE-PACIFICO,2023-11-06,473,462,11,0.0232558139534884
NORTE-PACIFICO,2023-11-07,517,507,10,0.0193423597678917
NORTE-PACIFICO,2023-11-08,523,510,13,0.0248565965583174
NORTE-PACIFICO,2023-11-09,505,493,12,0.0237623762376238
NORTE-PACIFICO,2023-11-10,521,511,10,0.0191938579654511
NORTE-PACIFICO,2023-11-11,598,590,8,0.0133779264214047
NORTE-PACIFICO,2023-11-12,460,445,15,0.0326086956521739
NORTE-PACIFICO,2023-11-13,456,444,12,0.0263157894736842
NORTE-PACIFICO,2023-11-14,514,501,13,0.0252918287937743
NORTE-PACIFICO,2023-11-15,484,475,9,0.0185950413223141
NORTE-PACIFICO,2023-11-16,524,511,13,0.0248091603053435
NORTE-PACIFICO,2023-11-17,508,500,8,0.015748031496063
NORTE-PACIFICO,2023-11-18,644,631,13,0.0201863354037267
NORTE-PACIFICO,2023-11-19,475,465,10,0.0210526315789474
NORTE-PACIFICO,2023-11-20,431,421,10,0.0232018561484919
NORTE-PACIFICO,2023-11-21,546,530,16,0.0293040293040293
NORTE-PACIFICO,2023-11-22,495,484,11,0.0222222222222222
NORTE-PACIFICO,2023-11-23,553,540,13,0.0235081374321881
NORTE-PACIFICO,2023-11-24,573,565,8,0.0139616055846422
NORTE-PACIFICO,2023-11-25,612,599,13,0.0212418300653595
NORTE-PACIFICO,2023-11-26,448,446,2,0.00446428571428571
NORTE-PACIFICO,2023-11-27,444,434,10,0.0225225225225225
NORTE-PACIFICO,2023-11-28,522,511,11,0.0210727969348659
NORTE-PACIFICO,2023-11-29,504,489,15,0.0297619047619048
NORTE-PACIFICO,2023-11-30,474,466,8,0.0168776371308017
NORTE-PACIFICO,2023-12-01,516,502,14,0.0271317829457364
NORTE-PACIFICO,2023-12-02,619,607,12,0.0193861066235864
NORTE-PACIFICO,2023-12-03,476,466,10,0.0210084033613445
NORTE-PACIFICO,2023-12-04,502,483,19,0.0378486055776892
NORTE-PACIFICO,2023-12-05,538,519,19,0.0353159851301115
NORTE-PACIFICO,2023-12-06,520,506,14,0.0269230769230769
NORTE-PACIFICO,2023-12-07,527,514,13,0.0246679316888046
NORTE-PACIFICO,2023-12-08,544,534,10,0.0183823529411765
NORTE-PACIFICO,2023-12-09,556,549,7,0.012589928057554
NORTE-PACIFICO,2023-12-10,480,471,9,0.01875
NORTE-PACIFICO,2023-12-11,480,474,6,0.0125
NORTE-PACIFICO,2023-12-12,496,488,8,0.0161290322580645
NORTE-PACIFICO,2023-12-13,504,494,10,0.0198412698412698
NORTE-PACIFICO,2023-12-14,458,446,12,0.0262008733624454
NORTE-PACIFICO,2023-12-15,477,466,11,0.0230607966457023
NORTE-PACIFICO,2023-12-16,539,530,9,0.0166975881261596
NORTE-PACIFICO,2023-12-17,449,442,7,0.0155902004454343
OCCIDENTE-BAJIO,2023-01-02,304,192,112,0.368421052631579
OCCIDENTE-BAJIO,2023-01-03,430,281,149,0.346511627906977
OCCIDENTE-BAJIO,2023-01-04,370,230,140,0.378378378378378
OCCIDENTE-BAJIO,2023-01-05,385,246,139,0.361038961038961
OCCIDENTE-BAJIO,2023-01-06,396,261,135,0.340909090909091
OCCIDENTE-BAJIO,2023-01-07,430,280,150,0.348837209302326
OCCIDENTE-BAJIO,2023-01-08,252,171,81,0.321428571428571
OCCIDENTE-BAJIO,2023-01-09,389,243,146,0.375321336760925
OCCIDENTE-BAJIO,2023-01-10,435,286,149,0.342528735632184
OCCIDENTE-BAJIO,2023-01-11,449,285,164,0.365256124721604
OCCIDENTE-BAJIO,2023-01-12,386,272,114,0.295336787564767
OCCIDENTE-BAJIO,2023-01-13,385,241,144,0.374025974025974
OCCIDENTE-BAJIO,2023-01-14,461,320,141,0.3058568329718
OCCIDENTE-BAJIO,2023-01-15,289,209,80,0.27681660899654
OCCIDENTE-BAJIO,2023-01-16,398,258,140,0.351758793969849
OCCIDENTE-BAJIO,2023-01-17,417,291,126,0.302158273381295
OCCIDENTE-BAJIO,2023-01-18,375,256,119,0.317333333333333
OCCIDENTE-BAJIO,2023-01-19,400,277,123,0.3075
OCCIDENTE-BAJIO,2023-01-20,385,240,145,0.376623376623377
OCCIDENTE-BAJIO,2023-01-21,415,141,274,0.660240963855422
OCCIDENTE-BAJIO,2023-01-22,273,106,167,0.611721611721612
OCCIDENTE-BAJIO,2023-01-23,353,139,214,0.606232294617564
OCCIDENTE-BAJIO,2023-01-24,391,144,247,0.631713554987212
OCCIDENTE-BAJIO,2023-01-25,375,165,210,0.56
OCCIDENTE-BAJIO,2023-01-26,411,152,259,0.630170316301703
OCCIDENTE-BAJIO,2023-01-27,382,154,228,0.596858638743455
OCCIDENTE-BAJIO,2023-01-28,450,191,259,0.575555555555556
OCCIDENTE-BAJIO,2023-01-29,283,107,176,0.621908127208481
OCCIDENTE-BAJIO,2023-01-30,428,169,259,0.605140186915888
OCCIDENTE-BAJIO,2023-01-31,495,216,279,0.563636363636364
OCCIDENTE-BAJIO,2023-02-01,384,159,225,0.5859375
OCCIDENTE-BAJIO,2023-02-02,435,135,300,0.689655172413793
OCCIDENTE-BAJIO,2023-02-03,398,157,241,0.605527638190955
OCCIDENTE-BAJIO,2023-02-04,461,184,277,0.600867678958785
OCCIDENTE-BAJIO,2023-02-05,245,101,144,0.587755102040816
OCCIDENTE-BAJIO,2023-02-06,382,153,229,0.599476439790576
OCCIDENTE-BAJIO,2023-02-07,457,193,264,0.577680525164114
OCCIDENTE-BAJIO,2023-02-08,369,140,229,0.62059620596206
OCCIDENTE-BAJIO,2023-02-09,376,168,208,0.553191489361702
OCCIDENTE-BAJIO,2023-02-10,372,164,208,0.559139784946237
OCCIDENTE-BAJIO,2023-02-11,414,187,227,0.548309178743961
OCCIDENTE-BAJIO,2023-02-12,243,101,142,0.584362139917695
OCCIDENTE-BAJIO,2023-02-13,335,131,204,0.608955223880597
OCCIDENTE-BAJIO,2023-02-14,344,132,212,0.616279069767442
OCCIDENTE-BAJIO,2023-02-15,343,153,190,0.553935860058309
OCCIDENTE-BAJIO,2023-02-16,396,147,250,0.631313131313131
OCCIDENTE-BAJIO,2023-02-17,389,134,255,0.655526992287918
OCCIDENTE-BAJIO,2023-02-18,488,218,270,0.55327868852459
OCCIDENTE-BAJIO,2023-02-19,268,109,159,0.593283582089552
OCCIDENTE-BAJIO,2023-02-20,343,152,191,0.556851311953353
OCCIDENTE-BAJIO,2023-02-21,419,193,226,0.539379474940334
OCCIDENTE-BAJIO,2023-02-22,379,199,180,0.474934036939314
OCCIDENTE-BAJIO,2023-02-23,343,196,147,0.428571428571429
OCCIDENTE-BAJIO,2023-02-24,357,217,140,0.392156862745098
OCCIDENTE-BAJIO,2023-02-25,447,279,168,0.375838926174497
OCCIDENTE-BAJIO,2023-02-26,206,105,101,0.490291262135922
OCCIDENTE-BAJIO,2023-02-27,342,211,131,0.383040935672515
OCCIDENTE-BAJIO,2023-02-28,417,268,149,0.357314148681055
OCCIDENTE-BAJIO,2023-03-01,375,234,141,0.376
OCCIDENTE-BAJIO,2023-03-02,412,256,156,0.378640776699029
OCCIDENTE-BAJIO,2023-03-03,360,225,135,0.375
OCCIDENTE-BAJIO,2023-03-04,447,273,174,0.389261744966443
OCCIDENTE-BAJIO,2023-03-05,228,144,84,0.368421052631579
OCCIDENTE-BAJIO,2023-03-06,320,198,122,0.38125
OCCIDENTE-BAJIO,2023-03-07,381,251,130,0.341207349081365
OCCIDENTE-BAJIO,2023-03-08,370,262,108,0.291891891891892
OCCIDENTE-BAJIO,2023-03-09,329,293,36,0.109422492401216
OCCIDENTE-BAJIO,2023-03-10,328,286,42,0.128048780487805
OCCIDENTE-BAJIO,2023-03-11,412,350,62,0.150485436893204
OCCIDENTE-BAJIO,2023-03-12,259,231,28,0.108108108108108
OCCIDENTE-BAJIO,2023-03-13,312,273,39,0.125
OCCIDENTE-BAJIO,2023-03-14,386,326,60,0.155440414507772
OCCIDENTE-BAJIO,2023-03-15,391,353,38,0.0971867007672634
OCCIDENTE-BAJIO,2023-03-16,423,390,33,0.0780141843971631
OCCIDENTE-BAJIO,2023-03-17,484,442,42,0.0867768595041322
OCCIDENTE-BAJIO,2023-03-18,556,496,60,0.107913669064748
OCCIDENTE-BAJIO,2023-03-19,354,329,25,0.0706214689265537
OCCIDENTE-BAJIO,2023-03-20,443,407,36,0.0812641083521445
OCCIDENTE-BAJIO,2023-03-21,440,408,32,0.0727272727272727
OCCIDENTE-BAJIO,2023-03-22,397,372,25,0.0629722921914358
OCCIDENTE-BAJIO,2023-03-23,365,344,21,0.0575342465753425
OCCIDENTE-BAJIO,2023-03-24,397,373,24,0.0604534005037783
OCCIDENTE-BAJIO,2023-03-25,489,462,27,0.0552147239263804
OCCIDENTE-BAJIO,2023-03-26,335,321,14,0.0417910447761194
OCCIDENTE-BAJIO,2023-03-27,328,306,22,0.0670731707317073
OCCIDENTE-BAJIO,2023-03-28,324,310,14,0.0432098765432099
OCCIDENTE-BAJIO,2023-03-29,399,373,26,0.0651629072681704
OCCIDENTE-BAJIO,2023-03-30,427,392,35,0.0819672131147541
OCCIDENTE-BAJIO,2023-03-31,553,514,39,0.0705244122965642
OCCIDENTE-BAJIO,2023-04-01,493,472,21,0.0425963488843813
OCCIDENTE-BAJIO,2023-04-02,237,229,8,0.0337552742616034
OCCIDENTE-BAJIO,2023-04-03,398,384,14,0.0351758793969849
OCCIDENTE-BAJIO,2023-04-04,460,428,32,0.0695652173913043
OCCIDENTE-BAJIO,2023-04-05,367,333,34,0.0926430517711172
OCCIDENTE-BAJIO,2023-04-06,364,342,22,0.0604395604395604
OCCIDENTE-BAJIO,2023-04-07,271,258,13,0.0479704797047971
OCCIDENTE-BAJIO,2023-04-08,217,209,8,0.0368663594470046
OCCIDENTE-BAJIO,2023-04-09,160,155,5,0.03125
OCCIDENTE-BAJIO,2023-04-10,302,282,20,0.0662251655629139
OCCIDENTE-BAJIO,2023-04-11,371,337,34,0.091644204851752
OCCIDENTE-BAJIO,2023-04-12,350,314,36,0.102857142857143
OCCIDENTE-BAJIO,2023-04-13,320,290,30,0.09375
OCCIDENTE-BAJIO,2023-04-14,375,349,26,0.0693333333333333
OCCIDENTE-BAJIO,2023-04-15,519,474,45,0.0867052023121387
OCCIDENTE-BAJIO,2023-04-16,311,294,17,0.0546623794212219
OCCIDENTE-BAJIO,2023-04-17,361,339,22,0.0609418282548476
OCCIDENTE-BAJIO,2023-04-18,375,326,49,0.130666666666667
OCCIDENTE-BAJIO,2023-04-19,359,318,41,0.114206128133705
OCCIDENTE-BAJIO,2023-04-20,365,342,23,0.063013698630137
OCCIDENTE-BAJIO,2023-04-21,351,316,35,0.0997150997150997
OCCIDENTE-BAJIO,2023-04-22,413,379,34,0.0823244552058111
OCCIDENTE-BAJIO,2023-04-23,247,225,22,0.0890688259109312
OCCIDENTE-BAJIO,2023-04-24,407,377,30,0.0737100737100737
OCCIDENTE-BAJIO,2023-04-25,467,424,43,0.0920770877944325
OCCIDENTE-BAJIO,2023-04-26,391,359,32,0.0818414322250639
OCCIDENTE-BAJIO,2023-04-27,355,333,22,0.0619718309859155
OCCIDENTE-BAJIO,2023-04-28,418,382,36,0.0861244019138756
OCCIDENTE-BAJIO,2023-04-29,507,457,50,0.0986193293885602
OCCIDENTE-BAJIO,2023-04-30,293,269,24,0.0819112627986348
OCCIDENTE-BAJIO,2023-05-01,310,285,25,0.0806451612903226
OCCIDENTE-BAJIO,2023-05-02,361,337,24,0.0664819944598338
OCCIDENTE-BAJIO,2023-05-03,355,326,29,0.0816901408450704
OCCIDENTE-BAJIO,2023-05-04,340,302,38,0.111764705882353
OCCIDENTE-BAJIO,2023-05-05,382,348,34,0.0890052356020942
OCCIDENTE-BAJIO,2023-05-06,385,350,35,0.0909090909090909
OCCIDENTE-BAJIO,2023-05-07,229,216,13,0.0567685589519651
OCCIDENTE-BAJIO,2023-05-08,330,302,28,0.0848484848484849
OCCIDENTE-BAJIO,2023-05-09,351,329,22,0.0626780626780627
OCCIDENTE-BAJIO,2023-05-10,305,276,29,0.0950819672131148
OCCIDENTE-BAJIO,2023-05-11,323,299,24,0.0743034055727554
OCCIDENTE-BAJIO,2023-05-12,304,285,19,0.0625
OCCIDENTE-BAJIO,2023-05-13,468,415,53,0.113247863247863
OCCIDENTE-BAJIO,2023-05-14,370,338,32,0.0864864864864865
OCCIDENTE-BAJIO,2023-05-15,474,424,50,0.105485232067511
OCCIDENTE-BAJIO,2023-05-16,579,497,82,0.141623488773748
OCCIDENTE-BAJIO,2023-05-17,459,407,52,0.113289760348584
OCCIDENTE-BAJIO,2023-05-18,374,343,31,0.0828877005347594
OCCIDENTE-BAJIO,2023-05-19,374,327,47,0.125668449197861
OCCIDENTE-BAJIO,2023-05-20,487,438,49,0.100616016427105
OCCIDENTE-BAJIO,2023-05-21,348,312,36,0.103448275862069
OCCIDENTE-BAJIO,2023-05-22,384,338,46,0.119791666666667
OCCIDENTE-BAJIO,2023-05-23,390,351,39,0.1
OCCIDENTE-BAJIO,2023-05-24,392,338,54,0.137755102040816
OCCIDENTE-BAJIO,2023-05-25,403,351,52,0.129032258064516
OCCIDENTE-BAJIO,2023-05-26,451,393,58,0.12860310421286
OCCIDENTE-BAJIO,2023-05-27,534,463,71,0.132958801498127
OCCIDENTE-BAJIO,2023-05-28,355,297,58,0.163380281690141
OCCIDENTE-BAJIO,2023-05-29,422,350,72,0.170616113744076
OCCIDENTE-BAJIO,2023-05-30,532,442,90,0.169172932330827
OCCIDENTE-BAJIO,2023-05-31,590,510,80,0.135593220338983
OCCIDENTE-BAJIO,2023-06-01,909,839,70,0.077007700770077
OCCIDENTE-BAJIO,2023-06-02,713,623,90,0.126227208976157
OCCIDENTE-BAJIO,2023-06-03,887,781,106,0.119503945885006
OCCIDENTE-BAJIO,2023-06-04,640,549,91,0.1421875
OCCIDENTE-BAJIO,2023-06-05,439,378,61,0.138952164009112
OCCIDENTE-BAJIO,2023-06-06,460,419,41,0.0891304347826087
OCCIDENTE-BAJIO,2023-06-07,409,357,52,0.127139364303178
OCCIDENTE-BAJIO,2023-06-08,431,381,50,0.116009280742459
OCCIDENTE-BAJIO,2023-06-09,422,386,36,0.0853080568720379
OCCIDENTE-BAJIO,2023-06-10,503,451,52,0.10337972166998
OCCIDENTE-BAJIO,2023-06-11,328,295,33,0.100609756097561
OCCIDENTE-BAJIO,2023-06-12,413,360,53,0.128329297820823
OCCIDENTE-BAJIO,2023-06-13,453,396,57,0.125827814569536
OCCIDENTE-BAJIO,2023-06-14,471,433,38,0.0806794055201698
OCCIDENTE-BAJIO,2023-06-15,460,416,44,0.0956521739130435
OCCIDENTE-BAJIO,2023-06-16,446,408,38,0.0852017937219731
OCCIDENTE-BAJIO,2023-06-17,482,434,48,0.0995850622406639
OCCIDENTE-BAJIO,2023-06-18,313,282,31,0.0990415335463259
OCCIDENTE-BAJIO,2023-06-19,403,361,42,0.104218362282878
OCCIDENTE-BAJIO,2023-06-20,429,389,40,0.0932400932400932
OCCIDENTE-BAJIO,2023-06-21,431,392,39,0.0904872389791183
OCCIDENTE-BAJIO,2023-06-22,405,372,33,0.0814814814814815
OCCIDENTE-BAJIO,2023-06-23,353,326,27,0.0764872521246459
OCCIDENTE-BAJIO,2023-06-24,437,406,31,0.0709382151029748
OCCIDENTE-BAJIO,2023-06-25,301,284,17,0.0564784053156146
OCCIDENTE-BAJIO,2023-06-26,409,383,26,0.0635696821515892
OCCIDENTE-BAJIO,2023-06-27,434,407,27,0.0622119815668203
OCCIDENTE-BAJIO,2023-06-28,428,397,31,0.0724299065420561
OCCIDENTE-BAJIO,2023-06-29,410,382,28,0.0682926829268293
OCCIDENTE-BAJIO,2023-06-30,278,209,69,0.248201438848921
OCCIDENTE-BAJIO,2023-07-01,523,486,37,0.0707456978967495
OCCIDENTE-BAJIO,2023-07-02,314,296,18,0.0573248407643312
OCCIDENTE-BAJIO,2023-07-03,410,393,17,0.0414634146341463
OCCIDENTE-BAJIO,2023-07-04,560,527,33,0.0589285714285714
OCCIDENTE-BAJIO,2023-07-05,400,368,32,0.08
OCCIDENTE-BAJIO,2023-07-06,298,275,23,0.0771812080536913
OCCIDENTE-BAJIO,2023-07-07,497,474,23,0.0462776659959759
OCCIDENTE-BAJIO,2023-07-08,810,772,38,0.0469135802469136
OCCIDENTE-BAJIO,2023-07-09,435,412,23,0.0528735632183908
OCCIDENTE-BAJIO,2023-07-10,521,494,27,0.0518234165067179
OCCIDENTE-BAJIO,2023-07-11,551,511,40,0.0725952813067151
OCCIDENTE-BAJIO,2023-07-12,551,516,35,0.0635208711433757
OCCIDENTE-BAJIO,2023-07-13,504,467,37,0.0734126984126984
OCCIDENTE-BAJIO,2023-07-14,476,450,26,0.0546218487394958
OCCIDENTE-BAJIO,2023-07-15,836,794,42,0.0502392344497608
OCCIDENTE-BAJIO,2023-07-16,358,341,17,0.0474860335195531
OCCIDENTE-BAJIO,2023-07-17,509,478,31,0.0609037328094303
OCCIDENTE-BAJIO,2023-07-18,497,472,25,0.0503018108651912
OCCIDENTE-BAJIO,2023-07-19,514,489,25,0.0486381322957198
OCCIDENTE-BAJIO,2023-07-20,632,601,31,0.0490506329113924
OCCIDENTE-BAJIO,2023-07-21,567,542,25,0.0440917107583774
OCCIDENTE-BAJIO,2023-07-22,770,730,40,0.051948051948052
OCCIDENTE-BAJIO,2023-07-23,400,385,15,0.0375
OCCIDENTE-BAJIO,2023-07-24,454,435,19,0.0418502202643172
OCCIDENTE-BAJIO,2023-07-25,589,551,38,0.0645161290322581
OCCIDENTE-BAJIO,2023-07-26,580,534,46,0.0793103448275862
OCCIDENTE-BAJIO,2023-07-27,552,535,17,0.0307971014492754
OCCIDENTE-BAJIO,2023-07-28,602,562,40,0.0664451827242525
OCCIDENTE-BAJIO,2023-07-29,737,698,39,0.0529172320217096
OCCIDENTE-BAJIO,2023-07-30,447,410,37,0.0827740492170022
OCCIDENTE-BAJIO,2023-07-31,625,595,30,0.048
OCCIDENTE-BAJIO,2023-08-01,624,578,46,0.0737179487179487
OCCIDENTE-BAJIO,2023-08-02,612,579,33,0.053921568627451
OCCIDENTE-BAJIO,2023-08-03,549,433,116,0.211293260473588
OCCIDENTE-BAJIO,2023-08-04,538,492,46,0.0855018587360595
OCCIDENTE-BAJIO,2023-08-05,645,610,35,0.0542635658914729
OCCIDENTE-BAJIO,2023-08-06,426,404,22,0.0516431924882629
OCCIDENTE-BAJIO,2023-08-07,517,499,18,0.034816247582205
OCCIDENTE-BAJIO,2023-08-08,565,551,14,0.0247787610619469
OCCIDENTE-BAJIO,2023-08-09,576,545,31,0.0538194444444444
OCCIDENTE-BAJIO,2023-08-10,623,591,32,0.0513643659711075
OCCIDENTE-BAJIO,2023-08-11,643,611,32,0.0497667185069984
OCCIDENTE-BAJIO,2023-08-12,687,648,39,0.0567685589519651
OCCIDENTE-BAJIO,2023-08-13,441,412,29,0.0657596371882086
OCCIDENTE-BAJIO,2023-08-14,533,506,27,0.050656660412758
OCCIDENTE-BAJIO,2023-08-15,678,638,40,0.0589970501474926
OCCIDENTE-BAJIO,2023-08-16,629,601,28,0.0445151033386327
OCCIDENTE-BAJIO,2023-08-17,591,555,36,0.0609137055837563
OCCIDENTE-BAJIO,2023-08-18,604,575,29,0.0480132450331126
OCCIDENTE-BAJIO,2023-08-19,696,657,39,0.0560344827586207
OCCIDENTE-BAJIO,2023-08-20,443,421,22,0.0496613995485327
OCCIDENTE-BAJIO,2023-08-21,549,529,20,0.0364298724954463
OCCIDENTE-BAJIO,2023-08-22,584,566,18,0.0308219178082192
OCCIDENTE-BAJIO,2023-08-23,566,541,25,0.0441696113074205
OCCIDENTE-BAJIO,2023-08-24,591,568,23,0.038917089678511
OCCIDENTE-BAJIO,2023-08-25,637,623,14,0.021978021978022
OCCIDENTE-BAJIO,2023-08-26,733,708,25,0.034106412005457
OCCIDENTE-BAJIO,2023-08-27,477,461,16,0.0335429769392034
OCCIDENTE-BAJIO,2023-08-28,550,532,18,0.0327272727272727
OCCIDENTE-BAJIO,2023-08-29,646,627,19,0.0294117647058824
OCCIDENTE-BAJIO,2023-08-30,554,543,11,0.01985559566787
OCCIDENTE-BAJIO,2023-08-31,596,576,20,0.0335570469798658
OCCIDENTE-BAJIO,2023-09-01,541,526,15,0.0277264325323475
OCCIDENTE-BAJIO,2023-09-02,594,584,10,0.0168350168350168
OCCIDENTE-BAJIO,2023-09-03,414,406,8,0.0193236714975845
OCCIDENTE-BAJIO,2023-09-04,481,471,10,0.0207900207900208
OCCIDENTE-BAJIO,2023-09-05,584,575,9,0.0154109589041096
OCCIDENTE-BAJIO,2023-09-06,544,528,16,0.0294117647058824
OCCIDENTE-BAJIO,2023-09-07,570,553,17,0.0298245614035088
OCCIDENTE-BAJIO,2023-09-08,531,523,8,0.0150659133709981
OCCIDENTE-BAJIO,2023-09-09,598,586,12,0.020066889632107
OCCIDENTE-BAJIO,2023-09-10,386,378,8,0.0207253886010363
OCCIDENTE-BAJIO,2023-09-11,510,497,13,0.0254901960784314
OCCIDENTE-BAJIO,2023-09-12,543,535,8,0.0147329650092081
OCCIDENTE-BAJIO,2023-09-13,542,531,11,0.0202952029520295
OCCIDENTE-BAJIO,2023-09-14,534,519,15,0.0280898876404494
OCCIDENTE-BAJIO,2023-09-15,614,602,12,0.0195439739413681
OCCIDENTE-BAJIO,2023-09-16,537,527,10,0.0186219739292365
OCCIDENTE-BAJIO,2023-09-17,410,403,7,0.0170731707317073
OCCIDENTE-BAJIO,2023-09-18,525,515,10,0.019047619047619
OCCIDENTE-BAJIO,2023-09-19,543,525,18,0.0331491712707182
OCCIDENTE-BAJIO,2023-09-20,446,437,9,0.0201793721973094
OCCIDENTE-BAJIO,2023-09-21,492,479,13,0.0264227642276423
OCCIDENTE-BAJIO,2023-09-22,540,523,17,0.0314814814814815
OCCIDENTE-BAJIO,2023-09-23,641,624,17,0.0265210608424337
OCCIDENTE-BAJIO,2023-09-24,376,369,7,0.0186170212765957
OCCIDENTE-BAJIO,2023-09-25,486,475,11,0.0226337448559671
OCCIDENTE-BAJIO,2023-09-26,525,511,14,0.0266666666666667
OCCIDENTE-BAJIO,2023-09-27,518,506,12,0.0231660231660232
OCCIDENTE-BAJIO,2023-09-28,564,546,18,0.0319148936170213
OCCIDENTE-BAJIO,2023-09-29,603,583,20,0.033167495854063
OCCIDENTE-BAJIO,2023-09-30,736,708,28,0.0380434782608696
OCCIDENTE-BAJIO,2023-10-01,432,420,12,0.0277777777777778
OCCIDENTE-BAJIO,2023-10-02,500,486,14,0.028
OCCIDENTE-BAJIO,2023-10-03,499,478,21,0.0420841683366733
OCCIDENTE-BAJIO,2023-10-04,461,438,23,0.0498915401301518
OCCIDENTE-BAJIO,2023-10-05,471,445,26,0.0552016985138004
OCCIDENTE-BAJIO,2023-10-06,490,463,27,0.0551020408163265
OCCIDENTE-BAJIO,2023-10-07,616,593,23,0.0373376623376623
OCCIDENTE-BAJIO,2023-10-08,386,369,17,0.0440414507772021
OCCIDENTE-BAJIO,2023-10-09,515,491,24,0.0466019417475728
OCCIDENTE-BAJIO,2023-10-10,432,408,24,0.0555555555555556
OCCIDENTE-BAJIO,2023-10-11,414,386,28,0.0676328502415459
OCCIDENTE-BAJIO,2023-10-12,449,425,24,0.0534521158129176
OCCIDENTE-BAJIO,2023-10-13,415,388,27,0.0650602409638554
OCCIDENTE-BAJIO,2023-10-14,516,492,24,0.0465116279069767
OCCIDENTE-BAJIO,2023-10-15,404,385,19,0.047029702970297
OCCIDENTE-BAJIO,2023-10-16,517,496,21,0.0406189555125725
OCCIDENTE-BAJIO,2023-10-17,444,434,10,0.0225225225225225
OCCIDENTE-BAJIO,2023-10-18,480,456,24,0.05
OCCIDENTE-BAJIO,2023-10-19,454,434,20,0.0440528634361234
OCCIDENTE-BAJIO,2023-10-20,523,501,22,0.0420650095602294
OCCIDENTE-BAJIO,2023-10-21,605,586,19,0.031404958677686
OCCIDENTE-BAJIO,2023-10-22,402,395,7,0.0174129353233831
OCCIDENTE-BAJIO,2023-10-23,468,454,14,0.0299145299145299
OCCIDENTE-BAJIO,2023-10-24,491,476,15,0.0305498981670061
OCCIDENTE-BAJIO,2023-10-25,498,484,14,0.0281124497991968
OCCIDENTE-BAJIO,2023-10-26,474,450,24,0.0506329113924051
OCCIDENTE-BAJIO,2023-10-27,484,470,14,0.0289256198347107
OCCIDENTE-BAJIO,2023-10-28,533,518,15,0.0281425891181989
OCCIDENTE-BAJIO,2023-10-29,328,322,6,0.0182926829268293
OCCIDENTE-BAJIO,2023-10-30,480,462,18,0.0375
OCCIDENTE-BAJIO,2023-10-31,600,578,22,0.0366666666666667
OCCIDENTE-BAJIO,2023-11-01,545,529,16,0.0293577981651376
OCCIDENTE-BAJIO,2023-11-02,538,524,14,0.0260223048327138
OCCIDENTE-BAJIO,2023-11-03,491,474,17,0.0346232179226069
OCCIDENTE-BAJIO,2023-11-04,588,572,16,0.0272108843537415
OCCIDENTE-BAJIO,2023-11-05,418,409,9,0.0215311004784689
OCCIDENTE-BAJIO,2023-11-06,513,491,22,0.0428849902534113
OCCIDENTE-BAJIO,2023-11-07,595,587,8,0.0134453781512605
OCCIDENTE-BAJIO,2023-11-08,532,506,26,0.0488721804511278
OCCIDENTE-BAJIO,2023-11-09,494,473,21,0.0425101214574899
OCCIDENTE-BAJIO,2023-11-10,499,481,18,0.0360721442885772
OCCIDENTE-BAJIO,2023-11-11,660,636,24,0.0363636363636364
OCCIDENTE-BAJIO,2023-11-12,415,405,10,0.0240963855421687
OCCIDENTE-BAJIO,2023-11-13,550,532,18,0.0327272727272727
OCCIDENTE-BAJIO,2023-11-14,594,572,22,0.037037037037037
OCCIDENTE-BAJIO,2023-11-15,594,579,15,0.0252525252525253
OCCIDENTE-BAJIO,2023-11-16,553,529,24,0.0433996383363472
OCCIDENTE-BAJIO,2023-11-17,581,563,18,0.0309810671256454
OCCIDENTE-BAJIO,2023-11-18,732,716,16,0.0218579234972678
OCCIDENTE-BAJIO,2023-11-19,472,461,11,0.0233050847457627
OCCIDENTE-BAJIO,2023-11-20,587,567,20,0.0340715502555366
OCCIDENTE-BAJIO,2023-11-21,616,593,23,0.0373376623376623
OCCIDENTE-BAJIO,2023-11-22,548,532,16,0.0291970802919708
OCCIDENTE-BAJIO,2023-11-23,562,542,20,0.0355871886120996
OCCIDENTE-BAJIO,2023-11-24,613,594,19,0.0309951060358891
OCCIDENTE-BAJIO,2023-11-25,652,637,15,0.0230061349693252
OCCIDENTE-BAJIO,2023-11-26,441,427,14,0.0317460317460317
OCCIDENTE-BAJIO,2023-11-27,522,503,19,0.0363984674329502
OCCIDENTE-BAJIO,2023-11-28,605,579,26,0.0429752066115702
OCCIDENTE-BAJIO,2023-11-29,607,570,37,0.0609555189456343
OCCIDENTE-BAJIO,2023-11-30,638,616,22,0.0344827586206897
OCCIDENTE-BAJIO,2023-12-01,557,529,28,0.0502692998204668
OCCIDENTE-BAJIO,2023-12-02,619,590,29,0.0468497576736672
OCCIDENTE-BAJIO,2023-12-03,443,420,23,0.0519187358916479
OCCIDENTE-BAJIO,2023-12-04,543,520,23,0.0423572744014733
OCCIDENTE-BAJIO,2023-12-05,595,566,29,0.0487394957983193
OCCIDENTE-BAJIO,2023-12-06,605,579,26,0.0429752066115702
OCCIDENTE-BAJIO,2023-12-07,510,492,18,0.0352941176470588
OCCIDENTE-BAJIO,2023-12-08,568,547,21,0.0369718309859155
OCCIDENTE-BAJIO,2023-12-09,620,587,33,0.0532258064516129
OCCIDENTE-BAJIO,2023-12-10,441,428,13,0.0294784580498866
OCCIDENTE-BAJIO,2023-12-11,476,454,22,0.046218487394958
OCCIDENTE-BAJIO,2023-12-12,572,546,26,0.0454545454545455
OCCIDENTE-BAJIO,2023-12-13,513,491,22,0.0428849902534113
OCCIDENTE-BAJIO,2023-12-14,527,504,23,0.0436432637571157
OCCIDENTE-BAJIO,2023-12-15,484,464,20,0.0413223140495868
OCCIDENTE-BAJIO,2023-12-16,658,637,21,0.0319148936170213
OCCIDENTE-BAJIO,2023-12-17,449,439,10,0.022271714922049
SURESTE,2023-01-02,69,52,17,0.246376811594203
SURESTE,2023-01-03,106,62,44,0.415094339622642
SURESTE,2023-01-04,122,71,51,0.418032786885246
SURESTE,2023-01-05,122,76,46,0.377049180327869
SURESTE,2023-01-06,108,68,40,0.37037037037037
SURESTE,2023-01-07,117,80,37,0.316239316239316
SURESTE,2023-01-08,98,54,44,0.448979591836735
SURESTE,2023-01-09,98,62,36,0.36734693877551
SURESTE,2023-01-10,133,68,65,0.488721804511278
SURESTE,2023-01-11,123,69,54,0.439024390243902
SURESTE,2023-01-12,112,70,42,0.375
SURESTE,2023-01-13,88,50,38,0.431818181818182
SURESTE,2023-01-14,116,72,44,0.379310344827586
SURESTE,2023-01-15,113,63,50,0.442477876106195
SURESTE,2023-01-16,110,47,63,0.572727272727273
SURESTE,2023-01-17,109,44,65,0.596330275229358
SURESTE,2023-01-18,87,46,41,0.471264367816092
SURESTE,2023-01-19,100,61,39,0.39
SURESTE,2023-01-20,93,52,41,0.440860215053763
SURESTE,2023-01-21,102,54,48,0.470588235294118
SURESTE,2023-01-22,90,48,42,0.466666666666667
SURESTE,2023-01-23,124,54,70,0.564516129032258
SURESTE,2023-01-24,109,51,58,0.532110091743119
SURESTE,2023-01-25,125,57,68,0.544
SURESTE,2023-01-26,91,40,51,0.56043956043956
SURESTE,2023-01-27,82,31,51,0.621951219512195
SURESTE,2023-01-28,85,36,49,0.576470588235294
SURESTE,2023-01-29,95,45,50,0.526315789473684
SURESTE,2023-01-30,102,37,65,0.637254901960784
SURESTE,2023-01-31,110,38,72,0.654545454545455
SURESTE,2023-02-01,103,42,61,0.592233009708738
SURESTE,2023-02-02,114,51,63,0.552631578947368
SURESTE,2023-02-03,116,36,80,0.689655172413793
SURESTE,2023-02-04,116,34,82,0.706896551724138
SURESTE,2023-02-05,119,45,74,0.621848739495798
SURESTE,2023-02-06,111,32,79,0.711711711711712
SURESTE,2023-02-07,93,37,56,0.602150537634409
SURESTE,2023-02-08,103,34,69,0.669902912621359
SURESTE,2023-02-09,93,32,61,0.655913978494624
SURESTE,2023-02-10,94,29,65,0.691489361702128
SURESTE,2023-02-11,114,41,73,0.640350877192982
SURESTE,2023-02-12,119,56,63,0.529411764705882
SURESTE,2023-02-13,89,36,53,0.595505617977528
SURESTE,2023-02-14,108,36,73,0.675925925925926
SURESTE,2023-02-15,99,39,60,0.606060606060606
SURESTE,2023-02-16,106,36,70,0.660377358490566
SURESTE,2023-02-17,87,32,55,0.632183908045977
SURESTE,2023-02-18,115,46,69,0.6
SURESTE,2023-02-19,105,33,72,0.685714285714286
SURESTE,2023-02-20,99,51,48,0.484848484848485
SURESTE,2023-02-21,117,58,59,0.504273504273504
SURESTE,2023-02-22,93,41,52,0.559139784946237
SURESTE,2023-02-23,103,51,52,0.504854368932039
SURESTE,2023-02-24,82,54,28,0.341463414634146
SURESTE,2023-02-25,102,51,51,0.5
SURESTE,2023-02-26,117,59,58,0.495726495726496
SURESTE,2023-02-27,109,67,42,0.385321100917431
SURESTE,2023-02-28,86,47,39,0.453488372093023
SURESTE,2023-03-01,84,52,32,0.380952380952381
SURESTE,2023-03-02,112,59,53,0.473214285714286
SURESTE,2023-03-03,112,66,46,0.410714285714286
SURESTE,2023-03-04,144,76,68,0.472222222222222
SURESTE,2023-03-05,122,54,68,0.557377049180328
SURESTE,2023-03-06,100,65,35,0.35
SURESTE,2023-03-07,111,69,42,0.378378378378378
SURESTE,2023-03-08,100,75,25,0.25
SURESTE,2023-03-09,109,78,31,0.284403669724771
SURESTE,2023-03-10,100,73,27,0.27
SURESTE,2023-03-11,124,89,35,0.282258064516129
SURESTE,2023-03-12,109,77,32,0.293577981651376
SURESTE,2023-03-13,107,79,28,0.261682242990654
SURESTE,2023-03-14,119,92,27,0.226890756302521
SURESTE,2023-03-15,99,79,20,0.202020202020202
SURESTE,2023-03-16,106,91,15,0.141509433962264
SURESTE,2023-03-17,152,116,36,0.236842105263158
SURESTE,2023-03-18,151,127,24,0.158940397350993
SURESTE,2023-03-19,115,94,21,0.182608695652174
SURESTE,2023-03-20,125,100,25,0.2
SURESTE,2023-03-21,143,128,15,0.104895104895105
SURESTE,2023-03-22,123,113,10,0.0813008130081301
SURESTE,2023-03-23,113,106,7,0.0619469026548673
SURESTE,2023-03-24,137,126,11,0.0802919708029197
SURESTE,2023-03-25,133,128,5,0.037593984962406
SURESTE,2023-03-26,102,92,10,0.0980392156862745
SURESTE,2023-03-27,105,98,7,0.0666666666666667
SURESTE,2023-03-28,104,98,6,0.0576923076923077
SURESTE,2023-03-29,115,109,6,0.0521739130434783
SURESTE,2023-03-30,141,138,3,0.0212765957446809
SURESTE,2023-03-31,164,149,15,0.0914634146341463
SURESTE,2023-04-01,135,128,7,0.0518518518518519
SURESTE,2023-04-02,95,93,2,0.0210526315789474
SURESTE,2023-04-03,103,102,1,0.00970873786407767
SURESTE,2023-04-04,106,102,4,0.0377358490566038
SURESTE,2023-04-05,90,66,24,0.266666666666667
SURESTE,2023-04-06,104,98,6,0.0576923076923077
SURESTE,2023-04-07,88,86,2,0.0227272727272727
SURESTE,2023-04-08,83,79,4,0.0481927710843374
SURESTE,2023-04-09,51,48,3,0.0588235294117647
SURESTE,2023-04-10,94,89,5,0.0531914893617021
SURESTE,2023-04-11,102,96,6,0.0588235294117647
SURESTE,2023-04-12,115,104,11,0.0956521739130435
SURESTE,2023-04-13,105,101,4,0.0380952380952381
SURESTE,2023-04-14,124,119,5,0.0403225806451613
SURESTE,2023-04-15,168,159,9,0.0535714285714286
SURESTE,2023-04-16,160,160,0,0
SURESTE,2023-04-17,147,143,4,0.0272108843537415
SURESTE,2023-04-18,128,124,4,0.03125
SURESTE,2023-04-19,135,128,7,0.0518518518518519
SURESTE,2023-04-20,134,123,11,0.082089552238806
SURESTE,2023-04-21,133,130,3,0.0225563909774436
SURESTE,2023-04-22,126,119,7,0.0555555555555556
SURESTE,2023-04-23,101,97,4,0.0396039603960396
SURESTE,2023-04-24,147,143,4,0.0272108843537415
SURESTE,2023-04-25,182,175,7,0.0384615384615385
SURESTE,2023-04-26,151,146,5,0.033112582781457
SURESTE,2023-04-27,131,124,7,0.0534351145038168
SURESTE,2023-04-28,120,114,6,0.05
SURESTE,2023-04-29,185,178,7,0.0378378378378378
SURESTE,2023-04-30,133,125,8,0.0601503759398496
SURESTE,2023-05-01,128,124,4,0.03125
SURESTE,2023-05-02,123,118,5,0.040650406504065
SURESTE,2023-05-03,110,105,5,0.0454545454545455
SURESTE,2023-05-04,90,84,6,0.0666666666666667
SURESTE,2023-05-05,106,102,4,0.0377358490566038
SURESTE,2023-05-06,118,115,3,0.0254237288135593
SURESTE,2023-05-07,95,90,5,0.0526315789473684
SURESTE,2023-05-08,100,95,5,0.05
SURESTE,2023-05-09,105,104,1,0.00952380952380952
SURESTE,2023-05-10,94,89,5,0.0531914893617021
SURESTE,2023-05-11,108,98,10,0.0925925925925926
SURESTE,2023-05-12,119,117,2,0.0168067226890756
SURESTE,2023-05-13,161,158,3,0.0186335403726708
SURESTE,2023-05-14,159,150,9,0.0566037735849057
SURESTE,2023-05-15,150,146,4,0.0266666666666667
SURESTE,2023-05-16,188,179,9,0.0478723404255319
SURESTE,2023-05-17,128,123,5,0.0390625
SURESTE,2023-05-18,98,91,7,0.0714285714285714
SURESTE,2023-05-19,116,110,6,0.0517241379310345
SURESTE,2023-05-20,154,153,1,0.00649350649350649
SURESTE,2023-05-21,136,131,5,0.0367647058823529
SURESTE,2023-05-22,118,110,8,0.0677966101694915
SURESTE,2023-05-23,128,120,8,0.0625
SURESTE,2023-05-24,121,117,4,0.0330578512396694
SURESTE,2023-05-25,106,100,6,0.0566037735849057
SURESTE,2023-05-26,149,145,4,0.0268456375838926
SURESTE,2023-05-27,176,173,3,0.0170454545454545
SURESTE,2023-05-28,116,115,1,0.00862068965517241
SURESTE,2023-05-29,158,152,6,0.0379746835443038
SURESTE,2023-05-30,191,190,1,0.00523560209424084
SURESTE,2023-05-31,169,161,8,0.0473372781065089
SURESTE,2023-06-01,261,255,6,0.0229885057471264
SURESTE,2023-06-02,183,176,7,0.0382513661202186
SURESTE,2023-06-03,200,196,4,0.02
SURESTE,2023-06-04,244,235,9,0.0368852459016393
SURESTE,2023-06-05,151,148,3,0.0198675496688742
SURESTE,2023-06-06,129,123,6,0.0465116279069767
SURESTE,2023-06-07,117,111,6,0.0512820512820513
SURESTE,2023-06-08,134,132,2,0.0149253731343284
SURESTE,2023-06-09,134,128,6,0.0447761194029851
SURESTE,2023-06-10,152,144,8,0.0526315789473684
SURESTE,2023-06-11,155,151,4,0.0258064516129032
SURESTE,2023-06-12,124,120,4,0.032258064516129
SURESTE,2023-06-13,120,118,2,0.0166666666666667
SURESTE,2023-06-14,113,109,4,0.0353982300884956
SURESTE,2023-06-15,149,147,2,0.0134228187919463
SURESTE,2023-06-16,146,143,3,0.0205479452054795
SURESTE,2023-06-17,193,188,5,0.0259067357512953
SURESTE,2023-06-18,182,178,4,0.021978021978022
SURESTE,2023-06-19,166,163,3,0.0180722891566265
SURESTE,2023-06-20,174,168,6,0.0344827586206897
SURESTE,2023-06-21,166,158,8,0.0481927710843374
SURESTE,2023-06-22,150,142,8,0.0533333333333333
SURESTE,2023-06-23,128,122,6,0.046875
SURESTE,2023-06-24,145,144,1,0.00689655172413793
SURESTE,2023-06-25,158,155,3,0.0189873417721519
SURESTE,2023-06-26,154,150,4,0.025974025974026
SURESTE,2023-06-27,158,153,5,0.0316455696202532
SURESTE,2023-06-28,157,152,5,0.0318471337579618
SURESTE,2023-06-29,169,168,1,0.00591715976331361
SURESTE,2023-06-30,93,84,9,0.0967741935483871
SURESTE,2023-07-01,182,177,5,0.0274725274725275
SURESTE,2023-07-02,166,166,0,0
SURESTE,2023-07-03,176,170,6,0.0340909090909091
SURESTE,2023-07-04,122,118,4,0.0327868852459016
SURESTE,2023-07-05,126,123,3,0.0238095238095238
SURESTE,2023-07-06,147,144,3,0.0204081632653061
SURESTE,2023-07-07,158,154,4,0.0253164556962025
SURESTE,2023-07-08,171,168,3,0.0175438596491228
SURESTE,2023-07-09,141,138,3,0.0212765957446809
SURESTE,2023-07-10,270,262,8,0.0296296296296296
SURESTE,2023-07-11,221,218,3,0.0135746606334842
SURESTE,2023-07-12,210,205,5,0.0238095238095238
SURESTE,2023-07-13,198,192,6,0.0303030303030303
SURESTE,2023-07-14,199,195,4,0.0201005025125628
SURESTE,2023-07-15,222,218,4,0.018018018018018
SURESTE,2023-07-16,207,205,2,0.00966183574879227
SURESTE,2023-07-17,222,217,5,0.0225225225225225
SURESTE,2023-07-18,196,192,4,0.0204081632653061
SURESTE,2023-07-19,172,167,5,0.0290697674418605
SURESTE,2023-07-20,235,229,6,0.025531914893617
SURESTE,2023-07-21,189,183,6,0.0317460317460317
SURESTE,2023-07-22,228,226,2,0.0087719298245614
SURESTE,2023-07-23,200,198,2,0.01
SURESTE,2023-07-24,207,206,1,0.00483091787439614
SURESTE,2023-07-25,216,208,8,0.037037037037037
SURESTE,2023-07-26,209,203,6,0.0287081339712919
SURESTE,2023-07-27,181,176,5,0.0276243093922652
SURESTE,2023-07-28,201,197,4,0.0199004975124378
SURESTE,2023-07-29,264,262,2,0.00757575757575758
SURESTE,2023-07-30,217,216,1,0.00460829493087558
SURESTE,2023-07-31,271,267,4,0.014760147601476
SURESTE,2023-08-01,213,206,7,0.0328638497652582
SURESTE,2023-08-02,214,211,3,0.014018691588785
SURESTE,2023-08-03,181,159,22,0.121546961325967
SURESTE,2023-08-04,191,186,5,0.0261780104712042
SURESTE,2023-08-05,201,190,11,0.054726368159204
SURESTE,2023-08-06,202,200,2,0.0099009900990099
SURESTE,2023-08-07,200,192,8,0.04
SURESTE,2023-08-08,181,175,6,0.0331491712707182
SURESTE,2023-08-09,205,202,3,0.0146341463414634
SURESTE,2023-08-10,198,194,4,0.0202020202020202
SURESTE,2023-08-11,178,165,13,0.0730337078651685
SURESTE,2023-08-12,201,193,8,0.0398009950248756
SURESTE,2023-08-13,217,210,7,0.032258064516129
SURESTE,2023-08-14,187,180,7,0.0374331550802139
SURESTE,2023-08-15,198,195,3,0.0151515151515152
SURESTE,2023-08-16,209,203,6,0.0287081339712919
SURESTE,2023-08-17,195,185,10,0.0512820512820513
SURESTE,2023-08-18,252,245,7,0.0277777777777778
SURESTE,2023-08-19,236,228,8,0.0338983050847458
SURESTE,2023-08-20,211,204,7,0.033175355450237
SURESTE,2023-08-21,199,199,0,0
SURESTE,2023-08-22,178,175,3,0.0168539325842697
SURESTE,2023-08-23,178,177,1,0.00561797752808989
SURESTE,2023-08-24,219,218,1,0.0045662100456621
SURESTE,2023-08-25,209,206,3,0.0143540669856459
SURESTE,2023-08-26,241,238,3,0.012448132780083
SURESTE,2023-08-27,199,199,0,0
SURESTE,2023-08-28,209,204,5,0.0239234449760766
SURESTE,2023-08-29,207,206,1,0.00483091787439614
SURESTE,2023-08-30,198,197,1,0.00505050505050505
SURESTE,2023-08-31,200,199,1,0.005
SURESTE,2023-09-01,191,191,0,0
SURESTE,2023-09-02,203,201,2,0.00985221674876847
SURESTE,2023-09-03,176,175,1,0.00568181818181818
SURESTE,2023-09-04,162,161,1,0.00617283950617284
SURESTE,2023-09-05,223,222,1,0.00448430493273543
SURESTE,2023-09-06,202,201,1,0.00495049504950495
SURESTE,2023-09-07,228,227,1,0.0043859649122807
SURESTE,2023-09-08,220,220,0,0
SURESTE,2023-09-09,225,224,1,0.00444444444444444
SURESTE,2023-09-10,180,180,0,0
SURESTE,2023-09-11,202,200,2,0.0099009900990099
SURESTE,2023-09-12,234,233,1,0.00427350427350427
SURESTE,2023-09-13,211,209,2,0.00947867298578199
SURESTE,2023-09-14,204,202,2,0.00980392156862745
SURESTE,2023-09-15,222,220,2,0.00900900900900901
SURESTE,2023-09-16,207,206,1,0.00483091787439614
SURESTE,2023-09-17,169,168,1,0.00591715976331361
SURESTE,2023-09-18,189,189,0,0
SURESTE,2023-09-19,189,188,1,0.00529100529100529
SURESTE,2023-09-20,182,179,3,0.0164835164835165
SURESTE,2023-09-21,187,186,1,0.0053475935828877
SURESTE,2023-09-22,196,195,1,0.00510204081632653
SURESTE,2023-09-23,224,222,2,0.00892857142857143
SURESTE,2023-09-24,180,178,2,0.0111111111111111
SURESTE,2023-09-25,192,190,2,0.0104166666666667
SURESTE,2023-09-26,205,204,1,0.0048780487804878
SURESTE,2023-09-27,212,212,0,0
SURESTE,2023-09-28,188,186,2,0.0106382978723404
SURESTE,2023-09-29,238,237,1,0.00420168067226891
SURESTE,2023-09-30,249,248,1,0.00401606425702811
SURESTE,2023-10-01,196,196,0,0
SURESTE,2023-10-02,198,198,0,0
SURESTE,2023-10-03,195,192,3,0.0153846153846154
SURESTE,2023-10-04,167,164,3,0.0179640718562874
SURESTE,2023-10-05,176,172,4,0.0227272727272727
SURESTE,2023-10-06,187,182,5,0.0267379679144385
SURESTE,2023-10-07,199,196,3,0.0150753768844221
SURESTE,2023-10-08,156,152,4,0.0256410256410256
SURESTE,2023-10-09,162,158,4,0.0246913580246914
SURESTE,2023-10-10,155,149,6,0.0387096774193548
SURESTE,2023-10-11,176,169,7,0.0397727272727273
SURESTE,2023-10-12,144,142,2,0.0138888888888889
SURESTE,2023-10-13,180,179,1,0.00555555555555556
SURESTE,2023-10-14,189,189,0,0
SURESTE,2023-10-15,174,170,4,0.0229885057471264
SURESTE,2023-10-16,179,177,2,0.0111731843575419
SURESTE,2023-10-17,189,182,7,0.037037037037037
SURESTE,2023-10-18,214,207,7,0.0327102803738318
SURESTE,2023-10-19,193,188,5,0.0259067357512953
SURESTE,2023-10-20,197,193,4,0.0203045685279188
SURESTE,2023-10-21,212,207,5,0.0235849056603774
SURESTE,2023-10-22,160,151,9,0.05625
SURESTE,2023-10-23,144,140,4,0.0277777777777778
SURESTE,2023-10-24,174,168,6,0.0344827586206897
SURESTE,2023-10-25,181,177,4,0.0220994475138122
SURESTE,2023-10-26,189,183,6,0.0317460317460317
SURESTE,2023-10-27,195,189,6,0.0307692307692308
SURESTE,2023-10-28,214,213,1,0.00467289719626168
SURESTE,2023-10-29,146,142,4,0.0273972602739726
SURESTE,2023-10-30,209,202,7,0.0334928229665072
SURESTE,2023-10-31,211,207,4,0.018957345971564
SURESTE,2023-11-01,202,199,3,0.0148514851485149
SURESTE,2023-11-02,184,181,3,0.016304347826087
SURESTE,2023-11-03,197,192,5,0.0253807106598985
SURESTE,2023-11-04,185,178,7,0.0378378378378378
SURESTE,2023-11-05,174,171,3,0.0172413793103448
SURESTE,2023-11-06,200,193,7,0.035
SURESTE,2023-11-07,211,209,2,0.00947867298578199
SURESTE,2023-11-08,229,220,9,0.0393013100436681
SURESTE,2023-11-09,217,214,3,0.0138248847926267
SURESTE,2023-11-10,190,187,3,0.0157894736842105
SURESTE,2023-11-11,223,220,3,0.0134529147982063
SURESTE,2023-11-12,218,215,3,0.0137614678899083
SURESTE,2023-11-13,203,195,8,0.0394088669950739
SURESTE,2023-11-14,229,223,6,0.0262008733624454
SURESTE,2023-11-15,275,260,15,0.0545454545454545
SURESTE,2023-11-16,240,233,7,0.0291666666666667
SURESTE,2023-11-17,232,224,8,0.0344827586206897
SURESTE,2023-11-18,285,279,6,0.0210526315789474
SURESTE,2023-11-19,246,238,8,0.032520325203252
SURESTE,2023-11-20,256,254,2,0.0078125
SURESTE,2023-11-21,234,229,5,0.0213675213675214
SURESTE,2023-11-22,212,206,6,0.0283018867924528
SURESTE,2023-11-23,228,225,3,0.0131578947368421
SURESTE,2023-11-24,201,196,5,0.0248756218905473
SURESTE,2023-11-25,237,230,7,0.029535864978903
SURESTE,2023-11-26,209,205,4,0.0191387559808612
SURESTE,2023-11-27,242,236,6,0.0247933884297521
SURESTE,2023-11-28,242,237,5,0.0206611570247934
SURESTE,2023-11-29,247,239,8,0.0323886639676113
SURESTE,2023-11-30,263,255,8,0.0304182509505703
SURESTE,2023-12-01,223,212,11,0.0493273542600897
SURESTE,2023-12-02,238,233,5,0.0210084033613445
SURESTE,2023-12-03,164,160,4,0.024390243902439
SURESTE,2023-12-04,180,179,1,0.00555555555555556
SURESTE,2023-12-05,199,192,7,0.0351758793969849
SURESTE,2023-12-06,209,204,5,0.0239234449760766
SURESTE,2023-12-07,227,222,5,0.0220264317180617
SURESTE,2023-12-08,232,224,8,0.0344827586206897
SURESTE,2023-12-09,248,242,6,0.0241935483870968
SURESTE,2023-12-10,195,188,7,0.0358974358974359
SURESTE,2023-12-11,196,191,5,0.0255102040816327
SURESTE,2023-12-12,198,191,7,0.0353535353535354
SURESTE,2023-12-13,197,194,3,0.0152284263959391
SURESTE,2023-12-14,213,205,8,0.0375586854460094
SURESTE,2023-12-15,177,174,3,0.0169491525423729
SURESTE,2023-12-16,212,210,2,0.00943396226415094
SURESTE,2023-12-17,199,197,2,0.0100502512562814