DIRECCION,Fecha,Instalaciones,Activaciones_automaticas,Activaciones_manuales,PorcAM
CENTRO 1,2023-02-15,677,334,343,0.506646971935007
CENTRO 1,2023-02-16,620,300,320,0.516129032258065
CENTRO 1,2023-02-17,613,307,306,0.499184339314845
CENTRO 1,2023-02-18,774,360,414,0.534883720930233
CENTRO 1,2023-02-19,722,335,387,0.53601108033241
CENTRO 1,2023-02-20,691,361,330,0.477568740955137
CENTRO 1,2023-02-21,659,466,193,0.292867981790592
CENTRO 1,2023-02-22,618,452,166,0.268608414239482
CENTRO 1,2023-02-23,606,494,112,0.184818481848185
CENTRO 1,2023-02-24,651,536,115,0.176651305683564
CENTRO 1,2023-02-25,786,607,179,0.227735368956743
CENTRO 1,2023-02-26,701,517,184,0.262482168330956
CENTRO 1,2023-02-27,678,536,142,0.209439528023599
CENTRO 1,2023-02-28,793,633,160,0.201765447667087
CENTRO 1,2023-03-01,624,502,122,0.195512820512821
CENTRO 1,2023-03-02,655,532,123,0.187786259541985
CENTRO 1,2023-03-03,734,616,118,0.160762942779292
CENTRO 1,2023-03-04,811,648,163,0.20098643649815
CENTRO 1,2023-03-05,739,549,190,0.257104194857916
CENTRO 1,2023-03-06,634,517,117,0.184542586750789
CENTRO 1,2023-03-07,690,563,127,0.184057971014493
CENTRO 1,2023-03-08,724,621,103,0.142265193370166
CENTRO 1,2023-03-09,707,618,89,0.125884016973126
CENTRO 1,2023-03-10,583,521,62,0.106346483704974
CENTRO 1,2023-03-11,788,702,86,0.109137055837563
CENTRO 1,2023-03-12,625,551,74,0.1184
CENTRO 1,2023-03-13,674,589,85,0.126112759643917
CENTRO 1,2023-03-14,714,643,71,0.0994397759103641
CENTRO 1,2023-03-15,681,655,26,0.0381791483113069
CENTRO 1,2023-03-16,813,797,16,0.019680196801968
CENTRO 1,2023-03-17,1056,1037,19,0.0179924242424242
CENTRO 1,2023-03-18,1154,1117,37,0.0320623916811092
CENTRO 1,2023-03-19,1094,1050,44,0.0402193784277879
CENTRO 1,2023-03-20,1214,1190,24,0.0197693574958814
CENTRO 1,2023-03-21,907,893,14,0.0154355016538037
CENTRO 1,2023-03-22,814,803,11,0.0135135135135135
CENTRO 1,2023-03-23,753,742,11,0.0146082337317397
CENTRO 1,2023-03-24,811,807,4,0.00493218249075216
CENTRO 1,2023-03-25,925,921,4,0.00432432432432432
CENTRO 1,2023-03-26,891,885,6,0.00673400673400673
CENTRO 1,2023-03-27,686,680,6,0.0087463556851312
CENTRO 1,2023-03-28,586,584,2,0.00341296928327645
CENTRO 1,2023-03-29,663,657,6,0.00904977375565611
CENTRO 1,2023-03-30,871,861,10,0.0114810562571757
CENTRO 1,2023-03-31,1093,1080,13,0.0118938700823422
CENTRO 1,2023-04-01,971,959,12,0.0123583934088568
CENTRO 1,2023-04-02,850,845,5,0.00588235294117647
CENTRO 1,2023-04-03,961,948,13,0.0135275754422477
CENTRO 1,2023-04-04,597,588,9,0.0150753768844221
CENTRO 1,2023-04-05,716,707,9,0.0125698324022346
CENTRO 1,2023-04-06,742,732,10,0.0134770889487871
CENTRO 1,2023-04-07,603,599,4,0.0066334991708126
CENTRO 1,2023-04-08,549,545,4,0.00728597449908925
CENTRO 1,2023-04-09,480,478,2,0.00416666666666667
CENTRO 1,2023-04-10,562,558,4,0.00711743772241993
CENTRO 1,2023-04-11,638,629,9,0.0141065830721003
CENTRO 1,2023-04-12,708,702,6,0.00847457627118644
CENTRO 1,2023-04-13,639,626,13,0.0203442879499218
CENTRO 1,2023-04-14,806,805,1,0.00124069478908189
CENTRO 1,2023-04-15,1018,1014,4,0.00392927308447937
CENTRO 1,2023-04-16,1042,1040,2,0.00191938579654511
CENTRO 1,2023-04-17,907,899,8,0.00882028665931643
CENTRO 1,2023-04-18,742,738,4,0.00539083557951483
CENTRO 1,2023-04-19,702,700,2,0.00284900284900285
CENTRO 1,2023-04-20,641,638,3,0.0046801872074883
CENTRO 1,2023-04-21,739,736,3,0.0040595399188092
CENTRO 1,2023-04-22,840,839,1,0.00119047619047619
CENTRO 1,2023-04-23,738,737,1,0.0013550135501355
CENTRO 1,2023-04-24,830,825,5,0.00602409638554217
CENTRO 1,2023-04-25,921,915,6,0.00651465798045603
CENTRO 1,2023-04-26,804,800,4,0.00497512437810945
CENTRO 1,2023-04-27,627,621,6,0.00956937799043062
CENTRO 1,2023-04-28,837,827,10,0.01194743130227
CENTRO 1,2023-04-29,992,981,11,0.0110887096774194
CENTRO 1,2023-04-30,865,848,17,0.0196531791907514
CENTRO 1,2023-05-01,846,833,13,0.0153664302600473
CENTRO 1,2023-05-02,755,745,10,0.0132450331125828
CENTRO 1,2023-05-03,654,644,10,0.0152905198776758
CENTRO 1,2023-05-04,596,588,8,0.0134228187919463
CENTRO 1,2023-05-05,704,696,8,0.0113636363636364
CENTRO 1,2023-05-06,748,738,10,0.0133689839572193
CENTRO 1,2023-05-07,581,572,9,0.0154905335628227
CENTRO 1,2023-05-08,646,638,8,0.0123839009287926
CENTRO 1,2023-05-09,652,633,19,0.0291411042944785
CENTRO 1,2023-05-10,609,593,16,0.0262725779967159
CENTRO 1,2023-05-11,606,600,6,0.0099009900990099
CENTRO 1,2023-05-12,622,616,6,0.00964630225080386
CENTRO 1,2023-05-13,947,931,16,0.0168954593453009
CENTRO 1,2023-05-14,1051,1040,11,0.0104662226450999
CENTRO 1,2023-05-15,1150,1132,18,0.0156521739130435
CENTRO 1,2023-05-16,1213,1198,15,0.0123660346248969
CENTRO 1,2023-05-17,931,914,17,0.0182599355531686
CENTRO 1,2023-05-18,712,700,12,0.0168539325842697
CENTRO 1,2023-05-19,753,740,13,0.0172642762284197
CENTRO 1,2023-05-20,925,904,21,0.0227027027027027
CENTRO 1,2023-05-21,839,831,8,0.00953516090584029
CENTRO 1,2023-05-22,800,790,10,0.0125
CENTRO 1,2023-05-23,751,735,16,0.0213049267643142
CENTRO 1,2023-05-24,703,686,17,0.0241820768136558
CENTRO 1,2023-05-25,713,700,13,0.0182328190743338
CENTRO 1,2023-05-26,881,865,16,0.018161180476731
CENTRO 1,2023-05-27,875,850,25,0.0285714285714286
CENTRO 1,2023-05-28,790,782,8,0.010126582278481
CENTRO 1,2023-05-29,725,717,8,0.0110344827586207
CENTRO 1,2023-05-30,862,845,17,0.0197215777262181
CENTRO 1,2023-05-31,961,946,15,0.0156087408949011
CENTRO 1,2023-06-01,675,662,13,0.0192592592592593
CENTRO 1,2023-06-02,634,622,12,0.0189274447949527
CENTRO 1,2023-06-03,858,849,9,0.0104895104895105
CENTRO 1,2023-06-04,873,858,15,0.0171821305841924
CENTRO 1,2023-06-05,855,835,20,0.0233918128654971
CENTRO 1,2023-06-06,690,681,9,0.0130434782608696
CENTRO 1,2023-06-07,646,630,16,0.0247678018575851
CENTRO 1,2023-06-08,605,593,12,0.0198347107438017
CENTRO 1,2023-06-09,707,695,12,0.016973125884017
CENTRO 1,2023-06-10,885,865,20,0.0225988700564972
CENTRO 1,2023-06-11,786,770,16,0.0203562340966921
CENTRO 1,2023-06-12,760,743,17,0.0223684210526316
CENTRO 1,2023-06-13,759,748,11,0.0144927536231884
CENTRO 1,2023-06-14,779,766,13,0.0166880616174583
CENTRO 1,2023-06-15,780,761,19,0.0243589743589744
CENTRO 1,2023-06-16,804,789,15,0.0186567164179104
CENTRO 1,2023-06-17,942,922,20,0.0212314225053079
CENTRO 1,2023-06-18,691,681,10,0.0144717800289436
CENTRO 1,2023-06-19,783,775,8,0.0102171136653895
CENTRO 1,2023-06-20,808,797,11,0.0136138613861386
CENTRO 1,2023-06-21,712,695,17,0.023876404494382
CENTRO 1,2023-06-22,678,664,14,0.0206489675516224
CENTRO 1,2023-06-23,746,724,22,0.0294906166219839
CENTRO 1,2023-06-24,856,836,20,0.0233644859813084
CENTRO 1,2023-06-25,698,680,18,0.0257879656160458
CENTRO 1,2023-06-26,756,742,14,0.0185185185185185
CENTRO 1,2023-06-27,662,651,11,0.0166163141993958
CENTRO 1,2023-06-28,714,699,15,0.0210084033613445
CENTRO 1,2023-06-29,766,749,17,0.0221932114882507
CENTRO 1,2023-06-30,581,538,43,0.0740103270223752
CENTRO 1,2023-07-01,917,902,15,0.0163576881134133
CENTRO 1,2023-07-02,727,714,13,0.0178817056396149
CENTRO 1,2023-07-03,740,726,14,0.0189189189189189
CENTRO 1,2023-07-04,672,656,16,0.0238095238095238
CENTRO 1,2023-07-05,731,720,11,0.0150478796169631
CENTRO 1,2023-07-06,601,584,17,0.0282861896838602
CENTRO 1,2023-07-07,763,746,17,0.0222804718217562
CENTRO 1,2023-07-08,797,776,21,0.0263488080301129
CENTRO 1,2023-07-09,697,684,13,0.0186513629842181
CENTRO 1,2023-07-10,715,700,15,0.020979020979021
CENTRO 1,2023-07-11,712,694,18,0.0252808988764045
CENTRO 1,2023-07-12,732,712,20,0.0273224043715847
CENTRO 1,2023-07-13,655,633,22,0.033587786259542
CENTRO 1,2023-07-14,733,712,21,0.0286493860845839
CENTRO 1,2023-07-15,873,858,15,0.0171821305841924
CENTRO 1,2023-07-16,733,715,18,0.0245566166439291
CENTRO 1,2023-07-17,754,735,19,0.0251989389920424
CENTRO 1,2023-07-18,787,773,14,0.0177890724269377
CENTRO 1,2023-07-19,686,662,24,0.0349854227405248
CENTRO 1,2023-07-20,791,778,13,0.0164348925410872
CENTRO 1,2023-07-21,694,683,11,0.015850144092219
CENTRO 1,2023-07-22,836,820,16,0.0191387559808612
CENTRO 1,2023-07-23,757,740,17,0.0224570673712021
CENTRO 1,2023-07-24,701,688,13,0.0185449358059914
CENTRO 1,2023-07-25,789,767,22,0.0278833967046895
CENTRO 1,2023-07-26,901,885,16,0.0177580466148724
CENTRO 1,2023-07-27,827,813,14,0.0169286577992745
CENTRO 1,2023-07-28,832,818,14,0.0168269230769231
CENTRO 1,2023-07-29,894,886,8,0.00894854586129754
CENTRO 1,2023-07-30,927,908,19,0.0204962243797195
CENTRO 1,2023-07-31,991,975,16,0.0161453077699294
CENTRO 1,2023-08-01,807,783,24,0.0297397769516729
CENTRO 1,2023-08-02,737,719,18,0.0244233378561737
CENTRO 1,2023-08-03,709,660,49,0.0691114245416079
CENTRO 1,2023-08-04,818,796,22,0.0268948655256724
CENTRO 1,2023-08-05,879,855,24,0.0273037542662116
CENTRO 1,2023-08-06,769,746,23,0.0299089726918075
CENTRO 1,2023-08-07,762,747,15,0.0196850393700787
CENTRO 1,2023-08-08,742,721,21,0.0283018867924528
CENTRO 1,2023-08-09,782,754,28,0.0358056265984655
CENTRO 1,2023-08-10,732,710,22,0.0300546448087432
CENTRO 1,2023-08-11,802,788,14,0.0174563591022444
CENTRO 1,2023-08-12,819,796,23,0.0280830280830281
CENTRO 1,2023-08-13,874,832,42,0.0480549199084668
CENTRO 1,2023-08-14,791,768,23,0.0290771175726928
CENTRO 1,2023-08-15,934,914,20,0.0214132762312634
CENTRO 1,2023-08-16,839,819,20,0.0238379022646007
CENTRO 1,2023-08-17,739,722,17,0.0230040595399188
CENTRO 1,2023-08-18,793,779,14,0.0176544766708701
CENTRO 1,2023-08-19,829,811,18,0.0217129071170084
CENTRO 1,2023-08-20,766,747,19,0.0248041775456919
CENTRO 1,2023-08-21,710,709,1,0.00140845070422535
CENTRO 1,2023-08-22,746,745,1,0.00134048257372654
CENTRO 1,2023-08-23,751,749,2,0.00266311584553928
CENTRO 1,2023-08-24,762,760,2,0.0026246719160105
CENTRO 1,2023-08-25,829,829,0,0
CENTRO 1,2023-08-26,1009,1007,2,0.00198216055500496
CENTRO 1,2023-08-27,952,951,1,0.00105042016806723
CENTRO 1,2023-08-28,894,892,2,0.00223713646532438
CENTRO 1,2023-08-29,913,911,2,0.00219058050383352
CENTRO 1,2023-08-30,862,860,2,0.00232018561484919
CENTRO 1,2023-08-31,775,768,7,0.00903225806451613
CENTRO 1,2023-09-01,736,734,2,0.00271739130434783
CENTRO 1,2023-09-02,795,792,3,0.00377358490566038
CENTRO 1,2023-09-03,743,740,3,0.00403768506056528
CENTRO 1,2023-09-04,726,725,1,0.00137741046831956
CENTRO 1,2023-09-05,704,702,2,0.00284090909090909
CENTRO 1,2023-09-06,716,715,1,0.00139664804469274
CENTRO 1,2023-09-07,793,789,4,0.00504413619167718
CENTRO 1,2023-09-08,650,649,1,0.00153846153846154
CENTRO 1,2023-09-09,804,804,0,0
CENTRO 1,2023-09-10,768,766,2,0.00260416666666667
CENTRO 1,2023-09-11,670,669,1,0.00149253731343284
CENTRO 1,2023-09-12,619,616,3,0.00484652665589661
CENTRO 1,2023-09-13,625,624,1,0.0016
CENTRO 1,2023-09-14,647,645,2,0.00309119010819165
CENTRO 1,2023-09-15,575,569,6,0.0104347826086957
CENTRO 1,2023-09-16,622,618,4,0.00643086816720257
CENTRO 1,2023-09-17,695,693,2,0.00287769784172662
CENTRO 1,2023-09-18,686,685,1,0.00145772594752187
CENTRO 1,2023-09-19,647,643,4,0.00618238021638331
CENTRO 1,2023-09-20,518,516,2,0.00386100386100386
CENTRO 1,2023-09-21,702,698,4,0.0056980056980057
CENTRO 1,2023-09-22,866,864,2,0.0023094688221709
CENTRO 1,2023-09-23,851,850,1,0.00117508813160987
CENTRO 1,2023-09-24,875,873,2,0.00228571428571429
CENTRO 1,2023-09-25,743,741,2,0.00269179004037685
CENTRO 1,2023-09-26,731,728,3,0.00410396716826265
CENTRO 1,2023-09-27,694,691,3,0.00432276657060519
CENTRO 1,2023-09-28,817,811,6,0.00734394124847001
CENTRO 1,2023-09-29,896,893,3,0.00334821428571429
CENTRO 1,2023-09-30,1088,1081,7,0.00643382352941176
CENTRO 1,2023-10-01,745,741,4,0.00536912751677852
CENTRO 1,2023-10-02,718,716,2,0.00278551532033426
CENTRO 1,2023-10-03,663,643,20,0.0301659125188537
CENTRO 1,2023-10-04,660,645,15,0.0227272727272727
CENTRO 1,2023-10-05,656,634,22,0.0335365853658537
CENTRO 1,2023-10-06,731,702,29,0.039671682626539
CENTRO 1,2023-10-07,848,823,25,0.0294811320754717
CENTRO 1,2023-10-08,764,742,22,0.0287958115183246
CENTRO 1,2023-10-09,727,704,23,0.031636863823934
CENTRO 1,2023-10-10,603,586,17,0.0281923714759536
CENTRO 1,2023-10-11,619,604,15,0.024232633279483
CENTRO 1,2023-10-12,583,568,15,0.0257289879931389
CENTRO 1,2023-10-13,675,657,18,0.0266666666666667
CENTRO 1,2023-10-14,864,845,19,0.0219907407407407
CENTRO 1,2023-10-15,862,836,26,0.0301624129930394
CENTRO 1,2023-10-16,820,802,18,0.0219512195121951
CENTRO 1,2023-10-17,762,737,25,0.0328083989501312
CENTRO 1,2023-10-18,678,655,23,0.0339233038348083
CENTRO 1,2023-10-19,709,690,19,0.0267983074753173
CENTRO 1,2023-10-20,734,718,16,0.0217983651226158
CENTRO 1,2023-10-21,916,893,23,0.0251091703056769
CENTRO 1,2023-10-22,806,777,29,0.0359801488833747
CENTRO 1,2023-10-23,785,764,21,0.0267515923566879
CENTRO 1,2023-10-24,726,702,24,0.0330578512396694
CENTRO 1,2023-10-25,626,605,21,0.0335463258785942
CENTRO 1,2023-10-26,599,582,17,0.0283806343906511
CENTRO 1,2023-10-27,650,630,20,0.0307692307692308
CENTRO 1,2023-10-28,796,777,19,0.0238693467336683
CENTRO 1,2023-10-29,756,737,19,0.0251322751322751
CENTRO 1,2023-10-30,729,692,37,0.0507544581618656
CENTRO 1,2023-10-31,958,931,27,0.0281837160751566
CENTRO 1,2023-11-01,725,700,25,0.0344827586206897
CENTRO 1,2023-11-02,676,659,17,0.0251479289940828
CENTRO 1,2023-11-03,650,629,21,0.0323076923076923
CENTRO 1,2023-11-04,898,876,22,0.0244988864142539
CENTRO 1,2023-11-05,937,905,32,0.0341515474919957
CENTRO 1,2023-11-06,897,875,22,0.0245261984392419
CENTRO 1,2023-11-07,929,901,28,0.0301399354144241
CENTRO 1,2023-11-08,875,852,23,0.0262857142857143
CENTRO 1,2023-11-09,786,760,26,0.0330788804071247
CENTRO 1,2023-11-10,807,793,14,0.0173482032218092
CENTRO 1,2023-11-11,1003,981,22,0.0219341974077767
CENTRO 1,2023-11-12,893,875,18,0.0201567749160134
CENTRO 1,2023-11-13,902,859,43,0.0476718403547672
CENTRO 1,2023-11-14,935,906,29,0.0310160427807487
CENTRO 1,2023-11-15,985,961,24,0.0243654822335025
CENTRO 1,2023-11-16,1085,1055,30,0.0276497695852535
CENTRO 1,2023-11-17,1139,1121,18,0.0158033362598771
CENTRO 1,2023-11-18,1287,1252,35,0.0271950271950272
CENTRO 1,2023-11-19,1301,1267,34,0.0261337432744043
CENTRO 1,2023-11-20,1290,1263,27,0.0209302325581395
CENTRO 1,2023-11-21,1078,1050,28,0.025974025974026
CENTRO 1,2023-11-22,919,893,26,0.0282916213275299
CENTRO 1,2023-11-23,883,859,24,0.0271800679501699
CENTRO 1,2023-11-24,916,886,30,0.0327510917030568
CENTRO 1,2023-11-25,1046,1027,19,0.0181644359464627
CENTRO 1,2023-11-26,943,917,26,0.0275715800636267
CENTRO 1,2023-11-27,978,942,36,0.0368098159509202
CENTRO 1,2023-11-28,1007,982,25,0.0248262164846077
CENTRO 1,2023-11-29,998,964,34,0.0340681362725451
CENTRO 1,2023-11-30,1201,1151,50,0.0416319733555371
CENTRO 1,2023-12-01,907,867,40,0.0441014332965821
CENTRO 1,2023-12-02,1044,997,47,0.0450191570881226
CENTRO 1,2023-12-03,1039,1002,37,0.0356111645813282
CENTRO 1,2023-12-04,947,913,34,0.0359028511087645
CENTRO 1,2023-12-05,853,816,37,0.0433763188745604
CENTRO 1,2023-12-06,856,825,31,0.036214953271028
CENTRO 1,2023-12-07,901,872,29,0.0321864594894562
CENTRO 1,2023-12-08,790,773,17,0.0215189873417722
CENTRO 1,2023-12-09,996,964,32,0.0321285140562249
CENTRO 1,2023-12-10,980,945,35,0.0357142857142857
CENTRO 1,2023-12-11,841,820,21,0.0249702734839477
CENTRO 1,2023-12-12,896,873,23,0.0256696428571429
CENTRO 1,2023-12-13,804,773,31,0.0385572139303483
CENTRO 1,2023-12-14,709,685,24,0.0338504936530324
CENTRO 1,2023-12-15,945,916,29,0.0306878306878307
CENTRO 1,2023-12-16,1075,1044,31,0.0288372093023256
CENTRO 1,2023-12-17,924,888,36,0.038961038961039
CENTRO 1,2023-12-18,954,925,29,0.030398322851153
CENTRO 1,2023-12-19,931,899,32,0.0343716433941998
CENTRO 1,2023-12-20,951,918,33,0.0347003154574132
CENTRO 1,2023-12-21,951,925,26,0.0273396424815983
CENTRO 1,2023-12-22,836,808,28,0.0334928229665072
CENTRO 1,2023-12-23,911,882,29,0.0318331503841932
CENTRO 1,2023-12-24,667,641,26,0.0389805097451274
CENTRO 1,2023-12-25,260,249,11,0.0423076923076923
CENTRO 1,2023-12-26,760,734,26,0.0342105263157895
CENTRO 1,2023-12-27,964,942,22,0.0228215767634855
CENTRO 1,2023-12-28,955,933,22,0.0230366492146597
CENTRO 1,2023-12-29,937,903,34,0.0362860192102455
CENTRO 1,2023-12-30,939,915,24,0.0255591054313099
CENTRO 1,2023-12-31,586,572,14,0.0238907849829352
CENTRO 1,2024-01-01,174,166,8,0.0459770114942529
CENTRO 1,2024-01-02,712,690,22,0.0308988764044944
CENTRO 1,2024-01-03,911,896,15,0.0164654226125137
CENTRO 1,2024-01-04,871,844,27,0.0309988518943743
CENTRO 1,2024-01-05,885,869,16,0.0180790960451977
CENTRO 1,2024-01-06,829,803,26,0.0313630880579011
CENTRO 1,2024-01-07,868,852,16,0.0184331797235023
CENTRO 1,2024-01-08,887,854,33,0.0372040586245772
CENTRO 1,2024-01-09,943,920,23,0.024390243902439
CENTRO 1,2024-01-10,889,861,28,0.031496062992126
CENTRO 1,2024-01-11,947,926,21,0.0221752903907075
CENTRO 1,2024-01-12,941,918,23,0.024442082890542
CENTRO 1,2024-01-13,1058,1031,27,0.0255198487712665
CENTRO 1,2024-01-14,1039,1012,27,0.0259865255052935
CENTRO 1,2024-01-15,977,951,26,0.0266120777891505
CENTRO 1,2024-01-16,998,973,25,0.0250501002004008
CENTRO 1,2024-01-17,859,830,29,0.0337601862630966
CENTRO 1,2024-01-18,948,931,17,0.0179324894514768
CENTRO 1,2024-01-19,855,835,20,0.0233918128654971
CENTRO 1,2024-01-20,971,943,28,0.0288362512873326
CENTRO 1,2024-01-21,868,850,18,0.0207373271889401
CENTRO 1,2024-01-22,846,823,23,0.0271867612293144
CENTRO 1,2024-01-23,886,856,30,0.0338600451467269
CENTRO 1,2024-01-24,905,871,34,0.0375690607734807
CENTRO 1,2024-01-25,813,789,24,0.029520295202952
CENTRO 1,2024-01-26,788,760,28,0.0355329949238579
CENTRO 1,2024-01-27,994,972,22,0.0221327967806841
CENTRO 1,2024-01-28,850,823,27,0.0317647058823529
CENTRO 1,2024-01-29,853,831,22,0.0257913247362251
CENTRO 1,2024-01-30,858,819,39,0.0454545454545455
CENTRO 1,2024-01-31,1018,992,26,0.0255402750491159
CENTRO 1,2024-02-01,884,850,34,0.0384615384615385
CENTRO 1,2024-02-02,799,784,15,0.0187734668335419
CENTRO 1,2024-02-03,937,916,21,0.0224119530416222
CENTRO 1,2024-02-04,874,854,20,0.022883295194508
CENTRO 1,2024-02-05,893,872,21,0.0235162374020157
CENTRO 1,2024-02-06,912,886,26,0.0285087719298246
CENTRO 1,2024-02-07,818,791,27,0.0330073349633252
CENTRO 1,2024-02-08,791,767,24,0.0303413400758533
CENTRO 1,2024-02-09,792,768,24,0.0303030303030303
CENTRO 1,2024-02-10,946,922,24,0.025369978858351
CENTRO 1,2024-02-11,774,745,29,0.0374677002583979
CENTRO 1,2024-02-12,697,675,22,0.0315638450502152
CENTRO 1,2024-02-13,809,789,20,0.0247218788627936
CENTRO 1,2024-02-14,690,668,22,0.0318840579710145
CENTRO 1,2024-02-15,781,762,19,0.0243277848911652
CENTRO 2,2023-02-15,551,319,232,0.421052631578947
CENTRO 2,2023-02-16,605,334,271,0.447933884297521
CENTRO 2,2023-02-17,561,293,268,0.477718360071301
CENTRO 2,2023-02-18,720,370,350,0.486111111111111
CENTRO 2,2023-02-19,480,271,209,0.435416666666667
CENTRO 2,2023-02-20,545,305,240,0.440366972477064
CENTRO 2,2023-02-21,542,318,224,0.413284132841328
CENTRO 2,2023-02-22,569,360,209,0.367311072056239
CENTRO 2,2023-02-23,528,330,198,0.375
CENTRO 2,2023-02-24,554,338,216,0.389891696750903
CENTRO 2,2023-02-25,664,409,255,0.384036144578313
CENTRO 2,2023-02-26,471,308,163,0.346072186836518
CENTRO 2,2023-02-27,593,356,237,0.399662731871838
CENTRO 2,2023-02-28,663,415,248,0.374057315233786
CENTRO 2,2023-03-01,611,373,238,0.389525368248772
CENTRO 2,2023-03-02,534,305,229,0.428838951310861
CENTRO 2,2023-03-03,652,409,243,0.372699386503067
CENTRO 2,2023-03-04,748,469,279,0.372994652406417
CENTRO 2,2023-03-05,553,325,228,0.412296564195298
CENTRO 2,2023-03-06,527,329,198,0.375711574952562
CENTRO 2,2023-03-07,606,387,219,0.361386138613861
CENTRO 2,2023-03-08,597,397,200,0.33500837520938
CENTRO 2,2023-03-09,554,390,164,0.296028880866426
CENTRO 2,2023-03-10,560,430,130,0.232142857142857
CENTRO 2,2023-03-11,640,466,174,0.271875
CENTRO 2,2023-03-12,506,375,131,0.258893280632411
CENTRO 2,2023-03-13,547,402,145,0.26508226691042
CENTRO 2,2023-03-14,584,445,139,0.238013698630137
CENTRO 2,2023-03-15,616,514,102,0.165584415584416
CENTRO 2,2023-03-16,662,555,107,0.161631419939577
CENTRO 2,2023-03-17,813,672,141,0.173431734317343
CENTRO 2,2023-03-18,919,767,152,0.165397170837867
CENTRO 2,2023-03-19,702,609,93,0.132478632478632
CENTRO 2,2023-03-20,825,706,119,0.144242424242424
CENTRO 2,2023-03-21,685,630,55,0.0802919708029197
CENTRO 2,2023-03-22,624,572,52,0.0833333333333333
CENTRO 2,2023-03-23,632,585,47,0.0743670886075949
CENTRO 2,2023-03-24,617,571,46,0.0745542949756888
CENTRO 2,2023-03-25,744,694,50,0.0672043010752688
CENTRO 2,2023-03-26,593,551,42,0.0708263069139966
CENTRO 2,2023-03-27,524,495,29,0.0553435114503817
CENTRO 2,2023-03-28,510,482,28,0.0549019607843137
CENTRO 2,2023-03-29,542,517,25,0.0461254612546125
CENTRO 2,2023-03-30,647,603,44,0.0680061823802164
CENTRO 2,2023-03-31,949,889,60,0.0632244467860906
CENTRO 2,2023-04-01,754,727,27,0.0358090185676393
CENTRO 2,2023-04-02,490,457,33,0.0673469387755102
CENTRO 2,2023-04-03,692,667,25,0.0361271676300578
CENTRO 2,2023-04-04,688,652,36,0.0523255813953488
CENTRO 2,2023-04-05,576,511,65,0.112847222222222
CENTRO 2,2023-04-06,637,611,26,0.0408163265306122
CENTRO 2,2023-04-07,455,440,15,0.032967032967033
CENTRO 2,2023-04-08,343,330,13,0.0379008746355685
CENTRO 2,2023-04-09,317,303,14,0.0441640378548896
CENTRO 2,2023-04-10,484,463,21,0.0433884297520661
CENTRO 2,2023-04-11,529,493,36,0.0680529300567108
CENTRO 2,2023-04-12,568,531,37,0.0651408450704225
CENTRO 2,2023-04-13,550,523,27,0.0490909090909091
CENTRO 2,2023-04-14,644,599,45,0.0698757763975155
CENTRO 2,2023-04-15,898,822,76,0.0846325167037862
CENTRO 2,2023-04-16,729,698,31,0.0425240054869684
CENTRO 2,2023-04-17,683,646,37,0.0541727672035139
CENTRO 2,2023-04-18,640,583,57,0.0890625
CENTRO 2,2023-04-19,578,538,40,0.069204152249135
CENTRO 2,2023-04-20,544,506,38,0.0698529411764706
CENTRO 2,2023-04-21,623,589,34,0.0545746388443018
CENTRO 2,2023-04-22,717,680,37,0.0516039051603905
CENTRO 2,2023-04-23,624,593,31,0.0496794871794872
CENTRO 2,2023-04-24,662,617,45,0.06797583081571
CENTRO 2,2023-04-25,753,698,55,0.0730411686586985
CENTRO 2,2023-04-26,642,605,37,0.0576323987538941
CENTRO 2,2023-04-27,587,545,42,0.0715502555366269
CENTRO 2,2023-04-28,689,638,51,0.0740203193033382
CENTRO 2,2023-04-29,910,843,67,0.0736263736263736
CENTRO 2,2023-04-30,681,629,52,0.0763582966226138
CENTRO 2,2023-05-01,536,479,57,0.10634328358209
CENTRO 2,2023-05-02,694,639,55,0.0792507204610951
CENTRO 2,2023-05-03,581,538,43,0.0740103270223752
CENTRO 2,2023-05-04,622,582,40,0.0643086816720257
CENTRO 2,2023-05-05,644,604,40,0.062111801242236
CENTRO 2,2023-05-06,657,606,51,0.0776255707762557
CENTRO 2,2023-05-07,510,485,25,0.0490196078431373
CENTRO 2,2023-05-08,582,543,39,0.0670103092783505
CENTRO 2,2023-05-09,566,526,40,0.0706713780918728
CENTRO 2,2023-05-10,584,534,50,0.0856164383561644
CENTRO 2,2023-05-11,545,504,41,0.0752293577981651
CENTRO 2,2023-05-12,630,575,55,0.0873015873015873
CENTRO 2,2023-05-13,848,803,45,0.0530660377358491
CENTRO 2,2023-05-14,750,703,47,0.0626666666666667
CENTRO 2,2023-05-15,955,880,75,0.0785340314136126
CENTRO 2,2023-05-16,941,867,74,0.0786397449521785
CENTRO 2,2023-05-17,875,804,71,0.0811428571428571
CENTRO 2,2023-05-18,654,614,40,0.0611620795107034
CENTRO 2,2023-05-19,555,509,46,0.0828828828828829
CENTRO 2,2023-05-20,770,718,52,0.0675324675324675
CENTRO 2,2023-05-21,625,583,42,0.0672
CENTRO 2,2023-05-22,737,694,43,0.0583446404341927
CENTRO 2,2023-05-23,609,575,34,0.0558292282430213
CENTRO 2,2023-05-24,607,569,38,0.0626029654036244
CENTRO 2,2023-05-25,652,600,52,0.0797546012269939
CENTRO 2,2023-05-26,674,624,50,0.0741839762611276
CENTRO 2,2023-05-27,752,699,53,0.0704787234042553
CENTRO 2,2023-05-28,562,525,37,0.0658362989323843
CENTRO 2,2023-05-29,699,639,60,0.0858369098712446
CENTRO 2,2023-05-30,780,699,81,0.103846153846154
CENTRO 2,2023-05-31,823,753,70,0.0850546780072904
CENTRO 2,2023-06-01,673,615,58,0.0861812778603269
CENTRO 2,2023-06-02,599,541,58,0.0968280467445743
CENTRO 2,2023-06-03,670,611,59,0.0880597014925373
CENTRO 2,2023-06-04,596,552,44,0.0738255033557047
CENTRO 2,2023-06-05,640,569,71,0.1109375
CENTRO 2,2023-06-06,581,542,39,0.0671256454388985
CENTRO 2,2023-06-07,597,547,50,0.0837520938023451
CENTRO 2,2023-06-08,629,580,49,0.0779014308426073
CENTRO 2,2023-06-09,613,554,59,0.0962479608482871
CENTRO 2,2023-06-10,670,616,54,0.0805970149253731
CENTRO 2,2023-06-11,552,515,37,0.0670289855072464
CENTRO 2,2023-06-12,621,564,57,0.0917874396135266
CENTRO 2,2023-06-13,567,513,54,0.0952380952380952
CENTRO 2,2023-06-14,715,659,56,0.0783216783216783
CENTRO 2,2023-06-15,688,639,49,0.0712209302325581
CENTRO 2,2023-06-16,690,638,52,0.0753623188405797
CENTRO 2,2023-06-17,733,675,58,0.0791268758526603
CENTRO 2,2023-06-18,540,506,34,0.062962962962963
CENTRO 2,2023-06-19,632,583,49,0.0775316455696203
CENTRO 2,2023-06-20,626,581,45,0.0718849840255591
CENTRO 2,2023-06-21,632,584,48,0.0759493670886076
CENTRO 2,2023-06-22,577,539,38,0.0658578856152513
CENTRO 2,2023-06-23,632,580,52,0.0822784810126582
CENTRO 2,2023-06-24,731,683,48,0.0656634746922025
CENTRO 2,2023-06-25,521,490,31,0.0595009596928983
CENTRO 2,2023-06-26,599,565,34,0.0567612687813022
CENTRO 2,2023-06-27,579,558,21,0.0362694300518135
CENTRO 2,2023-06-28,588,566,22,0.0374149659863946
CENTRO 2,2023-06-29,635,587,48,0.0755905511811024
CENTRO 2,2023-06-30,464,396,68,0.146551724137931
CENTRO 2,2023-07-01,708,671,37,0.0522598870056497
CENTRO 2,2023-07-02,444,432,12,0.027027027027027
CENTRO 2,2023-07-03,637,611,26,0.0408163265306122
CENTRO 2,2023-07-04,540,516,24,0.0444444444444444
CENTRO 2,2023-07-05,442,420,22,0.0497737556561086
CENTRO 2,2023-07-06,447,426,21,0.0469798657718121
CENTRO 2,2023-07-07,642,623,19,0.029595015576324
CENTRO 2,2023-07-08,741,716,25,0.0337381916329285
CENTRO 2,2023-07-09,547,525,22,0.0402193784277879
CENTRO 2,2023-07-10,599,573,26,0.0434056761268781
CENTRO 2,2023-07-11,623,594,29,0.0465489566613162
CENTRO 2,2023-07-12,555,525,30,0.0540540540540541
CENTRO 2,2023-07-13,553,522,31,0.0560578661844485
CENTRO 2,2023-07-14,551,526,25,0.0453720508166969
CENTRO 2,2023-07-15,696,671,25,0.0359195402298851
CENTRO 2,2023-07-16,561,544,17,0.0303030303030303
CENTRO 2,2023-07-17,616,594,22,0.0357142857142857
CENTRO 2,2023-07-18,604,584,20,0.033112582781457
CENTRO 2,2023-07-19,620,597,23,0.0370967741935484
CENTRO 2,2023-07-20,694,662,32,0.0461095100864553
CENTRO 2,2023-07-21,620,596,24,0.0387096774193548
CENTRO 2,2023-07-22,706,684,22,0.0311614730878187
CENTRO 2,2023-07-23,505,488,17,0.0336633663366337
CENTRO 2,2023-07-24,610,584,26,0.0426229508196721
CENTRO 2,2023-07-25,644,620,24,0.0372670807453416
CENTRO 2,2023-07-26,621,597,24,0.0386473429951691
CENTRO 2,2023-07-27,662,640,22,0.0332326283987915
CENTRO 2,2023-07-28,761,736,25,0.0328515111695138
CENTRO 2,2023-07-29,764,739,25,0.0327225130890052
CENTRO 2,2023-07-30,631,615,16,0.0253565768621236
CENTRO 2,2023-07-31,722,698,24,0.0332409972299169
CENTRO 2,2023-08-01,735,707,28,0.0380952380952381
CENTRO 2,2023-08-02,713,682,31,0.0434782608695652
CENTRO 2,2023-08-03,719,599,120,0.166898470097357
CENTRO 2,2023-08-04,657,630,27,0.0410958904109589
CENTRO 2,2023-08-05,786,750,36,0.0458015267175573
CENTRO 2,2023-08-06,629,613,16,0.0254372019077901
CENTRO 2,2023-08-07,656,634,22,0.0335365853658537
CENTRO 2,2023-08-08,670,647,23,0.0343283582089552
CENTRO 2,2023-08-09,676,644,32,0.0473372781065089
CENTRO 2,2023-08-10,624,599,25,0.0400641025641026
CENTRO 2,2023-08-11,697,664,33,0.0473457675753228
CENTRO 2,2023-08-12,749,731,18,0.0240320427236315
CENTRO 2,2023-08-13,618,598,20,0.0323624595469256
CENTRO 2,2023-08-14,584,555,29,0.0496575342465753
CENTRO 2,2023-08-15,803,777,26,0.0323785803237858
CENTRO 2,2023-08-16,653,631,22,0.0336906584992343
CENTRO 2,2023-08-17,649,617,32,0.049306625577812
CENTRO 2,2023-08-18,720,689,31,0.0430555555555556
CENTRO 2,2023-08-19,773,746,27,0.0349288486416559
CENTRO 2,2023-08-20,578,556,22,0.0380622837370242
CENTRO 2,2023-08-21,626,621,5,0.00798722044728434
CENTRO 2,2023-08-22,608,606,2,0.00328947368421053
CENTRO 2,2023-08-23,628,618,10,0.0159235668789809
CENTRO 2,2023-08-24,669,656,13,0.0194319880418535
CENTRO 2,2023-08-25,704,694,10,0.0142045454545455
CENTRO 2,2023-08-26,798,792,6,0.0075187969924812
CENTRO 2,2023-08-27,686,682,4,0.00583090379008746
CENTRO 2,2023-08-28,687,679,8,0.0116448326055313
CENTRO 2,2023-08-29,659,649,10,0.0151745068285281
CENTRO 2,2023-08-30,694,687,7,0.0100864553314121
CENTRO 2,2023-08-31,635,626,9,0.0141732283464567
CENTRO 2,2023-09-01,649,644,5,0.00770416024653313
CENTRO 2,2023-09-02,754,748,6,0.00795755968169761
CENTRO 2,2023-09-03,590,588,2,0.00338983050847458
CENTRO 2,2023-09-04,594,591,3,0.00505050505050505
CENTRO 2,2023-09-05,663,661,2,0.00301659125188537
CENTRO 2,2023-09-06,585,578,7,0.011965811965812
CENTRO 2,2023-09-07,543,541,2,0.00368324125230203
CENTRO 2,2023-09-08,521,516,5,0.00959692898272553
CENTRO 2,2023-09-09,722,720,2,0.00277008310249307
CENTRO 2,2023-09-10,567,566,1,0.0017636684303351
CENTRO 2,2023-09-11,581,572,9,0.0154905335628227
CENTRO 2,2023-09-12,614,608,6,0.00977198697068404
CENTRO 2,2023-09-13,485,473,12,0.0247422680412371
CENTRO 2,2023-09-14,519,507,12,0.023121387283237
CENTRO 2,2023-09-15,643,632,11,0.0171073094867807
CENTRO 2,2023-09-16,484,478,6,0.012396694214876
CENTRO 2,2023-09-17,552,544,8,0.0144927536231884
CENTRO 2,2023-09-18,622,618,4,0.00643086816720257
CENTRO 2,2023-09-19,604,596,8,0.0132450331125828
CENTRO 2,2023-09-20,584,575,9,0.0154109589041096
CENTRO 2,2023-09-21,657,642,15,0.0228310502283105
CENTRO 2,2023-09-22,667,652,15,0.0224887556221889
CENTRO 2,2023-09-23,772,763,9,0.0116580310880829
CENTRO 2,2023-09-24,573,565,8,0.0139616055846422
CENTRO 2,2023-09-25,609,597,12,0.0197044334975369
CENTRO 2,2023-09-26,636,630,6,0.00943396226415094
CENTRO 2,2023-09-27,580,576,4,0.00689655172413793
CENTRO 2,2023-09-28,660,651,9,0.0136363636363636
CENTRO 2,2023-09-29,717,701,16,0.0223152022315202
CENTRO 2,2023-09-30,881,858,23,0.0261066969353008
CENTRO 2,2023-10-01,541,531,10,0.0184842883548983
CENTRO 2,2023-10-02,583,575,8,0.0137221269296741
CENTRO 2,2023-10-03,600,581,19,0.0316666666666667
CENTRO 2,2023-10-04,545,524,21,0.0385321100917431
CENTRO 2,2023-10-05,526,504,22,0.0418250950570342
CENTRO 2,2023-10-06,590,567,23,0.0389830508474576
CENTRO 2,2023-10-07,635,623,12,0.0188976377952756
CENTRO 2,2023-10-08,497,472,25,0.0503018108651912
CENTRO 2,2023-10-09,541,520,21,0.0388170055452865
CENTRO 2,2023-10-10,538,524,14,0.0260223048327138
CENTRO 2,2023-10-11,532,500,32,0.0601503759398496
CENTRO 2,2023-10-12,472,453,19,0.0402542372881356
CENTRO 2,2023-10-13,467,445,22,0.0471092077087794
CENTRO 2,2023-10-14,698,672,26,0.0372492836676218
CENTRO 2,2023-10-15,562,549,13,0.0231316725978648
CENTRO 2,2023-10-16,640,621,19,0.0296875
CENTRO 2,2023-10-17,592,579,13,0.0219594594594595
CENTRO 2,2023-10-18,578,556,22,0.0380622837370242
CENTRO 2,2023-10-19,570,548,22,0.0385964912280702
CENTRO 2,2023-10-20,552,537,15,0.0271739130434783
CENTRO 2,2023-10-21,635,616,19,0.0299212598425197
CENTRO 2,2023-10-22,505,492,13,0.0257425742574257
CENTRO 2,2023-10-23,531,507,24,0.0451977401129944
CENTRO 2,2023-10-24,542,527,15,0.0276752767527675
CENTRO 2,2023-10-25,531,516,15,0.0282485875706215
CENTRO 2,2023-10-26,569,555,14,0.0246045694200351
CENTRO 2,2023-10-27,567,556,11,0.0194003527336861
CENTRO 2,2023-10-28,670,651,19,0.0283582089552239
CENTRO 2,2023-10-29,536,522,14,0.0261194029850746
CENTRO 2,2023-10-30,568,549,19,0.0334507042253521
CENTRO 2,2023-10-31,676,653,23,0.0340236686390533
CENTRO 2,2023-11-01,617,601,16,0.0259319286871961
CENTRO 2,2023-11-02,546,531,15,0.0274725274725275
CENTRO 2,2023-11-03,569,555,14,0.0246045694200351
CENTRO 2,2023-11-04,644,629,15,0.0232919254658385
CENTRO 2,2023-11-05,575,561,14,0.0243478260869565
CENTRO 2,2023-11-06,606,592,14,0.0231023102310231
CENTRO 2,2023-11-07,629,602,27,0.0429252782193959
CENTRO 2,2023-11-08,639,622,17,0.02660406885759
CENTRO 2,2023-11-09,593,579,14,0.0236087689713322
CENTRO 2,2023-11-10,603,580,23,0.0381426202321725
CENTRO 2,2023-11-11,713,693,20,0.0280504908835905
CENTRO 2,2023-11-12,571,556,15,0.0262697022767075
CENTRO 2,2023-11-13,633,609,24,0.037914691943128
CENTRO 2,2023-11-14,662,640,22,0.0332326283987915
CENTRO 2,2023-11-15,682,666,16,0.0234604105571848
CENTRO 2,2023-11-16,670,648,22,0.0328358208955224
CENTRO 2,2023-11-17,768,741,27,0.03515625
CENTRO 2,2023-11-18,915,889,26,0.0284153005464481
CENTRO 2,2023-11-19,643,628,15,0.0233281493001555
CENTRO 2,2023-11-20,771,751,20,0.0259403372243839
CENTRO 2,2023-11-21,737,714,23,0.0312075983717775
CENTRO 2,2023-11-22,706,685,21,0.0297450424929178
CENTRO 2,2023-11-23,695,677,18,0.0258992805755396
CENTRO 2,2023-11-24,653,634,19,0.0290964777947933
CENTRO 2,2023-11-25,775,759,16,0.0206451612903226
CENTRO 2,2023-11-26,631,612,19,0.0301109350237718
CENTRO 2,2023-11-27,696,677,19,0.0272988505747126
CENTRO 2,2023-11-28,727,705,22,0.0302613480055021
CENTRO 2,2023-11-29,668,618,50,0.0748502994011976
CENTRO 2,2023-11-30,838,790,48,0.0572792362768496
CENTRO 2,2023-12-01,720,692,28,0.0388888888888889
CENTRO 2,2023-12-02,721,688,33,0.0457697642163662
CENTRO 2,2023-12-03,658,627,31,0.047112462006079
CENTRO 2,2023-12-04,635,613,22,0.0346456692913386
CENTRO 2,2023-12-05,654,615,39,0.0596330275229358
CENTRO 2,2023-12-06,614,590,24,0.0390879478827362
CENTRO 2,2023-12-07,563,542,21,0.0373001776198934
CENTRO 2,2023-12-08,632,603,29,0.0458860759493671
CENTRO 2,2023-12-09,717,693,24,0.0334728033472803
CENTRO 2,2023-12-10,538,529,9,0.016728624535316
CENTRO 2,2023-12-11,609,588,21,0.0344827586206897
CENTRO 2,2023-12-12,707,673,34,0.0480905233380481
CENTRO 2,2023-12-13,547,531,16,0.0292504570383912
CENTRO 2,2023-12-14,567,541,26,0.0458553791887125
CENTRO 2,2023-12-15,615,601,14,0.0227642276422764
CENTRO 2,2023-12-16,693,679,14,0.0202020202020202
CENTRO 2,2023-12-17,544,533,11,0.0202205882352941
CENTRO 2,2023-12-18,670,654,16,0.0238805970149254
CENTRO 2,2023-12-19,717,698,19,0.0264993026499303
CENTRO 2,2023-12-20,724,698,26,0.0359116022099447
CENTRO 2,2023-12-21,682,664,18,0.0263929618768328
CENTRO 2,2023-12-22,648,632,16,0.0246913580246914
CENTRO 2,2023-12-23,705,680,25,0.0354609929078014
CENTRO 2,2023-12-24,380,371,9,0.0236842105263158
CENTRO 2,2023-12-25,174,167,7,0.0402298850574713
CENTRO 2,2023-12-26,567,548,19,0.0335097001763668
CENTRO 2,2023-12-27,753,733,20,0.0265604249667995
CENTRO 2,2023-12-28,750,729,21,0.028
CENTRO 2,2023-12-29,703,686,17,0.0241820768136558
CENTRO 2,2023-12-30,699,683,16,0.0228898426323319
CENTRO 2,2023-12-31,334,327,7,0.0209580838323353
CENTRO 2,2024-01-01,134,132,2,0.0149253731343284
CENTRO 2,2024-01-02,587,572,15,0.0255536626916525
CENTRO 2,2024-01-03,773,757,16,0.0206985769728331
CENTRO 2,2024-01-04,707,689,18,0.0254596888260255
CENTRO 2,2024-01-05,649,627,22,0.0338983050847458
CENTRO 2,2024-01-06,689,673,16,0.02322206095791
CENTRO 2,2024-01-07,525,515,10,0.019047619047619
CENTRO 2,2024-01-08,665,646,19,0.0285714285714286
CENTRO 2,2024-01-09,645,626,19,0.0294573643410853
CENTRO 2,2024-01-10,673,657,16,0.0237741456166419
CENTRO 2,2024-01-11,642,625,17,0.0264797507788162
CENTRO 2,2024-01-12,671,649,22,0.0327868852459016
CENTRO 2,2024-01-13,799,775,24,0.0300375469336671
CENTRO 2,2024-01-14,659,644,15,0.0227617602427921
CENTRO 2,2024-01-15,761,736,25,0.0328515111695138
CENTRO 2,2024-01-16,755,728,27,0.0357615894039735
CENTRO 2,2024-01-17,705,683,22,0.0312056737588652
CENTRO 2,2024-01-18,702,685,17,0.0242165242165242
CENTRO 2,2024-01-19,640,618,22,0.034375
CENTRO 2,2024-01-20,716,690,26,0.0363128491620112
CENTRO 2,2024-01-21,587,574,13,0.0221465076660988
CENTRO 2,2024-01-22,679,656,23,0.0338733431516937
CENTRO 2,2024-01-23,643,633,10,0.015552099533437
CENTRO 2,2024-01-24,650,629,21,0.0323076923076923
CENTRO 2,2024-01-25,651,629,22,0.0337941628264209
CENTRO 2,2024-01-26,677,656,21,0.0310192023633678
CENTRO 2,2024-01-27,785,770,15,0.0191082802547771
CENTRO 2,2024-01-28,605,590,15,0.0247933884297521
CENTRO 2,2024-01-29,706,681,25,0.0354107648725212
CENTRO 2,2024-01-30,661,636,25,0.037821482602118
CENTRO 2,2024-01-31,737,717,20,0.0271370420624152
CENTRO 2,2024-02-01,645,624,21,0.0325581395348837
CENTRO 2,2024-02-02,661,650,11,0.0166414523449319
CENTRO 2,2024-02-03,752,730,22,0.0292553191489362
CENTRO 2,2024-02-04,587,574,13,0.0221465076660988
CENTRO 2,2024-02-05,639,627,12,0.0187793427230047
CENTRO 2,2024-02-06,669,640,29,0.0433482810164425
CENTRO 2,2024-02-07,679,655,24,0.0353460972017673
CENTRO 2,2024-02-08,633,611,22,0.0347551342812006
CENTRO 2,2024-02-09,641,620,21,0.0327613104524181
CENTRO 2,2024-02-10,788,778,10,0.0126903553299492
CENTRO 2,2024-02-11,515,501,14,0.0271844660194175
CENTRO 2,2024-02-12,512,479,33,0.064453125
CENTRO 2,2024-02-13,636,623,13,0.020440251572327
CENTRO 2,2024-02-14,573,558,15,0.0261780104712042
CENTRO 2,2024-02-15,605,588,17,0.028099173553719
NORESTE-FRONTERA,2023-02-15,544,439,105,0.193014705882353
NORESTE-FRONTERA,2023-02-16,569,458,111,0.195079086115993
NORESTE-FRONTERA,2023-02-17,589,458,131,0.222410865874363
NORESTE-FRONTERA,2023-02-18,759,593,166,0.21870882740448
NORESTE-FRONTERA,2023-02-19,464,347,117,0.252155172413793
NORESTE-FRONTERA,2023-02-20,513,399,114,0.222222222222222
NORESTE-FRONTERA,2023-02-21,521,393,128,0.245681381957774
NORESTE-FRONTERA,2023-02-22,545,410,135,0.247706422018349
NORESTE-FRONTERA,2023-02-23,519,384,135,0.260115606936416
NORESTE-FRONTERA,2023-02-24,516,376,140,0.271317829457364
NORESTE-FRONTERA,2023-02-25,760,510,250,0.328947368421053
NORESTE-FRONTERA,2023-02-26,454,340,114,0.251101321585903
NORESTE-FRONTERA,2023-02-27,536,391,145,0.270522388059701
NORESTE-FRONTERA,2023-02-28,647,477,170,0.262751159196291
NORESTE-FRONTERA,2023-03-01,604,456,148,0.245033112582781
NORESTE-FRONTERA,2023-03-02,634,472,162,0.255520504731861
NORESTE-FRONTERA,2023-03-03,671,500,171,0.254843517138599
NORESTE-FRONTERA,2023-03-04,792,563,229,0.289141414141414
NORESTE-FRONTERA,2023-03-05,398,285,113,0.28391959798995
NORESTE-FRONTERA,2023-03-06,523,395,128,0.244741873804971
NORESTE-FRONTERA,2023-03-07,603,451,152,0.252072968490879
NORESTE-FRONTERA,2023-03-08,628,459,169,0.269108280254777
NORESTE-FRONTERA,2023-03-09,587,493,94,0.160136286201022
NORESTE-FRONTERA,2023-03-10,646,544,102,0.157894736842105
NORESTE-FRONTERA,2023-03-11,798,664,134,0.167919799498747
NORESTE-FRONTERA,2023-03-12,507,422,85,0.167652859960552
NORESTE-FRONTERA,2023-03-13,550,468,82,0.149090909090909
NORESTE-FRONTERA,2023-03-14,637,531,106,0.166405023547881
NORESTE-FRONTERA,2023-03-15,584,541,43,0.0736301369863014
NORESTE-FRONTERA,2023-03-16,676,638,38,0.0562130177514793
NORESTE-FRONTERA,2023-03-17,773,714,59,0.0763260025873221
NORESTE-FRONTERA,2023-03-18,976,914,62,0.0635245901639344
NORESTE-FRONTERA,2023-03-19,581,540,41,0.0705679862306368
NORESTE-FRONTERA,2023-03-20,660,612,48,0.0727272727272727
NORESTE-FRONTERA,2023-03-21,737,702,35,0.0474898236092266
NORESTE-FRONTERA,2023-03-22,688,663,25,0.0363372093023256
NORESTE-FRONTERA,2023-03-23,714,688,26,0.0364145658263305
NORESTE-FRONTERA,2023-03-24,730,693,37,0.0506849315068493
NORESTE-FRONTERA,2023-03-25,822,782,40,0.048661800486618
NORESTE-FRONTERA,2023-03-26,528,496,32,0.0606060606060606
NORESTE-FRONTERA,2023-03-27,642,617,25,0.0389408099688473
NORESTE-FRONTERA,2023-03-28,511,495,16,0.0313111545988258
NORESTE-FRONTERA,2023-03-29,614,579,35,0.0570032573289902
NORESTE-FRONTERA,2023-03-30,704,667,37,0.0525568181818182
NORESTE-FRONTERA,2023-03-31,976,941,35,0.0358606557377049
NORESTE-FRONTERA,2023-04-01,780,756,24,0.0307692307692308
NORESTE-FRONTERA,2023-04-02,454,435,19,0.0418502202643172
NORESTE-FRONTERA,2023-04-03,703,685,18,0.0256045519203414
NORESTE-FRONTERA,2023-04-04,632,621,11,0.0174050632911392
NORESTE-FRONTERA,2023-04-05,552,528,24,0.0434782608695652
NORESTE-FRONTERA,2023-04-06,639,631,8,0.0125195618153365
NORESTE-FRONTERA,2023-04-07,607,602,5,0.00823723228995058
NORESTE-FRONTERA,2023-04-08,562,556,6,0.0106761565836299
NORESTE-FRONTERA,2023-04-09,342,339,3,0.0087719298245614
NORESTE-FRONTERA,2023-04-10,490,481,9,0.0183673469387755
NORESTE-FRONTERA,2023-04-11,590,576,14,0.023728813559322
NORESTE-FRONTERA,2023-04-12,546,535,11,0.0201465201465201
NORESTE-FRONTERA,2023-04-13,532,520,12,0.0225563909774436
NORESTE-FRONTERA,2023-04-14,717,706,11,0.0153417015341702
NORESTE-FRONTERA,2023-04-15,875,852,23,0.0262857142857143
NORESTE-FRONTERA,2023-04-16,564,552,12,0.0212765957446809
NORESTE-FRONTERA,2023-04-17,678,656,22,0.0324483775811209
NORESTE-FRONTERA,2023-04-18,669,651,18,0.0269058295964126
NORESTE-FRONTERA,2023-04-19,597,581,16,0.0268006700167504
NORESTE-FRONTERA,2023-04-20,597,570,27,0.0452261306532663
NORESTE-FRONTERA,2023-04-21,734,713,21,0.0286103542234332
NORESTE-FRONTERA,2023-04-22,767,744,23,0.029986962190352
NORESTE-FRONTERA,2023-04-23,565,555,10,0.0176991150442478
NORESTE-FRONTERA,2023-04-24,645,630,15,0.0232558139534884
NORESTE-FRONTERA,2023-04-25,769,740,29,0.0377113133940182
NORESTE-FRONTERA,2023-04-26,693,675,18,0.025974025974026
NORESTE-FRONTERA,2023-04-27,609,590,19,0.0311986863711002
NORESTE-FRONTERA,2023-04-28,727,702,25,0.0343878954607978
NORESTE-FRONTERA,2023-04-29,850,819,31,0.0364705882352941
NORESTE-FRONTERA,2023-04-30,649,624,25,0.0385208012326656
NORESTE-FRONTERA,2023-05-01,538,522,16,0.0297397769516729
NORESTE-FRONTERA,2023-05-02,620,601,19,0.0306451612903226
NORESTE-FRONTERA,2023-05-03,588,572,16,0.0272108843537415
NORESTE-FRONTERA,2023-05-04,628,605,23,0.036624203821656
NORESTE-FRONTERA,2023-05-05,711,682,29,0.0407876230661041
NORESTE-FRONTERA,2023-05-06,736,713,23,0.03125
NORESTE-FRONTERA,2023-05-07,567,552,15,0.0264550264550265
NORESTE-FRONTERA,2023-05-08,581,554,27,0.0464716006884682
NORESTE-FRONTERA,2023-05-09,653,628,25,0.0382848392036753
NORESTE-FRONTERA,2023-05-10,587,555,32,0.0545144804088586
NORESTE-FRONTERA,2023-05-11,610,579,31,0.0508196721311475
NORESTE-FRONTERA,2023-05-12,652,624,28,0.0429447852760736
NORESTE-FRONTERA,2023-05-13,851,815,36,0.0423031727379553
NORESTE-FRONTERA,2023-05-14,794,764,30,0.0377833753148615
NORESTE-FRONTERA,2023-05-15,874,840,34,0.0389016018306636
NORESTE-FRONTERA,2023-05-16,925,894,31,0.0335135135135135
NORESTE-FRONTERA,2023-05-17,850,810,40,0.0470588235294118
NORESTE-FRONTERA,2023-05-18,582,564,18,0.0309278350515464
NORESTE-FRONTERA,2023-05-19,727,695,32,0.0440165061898212
NORESTE-FRONTERA,2023-05-20,742,715,27,0.0363881401617251
NORESTE-FRONTERA,2023-05-21,696,661,35,0.0502873563218391
NORESTE-FRONTERA,2023-05-22,707,679,28,0.0396039603960396
NORESTE-FRONTERA,2023-05-23,663,643,20,0.0301659125188537
NORESTE-FRONTERA,2023-05-24,639,608,31,0.0485133020344288
NORESTE-FRONTERA,2023-05-25,645,603,42,0.0651162790697674
NORESTE-FRONTERA,2023-05-26,527,495,32,0.0607210626185958
NORESTE-FRONTERA,2023-05-27,647,600,47,0.0726429675425039
NORESTE-FRONTERA,2023-05-28,548,513,35,0.0638686131386861
NORESTE-FRONTERA,2023-05-29,608,575,33,0.0542763157894737
NORESTE-FRONTERA,2023-05-30,584,545,39,0.0667808219178082
NORESTE-FRONTERA,2023-05-31,634,592,42,0.0662460567823344
NORESTE-FRONTERA,2023-06-01,484,447,37,0.0764462809917355
NORESTE-FRONTERA,2023-06-02,551,517,34,0.0617059891107078
NORESTE-FRONTERA,2023-06-03,605,579,26,0.0429752066115702
NORESTE-FRONTERA,2023-06-04,530,508,22,0.0415094339622641
NORESTE-FRONTERA,2023-06-05,554,525,29,0.0523465703971119
NORESTE-FRONTERA,2023-06-06,584,557,27,0.0462328767123288
NORESTE-FRONTERA,2023-06-07,632,601,31,0.0490506329113924
NORESTE-FRONTERA,2023-06-08,569,539,30,0.0527240773286467
NORESTE-FRONTERA,2023-06-09,613,589,24,0.0391517128874388
NORESTE-FRONTERA,2023-06-10,687,655,32,0.0465793304221252
NORESTE-FRONTERA,2023-06-11,540,519,21,0.0388888888888889
NORESTE-FRONTERA,2023-06-12,614,589,25,0.0407166123778502
NORESTE-FRONTERA,2023-06-13,630,600,30,0.0476190476190476
NORESTE-FRONTERA,2023-06-14,612,582,30,0.0490196078431373
NORESTE-FRONTERA,2023-06-15,603,572,31,0.0514096185737977
NORESTE-FRONTERA,2023-06-16,598,560,38,0.0635451505016722
NORESTE-FRONTERA,2023-06-17,692,663,29,0.0419075144508671
NORESTE-FRONTERA,2023-06-18,437,416,21,0.0480549199084668
NORESTE-FRONTERA,2023-06-19,592,561,31,0.0523648648648649
NORESTE-FRONTERA,2023-06-20,542,513,29,0.0535055350553506
NORESTE-FRONTERA,2023-06-21,578,545,33,0.0570934256055363
NORESTE-FRONTERA,2023-06-22,624,603,21,0.0336538461538462
NORESTE-FRONTERA,2023-06-23,643,604,39,0.0606531881804044
NORESTE-FRONTERA,2023-06-24,700,664,36,0.0514285714285714
NORESTE-FRONTERA,2023-06-25,535,513,22,0.0411214953271028
NORESTE-FRONTERA,2023-06-26,602,574,28,0.0465116279069767
NORESTE-FRONTERA,2023-06-27,661,626,35,0.0529500756429652
NORESTE-FRONTERA,2023-06-28,542,518,24,0.044280442804428
NORESTE-FRONTERA,2023-06-29,601,583,18,0.0299500831946755
NORESTE-FRONTERA,2023-06-30,341,324,17,0.0498533724340176
NORESTE-FRONTERA,2023-07-01,620,607,13,0.0209677419354839
NORESTE-FRONTERA,2023-07-02,417,406,11,0.026378896882494
NORESTE-FRONTERA,2023-07-03,555,541,14,0.0252252252252252
NORESTE-FRONTERA,2023-07-04,621,602,19,0.0305958132045089
NORESTE-FRONTERA,2023-07-05,397,387,10,0.0251889168765743
NORESTE-FRONTERA,2023-07-06,491,477,14,0.0285132382892057
NORESTE-FRONTERA,2023-07-07,593,582,11,0.0185497470489039
NORESTE-FRONTERA,2023-07-08,645,631,14,0.0217054263565891
NORESTE-FRONTERA,2023-07-09,541,538,3,0.0055452865064695
NORESTE-FRONTERA,2023-07-10,537,523,14,0.0260707635009311
NORESTE-FRONTERA,2023-07-11,594,579,15,0.0252525252525253
NORESTE-FRONTERA,2023-07-12,612,598,14,0.0228758169934641
NORESTE-FRONTERA,2023-07-13,635,618,17,0.0267716535433071
NORESTE-FRONTERA,2023-07-14,617,603,14,0.0226904376012966
NORESTE-FRONTERA,2023-07-15,733,709,24,0.0327421555252387
NORESTE-FRONTERA,2023-07-16,466,464,2,0.00429184549356223
NORESTE-FRONTERA,2023-07-17,618,604,14,0.0226537216828479
NORESTE-FRONTERA,2023-07-18,641,634,7,0.0109204368174727
NORESTE-FRONTERA,2023-07-19,579,570,9,0.0155440414507772
NORESTE-FRONTERA,2023-07-20,637,624,13,0.0204081632653061
NORESTE-FRONTERA,2023-07-21,728,712,16,0.021978021978022
NORESTE-FRONTERA,2023-07-22,764,750,14,0.0183246073298429
NORESTE-FRONTERA,2023-07-23,504,501,3,0.00595238095238095
NORESTE-FRONTERA,2023-07-24,569,552,17,0.0298769771528998
NORESTE-FRONTERA,2023-07-25,642,629,13,0.0202492211838006
NORESTE-FRONTERA,2023-07-26,651,637,14,0.021505376344086
NORESTE-FRONTERA,2023-07-27,680,670,10,0.0147058823529412
NORESTE-FRONTERA,2023-07-28,737,722,15,0.0203527815468114
NORESTE-FRONTERA,2023-07-29,744,730,14,0.0188172043010753
NORESTE-FRONTERA,2023-07-30,507,499,8,0.0157790927021696
NORESTE-FRONTERA,2023-07-31,593,576,17,0.0286677908937605
NORESTE-FRONTERA,2023-08-01,596,573,23,0.0385906040268456
NORESTE-FRONTERA,2023-08-02,719,697,22,0.0305980528511822
NORESTE-FRONTERA,2023-08-03,640,544,96,0.15
NORESTE-FRONTERA,2023-08-04,659,630,29,0.0440060698027314
NORESTE-FRONTERA,2023-08-05,732,705,27,0.0368852459016393
NORESTE-FRONTERA,2023-08-06,497,476,21,0.0422535211267606
NORESTE-FRONTERA,2023-08-07,585,561,24,0.041025641025641
NORESTE-FRONTERA,2023-08-08,601,580,21,0.0349417637271215
NORESTE-FRONTERA,2023-08-09,586,566,20,0.0341296928327645
NORESTE-FRONTERA,2023-08-10,573,549,24,0.0418848167539267
NORESTE-FRONTERA,2023-08-11,691,666,25,0.0361794500723589
NORESTE-FRONTERA,2023-08-12,631,599,32,0.0507131537242472
NORESTE-FRONTERA,2023-08-13,424,406,18,0.0424528301886792
NORESTE-FRONTERA,2023-08-14,543,524,19,0.0349907918968692
NORESTE-FRONTERA,2023-08-15,657,639,18,0.0273972602739726
NORESTE-FRONTERA,2023-08-16,653,633,20,0.0306278713629403
NORESTE-FRONTERA,2023-08-17,705,678,27,0.0382978723404255
NORESTE-FRONTERA,2023-08-18,796,781,15,0.0188442211055276
NORESTE-FRONTERA,2023-08-19,886,833,53,0.0598194130925508
NORESTE-FRONTERA,2023-08-20,589,566,23,0.0390492359932088
NORESTE-FRONTERA,2023-08-21,570,551,19,0.0333333333333333
NORESTE-FRONTERA,2023-08-22,572,551,21,0.0367132867132867
NORESTE-FRONTERA,2023-08-23,686,647,39,0.0568513119533528
NORESTE-FRONTERA,2023-08-24,646,612,34,0.0526315789473684
NORESTE-FRONTERA,2023-08-25,792,750,42,0.053030303030303
NORESTE-FRONTERA,2023-08-26,894,859,35,0.0391498881431767
NORESTE-FRONTERA,2023-08-27,667,634,33,0.0494752623688156
NORESTE-FRONTERA,2023-08-28,640,611,29,0.0453125
NORESTE-FRONTERA,2023-08-29,629,606,23,0.0365659777424483
NORESTE-FRONTERA,2023-08-30,578,567,11,0.0190311418685121
NORESTE-FRONTERA,2023-08-31,622,609,13,0.0209003215434084
NORESTE-FRONTERA,2023-09-01,585,577,8,0.0136752136752137
NORESTE-FRONTERA,2023-09-02,641,634,7,0.0109204368174727
NORESTE-FRONTERA,2023-09-03,549,540,9,0.0163934426229508
NORESTE-FRONTERA,2023-09-04,583,577,6,0.0102915951972556
NORESTE-FRONTERA,2023-09-05,668,659,9,0.0134730538922156
NORESTE-FRONTERA,2023-09-06,663,658,5,0.00754147812971342
NORESTE-FRONTERA,2023-09-07,569,565,4,0.0070298769771529
NORESTE-FRONTERA,2023-09-08,599,594,5,0.00834724540901502
NORESTE-FRONTERA,2023-09-09,702,687,15,0.0213675213675214
NORESTE-FRONTERA,2023-09-10,510,507,3,0.00588235294117647
NORESTE-FRONTERA,2023-09-11,558,552,6,0.010752688172043
NORESTE-FRONTERA,2023-09-12,624,614,10,0.016025641025641
NORESTE-FRONTERA,2023-09-13,616,608,8,0.012987012987013
NORESTE-FRONTERA,2023-09-14,515,511,4,0.00776699029126214
NORESTE-FRONTERA,2023-09-15,665,650,15,0.0225563909774436
NORESTE-FRONTERA,2023-09-16,488,482,6,0.0122950819672131
NORESTE-FRONTERA,2023-09-17,498,491,7,0.0140562248995984
NORESTE-FRONTERA,2023-09-18,564,557,7,0.0124113475177305
NORESTE-FRONTERA,2023-09-19,441,439,2,0.00453514739229025
NORESTE-FRONTERA,2023-09-20,372,369,3,0.00806451612903226
NORESTE-FRONTERA,2023-09-21,390,374,16,0.041025641025641
NORESTE-FRONTERA,2023-09-22,624,613,11,0.0176282051282051
NORESTE-FRONTERA,2023-09-23,693,681,12,0.0173160173160173
NORESTE-FRONTERA,2023-09-24,522,515,7,0.0134099616858238
NORESTE-FRONTERA,2023-09-25,570,560,10,0.0175438596491228
NORESTE-FRONTERA,2023-09-26,581,566,15,0.0258175559380379
NORESTE-FRONTERA,2023-09-27,580,567,13,0.0224137931034483
NORESTE-FRONTERA,2023-09-28,638,622,16,0.0250783699059561
NORESTE-FRONTERA,2023-09-29,641,615,26,0.0405616224648986
NORESTE-FRONTERA,2023-09-30,717,697,20,0.0278940027894003
NORESTE-FRONTERA,2023-10-01,480,462,18,0.0375
NORESTE-FRONTERA,2023-10-02,530,518,12,0.0226415094339623
NORESTE-FRONTERA,2023-10-03,425,412,13,0.0305882352941176
NORESTE-FRONTERA,2023-10-04,634,606,28,0.0441640378548896
NORESTE-FRONTERA,2023-10-05,496,478,18,0.0362903225806452
NORESTE-FRONTERA,2023-10-06,570,553,17,0.0298245614035088
NORESTE-FRONTERA,2023-10-07,651,626,25,0.0384024577572965
NORESTE-FRONTERA,2023-10-08,473,454,19,0.040169133192389
NORESTE-FRONTERA,2023-10-09,538,517,21,0.0390334572490706
NORESTE-FRONTERA,2023-10-10,473,465,8,0.0169133192389006
NORESTE-FRONTERA,2023-10-11,535,520,15,0.0280373831775701
NORESTE-FRONTERA,2023-10-12,448,432,16,0.0357142857142857
NORESTE-FRONTERA,2023-10-13,421,410,11,0.0261282660332542
NORESTE-FRONTERA,2023-10-14,571,555,16,0.0280210157618214
NORESTE-FRONTERA,2023-10-15,476,464,12,0.0252100840336134
NORESTE-FRONTERA,2023-10-16,567,553,14,0.0246913580246914
NORESTE-FRONTERA,2023-10-17,582,571,11,0.0189003436426117
NORESTE-FRONTERA,2023-10-18,640,623,17,0.0265625
NORESTE-FRONTERA,2023-10-19,588,577,11,0.0187074829931973
NORESTE-FRONTERA,2023-10-20,581,564,17,0.0292598967297762
NORESTE-FRONTERA,2023-10-21,682,667,15,0.0219941348973607
NORESTE-FRONTERA,2023-10-22,478,470,8,0.0167364016736402
NORESTE-FRONTERA,2023-10-23,544,523,21,0.0386029411764706
NORESTE-FRONTERA,2023-10-24,540,523,17,0.0314814814814815
NORESTE-FRONTERA,2023-10-25,563,550,13,0.0230905861456483
NORESTE-FRONTERA,2023-10-26,600,582,18,0.03
NORESTE-FRONTERA,2023-10-27,571,556,15,0.0262697022767075
NORESTE-FRONTERA,2023-10-28,686,674,12,0.0174927113702624
NORESTE-FRONTERA,2023-10-29,458,446,12,0.0262008733624454
NORESTE-FRONTERA,2023-10-30,459,450,9,0.0196078431372549
NORESTE-FRONTERA,2023-10-31,488,479,9,0.0184426229508197
NORESTE-FRONTERA,2023-11-01,555,541,14,0.0252252252252252
NORESTE-FRONTERA,2023-11-02,574,562,12,0.0209059233449477
NORESTE-FRONTERA,2023-11-03,641,627,14,0.0218408736349454
NORESTE-FRONTERA,2023-11-04,694,675,19,0.0273775216138329
NORESTE-FRONTERA,2023-11-05,522,511,11,0.0210727969348659
NORESTE-FRONTERA,2023-11-06,592,580,12,0.0202702702702703
NORESTE-FRONTERA,2023-11-07,634,620,14,0.0220820189274448
NORESTE-FRONTERA,2023-11-08,641,631,10,0.015600624024961
NORESTE-FRONTERA,2023-11-09,654,641,13,0.0198776758409786
NORESTE-FRONTERA,2023-11-10,615,609,6,0.00975609756097561
NORESTE-FRONTERA,2023-11-11,766,748,18,0.0234986945169713
NORESTE-FRONTERA,2023-11-12,414,404,10,0.0241545893719807
NORESTE-FRONTERA,2023-11-13,621,603,18,0.0289855072463768
NORESTE-FRONTERA,2023-11-14,679,665,14,0.0206185567010309
NORESTE-FRONTERA,2023-11-15,607,593,14,0.0230642504118616
NORESTE-FRONTERA,2023-11-16,598,576,22,0.0367892976588629
NORESTE-FRONTERA,2023-11-17,768,752,16,0.0208333333333333
NORESTE-FRONTERA,2023-11-18,878,864,14,0.0159453302961276
NORESTE-FRONTERA,2023-11-19,623,612,11,0.0176565008025682
NORESTE-FRONTERA,2023-11-20,605,591,14,0.0231404958677686
NORESTE-FRONTERA,2023-11-21,630,616,14,0.0222222222222222
NORESTE-FRONTERA,2023-11-22,614,598,16,0.0260586319218241
NORESTE-FRONTERA,2023-11-23,727,711,16,0.0220082530949106
NORESTE-FRONTERA,2023-11-24,749,730,19,0.0253671562082777
NORESTE-FRONTERA,2023-11-25,796,780,16,0.0201005025125628
NORESTE-FRONTERA,2023-11-26,745,727,18,0.0241610738255034
NORESTE-FRONTERA,2023-11-27,605,596,9,0.0148760330578512
NORESTE-FRONTERA,2023-11-28,714,706,8,0.0112044817927171
NORESTE-FRONTERA,2023-11-29,729,690,39,0.0534979423868313
NORESTE-FRONTERA,2023-11-30,752,719,33,0.0438829787234043
NORESTE-FRONTERA,2023-12-01,631,612,19,0.0301109350237718
NORESTE-FRONTERA,2023-12-02,830,802,28,0.0337349397590361
NORESTE-FRONTERA,2023-12-03,691,673,18,0.0260492040520984
NORESTE-FRONTERA,2023-12-04,662,634,28,0.0422960725075529
NORESTE-FRONTERA,2023-12-05,696,671,25,0.0359195402298851
NORESTE-FRONTERA,2023-12-06,678,651,27,0.0398230088495575
NORESTE-FRONTERA,2023-12-07,724,702,22,0.0303867403314917
NORESTE-FRONTERA,2023-12-08,800,779,21,0.02625
NORESTE-FRONTERA,2023-12-09,826,801,25,0.0302663438256659
NORESTE-FRONTERA,2023-12-10,675,649,26,0.0385185185185185
NORESTE-FRONTERA,2023-12-11,531,514,17,0.032015065913371
NORESTE-FRONTERA,2023-12-12,674,647,27,0.0400593471810089
NORESTE-FRONTERA,2023-12-13,602,589,13,0.0215946843853821
NORESTE-FRONTERA,2023-12-14,600,582,18,0.03
NORESTE-FRONTERA,2023-12-15,607,586,21,0.0345963756177924
NORESTE-FRONTERA,2023-12-16,715,693,22,0.0307692307692308
NORESTE-FRONTERA,2023-12-17,552,537,15,0.0271739130434783
NORESTE-FRONTERA,2023-12-18,621,603,18,0.0289855072463768
NORESTE-FRONTERA,2023-12-19,720,702,18,0.025
NORESTE-FRONTERA,2023-12-20,779,756,23,0.0295250320924262
NORESTE-FRONTERA,2023-12-21,691,663,28,0.040520984081042
NORESTE-FRONTERA,2023-12-22,748,731,17,0.0227272727272727
NORESTE-FRONTERA,2023-12-23,783,764,19,0.0242656449553001
NORESTE-FRONTERA,2023-12-24,462,458,4,0.00865800865800866
NORESTE-FRONTERA,2023-12-25,170,170,0,0
NORESTE-FRONTERA,2023-12-26,588,577,11,0.0187074829931973
NORESTE-FRONTERA,2023-12-27,760,739,21,0.0276315789473684
NORESTE-FRONTERA,2023-12-28,749,731,18,0.0240320427236315
NORESTE-FRONTERA,2023-12-29,823,802,21,0.0255164034021871
NORESTE-FRONTERA,2023-12-30,771,760,11,0.0142671854734112
NORESTE-FRONTERA,2023-12-31,396,387,9,0.0227272727272727
NORESTE-FRONTERA,2024-01-01,83,82,1,0.0120481927710843
NORESTE-FRONTERA,2024-01-02,499,487,12,0.0240480961923848
NORESTE-FRONTERA,2024-01-03,770,753,17,0.0220779220779221
NORESTE-FRONTERA,2024-01-04,702,687,15,0.0213675213675214
NORESTE-FRONTERA,2024-01-05,769,748,21,0.0273081924577373
NORESTE-FRONTERA,2024-01-06,894,865,29,0.0324384787472036
NORESTE-FRONTERA,2024-01-07,586,576,10,0.0170648464163823
NORESTE-FRONTERA,2024-01-08,588,577,11,0.0187074829931973
NORESTE-FRONTERA,2024-01-09,639,619,20,0.0312989045383412
NORESTE-FRONTERA,2024-01-10,671,654,17,0.0253353204172876
NORESTE-FRONTERA,2024-01-11,655,647,8,0.0122137404580153
NORESTE-FRONTERA,2024-01-12,776,759,17,0.0219072164948454
NORESTE-FRONTERA,2024-01-13,806,795,11,0.0136476426799007
NORESTE-FRONTERA,2024-01-14,627,619,8,0.0127591706539075
NORESTE-FRONTERA,2024-01-15,668,646,22,0.0329341317365269
NORESTE-FRONTERA,2024-01-16,697,681,16,0.0229555236728838
NORESTE-FRONTERA,2024-01-17,729,705,24,0.0329218106995885
NORESTE-FRONTERA,2024-01-18,735,718,17,0.0231292517006803
NORESTE-FRONTERA,2024-01-19,682,665,17,0.0249266862170088
NORESTE-FRONTERA,2024-01-20,761,743,18,0.0236530880420499
NORESTE-FRONTERA,2024-01-21,613,597,16,0.0261011419249592
NORESTE-FRONTERA,2024-01-22,655,640,15,0.0229007633587786
NORESTE-FRONTERA,2024-01-23,703,676,27,0.0384068278805121
NORESTE-FRONTERA,2024-01-24,659,644,15,0.0227617602427921
NORESTE-FRONTERA,2024-01-25,733,717,16,0.0218281036834925
NORESTE-FRONTERA,2024-01-26,727,700,27,0.0371389270976616
NORESTE-FRONTERA,2024-01-27,795,777,18,0.0226415094339623
NORESTE-FRONTERA,2024-01-28,570,556,14,0.0245614035087719
NORESTE-FRONTERA,2024-01-29,653,632,21,0.0321592649310873
NORESTE-FRONTERA,2024-01-30,565,547,18,0.031858407079646
NORESTE-FRONTERA,2024-01-31,693,676,17,0.0245310245310245
NORESTE-FRONTERA,2024-02-01,639,621,18,0.028169014084507
NORESTE-FRONTERA,2024-02-02,657,637,20,0.030441400304414
NORESTE-FRONTERA,2024-02-03,729,706,23,0.0315500685871056
NORESTE-FRONTERA,2024-02-04,551,542,9,0.0163339382940109
NORESTE-FRONTERA,2024-02-05,488,481,7,0.014344262295082
NORESTE-FRONTERA,2024-02-06,616,604,12,0.0194805194805195
NORESTE-FRONTERA,2024-02-07,662,646,16,0.0241691842900302
NORESTE-FRONTERA,2024-02-08,724,721,3,0.00414364640883978
NORESTE-FRONTERA,2024-02-09,664,651,13,0.019578313253012
NORESTE-FRONTERA,2024-02-10,776,763,13,0.0167525773195876
NORESTE-FRONTERA,2024-02-11,534,528,6,0.0112359550561798
NORESTE-FRONTERA,2024-02-12,516,502,14,0.0271317829457364
NORESTE-FRONTERA,2024-02-13,678,668,10,0.0147492625368732
NORESTE-FRONTERA,2024-02-14,620,606,14,0.0225806451612903
NORESTE-FRONTERA,2024-02-15,607,596,11,0.0181219110378913
NORTE-PACIFICO,2023-02-15,469,147,322,0.686567164179104
NORTE-PACIFICO,2023-02-16,432,138,294,0.680555555555556
NORTE-PACIFICO,2023-02-17,480,120,360,0.75
NORTE-PACIFICO,2023-02-18,564,160,404,0.716312056737589
NORTE-PACIFICO,2023-02-19,312,73,239,0.766025641025641
NORTE-PACIFICO,2023-02-20,469,123,346,0.73773987206823
NORTE-PACIFICO,2023-02-21,471,137,334,0.709129511677282
NORTE-PACIFICO,2023-02-22,434,134,300,0.691244239631336
NORTE-PACIFICO,2023-02-23,396,139,257,0.648989898989899
NORTE-PACIFICO,2023-02-24,457,164,293,0.641137855579869
NORTE-PACIFICO,2023-02-25,434,138,296,0.682027649769585
NORTE-PACIFICO,2023-02-26,326,100,226,0.693251533742331
NORTE-PACIFICO,2023-02-27,451,147,304,0.674057649667406
NORTE-PACIFICO,2023-02-28,458,169,289,0.631004366812227
NORTE-PACIFICO,2023-03-01,340,125,215,0.632352941176471
NORTE-PACIFICO,2023-03-02,455,142,313,0.687912087912088
NORTE-PACIFICO,2023-03-03,526,175,351,0.667300380228137
NORTE-PACIFICO,2023-03-04,649,193,456,0.702619414483821
NORTE-PACIFICO,2023-03-05,455,127,328,0.720879120879121
NORTE-PACIFICO,2023-03-06,414,139,275,0.664251207729469
NORTE-PACIFICO,2023-03-07,447,164,283,0.633109619686801
NORTE-PACIFICO,2023-03-08,523,164,359,0.686424474187381
NORTE-PACIFICO,2023-03-09,477,222,255,0.534591194968553
NORTE-PACIFICO,2023-03-10,389,212,177,0.455012853470437
NORTE-PACIFICO,2023-03-11,588,296,292,0.496598639455782
NORTE-PACIFICO,2023-03-12,412,202,210,0.509708737864078
NORTE-PACIFICO,2023-03-13,414,233,181,0.43719806763285
NORTE-PACIFICO,2023-03-14,422,267,155,0.367298578199052
NORTE-PACIFICO,2023-03-15,385,323,62,0.161038961038961
NORTE-PACIFICO,2023-03-16,403,342,61,0.15136476426799
NORTE-PACIFICO,2023-03-17,535,453,82,0.153271028037383
NORTE-PACIFICO,2023-03-18,587,496,91,0.155025553662692
NORTE-PACIFICO,2023-03-19,419,355,64,0.152744630071599
NORTE-PACIFICO,2023-03-20,472,395,77,0.163135593220339
NORTE-PACIFICO,2023-03-21,379,330,49,0.129287598944591
NORTE-PACIFICO,2023-03-22,418,363,55,0.131578947368421
NORTE-PACIFICO,2023-03-23,448,390,58,0.129464285714286
NORTE-PACIFICO,2023-03-24,517,458,59,0.114119922630561
NORTE-PACIFICO,2023-03-25,599,534,65,0.108514190317195
NORTE-PACIFICO,2023-03-26,471,416,55,0.116772823779193
NORTE-PACIFICO,2023-03-27,369,335,34,0.0921409214092141
NORTE-PACIFICO,2023-03-28,413,374,39,0.0944309927360775
NORTE-PACIFICO,2023-03-29,444,406,38,0.0855855855855856
NORTE-PACIFICO,2023-03-30,510,466,44,0.0862745098039216
NORTE-PACIFICO,2023-03-31,586,533,53,0.0904436860068259
NORTE-PACIFICO,2023-04-01,592,538,54,0.0912162162162162
NORTE-PACIFICO,2023-04-02,366,335,31,0.0846994535519126
NORTE-PACIFICO,2023-04-03,499,461,38,0.0761523046092184
NORTE-PACIFICO,2023-04-04,512,483,29,0.056640625
NORTE-PACIFICO,2023-04-05,467,431,36,0.0770877944325482
NORTE-PACIFICO,2023-04-06,453,423,30,0.0662251655629139
NORTE-PACIFICO,2023-04-07,391,370,21,0.0537084398976982
NORTE-PACIFICO,2023-04-08,383,364,19,0.0496083550913838
NORTE-PACIFICO,2023-04-09,262,244,18,0.0687022900763359
NORTE-PACIFICO,2023-04-10,415,386,29,0.0698795180722892
NORTE-PACIFICO,2023-04-11,466,434,32,0.0686695278969957
NORTE-PACIFICO,2023-04-12,461,435,26,0.0563991323210412
NORTE-PACIFICO,2023-04-13,455,435,20,0.043956043956044
NORTE-PACIFICO,2023-04-14,513,476,37,0.0721247563352826
NORTE-PACIFICO,2023-04-15,696,661,35,0.0502873563218391
NORTE-PACIFICO,2023-04-16,557,531,26,0.0466786355475763
NORTE-PACIFICO,2023-04-17,490,468,22,0.0448979591836735
NORTE-PACIFICO,2023-04-18,472,456,16,0.0338983050847458
NORTE-PACIFICO,2023-04-19,444,425,19,0.0427927927927928
NORTE-PACIFICO,2023-04-20,442,421,21,0.0475113122171946
NORTE-PACIFICO,2023-04-21,473,440,33,0.0697674418604651
NORTE-PACIFICO,2023-04-22,558,531,27,0.0483870967741935
NORTE-PACIFICO,2023-04-23,398,376,22,0.0552763819095477
NORTE-PACIFICO,2023-04-24,453,438,15,0.033112582781457
NORTE-PACIFICO,2023-04-25,589,551,38,0.0645161290322581
NORTE-PACIFICO,2023-04-26,491,454,37,0.0753564154786151
NORTE-PACIFICO,2023-04-27,439,413,26,0.0592255125284738
NORTE-PACIFICO,2023-04-28,576,537,39,0.0677083333333333
NORTE-PACIFICO,2023-04-29,669,624,45,0.0672645739910314
NORTE-PACIFICO,2023-04-30,438,411,27,0.0616438356164384
NORTE-PACIFICO,2023-05-01,373,345,28,0.0750670241286863
NORTE-PACIFICO,2023-05-02,459,438,21,0.0457516339869281
NORTE-PACIFICO,2023-05-03,451,432,19,0.0421286031042129
NORTE-PACIFICO,2023-05-04,478,452,26,0.0543933054393305
NORTE-PACIFICO,2023-05-05,514,481,33,0.0642023346303502
NORTE-PACIFICO,2023-05-06,540,514,26,0.0481481481481481
NORTE-PACIFICO,2023-05-07,406,387,19,0.0467980295566502
NORTE-PACIFICO,2023-05-08,483,454,29,0.0600414078674948
NORTE-PACIFICO,2023-05-09,522,502,20,0.0383141762452107
NORTE-PACIFICO,2023-05-10,419,401,18,0.0429594272076372
NORTE-PACIFICO,2023-05-11,487,469,18,0.0369609856262834
NORTE-PACIFICO,2023-05-12,479,460,19,0.0396659707724426
NORTE-PACIFICO,2023-05-13,715,678,37,0.0517482517482517
NORTE-PACIFICO,2023-05-14,520,490,30,0.0576923076923077
NORTE-PACIFICO,2023-05-15,603,567,36,0.0597014925373134
NORTE-PACIFICO,2023-05-16,601,558,43,0.0715474209650582
NORTE-PACIFICO,2023-05-17,538,489,49,0.0910780669144981
NORTE-PACIFICO,2023-05-18,461,429,32,0.06941431670282
NORTE-PACIFICO,2023-05-19,453,415,38,0.0838852097130243
NORTE-PACIFICO,2023-05-20,601,564,37,0.0615640599001664
NORTE-PACIFICO,2023-05-21,491,462,29,0.0590631364562118
NORTE-PACIFICO,2023-05-22,497,468,29,0.0583501006036217
NORTE-PACIFICO,2023-05-23,461,420,41,0.0889370932754881
NORTE-PACIFICO,2023-05-24,475,455,20,0.0421052631578947
NORTE-PACIFICO,2023-05-25,506,466,40,0.0790513833992095
NORTE-PACIFICO,2023-05-26,589,533,56,0.0950764006791171
NORTE-PACIFICO,2023-05-27,665,590,75,0.112781954887218
NORTE-PACIFICO,2023-05-28,402,370,32,0.0796019900497512
NORTE-PACIFICO,2023-05-29,548,518,30,0.0547445255474453
NORTE-PACIFICO,2023-05-30,495,452,43,0.0868686868686869
NORTE-PACIFICO,2023-05-31,586,536,50,0.0853242320819113
NORTE-PACIFICO,2023-06-01,439,412,27,0.061503416856492
NORTE-PACIFICO,2023-06-02,441,406,35,0.0793650793650794
NORTE-PACIFICO,2023-06-03,585,527,58,0.0991452991452991
NORTE-PACIFICO,2023-06-04,439,387,52,0.118451025056948
NORTE-PACIFICO,2023-06-05,453,423,30,0.0662251655629139
NORTE-PACIFICO,2023-06-06,495,463,32,0.0646464646464646
NORTE-PACIFICO,2023-06-07,464,421,43,0.0926724137931035
NORTE-PACIFICO,2023-06-08,497,470,27,0.0543259557344064
NORTE-PACIFICO,2023-06-09,519,470,49,0.0944123314065511
NORTE-PACIFICO,2023-06-10,632,580,52,0.0822784810126582
NORTE-PACIFICO,2023-06-11,500,449,51,0.102
NORTE-PACIFICO,2023-06-12,515,477,38,0.0737864077669903
NORTE-PACIFICO,2023-06-13,589,550,39,0.066213921901528
NORTE-PACIFICO,2023-06-14,533,504,29,0.0544090056285178
NORTE-PACIFICO,2023-06-15,506,475,31,0.0612648221343874
NORTE-PACIFICO,2023-06-16,504,469,35,0.0694444444444444
NORTE-PACIFICO,2023-06-17,608,566,42,0.0690789473684211
NORTE-PACIFICO,2023-06-18,433,392,41,0.0946882217090069
NORTE-PACIFICO,2023-06-19,539,504,35,0.0649350649350649
NORTE-PACIFICO,2023-06-20,474,449,25,0.0527426160337553
NORTE-PACIFICO,2023-06-21,517,481,36,0.0696324951644101
NORTE-PACIFICO,2023-06-22,410,379,31,0.075609756097561
NORTE-PACIFICO,2023-06-23,415,397,18,0.0433734939759036
NORTE-PACIFICO,2023-06-24,544,521,23,0.0422794117647059
NORTE-PACIFICO,2023-06-25,401,370,31,0.0773067331670823
NORTE-PACIFICO,2023-06-26,438,416,22,0.0502283105022831
NORTE-PACIFICO,2023-06-27,489,468,21,0.0429447852760736
NORTE-PACIFICO,2023-06-28,476,461,15,0.0315126050420168
NORTE-PACIFICO,2023-06-29,450,436,14,0.0311111111111111
NORTE-PACIFICO,2023-06-30,320,287,33,0.103125
NORTE-PACIFICO,2023-07-01,538,514,24,0.0446096654275093
NORTE-PACIFICO,2023-07-02,333,319,14,0.042042042042042
NORTE-PACIFICO,2023-07-03,426,411,15,0.0352112676056338
NORTE-PACIFICO,2023-07-04,391,383,8,0.020460358056266
NORTE-PACIFICO,2023-07-05,297,287,10,0.0336700336700337
NORTE-PACIFICO,2023-07-06,292,281,11,0.0376712328767123
NORTE-PACIFICO,2023-07-07,288,286,2,0.00694444444444444
NORTE-PACIFICO,2023-07-08,465,458,7,0.0150537634408602
NORTE-PACIFICO,2023-07-09,419,414,5,0.0119331742243437
NORTE-PACIFICO,2023-07-10,462,442,20,0.0432900432900433
NORTE-PACIFICO,2023-07-11,377,366,11,0.0291777188328912
NORTE-PACIFICO,2023-07-12,443,428,15,0.0338600451467269
NORTE-PACIFICO,2023-07-13,381,369,12,0.031496062992126
NORTE-PACIFICO,2023-07-14,396,380,16,0.0404040404040404
NORTE-PACIFICO,2023-07-15,436,421,15,0.0344036697247706
NORTE-PACIFICO,2023-07-16,302,289,13,0.043046357615894
NORTE-PACIFICO,2023-07-17,429,418,11,0.0256410256410256
NORTE-PACIFICO,2023-07-18,413,401,12,0.0290556900726392
NORTE-PACIFICO,2023-07-19,428,411,17,0.0397196261682243
NORTE-PACIFICO,2023-07-20,491,481,10,0.0203665987780041
NORTE-PACIFICO,2023-07-21,484,473,11,0.0227272727272727
NORTE-PACIFICO,2023-07-22,522,509,13,0.024904214559387
NORTE-PACIFICO,2023-07-23,342,328,14,0.0409356725146199
NORTE-PACIFICO,2023-07-24,428,420,8,0.0186915887850467
NORTE-PACIFICO,2023-07-25,482,471,11,0.0228215767634855
NORTE-PACIFICO,2023-07-26,452,436,16,0.0353982300884956
NORTE-PACIFICO,2023-07-27,456,451,5,0.0109649122807018
NORTE-PACIFICO,2023-07-28,520,508,12,0.0230769230769231
NORTE-PACIFICO,2023-07-29,540,528,12,0.0222222222222222
NORTE-PACIFICO,2023-07-30,380,372,8,0.0210526315789474
NORTE-PACIFICO,2023-07-31,446,432,14,0.031390134529148
NORTE-PACIFICO,2023-08-01,471,452,19,0.0403397027600849
NORTE-PACIFICO,2023-08-02,459,437,22,0.0479302832244009
NORTE-PACIFICO,2023-08-03,477,402,75,0.157232704402516
NORTE-PACIFICO,2023-08-04,486,461,25,0.051440329218107
NORTE-PACIFICO,2023-08-05,499,480,19,0.0380761523046092
NORTE-PACIFICO,2023-08-06,393,371,22,0.0559796437659033
NORTE-PACIFICO,2023-08-07,426,411,15,0.0352112676056338
NORTE-PACIFICO,2023-08-08,453,438,15,0.033112582781457
NORTE-PACIFICO,2023-08-09,450,436,14,0.0311111111111111
NORTE-PACIFICO,2023-08-10,446,416,30,0.0672645739910314
NORTE-PACIFICO,2023-08-11,546,527,19,0.0347985347985348
NORTE-PACIFICO,2023-08-12,509,469,40,0.0785854616895874
NORTE-PACIFICO,2023-08-13,413,387,26,0.062953995157385
NORTE-PACIFICO,2023-08-14,410,392,18,0.0439024390243902
NORTE-PACIFICO,2023-08-15,450,429,21,0.0466666666666667
NORTE-PACIFICO,2023-08-16,390,368,22,0.0564102564102564
NORTE-PACIFICO,2023-08-17,415,402,13,0.0313253012048193
NORTE-PACIFICO,2023-08-18,486,463,23,0.0473251028806584
NORTE-PACIFICO,2023-08-19,513,495,18,0.0350877192982456
NORTE-PACIFICO,2023-08-20,192,186,6,0.03125
NORTE-PACIFICO,2023-08-21,329,323,6,0.0182370820668693
NORTE-PACIFICO,2023-08-22,419,410,9,0.0214797136038186
NORTE-PACIFICO,2023-08-23,414,402,12,0.0289855072463768
NORTE-PACIFICO,2023-08-24,459,451,8,0.0174291938997821
NORTE-PACIFICO,2023-08-25,445,430,15,0.0337078651685393
NORTE-PACIFICO,2023-08-26,534,518,16,0.0299625468164794
NORTE-PACIFICO,2023-08-27,421,417,4,0.00950118764845606
NORTE-PACIFICO,2023-08-28,487,475,12,0.0246406570841889
NORTE-PACIFICO,2023-08-29,442,441,1,0.00226244343891403
NORTE-PACIFICO,2023-08-30,453,451,2,0.00441501103752759
NORTE-PACIFICO,2023-08-31,514,511,3,0.00583657587548638
NORTE-PACIFICO,2023-09-01,375,369,6,0.016
NORTE-PACIFICO,2023-09-02,531,527,4,0.00753295668549906
NORTE-PACIFICO,2023-09-03,393,390,3,0.00763358778625954
NORTE-PACIFICO,2023-09-04,441,440,1,0.00226757369614512
NORTE-PACIFICO,2023-09-05,469,465,4,0.00852878464818763
NORTE-PACIFICO,2023-09-06,466,462,4,0.00858369098712446
NORTE-PACIFICO,2023-09-07,433,433,0,0
NORTE-PACIFICO,2023-09-08,505,500,5,0.0099009900990099
NORTE-PACIFICO,2023-09-09,561,555,6,0.0106951871657754
NORTE-PACIFICO,2023-09-10,408,405,3,0.00735294117647059
NORTE-PACIFICO,2023-09-11,432,427,5,0.0115740740740741
NORTE-PACIFICO,2023-09-12,459,459,0,0
NORTE-PACIFICO,2023-09-13,432,429,3,0.00694444444444444
NORTE-PACIFICO,2023-09-14,409,405,4,0.0097799511002445
NORTE-PACIFICO,2023-09-15,442,440,2,0.00452488687782805
NORTE-PACIFICO,2023-09-16,368,364,4,0.0108695652173913
NORTE-PACIFICO,2023-09-17,401,399,2,0.00498753117206983
NORTE-PACIFICO,2023-09-18,493,492,1,0.00202839756592292
NORTE-PACIFICO,2023-09-19,477,473,4,0.00838574423480084
NORTE-PACIFICO,2023-09-20,420,417,3,0.00714285714285714
NORTE-PACIFICO,2023-09-21,478,472,6,0.0125523012552301
NORTE-PACIFICO,2023-09-22,491,482,9,0.0183299389002037
NORTE-PACIFICO,2023-09-23,573,562,11,0.0191972076788831
NORTE-PACIFICO,2023-09-24,413,408,5,0.0121065375302663
NORTE-PACIFICO,2023-09-25,417,411,6,0.0143884892086331
NORTE-PACIFICO,2023-09-26,460,454,6,0.0130434782608696
NORTE-PACIFICO,2023-09-27,446,442,4,0.00896860986547085
NORTE-PACIFICO,2023-09-28,474,471,3,0.00632911392405063
NORTE-PACIFICO,2023-09-29,489,484,5,0.0102249488752556
NORTE-PACIFICO,2023-09-30,562,559,3,0.00533807829181495
NORTE-PACIFICO,2023-10-01,368,365,3,0.00815217391304348
NORTE-PACIFICO,2023-10-02,371,368,3,0.00808625336927224
NORTE-PACIFICO,2023-10-03,458,447,11,0.0240174672489083
NORTE-PACIFICO,2023-10-04,449,439,10,0.022271714922049
NORTE-PACIFICO,2023-10-05,462,456,6,0.012987012987013
NORTE-PACIFICO,2023-10-06,522,502,20,0.0383141762452107
NORTE-PACIFICO,2023-10-07,546,532,14,0.0256410256410256
NORTE-PACIFICO,2023-10-08,417,405,12,0.0287769784172662
NORTE-PACIFICO,2023-10-09,425,418,7,0.0164705882352941
NORTE-PACIFICO,2023-10-10,426,415,11,0.0258215962441315
NORTE-PACIFICO,2023-10-11,390,382,8,0.0205128205128205
NORTE-PACIFICO,2023-10-12,423,413,10,0.0236406619385343
NORTE-PACIFICO,2023-10-13,436,420,16,0.036697247706422
NORTE-PACIFICO,2023-10-14,502,490,12,0.0239043824701195
NORTE-PACIFICO,2023-10-15,417,411,6,0.0143884892086331
NORTE-PACIFICO,2023-10-16,437,425,12,0.0274599542334096
NORTE-PACIFICO,2023-10-17,429,422,7,0.0163170163170163
NORTE-PACIFICO,2023-10-18,389,377,12,0.0308483290488432
NORTE-PACIFICO,2023-10-19,431,423,8,0.0185614849187935
NORTE-PACIFICO,2023-10-20,455,446,9,0.0197802197802198
NORTE-PACIFICO,2023-10-21,553,543,10,0.0180831826401447
NORTE-PACIFICO,2023-10-22,350,340,10,0.0285714285714286
NORTE-PACIFICO,2023-10-23,369,359,10,0.02710027100271
NORTE-PACIFICO,2023-10-24,435,424,11,0.0252873563218391
NORTE-PACIFICO,2023-10-25,424,406,18,0.0424528301886792
NORTE-PACIFICO,2023-10-26,441,435,6,0.0136054421768707
NORTE-PACIFICO,2023-10-27,463,453,10,0.0215982721382289
NORTE-PACIFICO,2023-10-28,483,479,4,0.0082815734989648
NORTE-PACIFICO,2023-10-29,343,334,9,0.0262390670553936
NORTE-PACIFICO,2023-10-30,388,377,11,0.0283505154639175
NORTE-PACIFICO,2023-10-31,425,419,6,0.0141176470588235
NORTE-PACIFICO,2023-11-01,453,447,6,0.0132450331125828
NORTE-PACIFICO,2023-11-02,491,480,11,0.0224032586558045
NORTE-PACIFICO,2023-11-03,436,423,13,0.0298165137614679
NORTE-PACIFICO,2023-11-04,569,557,12,0.0210896309314587
NORTE-PACIFICO,2023-11-05,427,421,6,0.0140515222482436
NORTE-PACIFICO,2023-11-06,473,462,11,0.0232558139534884
NORTE-PACIFICO,2023-11-07,517,507,10,0.0193423597678917
NORTE-PACIFICO,2023-11-08,523,510,13,0.0248565965583174
NORTE-PACIFICO,2023-11-09,505,493,12,0.0237623762376238
NORTE-PACIFICO,2023-11-10,521,511,10,0.0191938579654511
NORTE-PACIFICO,2023-11-11,598,590,8,0.0133779264214047
NORTE-PACIFICO,2023-11-12,460,445,15,0.0326086956521739
NORTE-PACIFICO,2023-11-13,456,444,12,0.0263157894736842
NORTE-PACIFICO,2023-11-14,514,501,13,0.0252918287937743
NORTE-PACIFICO,2023-11-15,484,475,9,0.0185950413223141
NORTE-PACIFICO,2023-11-16,524,511,13,0.0248091603053435
NORTE-PACIFICO,2023-11-17,508,500,8,0.015748031496063
NORTE-PACIFICO,2023-11-18,644,631,13,0.0201863354037267
NORTE-PACIFICO,2023-11-19,475,465,10,0.0210526315789474
NORTE-PACIFICO,2023-11-20,431,421,10,0.0232018561484919
NORTE-PACIFICO,2023-11-21,546,530,16,0.0293040293040293
NORTE-PACIFICO,2023-11-22,495,484,11,0.0222222222222222
NORTE-PACIFICO,2023-11-23,553,540,13,0.0235081374321881
NORTE-PACIFICO,2023-11-24,573,565,8,0.0139616055846422
NORTE-PACIFICO,2023-11-25,612,599,13,0.0212418300653595
NORTE-PACIFICO,2023-11-26,448,446,2,0.00446428571428571
NORTE-PACIFICO,2023-11-27,444,434,10,0.0225225225225225
NORTE-PACIFICO,2023-11-28,522,511,11,0.0210727969348659
NORTE-PACIFICO,2023-11-29,504,489,15,0.0297619047619048
NORTE-PACIFICO,2023-11-30,474,466,8,0.0168776371308017
NORTE-PACIFICO,2023-12-01,516,502,14,0.0271317829457364
NORTE-PACIFICO,2023-12-02,619,607,12,0.0193861066235864
NORTE-PACIFICO,2023-12-03,476,466,10,0.0210084033613445
NORTE-PACIFICO,2023-12-04,502,483,19,0.0378486055776892
NORTE-PACIFICO,2023-12-05,538,519,19,0.0353159851301115
NORTE-PACIFICO,2023-12-06,520,506,14,0.0269230769230769
NORTE-PACIFICO,2023-12-07,527,514,13,0.0246679316888046
NORTE-PACIFICO,2023-12-08,544,534,10,0.0183823529411765
NORTE-PACIFICO,2023-12-09,559,552,7,0.0125223613595707
NORTE-PACIFICO,2023-12-10,480,471,9,0.01875
NORTE-PACIFICO,2023-12-11,480,474,6,0.0125
NORTE-PACIFICO,2023-12-12,496,488,8,0.0161290322580645
NORTE-PACIFICO,2023-12-13,504,494,10,0.0198412698412698
NORTE-PACIFICO,2023-12-14,458,446,12,0.0262008733624454
NORTE-PACIFICO,2023-12-15,477,466,11,0.0230607966457023
NORTE-PACIFICO,2023-12-16,539,530,9,0.0166975881261596
NORTE-PACIFICO,2023-12-17,449,442,7,0.0155902004454343
NORTE-PACIFICO,2023-12-18,483,474,9,0.0186335403726708
NORTE-PACIFICO,2023-12-19,548,539,9,0.0164233576642336
NORTE-PACIFICO,2023-12-20,536,517,19,0.0354477611940298
NORTE-PACIFICO,2023-12-21,579,565,14,0.0241796200345423
NORTE-PACIFICO,2023-12-22,481,471,10,0.0207900207900208
NORTE-PACIFICO,2023-12-23,529,523,6,0.0113421550094518
NORTE-PACIFICO,2023-12-24,249,244,5,0.0200803212851406
NORTE-PACIFICO,2023-12-25,34,33,1,0.0294117647058824
NORTE-PACIFICO,2023-12-26,499,490,9,0.0180360721442886
NORTE-PACIFICO,2023-12-27,510,497,13,0.0254901960784314
NORTE-PACIFICO,2023-12-28,543,529,14,0.0257826887661142
NORTE-PACIFICO,2023-12-29,543,536,7,0.0128913443830571
NORTE-PACIFICO,2023-12-30,521,510,11,0.0211132437619962
NORTE-PACIFICO,2023-12-31,240,237,3,0.0125
NORTE-PACIFICO,2024-01-01,29,29,0,0
NORTE-PACIFICO,2024-01-02,440,431,9,0.0204545454545455
NORTE-PACIFICO,2024-01-03,473,464,9,0.0190274841437632
NORTE-PACIFICO,2024-01-04,547,537,10,0.0182815356489945
NORTE-PACIFICO,2024-01-05,581,567,14,0.0240963855421687
NORTE-PACIFICO,2024-01-06,633,619,14,0.0221169036334913
NORTE-PACIFICO,2024-01-07,469,463,6,0.0127931769722814
NORTE-PACIFICO,2024-01-08,439,426,13,0.0296127562642369
NORTE-PACIFICO,2024-01-09,591,576,15,0.0253807106598985
NORTE-PACIFICO,2024-01-10,563,552,11,0.019538188277087
NORTE-PACIFICO,2024-01-11,447,433,14,0.0313199105145414
NORTE-PACIFICO,2024-01-12,558,547,11,0.0197132616487455
NORTE-PACIFICO,2024-01-13,646,634,12,0.0185758513931889
NORTE-PACIFICO,2024-01-14,479,472,7,0.0146137787056367
NORTE-PACIFICO,2024-01-15,399,381,18,0.0451127819548872
NORTE-PACIFICO,2024-01-16,625,612,13,0.0208
NORTE-PACIFICO,2024-01-17,525,517,8,0.0152380952380952
NORTE-PACIFICO,2024-01-18,604,593,11,0.0182119205298013
NORTE-PACIFICO,2024-01-19,528,512,16,0.0303030303030303
NORTE-PACIFICO,2024-01-20,521,513,8,0.0153550863723608
NORTE-PACIFICO,2024-01-21,459,453,6,0.0130718954248366
NORTE-PACIFICO,2024-01-22,318,309,9,0.0283018867924528
NORTE-PACIFICO,2024-01-23,513,506,7,0.01364522417154
NORTE-PACIFICO,2024-01-24,535,511,24,0.0448598130841121
NORTE-PACIFICO,2024-01-25,485,478,7,0.0144329896907217
NORTE-PACIFICO,2024-01-26,555,546,9,0.0162162162162162
NORTE-PACIFICO,2024-01-27,624,611,13,0.0208333333333333
NORTE-PACIFICO,2024-01-28,442,437,5,0.0113122171945701
NORTE-PACIFICO,2024-01-29,425,416,9,0.0211764705882353
NORTE-PACIFICO,2024-01-30,492,480,12,0.024390243902439
NORTE-PACIFICO,2024-01-31,515,506,9,0.0174757281553398
NORTE-PACIFICO,2024-02-01,334,326,8,0.0239520958083832
NORTE-PACIFICO,2024-02-02,545,533,12,0.0220183486238532
NORTE-PACIFICO,2024-02-03,592,576,16,0.027027027027027
NORTE-PACIFICO,2024-02-04,523,509,14,0.0267686424474187
NORTE-PACIFICO,2024-02-05,342,338,4,0.0116959064327485
NORTE-PACIFICO,2024-02-06,473,461,12,0.025369978858351
NORTE-PACIFICO,2024-02-07,527,512,15,0.0284629981024668
NORTE-PACIFICO,2024-02-08,500,493,7,0.014
NORTE-PACIFICO,2024-02-09,498,488,10,0.0200803212851406
NORTE-PACIFICO,2024-02-10,652,638,14,0.0214723926380368
NORTE-PACIFICO,2024-02-11,450,441,9,0.02
NORTE-PACIFICO,2024-02-12,388,379,9,0.0231958762886598
NORTE-PACIFICO,2024-02-13,550,543,7,0.0127272727272727
NORTE-PACIFICO,2024-02-14,477,475,2,0.00419287211740042
NORTE-PACIFICO,2024-02-15,408,403,5,0.0122549019607843
OCCIDENTE-BAJIO,2023-02-15,474,215,259,0.546413502109705
OCCIDENTE-BAJIO,2023-02-16,541,209,332,0.613678373382625
OCCIDENTE-BAJIO,2023-02-17,519,179,340,0.655105973025048
OCCIDENTE-BAJIO,2023-02-18,657,299,358,0.544901065449011
OCCIDENTE-BAJIO,2023-02-19,364,154,210,0.576923076923077
OCCIDENTE-BAJIO,2023-02-20,452,201,251,0.555309734513274
OCCIDENTE-BAJIO,2023-02-21,559,278,281,0.502683363148479
OCCIDENTE-BAJIO,2023-02-22,506,289,217,0.428853754940711
OCCIDENTE-BAJIO,2023-02-23,470,286,184,0.391489361702128
OCCIDENTE-BAJIO,2023-02-24,485,305,180,0.371134020618557
OCCIDENTE-BAJIO,2023-02-25,607,412,195,0.321252059308072
OCCIDENTE-BAJIO,2023-02-26,306,179,127,0.415032679738562
OCCIDENTE-BAJIO,2023-02-27,486,325,161,0.331275720164609
OCCIDENTE-BAJIO,2023-02-28,579,388,191,0.329879101899827
OCCIDENTE-BAJIO,2023-03-01,515,332,183,0.355339805825243
OCCIDENTE-BAJIO,2023-03-02,533,351,182,0.341463414634146
OCCIDENTE-BAJIO,2023-03-03,508,345,163,0.320866141732283
OCCIDENTE-BAJIO,2023-03-04,610,408,202,0.331147540983607
OCCIDENTE-BAJIO,2023-03-05,317,210,107,0.337539432176656
OCCIDENTE-BAJIO,2023-03-06,444,303,141,0.317567567567568
OCCIDENTE-BAJIO,2023-03-07,517,363,154,0.297872340425532
OCCIDENTE-BAJIO,2023-03-08,513,397,116,0.226120857699805
OCCIDENTE-BAJIO,2023-03-09,471,421,50,0.106157112526539
OCCIDENTE-BAJIO,2023-03-10,457,402,55,0.12035010940919
OCCIDENTE-BAJIO,2023-03-11,559,483,76,0.135957066189624
OCCIDENTE-BAJIO,2023-03-12,361,322,39,0.10803324099723
OCCIDENTE-BAJIO,2023-03-13,428,380,48,0.11214953271028
OCCIDENTE-BAJIO,2023-03-14,521,455,66,0.126679462571977
OCCIDENTE-BAJIO,2023-03-15,516,468,48,0.0930232558139535
OCCIDENTE-BAJIO,2023-03-16,565,526,39,0.0690265486725664
OCCIDENTE-BAJIO,2023-03-17,667,609,58,0.0869565217391304
OCCIDENTE-BAJIO,2023-03-18,788,707,81,0.102791878172589
OCCIDENTE-BAJIO,2023-03-19,492,452,40,0.0813008130081301
OCCIDENTE-BAJIO,2023-03-20,644,589,55,0.0854037267080745
OCCIDENTE-BAJIO,2023-03-21,592,548,44,0.0743243243243243
OCCIDENTE-BAJIO,2023-03-22,538,504,34,0.0631970260223048
OCCIDENTE-BAJIO,2023-03-23,505,476,29,0.0574257425742574
OCCIDENTE-BAJIO,2023-03-24,534,501,33,0.0617977528089888
OCCIDENTE-BAJIO,2023-03-25,682,647,35,0.0513196480938416
OCCIDENTE-BAJIO,2023-03-26,449,429,20,0.044543429844098
OCCIDENTE-BAJIO,2023-03-27,456,432,24,0.0526315789473684
OCCIDENTE-BAJIO,2023-03-28,457,438,19,0.0415754923413567
OCCIDENTE-BAJIO,2023-03-29,546,516,30,0.0549450549450549
OCCIDENTE-BAJIO,2023-03-30,607,566,41,0.0675453047775947
OCCIDENTE-BAJIO,2023-03-31,799,741,58,0.0725907384230288
OCCIDENTE-BAJIO,2023-04-01,673,642,31,0.0460624071322437
OCCIDENTE-BAJIO,2023-04-02,342,324,18,0.0526315789473684
OCCIDENTE-BAJIO,2023-04-03,551,530,21,0.0381125226860254
OCCIDENTE-BAJIO,2023-04-04,627,584,43,0.0685805422647528
OCCIDENTE-BAJIO,2023-04-05,505,459,46,0.0910891089108911
OCCIDENTE-BAJIO,2023-04-06,500,470,30,0.06
OCCIDENTE-BAJIO,2023-04-07,383,361,22,0.0574412532637076
OCCIDENTE-BAJIO,2023-04-08,305,291,14,0.0459016393442623
OCCIDENTE-BAJIO,2023-04-09,220,211,9,0.0409090909090909
OCCIDENTE-BAJIO,2023-04-10,436,407,29,0.0665137614678899
OCCIDENTE-BAJIO,2023-04-11,510,466,44,0.0862745098039216
OCCIDENTE-BAJIO,2023-04-12,496,453,43,0.0866935483870968
OCCIDENTE-BAJIO,2023-04-13,434,400,34,0.0783410138248848
OCCIDENTE-BAJIO,2023-04-14,535,499,36,0.0672897196261682
OCCIDENTE-BAJIO,2023-04-15,747,689,58,0.0776439089692102
OCCIDENTE-BAJIO,2023-04-16,448,423,25,0.0558035714285714
OCCIDENTE-BAJIO,2023-04-17,509,482,27,0.0530451866404715
OCCIDENTE-BAJIO,2023-04-18,522,455,67,0.128352490421456
OCCIDENTE-BAJIO,2023-04-19,507,456,51,0.100591715976331
OCCIDENTE-BAJIO,2023-04-20,492,458,34,0.0691056910569106
OCCIDENTE-BAJIO,2023-04-21,478,434,44,0.0920502092050209
OCCIDENTE-BAJIO,2023-04-22,583,535,48,0.0823327615780446
OCCIDENTE-BAJIO,2023-04-23,357,327,30,0.0840336134453782
OCCIDENTE-BAJIO,2023-04-24,541,504,37,0.0683918669131238
OCCIDENTE-BAJIO,2023-04-25,655,603,52,0.0793893129770992
OCCIDENTE-BAJIO,2023-04-26,567,521,46,0.0811287477954145
OCCIDENTE-BAJIO,2023-04-27,458,427,31,0.0676855895196507
OCCIDENTE-BAJIO,2023-04-28,588,533,55,0.0935374149659864
OCCIDENTE-BAJIO,2023-04-29,734,670,64,0.0871934604904632
OCCIDENTE-BAJIO,2023-04-30,439,401,38,0.0865603644646925
OCCIDENTE-BAJIO,2023-05-01,455,415,40,0.0879120879120879
OCCIDENTE-BAJIO,2023-05-02,504,467,37,0.0734126984126984
OCCIDENTE-BAJIO,2023-05-03,468,429,39,0.0833333333333333
OCCIDENTE-BAJIO,2023-05-04,475,423,52,0.109473684210526
OCCIDENTE-BAJIO,2023-05-05,527,480,47,0.0891840607210626
OCCIDENTE-BAJIO,2023-05-06,550,501,49,0.0890909090909091
OCCIDENTE-BAJIO,2023-05-07,322,302,20,0.062111801242236
OCCIDENTE-BAJIO,2023-05-08,449,410,39,0.0868596881959911
OCCIDENTE-BAJIO,2023-05-09,499,465,34,0.0681362725450902
OCCIDENTE-BAJIO,2023-05-10,412,373,39,0.0946601941747573
OCCIDENTE-BAJIO,2023-05-11,436,404,32,0.073394495412844
OCCIDENTE-BAJIO,2023-05-12,418,387,31,0.0741626794258373
OCCIDENTE-BAJIO,2023-05-13,647,585,62,0.0958268933539413
OCCIDENTE-BAJIO,2023-05-14,529,492,37,0.0699432892249527
OCCIDENTE-BAJIO,2023-05-15,664,608,56,0.0843373493975904
OCCIDENTE-BAJIO,2023-05-16,778,675,103,0.132390745501285
OCCIDENTE-BAJIO,2023-05-17,611,550,61,0.0998363338788871
OCCIDENTE-BAJIO,2023-05-18,537,495,42,0.0782122905027933
OCCIDENTE-BAJIO,2023-05-19,497,439,58,0.116700201207243
OCCIDENTE-BAJIO,2023-05-20,676,610,66,0.0976331360946746
OCCIDENTE-BAJIO,2023-05-21,464,416,48,0.103448275862069
OCCIDENTE-BAJIO,2023-05-22,518,463,55,0.106177606177606
OCCIDENTE-BAJIO,2023-05-23,526,477,49,0.0931558935361217
OCCIDENTE-BAJIO,2023-05-24,536,471,65,0.121268656716418
OCCIDENTE-BAJIO,2023-05-25,547,477,70,0.127970749542962
OCCIDENTE-BAJIO,2023-05-26,558,497,61,0.109318996415771
OCCIDENTE-BAJIO,2023-05-27,680,602,78,0.114705882352941
OCCIDENTE-BAJIO,2023-05-28,463,396,67,0.144708423326134
OCCIDENTE-BAJIO,2023-05-29,521,439,82,0.157389635316699
OCCIDENTE-BAJIO,2023-05-30,654,553,101,0.154434250764526
OCCIDENTE-BAJIO,2023-05-31,751,653,98,0.130492676431425
OCCIDENTE-BAJIO,2023-06-01,604,523,81,0.134105960264901
OCCIDENTE-BAJIO,2023-06-02,530,463,67,0.126415094339623
OCCIDENTE-BAJIO,2023-06-03,634,570,64,0.100946372239748
OCCIDENTE-BAJIO,2023-06-04,470,416,54,0.114893617021277
OCCIDENTE-BAJIO,2023-06-05,534,467,67,0.125468164794007
OCCIDENTE-BAJIO,2023-06-06,563,514,49,0.0870337477797513
OCCIDENTE-BAJIO,2023-06-07,516,457,59,0.114341085271318
OCCIDENTE-BAJIO,2023-06-08,541,486,55,0.101663585951941
OCCIDENTE-BAJIO,2023-06-09,527,482,45,0.0853889943074004
OCCIDENTE-BAJIO,2023-06-10,653,592,61,0.0934150076569678
OCCIDENTE-BAJIO,2023-06-11,428,389,39,0.0911214953271028
OCCIDENTE-BAJIO,2023-06-12,524,463,61,0.116412213740458
OCCIDENTE-BAJIO,2023-06-13,556,492,64,0.115107913669065
OCCIDENTE-BAJIO,2023-06-14,569,523,46,0.0808435852372583
OCCIDENTE-BAJIO,2023-06-15,567,522,45,0.0793650793650794
OCCIDENTE-BAJIO,2023-06-16,565,521,44,0.0778761061946903
OCCIDENTE-BAJIO,2023-06-17,601,544,57,0.0948419301164725
OCCIDENTE-BAJIO,2023-06-18,398,363,35,0.0879396984924623
OCCIDENTE-BAJIO,2023-06-19,512,463,49,0.095703125
OCCIDENTE-BAJIO,2023-06-20,516,470,46,0.0891472868217054
OCCIDENTE-BAJIO,2023-06-21,544,497,47,0.0863970588235294
OCCIDENTE-BAJIO,2023-06-22,505,467,38,0.0752475247524752
OCCIDENTE-BAJIO,2023-06-23,433,401,32,0.0739030023094688
OCCIDENTE-BAJIO,2023-06-24,561,519,42,0.0748663101604278
OCCIDENTE-BAJIO,2023-06-25,374,354,20,0.053475935828877
OCCIDENTE-BAJIO,2023-06-26,491,458,33,0.0672097759674134
OCCIDENTE-BAJIO,2023-06-27,550,522,28,0.0509090909090909
OCCIDENTE-BAJIO,2023-06-28,527,492,35,0.0664136622390892
OCCIDENTE-BAJIO,2023-06-29,512,476,36,0.0703125
OCCIDENTE-BAJIO,2023-06-30,362,269,93,0.256906077348066
OCCIDENTE-BAJIO,2023-07-01,638,594,44,0.0689655172413793
OCCIDENTE-BAJIO,2023-07-02,406,384,22,0.0541871921182266
OCCIDENTE-BAJIO,2023-07-03,502,484,18,0.0358565737051793
OCCIDENTE-BAJIO,2023-07-04,560,527,33,0.0589285714285714
OCCIDENTE-BAJIO,2023-07-05,400,368,32,0.08
OCCIDENTE-BAJIO,2023-07-06,298,275,23,0.0771812080536913
OCCIDENTE-BAJIO,2023-07-07,497,474,23,0.0462776659959759
OCCIDENTE-BAJIO,2023-07-08,810,772,38,0.0469135802469136
OCCIDENTE-BAJIO,2023-07-09,435,412,23,0.0528735632183908
OCCIDENTE-BAJIO,2023-07-10,521,494,27,0.0518234165067179
OCCIDENTE-BAJIO,2023-07-11,551,511,40,0.0725952813067151
OCCIDENTE-BAJIO,2023-07-12,551,516,35,0.0635208711433757
OCCIDENTE-BAJIO,2023-07-13,504,467,37,0.0734126984126984
OCCIDENTE-BAJIO,2023-07-14,476,450,26,0.0546218487394958
OCCIDENTE-BAJIO,2023-07-15,836,794,42,0.0502392344497608
OCCIDENTE-BAJIO,2023-07-16,358,341,17,0.0474860335195531
OCCIDENTE-BAJIO,2023-07-17,509,478,31,0.0609037328094303
OCCIDENTE-BAJIO,2023-07-18,497,472,25,0.0503018108651912
OCCIDENTE-BAJIO,2023-07-19,514,489,25,0.0486381322957198
OCCIDENTE-BAJIO,2023-07-20,632,601,31,0.0490506329113924
OCCIDENTE-BAJIO,2023-07-21,567,542,25,0.0440917107583774
OCCIDENTE-BAJIO,2023-07-22,770,730,40,0.051948051948052
OCCIDENTE-BAJIO,2023-07-23,400,385,15,0.0375
OCCIDENTE-BAJIO,2023-07-24,454,435,19,0.0418502202643172
OCCIDENTE-BAJIO,2023-07-25,589,551,38,0.0645161290322581
OCCIDENTE-BAJIO,2023-07-26,580,534,46,0.0793103448275862
OCCIDENTE-BAJIO,2023-07-27,552,535,17,0.0307971014492754
OCCIDENTE-BAJIO,2023-07-28,602,562,40,0.0664451827242525
OCCIDENTE-BAJIO,2023-07-29,738,699,39,0.0528455284552846
OCCIDENTE-BAJIO,2023-07-30,447,410,37,0.0827740492170022
OCCIDENTE-BAJIO,2023-07-31,625,595,30,0.048
OCCIDENTE-BAJIO,2023-08-01,624,578,46,0.0737179487179487
OCCIDENTE-BAJIO,2023-08-02,613,578,35,0.0570962479608483
OCCIDENTE-BAJIO,2023-08-03,549,433,116,0.211293260473588
OCCIDENTE-BAJIO,2023-08-04,538,492,46,0.0855018587360595
OCCIDENTE-BAJIO,2023-08-05,645,610,35,0.0542635658914729
OCCIDENTE-BAJIO,2023-08-06,426,404,22,0.0516431924882629
OCCIDENTE-BAJIO,2023-08-07,517,499,18,0.034816247582205
OCCIDENTE-BAJIO,2023-08-08,565,551,14,0.0247787610619469
OCCIDENTE-BAJIO,2023-08-09,576,545,31,0.0538194444444444
OCCIDENTE-BAJIO,2023-08-10,623,591,32,0.0513643659711075
OCCIDENTE-BAJIO,2023-08-11,643,611,32,0.0497667185069984
OCCIDENTE-BAJIO,2023-08-12,687,648,39,0.0567685589519651
OCCIDENTE-BAJIO,2023-08-13,441,412,29,0.0657596371882086
OCCIDENTE-BAJIO,2023-08-14,533,506,27,0.050656660412758
OCCIDENTE-BAJIO,2023-08-15,678,638,40,0.0589970501474926
OCCIDENTE-BAJIO,2023-08-16,629,601,28,0.0445151033386327
OCCIDENTE-BAJIO,2023-08-17,592,556,36,0.0608108108108108
OCCIDENTE-BAJIO,2023-08-18,604,575,29,0.0480132450331126
OCCIDENTE-BAJIO,2023-08-19,696,657,39,0.0560344827586207
OCCIDENTE-BAJIO,2023-08-20,443,421,22,0.0496613995485327
OCCIDENTE-BAJIO,2023-08-21,549,529,20,0.0364298724954463
OCCIDENTE-BAJIO,2023-08-22,584,566,18,0.0308219178082192
OCCIDENTE-BAJIO,2023-08-23,566,541,25,0.0441696113074205
OCCIDENTE-BAJIO,2023-08-24,591,568,23,0.038917089678511
OCCIDENTE-BAJIO,2023-08-25,637,623,14,0.021978021978022
OCCIDENTE-BAJIO,2023-08-26,733,708,25,0.034106412005457
OCCIDENTE-BAJIO,2023-08-27,478,462,16,0.0334728033472803
OCCIDENTE-BAJIO,2023-08-28,550,532,18,0.0327272727272727
OCCIDENTE-BAJIO,2023-08-29,646,627,19,0.0294117647058824
OCCIDENTE-BAJIO,2023-08-30,554,543,11,0.01985559566787
OCCIDENTE-BAJIO,2023-08-31,596,576,20,0.0335570469798658
OCCIDENTE-BAJIO,2023-09-01,541,526,15,0.0277264325323475
OCCIDENTE-BAJIO,2023-09-02,594,584,10,0.0168350168350168
OCCIDENTE-BAJIO,2023-09-03,414,406,8,0.0193236714975845
OCCIDENTE-BAJIO,2023-09-04,481,471,10,0.0207900207900208
OCCIDENTE-BAJIO,2023-09-05,584,575,9,0.0154109589041096
OCCIDENTE-BAJIO,2023-09-06,544,528,16,0.0294117647058824
OCCIDENTE-BAJIO,2023-09-07,570,553,17,0.0298245614035088
OCCIDENTE-BAJIO,2023-09-08,531,523,8,0.0150659133709981
OCCIDENTE-BAJIO,2023-09-09,598,586,12,0.020066889632107
OCCIDENTE-BAJIO,2023-09-10,386,378,8,0.0207253886010363
OCCIDENTE-BAJIO,2023-09-11,510,497,13,0.0254901960784314
OCCIDENTE-BAJIO,2023-09-12,543,535,8,0.0147329650092081
OCCIDENTE-BAJIO,2023-09-13,542,531,11,0.0202952029520295
OCCIDENTE-BAJIO,2023-09-14,534,519,15,0.0280898876404494
OCCIDENTE-BAJIO,2023-09-15,614,602,12,0.0195439739413681
OCCIDENTE-BAJIO,2023-09-16,537,527,10,0.0186219739292365
OCCIDENTE-BAJIO,2023-09-17,410,403,7,0.0170731707317073
OCCIDENTE-BAJIO,2023-09-18,525,515,10,0.019047619047619
OCCIDENTE-BAJIO,2023-09-19,543,525,18,0.0331491712707182
OCCIDENTE-BAJIO,2023-09-20,446,437,9,0.0201793721973094
OCCIDENTE-BAJIO,2023-09-21,492,479,13,0.0264227642276423
OCCIDENTE-BAJIO,2023-09-22,540,523,17,0.0314814814814815
OCCIDENTE-BAJIO,2023-09-23,641,624,17,0.0265210608424337
OCCIDENTE-BAJIO,2023-09-24,376,369,7,0.0186170212765957
OCCIDENTE-BAJIO,2023-09-25,486,475,11,0.0226337448559671
OCCIDENTE-BAJIO,2023-09-26,525,511,14,0.0266666666666667
OCCIDENTE-BAJIO,2023-09-27,518,506,12,0.0231660231660232
OCCIDENTE-BAJIO,2023-09-28,564,546,18,0.0319148936170213
OCCIDENTE-BAJIO,2023-09-29,603,583,20,0.033167495854063
OCCIDENTE-BAJIO,2023-09-30,736,708,28,0.0380434782608696
OCCIDENTE-BAJIO,2023-10-01,432,420,12,0.0277777777777778
OCCIDENTE-BAJIO,2023-10-02,500,486,14,0.028
OCCIDENTE-BAJIO,2023-10-03,499,478,21,0.0420841683366733
OCCIDENTE-BAJIO,2023-10-04,461,438,23,0.0498915401301518
OCCIDENTE-BAJIO,2023-10-05,471,445,26,0.0552016985138004
OCCIDENTE-BAJIO,2023-10-06,490,463,27,0.0551020408163265
OCCIDENTE-BAJIO,2023-10-07,616,593,23,0.0373376623376623
OCCIDENTE-BAJIO,2023-10-08,386,369,17,0.0440414507772021
OCCIDENTE-BAJIO,2023-10-09,515,491,24,0.0466019417475728
OCCIDENTE-BAJIO,2023-10-10,432,408,24,0.0555555555555556
OCCIDENTE-BAJIO,2023-10-11,414,386,28,0.0676328502415459
OCCIDENTE-BAJIO,2023-10-12,449,425,24,0.0534521158129176
OCCIDENTE-BAJIO,2023-10-13,415,388,27,0.0650602409638554
OCCIDENTE-BAJIO,2023-10-14,516,492,24,0.0465116279069767
OCCIDENTE-BAJIO,2023-10-15,404,385,19,0.047029702970297
OCCIDENTE-BAJIO,2023-10-16,517,496,21,0.0406189555125725
OCCIDENTE-BAJIO,2023-10-17,444,434,10,0.0225225225225225
OCCIDENTE-BAJIO,2023-10-18,480,456,24,0.05
OCCIDENTE-BAJIO,2023-10-19,454,434,20,0.0440528634361234
OCCIDENTE-BAJIO,2023-10-20,523,501,22,0.0420650095602294
OCCIDENTE-BAJIO,2023-10-21,605,586,19,0.031404958677686
OCCIDENTE-BAJIO,2023-10-22,402,395,7,0.0174129353233831
OCCIDENTE-BAJIO,2023-10-23,468,454,14,0.0299145299145299
OCCIDENTE-BAJIO,2023-10-24,491,476,15,0.0305498981670061
OCCIDENTE-BAJIO,2023-10-25,498,484,14,0.0281124497991968
OCCIDENTE-BAJIO,2023-10-26,474,450,24,0.0506329113924051
OCCIDENTE-BAJIO,2023-10-27,484,470,14,0.0289256198347107
OCCIDENTE-BAJIO,2023-10-28,533,518,15,0.0281425891181989
OCCIDENTE-BAJIO,2023-10-29,328,322,6,0.0182926829268293
OCCIDENTE-BAJIO,2023-10-30,480,462,18,0.0375
OCCIDENTE-BAJIO,2023-10-31,600,578,22,0.0366666666666667
OCCIDENTE-BAJIO,2023-11-01,545,529,16,0.0293577981651376
OCCIDENTE-BAJIO,2023-11-02,538,524,14,0.0260223048327138
OCCIDENTE-BAJIO,2023-11-03,491,474,17,0.0346232179226069
OCCIDENTE-BAJIO,2023-11-04,588,572,16,0.0272108843537415
OCCIDENTE-BAJIO,2023-11-05,418,409,9,0.0215311004784689
OCCIDENTE-BAJIO,2023-11-06,513,491,22,0.0428849902534113
OCCIDENTE-BAJIO,2023-11-07,595,587,8,0.0134453781512605
OCCIDENTE-BAJIO,2023-11-08,532,506,26,0.0488721804511278
OCCIDENTE-BAJIO,2023-11-09,494,473,21,0.0425101214574899
OCCIDENTE-BAJIO,2023-11-10,499,481,18,0.0360721442885772
OCCIDENTE-BAJIO,2023-11-11,660,636,24,0.0363636363636364
OCCIDENTE-BAJIO,2023-11-12,415,405,10,0.0240963855421687
OCCIDENTE-BAJIO,2023-11-13,550,532,18,0.0327272727272727
OCCIDENTE-BAJIO,2023-11-14,594,572,22,0.037037037037037
OCCIDENTE-BAJIO,2023-11-15,594,579,15,0.0252525252525253
OCCIDENTE-BAJIO,2023-11-16,553,529,24,0.0433996383363472
OCCIDENTE-BAJIO,2023-11-17,581,563,18,0.0309810671256454
OCCIDENTE-BAJIO,2023-11-18,732,716,16,0.0218579234972678
OCCIDENTE-BAJIO,2023-11-19,472,461,11,0.0233050847457627
OCCIDENTE-BAJIO,2023-11-20,587,567,20,0.0340715502555366
OCCIDENTE-BAJIO,2023-11-21,616,593,23,0.0373376623376623
OCCIDENTE-BAJIO,2023-11-22,548,532,16,0.0291970802919708
OCCIDENTE-BAJIO,2023-11-23,562,542,20,0.0355871886120996
OCCIDENTE-BAJIO,2023-11-24,613,594,19,0.0309951060358891
OCCIDENTE-BAJIO,2023-11-25,652,637,15,0.0230061349693252
OCCIDENTE-BAJIO,2023-11-26,441,427,14,0.0317460317460317
OCCIDENTE-BAJIO,2023-11-27,522,503,19,0.0363984674329502
OCCIDENTE-BAJIO,2023-11-28,605,579,26,0.0429752066115702
OCCIDENTE-BAJIO,2023-11-29,607,570,37,0.0609555189456343
OCCIDENTE-BAJIO,2023-11-30,638,616,22,0.0344827586206897
OCCIDENTE-BAJIO,2023-12-01,557,529,28,0.0502692998204668
OCCIDENTE-BAJIO,2023-12-02,619,590,29,0.0468497576736672
OCCIDENTE-BAJIO,2023-12-03,443,420,23,0.0519187358916479
OCCIDENTE-BAJIO,2023-12-04,543,520,23,0.0423572744014733
OCCIDENTE-BAJIO,2023-12-05,595,566,29,0.0487394957983193
OCCIDENTE-BAJIO,2023-12-06,605,579,26,0.0429752066115702
OCCIDENTE-BAJIO,2023-12-07,510,492,18,0.0352941176470588
OCCIDENTE-BAJIO,2023-12-08,568,547,21,0.0369718309859155
OCCIDENTE-BAJIO,2023-12-09,620,587,33,0.0532258064516129
OCCIDENTE-BAJIO,2023-12-10,441,428,13,0.0294784580498866
OCCIDENTE-BAJIO,2023-12-11,476,454,22,0.046218487394958
OCCIDENTE-BAJIO,2023-12-12,572,546,26,0.0454545454545455
OCCIDENTE-BAJIO,2023-12-13,513,491,22,0.0428849902534113
OCCIDENTE-BAJIO,2023-12-14,527,504,23,0.0436432637571157
OCCIDENTE-BAJIO,2023-12-15,484,464,20,0.0413223140495868
OCCIDENTE-BAJIO,2023-12-16,658,637,21,0.0319148936170213
OCCIDENTE-BAJIO,2023-12-17,449,439,10,0.022271714922049
OCCIDENTE-BAJIO,2023-12-18,594,572,22,0.037037037037037
OCCIDENTE-BAJIO,2023-12-19,579,553,26,0.0449050086355786
OCCIDENTE-BAJIO,2023-12-20,614,584,30,0.0488599348534202
OCCIDENTE-BAJIO,2023-12-21,567,543,24,0.0423280423280423
OCCIDENTE-BAJIO,2023-12-22,580,562,18,0.0310344827586207
OCCIDENTE-BAJIO,2023-12-23,606,590,16,0.0264026402640264
OCCIDENTE-BAJIO,2023-12-24,324,314,10,0.0308641975308642
OCCIDENTE-BAJIO,2023-12-25,112,108,4,0.0357142857142857
OCCIDENTE-BAJIO,2023-12-26,470,457,13,0.0276595744680851
OCCIDENTE-BAJIO,2023-12-27,606,587,19,0.0313531353135314
OCCIDENTE-BAJIO,2023-12-28,649,628,21,0.0323574730354391
OCCIDENTE-BAJIO,2023-12-29,639,618,21,0.0328638497652582
OCCIDENTE-BAJIO,2023-12-30,668,654,14,0.0209580838323353
OCCIDENTE-BAJIO,2023-12-31,347,344,3,0.00864553314121038
OCCIDENTE-BAJIO,2024-01-01,116,111,5,0.0431034482758621
OCCIDENTE-BAJIO,2024-01-02,483,472,11,0.0227743271221532
OCCIDENTE-BAJIO,2024-01-03,684,668,16,0.0233918128654971
OCCIDENTE-BAJIO,2024-01-04,608,588,20,0.0328947368421053
OCCIDENTE-BAJIO,2024-01-05,610,588,22,0.0360655737704918
OCCIDENTE-BAJIO,2024-01-06,641,626,15,0.0234009360374415
OCCIDENTE-BAJIO,2024-01-07,412,398,14,0.0339805825242718
OCCIDENTE-BAJIO,2024-01-08,616,588,28,0.0454545454545455
OCCIDENTE-BAJIO,2024-01-09,678,654,24,0.0353982300884956
OCCIDENTE-BAJIO,2024-01-10,605,586,19,0.031404958677686
OCCIDENTE-BAJIO,2024-01-11,633,615,18,0.028436018957346
OCCIDENTE-BAJIO,2024-01-12,607,595,12,0.0197693574958814
OCCIDENTE-BAJIO,2024-01-13,693,664,29,0.0418470418470418
OCCIDENTE-BAJIO,2024-01-14,482,465,17,0.0352697095435685
OCCIDENTE-BAJIO,2024-01-15,587,566,21,0.0357751277683135
OCCIDENTE-BAJIO,2024-01-16,648,630,18,0.0277777777777778
OCCIDENTE-BAJIO,2024-01-17,627,607,20,0.0318979266347687
OCCIDENTE-BAJIO,2024-01-18,578,562,16,0.027681660899654
OCCIDENTE-BAJIO,2024-01-19,580,554,26,0.0448275862068966
OCCIDENTE-BAJIO,2024-01-20,654,642,12,0.018348623853211
OCCIDENTE-BAJIO,2024-01-21,412,398,14,0.0339805825242718
OCCIDENTE-BAJIO,2024-01-22,474,455,19,0.040084388185654
OCCIDENTE-BAJIO,2024-01-23,561,541,20,0.035650623885918
OCCIDENTE-BAJIO,2024-01-24,592,565,27,0.0456081081081081
OCCIDENTE-BAJIO,2024-01-25,550,534,16,0.0290909090909091
OCCIDENTE-BAJIO,2024-01-26,590,571,19,0.0322033898305085
OCCIDENTE-BAJIO,2024-01-27,652,634,18,0.0276073619631902
OCCIDENTE-BAJIO,2024-01-28,423,411,12,0.0283687943262411
OCCIDENTE-BAJIO,2024-01-29,534,515,19,0.0355805243445693
OCCIDENTE-BAJIO,2024-01-30,593,566,27,0.045531197301855
OCCIDENTE-BAJIO,2024-01-31,612,589,23,0.0375816993464052
OCCIDENTE-BAJIO,2024-02-01,518,502,16,0.0308880308880309
OCCIDENTE-BAJIO,2024-02-02,554,526,28,0.0505415162454874
OCCIDENTE-BAJIO,2024-02-03,657,633,24,0.0365296803652968
OCCIDENTE-BAJIO,2024-02-04,430,423,7,0.0162790697674419
OCCIDENTE-BAJIO,2024-02-05,449,434,15,0.0334075723830735
OCCIDENTE-BAJIO,2024-02-06,588,570,18,0.0306122448979592
OCCIDENTE-BAJIO,2024-02-07,604,587,17,0.0281456953642384
OCCIDENTE-BAJIO,2024-02-08,541,535,6,0.011090573012939
OCCIDENTE-BAJIO,2024-02-09,564,554,10,0.0177304964539007
OCCIDENTE-BAJIO,2024-02-10,628,615,13,0.0207006369426752
OCCIDENTE-BAJIO,2024-02-11,379,369,10,0.0263852242744063
OCCIDENTE-BAJIO,2024-02-12,408,389,19,0.0465686274509804
OCCIDENTE-BAJIO,2024-02-13,564,539,25,0.0443262411347518
OCCIDENTE-BAJIO,2024-02-14,490,477,13,0.026530612244898
OCCIDENTE-BAJIO,2024-02-15,525,515,10,0.019047619047619
ORIENTE,2023-02-15,352,155,197,0.559659090909091
ORIENTE,2023-02-16,355,176,179,0.504225352112676
ORIENTE,2023-02-17,293,151,142,0.484641638225256
ORIENTE,2023-02-18,361,202,159,0.440443213296399
ORIENTE,2023-02-19,270,130,140,0.518518518518518
ORIENTE,2023-02-20,310,165,145,0.467741935483871
ORIENTE,2023-02-21,333,182,151,0.453453453453453
ORIENTE,2023-02-22,314,157,157,0.5
ORIENTE,2023-02-23,330,184,146,0.442424242424242
ORIENTE,2023-02-24,370,211,159,0.42972972972973
ORIENTE,2023-02-25,371,228,143,0.38544474393531
ORIENTE,2023-02-26,254,150,104,0.409448818897638
ORIENTE,2023-02-27,381,205,176,0.461942257217848
ORIENTE,2023-02-28,424,233,191,0.450471698113208
ORIENTE,2023-03-01,366,177,189,0.516393442622951
ORIENTE,2023-03-02,251,136,115,0.458167330677291
ORIENTE,2023-03-03,315,207,108,0.342857142857143
ORIENTE,2023-03-04,344,202,142,0.412790697674419
ORIENTE,2023-03-05,194,127,67,0.345360824742268
ORIENTE,2023-03-06,320,217,103,0.321875
ORIENTE,2023-03-07,321,228,93,0.289719626168224
ORIENTE,2023-03-08,334,255,79,0.236526946107784
ORIENTE,2023-03-09,301,262,39,0.129568106312292
ORIENTE,2023-03-10,287,269,18,0.0627177700348432
ORIENTE,2023-03-11,334,310,24,0.0718562874251497
ORIENTE,2023-03-12,235,213,22,0.0936170212765957
ORIENTE,2023-03-13,288,267,21,0.0729166666666667
ORIENTE,2023-03-14,317,301,16,0.0504731861198738
ORIENTE,2023-03-15,347,321,26,0.0749279538904899
ORIENTE,2023-03-16,412,393,19,0.0461165048543689
ORIENTE,2023-03-17,414,388,26,0.0628019323671498
ORIENTE,2023-03-18,503,478,25,0.0497017892644135
ORIENTE,2023-03-19,350,328,22,0.0628571428571429
ORIENTE,2023-03-20,423,402,21,0.049645390070922
ORIENTE,2023-03-21,382,368,14,0.0366492146596859
ORIENTE,2023-03-22,347,333,14,0.0403458213256484
ORIENTE,2023-03-23,345,336,9,0.0260869565217391
ORIENTE,2023-03-24,354,345,9,0.0254237288135593
ORIENTE,2023-03-25,388,378,10,0.0257731958762887
ORIENTE,2023-03-26,318,309,9,0.0283018867924528
ORIENTE,2023-03-27,282,272,10,0.0354609929078014
ORIENTE,2023-03-28,287,274,13,0.0452961672473868
ORIENTE,2023-03-29,321,316,5,0.0155763239875389
ORIENTE,2023-03-30,381,368,13,0.0341207349081365
ORIENTE,2023-03-31,532,515,17,0.0319548872180451
ORIENTE,2023-04-01,418,406,12,0.0287081339712919
ORIENTE,2023-04-02,249,242,7,0.0281124497991968
ORIENTE,2023-04-03,388,380,8,0.0206185567010309
ORIENTE,2023-04-04,366,353,13,0.0355191256830601
ORIENTE,2023-04-05,309,293,16,0.0517799352750809
ORIENTE,2023-04-06,351,340,11,0.0313390313390313
ORIENTE,2023-04-07,242,233,9,0.0371900826446281
ORIENTE,2023-04-08,234,231,3,0.0128205128205128
ORIENTE,2023-04-09,163,159,4,0.0245398773006135
ORIENTE,2023-04-10,255,242,13,0.0509803921568627
ORIENTE,2023-04-11,308,289,19,0.0616883116883117
ORIENTE,2023-04-12,325,306,19,0.0584615384615385
ORIENTE,2023-04-13,283,272,11,0.03886925795053
ORIENTE,2023-04-14,376,355,21,0.0558510638297872
ORIENTE,2023-04-15,523,488,35,0.0669216061185468
ORIENTE,2023-04-16,398,382,16,0.0402010050251256
ORIENTE,2023-04-17,344,330,14,0.0406976744186047
ORIENTE,2023-04-18,293,276,17,0.0580204778156997
ORIENTE,2023-04-19,289,274,15,0.0519031141868512
ORIENTE,2023-04-20,314,299,15,0.0477707006369427
ORIENTE,2023-04-21,319,305,14,0.0438871473354232
ORIENTE,2023-04-22,387,370,17,0.0439276485788114
ORIENTE,2023-04-23,286,269,17,0.0594405594405594
ORIENTE,2023-04-24,352,342,10,0.0284090909090909
ORIENTE,2023-04-25,469,437,32,0.0682302771855011
ORIENTE,2023-04-26,384,369,15,0.0390625
ORIENTE,2023-04-27,304,282,22,0.0723684210526316
ORIENTE,2023-04-28,407,377,30,0.0737100737100737
ORIENTE,2023-04-29,479,455,24,0.0501043841336117
ORIENTE,2023-04-30,395,378,17,0.0430379746835443
ORIENTE,2023-05-01,322,309,13,0.0403726708074534
ORIENTE,2023-05-02,326,313,13,0.0398773006134969
ORIENTE,2023-05-03,326,315,11,0.0337423312883436
ORIENTE,2023-05-04,306,290,16,0.0522875816993464
ORIENTE,2023-05-05,336,322,14,0.0416666666666667
ORIENTE,2023-05-06,365,352,13,0.0356164383561644
ORIENTE,2023-05-07,211,200,11,0.0521327014218009
ORIENTE,2023-05-08,266,251,15,0.056390977443609
ORIENTE,2023-05-09,356,339,17,0.047752808988764
ORIENTE,2023-05-10,288,274,14,0.0486111111111111
ORIENTE,2023-05-11,290,272,18,0.0620689655172414
ORIENTE,2023-05-12,281,272,9,0.0320284697508897
ORIENTE,2023-05-13,454,429,25,0.0550660792951542
ORIENTE,2023-05-14,423,406,17,0.0401891252955083
ORIENTE,2023-05-15,513,490,23,0.0448343079922027
ORIENTE,2023-05-16,545,520,25,0.0458715596330275
ORIENTE,2023-05-17,432,405,27,0.0625
ORIENTE,2023-05-18,307,293,14,0.0456026058631922
ORIENTE,2023-05-19,314,295,19,0.0605095541401274
ORIENTE,2023-05-20,438,413,25,0.0570776255707763
ORIENTE,2023-05-21,372,355,17,0.0456989247311828
ORIENTE,2023-05-22,354,332,22,0.0621468926553672
ORIENTE,2023-05-23,353,337,16,0.0453257790368272
ORIENTE,2023-05-24,341,327,14,0.0410557184750733
ORIENTE,2023-05-25,371,355,16,0.0431266846361186
ORIENTE,2023-05-26,385,361,24,0.0623376623376623
ORIENTE,2023-05-27,433,401,32,0.0739030023094688
ORIENTE,2023-05-28,263,239,24,0.091254752851711
ORIENTE,2023-05-29,345,326,19,0.0550724637681159
ORIENTE,2023-05-30,404,378,26,0.0643564356435644
ORIENTE,2023-05-31,483,461,22,0.0455486542443064
ORIENTE,2023-06-01,375,352,23,0.0613333333333333
ORIENTE,2023-06-02,308,294,14,0.0454545454545455
ORIENTE,2023-06-03,349,332,17,0.0487106017191977
ORIENTE,2023-06-04,352,326,26,0.0738636363636364
ORIENTE,2023-06-05,326,316,10,0.0306748466257669
ORIENTE,2023-06-06,298,288,10,0.0335570469798658
ORIENTE,2023-06-07,292,275,17,0.0582191780821918
ORIENTE,2023-06-08,311,296,15,0.0482315112540193
ORIENTE,2023-06-09,323,310,13,0.0402476780185759
ORIENTE,2023-06-10,403,389,14,0.0347394540942928
ORIENTE,2023-06-11,338,325,13,0.0384615384615385
ORIENTE,2023-06-12,303,291,12,0.0396039603960396
ORIENTE,2023-06-13,309,297,12,0.0388349514563107
ORIENTE,2023-06-14,347,330,17,0.0489913544668588
ORIENTE,2023-06-15,397,382,15,0.0377833753148615
ORIENTE,2023-06-16,351,337,14,0.0398860398860399
ORIENTE,2023-06-17,379,362,17,0.0448548812664908
ORIENTE,2023-06-18,333,321,12,0.036036036036036
ORIENTE,2023-06-19,374,366,8,0.0213903743315508
ORIENTE,2023-06-20,400,389,11,0.0275
ORIENTE,2023-06-21,354,339,15,0.0423728813559322
ORIENTE,2023-06-22,308,291,17,0.0551948051948052
ORIENTE,2023-06-23,312,300,12,0.0384615384615385
ORIENTE,2023-06-24,336,327,9,0.0267857142857143
ORIENTE,2023-06-25,327,317,10,0.0305810397553517
ORIENTE,2023-06-26,322,309,13,0.0403726708074534
ORIENTE,2023-06-27,389,379,10,0.025706940874036
ORIENTE,2023-06-28,331,317,14,0.0422960725075529
ORIENTE,2023-06-29,382,368,14,0.0366492146596859
ORIENTE,2023-06-30,303,275,28,0.0924092409240924
ORIENTE,2023-07-01,441,425,16,0.036281179138322
ORIENTE,2023-07-02,246,236,10,0.040650406504065
ORIENTE,2023-07-03,359,353,6,0.0167130919220056
ORIENTE,2023-07-04,331,319,12,0.0362537764350453
ORIENTE,2023-07-05,348,334,14,0.0402298850574713
ORIENTE,2023-07-06,324,307,17,0.0524691358024691
ORIENTE,2023-07-07,366,349,17,0.046448087431694
ORIENTE,2023-07-08,417,408,9,0.0215827338129496
ORIENTE,2023-07-09,303,295,8,0.0264026402640264
ORIENTE,2023-07-10,318,309,9,0.0283018867924528
ORIENTE,2023-07-11,360,347,13,0.0361111111111111
ORIENTE,2023-07-12,337,329,8,0.0237388724035608
ORIENTE,2023-07-13,307,293,14,0.0456026058631922
ORIENTE,2023-07-14,339,329,10,0.0294985250737463
ORIENTE,2023-07-15,413,405,8,0.0193704600484262
ORIENTE,2023-07-16,318,311,7,0.0220125786163522
ORIENTE,2023-07-17,317,304,13,0.0410094637223975
ORIENTE,2023-07-18,303,294,9,0.0297029702970297
ORIENTE,2023-07-19,319,313,6,0.0188087774294671
ORIENTE,2023-07-20,370,359,11,0.0297297297297297
ORIENTE,2023-07-21,332,326,6,0.0180722891566265
ORIENTE,2023-07-22,339,331,8,0.023598820058997
ORIENTE,2023-07-23,289,281,8,0.027681660899654
ORIENTE,2023-07-24,346,337,9,0.0260115606936416
ORIENTE,2023-07-25,360,353,7,0.0194444444444444
ORIENTE,2023-07-26,349,337,12,0.0343839541547278
ORIENTE,2023-07-27,357,346,11,0.030812324929972
ORIENTE,2023-07-28,371,362,9,0.0242587601078167
ORIENTE,2023-07-29,457,443,14,0.0306345733041575
ORIENTE,2023-07-30,349,343,6,0.0171919770773639
ORIENTE,2023-07-31,465,458,7,0.0150537634408602
ORIENTE,2023-08-01,389,368,21,0.0539845758354756
ORIENTE,2023-08-02,356,344,12,0.0337078651685393
ORIENTE,2023-08-03,364,318,46,0.126373626373626
ORIENTE,2023-08-04,302,291,11,0.0364238410596026
ORIENTE,2023-08-05,364,358,6,0.0164835164835165
ORIENTE,2023-08-06,286,279,7,0.0244755244755245
ORIENTE,2023-08-07,355,349,6,0.0169014084507042
ORIENTE,2023-08-08,353,342,11,0.0311614730878187
ORIENTE,2023-08-09,390,378,12,0.0307692307692308
ORIENTE,2023-08-10,408,403,5,0.0122549019607843
ORIENTE,2023-08-11,385,380,5,0.012987012987013
ORIENTE,2023-08-12,387,374,13,0.0335917312661499
ORIENTE,2023-08-13,307,296,11,0.0358306188925081
ORIENTE,2023-08-14,375,368,7,0.0186666666666667
ORIENTE,2023-08-15,376,371,5,0.0132978723404255
ORIENTE,2023-08-16,405,394,11,0.0271604938271605
ORIENTE,2023-08-17,393,372,21,0.0534351145038168
ORIENTE,2023-08-18,398,386,12,0.0301507537688442
ORIENTE,2023-08-19,409,400,9,0.0220048899755501
ORIENTE,2023-08-20,298,288,10,0.0335570469798658
ORIENTE,2023-08-21,323,319,4,0.0123839009287926
ORIENTE,2023-08-22,339,338,1,0.00294985250737463
ORIENTE,2023-08-23,330,327,3,0.00909090909090909
ORIENTE,2023-08-24,371,366,5,0.0134770889487871
ORIENTE,2023-08-25,412,406,6,0.0145631067961165
ORIENTE,2023-08-26,412,408,4,0.00970873786407767
ORIENTE,2023-08-27,303,299,4,0.0132013201320132
ORIENTE,2023-08-28,356,354,2,0.00561797752808989
ORIENTE,2023-08-29,364,362,2,0.00549450549450549
ORIENTE,2023-08-30,359,357,2,0.00557103064066852
ORIENTE,2023-08-31,365,364,1,0.00273972602739726
ORIENTE,2023-09-01,308,301,7,0.0227272727272727
ORIENTE,2023-09-02,321,321,0,0
ORIENTE,2023-09-03,264,263,1,0.00378787878787879
ORIENTE,2023-09-04,334,333,1,0.0029940119760479
ORIENTE,2023-09-05,380,379,1,0.00263157894736842
ORIENTE,2023-09-06,341,340,1,0.00293255131964809
ORIENTE,2023-09-07,311,308,3,0.00964630225080386
ORIENTE,2023-09-08,317,314,3,0.00946372239747634
ORIENTE,2023-09-09,371,369,2,0.00539083557951483
ORIENTE,2023-09-10,262,261,1,0.00381679389312977
ORIENTE,2023-09-11,299,297,2,0.00668896321070234
ORIENTE,2023-09-12,370,366,4,0.0108108108108108
ORIENTE,2023-09-13,309,305,4,0.0129449838187702
ORIENTE,2023-09-14,369,367,2,0.00542005420054201
ORIENTE,2023-09-15,426,422,4,0.00938967136150235
ORIENTE,2023-09-16,313,310,3,0.00958466453674121
ORIENTE,2023-09-17,258,257,1,0.00387596899224806
ORIENTE,2023-09-18,338,338,0,0
ORIENTE,2023-09-19,341,339,2,0.00586510263929619
ORIENTE,2023-09-20,287,286,1,0.00348432055749129
ORIENTE,2023-09-21,309,306,3,0.00970873786407767
ORIENTE,2023-09-22,314,313,1,0.00318471337579618
ORIENTE,2023-09-23,374,372,2,0.0053475935828877
ORIENTE,2023-09-24,304,302,2,0.00657894736842105
ORIENTE,2023-09-25,346,344,2,0.00578034682080925
ORIENTE,2023-09-26,375,372,3,0.008
ORIENTE,2023-09-27,315,314,1,0.00317460317460317
ORIENTE,2023-09-28,330,329,1,0.00303030303030303
ORIENTE,2023-09-29,415,412,3,0.0072289156626506
ORIENTE,2023-09-30,506,503,3,0.00592885375494071
ORIENTE,2023-10-01,309,308,1,0.00323624595469256
ORIENTE,2023-10-02,299,296,3,0.0100334448160535
ORIENTE,2023-10-03,301,295,6,0.0199335548172757
ORIENTE,2023-10-04,306,301,5,0.0163398692810458
ORIENTE,2023-10-05,300,296,4,0.0133333333333333
ORIENTE,2023-10-06,356,345,11,0.0308988764044944
ORIENTE,2023-10-07,351,344,7,0.0199430199430199
ORIENTE,2023-10-08,236,229,7,0.0296610169491525
ORIENTE,2023-10-09,266,259,7,0.0263157894736842
ORIENTE,2023-10-10,256,249,7,0.02734375
ORIENTE,2023-10-11,300,292,8,0.0266666666666667
ORIENTE,2023-10-12,272,269,3,0.0110294117647059
ORIENTE,2023-10-13,323,314,9,0.0278637770897833
ORIENTE,2023-10-14,375,365,10,0.0266666666666667
ORIENTE,2023-10-15,286,283,3,0.0104895104895105
ORIENTE,2023-10-16,341,337,4,0.0117302052785924
ORIENTE,2023-10-17,296,288,8,0.027027027027027
ORIENTE,2023-10-18,309,299,10,0.0323624595469256
ORIENTE,2023-10-19,318,312,6,0.0188679245283019
ORIENTE,2023-10-20,306,294,12,0.0392156862745098
ORIENTE,2023-10-21,416,407,9,0.0216346153846154
ORIENTE,2023-10-22,309,303,6,0.0194174757281553
ORIENTE,2023-10-23,344,336,8,0.0232558139534884
ORIENTE,2023-10-24,322,315,7,0.0217391304347826
ORIENTE,2023-10-25,271,264,7,0.025830258302583
ORIENTE,2023-10-26,316,305,11,0.0348101265822785
ORIENTE,2023-10-27,307,293,14,0.0456026058631922
ORIENTE,2023-10-28,373,360,13,0.0348525469168901
ORIENTE,2023-10-29,267,257,10,0.0374531835205993
ORIENTE,2023-10-30,293,290,3,0.0102389078498294
ORIENTE,2023-10-31,402,395,7,0.0174129353233831
ORIENTE,2023-11-01,321,309,12,0.0373831775700935
ORIENTE,2023-11-02,259,254,5,0.0193050193050193
ORIENTE,2023-11-03,270,263,7,0.0259259259259259
ORIENTE,2023-11-04,311,305,6,0.0192926045016077
ORIENTE,2023-11-05,274,270,4,0.0145985401459854
ORIENTE,2023-11-06,347,335,12,0.0345821325648415
ORIENTE,2023-11-07,338,332,6,0.0177514792899408
ORIENTE,2023-11-08,326,319,7,0.0214723926380368
ORIENTE,2023-11-09,336,326,10,0.0297619047619048
ORIENTE,2023-11-10,334,325,9,0.0269461077844311
ORIENTE,2023-11-11,389,381,8,0.0205655526992288
ORIENTE,2023-11-12,284,274,10,0.0352112676056338
ORIENTE,2023-11-13,293,283,10,0.0341296928327645
ORIENTE,2023-11-14,382,376,6,0.0157068062827225
ORIENTE,2023-11-15,402,391,11,0.027363184079602
ORIENTE,2023-11-16,365,358,7,0.0191780821917808
ORIENTE,2023-11-17,392,382,10,0.0255102040816327
ORIENTE,2023-11-18,410,404,6,0.0146341463414634
ORIENTE,2023-11-19,342,332,10,0.0292397660818713
ORIENTE,2023-11-20,349,342,7,0.0200573065902579
ORIENTE,2023-11-21,339,332,7,0.0206489675516224
ORIENTE,2023-11-22,311,306,5,0.0160771704180064
ORIENTE,2023-11-23,337,329,8,0.0237388724035608
ORIENTE,2023-11-24,338,329,9,0.0266272189349112
ORIENTE,2023-11-25,397,394,3,0.00755667506297229
ORIENTE,2023-11-26,260,254,6,0.0230769230769231
ORIENTE,2023-11-27,345,339,6,0.0173913043478261
ORIENTE,2023-11-28,339,330,9,0.0265486725663717
ORIENTE,2023-11-29,391,369,22,0.0562659846547315
ORIENTE,2023-11-30,476,459,17,0.0357142857142857
ORIENTE,2023-12-01,373,359,14,0.0375335120643432
ORIENTE,2023-12-02,412,403,9,0.0218446601941748
ORIENTE,2023-12-03,316,304,12,0.0379746835443038
ORIENTE,2023-12-04,324,317,7,0.0216049382716049
ORIENTE,2023-12-05,359,349,10,0.0278551532033426
ORIENTE,2023-12-06,391,381,10,0.0255754475703325
ORIENTE,2023-12-07,389,376,13,0.0334190231362468
ORIENTE,2023-12-08,410,398,12,0.0292682926829268
ORIENTE,2023-12-09,410,400,10,0.024390243902439
ORIENTE,2023-12-10,282,271,11,0.0390070921985816
ORIENTE,2023-12-11,333,328,5,0.015015015015015
ORIENTE,2023-12-12,362,354,8,0.0220994475138122
ORIENTE,2023-12-13,329,323,6,0.0182370820668693
ORIENTE,2023-12-14,329,317,12,0.0364741641337386
ORIENTE,2023-12-15,347,337,10,0.0288184438040346
ORIENTE,2023-12-16,396,389,7,0.0176767676767677
ORIENTE,2023-12-17,348,335,13,0.0373563218390805
ORIENTE,2023-12-18,399,391,8,0.0200501253132832
ORIENTE,2023-12-19,425,408,17,0.04
ORIENTE,2023-12-20,358,349,9,0.0251396648044693
ORIENTE,2023-12-21,422,413,9,0.0213270142180095
ORIENTE,2023-12-22,380,373,7,0.0184210526315789
ORIENTE,2023-12-23,432,418,14,0.0324074074074074
ORIENTE,2023-12-24,239,232,7,0.0292887029288703
ORIENTE,2023-12-25,85,85,0,0
ORIENTE,2023-12-26,334,330,4,0.0119760479041916
ORIENTE,2023-12-27,415,405,10,0.0240963855421687
ORIENTE,2023-12-28,417,408,9,0.0215827338129496
ORIENTE,2023-12-29,406,393,13,0.0320197044334975
ORIENTE,2023-12-30,415,404,11,0.0265060240963855
ORIENTE,2023-12-31,174,170,4,0.0229885057471264
ORIENTE,2024-01-01,74,70,4,0.0540540540540541
ORIENTE,2024-01-02,276,270,6,0.0217391304347826
ORIENTE,2024-01-03,359,351,8,0.0222841225626741
ORIENTE,2024-01-04,378,373,5,0.0132275132275132
ORIENTE,2024-01-05,371,360,11,0.0296495956873315
ORIENTE,2024-01-06,386,380,6,0.0155440414507772
ORIENTE,2024-01-07,263,258,5,0.0190114068441065
ORIENTE,2024-01-08,358,350,8,0.0223463687150838
ORIENTE,2024-01-09,418,403,15,0.0358851674641148
ORIENTE,2024-01-10,422,414,8,0.018957345971564
ORIENTE,2024-01-11,385,372,13,0.0337662337662338
ORIENTE,2024-01-12,393,386,7,0.0178117048346056
ORIENTE,2024-01-13,460,449,11,0.0239130434782609
ORIENTE,2024-01-14,379,372,7,0.0184696569920844
ORIENTE,2024-01-15,417,402,15,0.0359712230215827
ORIENTE,2024-01-16,467,453,14,0.0299785867237687
ORIENTE,2024-01-17,442,434,8,0.0180995475113122
ORIENTE,2024-01-18,403,393,10,0.0248138957816377
ORIENTE,2024-01-19,334,324,10,0.029940119760479
ORIENTE,2024-01-20,404,396,8,0.0198019801980198
ORIENTE,2024-01-21,279,273,6,0.021505376344086
ORIENTE,2024-01-22,356,346,10,0.0280898876404494
ORIENTE,2024-01-23,340,332,8,0.0235294117647059
ORIENTE,2024-01-24,358,349,9,0.0251396648044693
ORIENTE,2024-01-25,317,310,7,0.0220820189274448
ORIENTE,2024-01-26,334,325,9,0.0269461077844311
ORIENTE,2024-01-27,370,362,8,0.0216216216216216
ORIENTE,2024-01-28,270,263,7,0.0259259259259259
ORIENTE,2024-01-29,333,325,8,0.024024024024024
ORIENTE,2024-01-30,369,358,11,0.029810298102981
ORIENTE,2024-01-31,463,452,11,0.0237580993520518
ORIENTE,2024-02-01,356,348,8,0.0224719101123595
ORIENTE,2024-02-02,340,329,11,0.0323529411764706
ORIENTE,2024-02-03,382,370,12,0.031413612565445
ORIENTE,2024-02-04,307,304,3,0.00977198697068404
ORIENTE,2024-02-05,341,334,7,0.0205278592375367
ORIENTE,2024-02-06,344,335,9,0.0261627906976744
ORIENTE,2024-02-07,356,345,11,0.0308988764044944
ORIENTE,2024-02-08,352,349,3,0.00852272727272727
ORIENTE,2024-02-09,343,334,9,0.0262390670553936
ORIENTE,2024-02-10,371,360,11,0.0296495956873315
ORIENTE,2024-02-11,241,227,14,0.0580912863070539
ORIENTE,2024-02-12,310,300,10,0.032258064516129
ORIENTE,2024-02-13,338,328,10,0.029585798816568
ORIENTE,2024-02-14,309,303,6,0.0194174757281553
ORIENTE,2024-02-15,350,346,4,0.0114285714285714
SURESTE,2023-02-15,191,94,97,0.507853403141361
SURESTE,2023-02-16,196,87,109,0.556122448979592
SURESTE,2023-02-17,179,77,102,0.569832402234637
SURESTE,2023-02-18,186,83,103,0.553763440860215
SURESTE,2023-02-19,172,69,103,0.598837209302326
SURESTE,2023-02-20,169,100,69,0.408284023668639
SURESTE,2023-02-21,196,117,79,0.403061224489796
SURESTE,2023-02-22,165,93,72,0.436363636363636
SURESTE,2023-02-23,169,95,74,0.437869822485207
SURESTE,2023-02-24,167,112,55,0.329341317365269
SURESTE,2023-02-25,199,121,78,0.391959798994975
SURESTE,2023-02-26,193,110,83,0.430051813471503
SURESTE,2023-02-27,190,117,73,0.384210526315789
SURESTE,2023-02-28,170,104,66,0.388235294117647
SURESTE,2023-03-01,141,93,48,0.340425531914894
SURESTE,2023-03-02,218,138,80,0.36697247706422
SURESTE,2023-03-03,183,114,69,0.377049180327869
SURESTE,2023-03-04,234,139,95,0.405982905982906
SURESTE,2023-03-05,204,110,94,0.46078431372549
SURESTE,2023-03-06,185,124,61,0.32972972972973
SURESTE,2023-03-07,191,129,62,0.324607329842932
SURESTE,2023-03-08,188,149,39,0.207446808510638
SURESTE,2023-03-09,191,149,42,0.219895287958115
SURESTE,2023-03-10,186,151,35,0.188172043010753
SURESTE,2023-03-11,194,145,49,0.252577319587629
SURESTE,2023-03-12,188,148,40,0.212765957446809
SURESTE,2023-03-13,191,147,44,0.230366492146597
SURESTE,2023-03-14,179,143,36,0.201117318435754
SURESTE,2023-03-15,186,159,27,0.145161290322581
SURESTE,2023-03-16,198,178,20,0.101010101010101
SURESTE,2023-03-17,269,223,46,0.171003717472119
SURESTE,2023-03-18,282,247,35,0.124113475177305
SURESTE,2023-03-19,189,163,26,0.137566137566138
SURESTE,2023-03-20,232,199,33,0.142241379310345
SURESTE,2023-03-21,243,214,29,0.119341563786008
SURESTE,2023-03-22,204,181,23,0.112745098039216
SURESTE,2023-03-23,211,191,20,0.0947867298578199
SURESTE,2023-03-24,220,203,17,0.0772727272727273
SURESTE,2023-03-25,225,207,18,0.08
SURESTE,2023-03-26,189,170,19,0.100529100529101
SURESTE,2023-03-27,176,160,16,0.0909090909090909
SURESTE,2023-03-28,200,185,15,0.075
SURESTE,2023-03-29,206,195,11,0.0533980582524272
SURESTE,2023-03-30,254,235,19,0.0748031496062992
SURESTE,2023-03-31,292,257,35,0.11986301369863
SURESTE,2023-04-01,255,232,23,0.0901960784313725
SURESTE,2023-04-02,163,151,12,0.0736196319018405
SURESTE,2023-04-03,208,197,11,0.0528846153846154
SURESTE,2023-04-04,203,177,26,0.12807881773399
SURESTE,2023-04-05,177,139,38,0.214689265536723
SURESTE,2023-04-06,180,163,17,0.0944444444444444
SURESTE,2023-04-07,187,178,9,0.0481283422459893
SURESTE,2023-04-08,160,143,17,0.10625
SURESTE,2023-04-09,109,102,7,0.0642201834862385
SURESTE,2023-04-10,172,154,18,0.104651162790698
SURESTE,2023-04-11,176,164,12,0.0681818181818182
SURESTE,2023-04-12,184,164,20,0.108695652173913
SURESTE,2023-04-13,166,158,8,0.0481927710843374
SURESTE,2023-04-14,216,208,8,0.037037037037037
SURESTE,2023-04-15,271,260,11,0.040590405904059
SURESTE,2023-04-16,274,271,3,0.0109489051094891
SURESTE,2023-04-17,240,233,7,0.0291666666666667
SURESTE,2023-04-18,197,192,5,0.0253807106598985
SURESTE,2023-04-19,209,201,8,0.0382775119617225
SURESTE,2023-04-20,214,201,13,0.0607476635514019
SURESTE,2023-04-21,207,202,5,0.0241545893719807
SURESTE,2023-04-22,229,218,11,0.0480349344978166
SURESTE,2023-04-23,198,190,8,0.0404040404040404
SURESTE,2023-04-24,242,235,7,0.0289256198347107
SURESTE,2023-04-25,275,267,8,0.0290909090909091
SURESTE,2023-04-26,243,234,9,0.037037037037037
SURESTE,2023-04-27,213,205,8,0.0375586854460094
SURESTE,2023-04-28,223,215,8,0.0358744394618834
SURESTE,2023-04-29,295,287,8,0.0271186440677966
SURESTE,2023-04-30,216,206,10,0.0462962962962963
SURESTE,2023-05-01,223,214,9,0.0403587443946188
SURESTE,2023-05-02,194,188,6,0.0309278350515464
SURESTE,2023-05-03,169,163,6,0.0355029585798817
SURESTE,2023-05-04,135,129,6,0.0444444444444444
SURESTE,2023-05-05,194,189,5,0.0257731958762887
SURESTE,2023-05-06,210,206,4,0.019047619047619
SURESTE,2023-05-07,157,151,6,0.0382165605095541
SURESTE,2023-05-08,163,158,5,0.0306748466257669
SURESTE,2023-05-09,171,168,3,0.0175438596491228
SURESTE,2023-05-10,151,140,11,0.0728476821192053
SURESTE,2023-05-11,158,147,11,0.069620253164557
SURESTE,2023-05-12,200,196,4,0.02
SURESTE,2023-05-13,275,268,7,0.0254545454545455
SURESTE,2023-05-14,230,221,9,0.0391304347826087
SURESTE,2023-05-15,240,235,5,0.0208333333333333
SURESTE,2023-05-16,287,274,13,0.0452961672473868
SURESTE,2023-05-17,216,206,10,0.0462962962962963
SURESTE,2023-05-18,183,174,9,0.0491803278688525
SURESTE,2023-05-19,189,183,6,0.0317460317460317
SURESTE,2023-05-20,253,249,4,0.0158102766798419
SURESTE,2023-05-21,225,218,7,0.0311111111111111
SURESTE,2023-05-22,198,188,10,0.0505050505050505
SURESTE,2023-05-23,203,194,9,0.0443349753694581
SURESTE,2023-05-24,202,196,6,0.0297029702970297
SURESTE,2023-05-25,187,177,10,0.053475935828877
SURESTE,2023-05-26,205,198,7,0.0341463414634146
SURESTE,2023-05-27,237,233,4,0.0168776371308017
SURESTE,2023-05-28,155,154,1,0.00645161290322581
SURESTE,2023-05-29,204,196,8,0.0392156862745098
SURESTE,2023-05-30,237,234,3,0.0126582278481013
SURESTE,2023-05-31,216,207,9,0.0416666666666667
SURESTE,2023-06-01,199,190,9,0.0452261306532663
SURESTE,2023-06-02,198,192,6,0.0303030303030303
SURESTE,2023-06-03,206,203,3,0.0145631067961165
SURESTE,2023-06-04,207,200,7,0.0338164251207729
SURESTE,2023-06-05,193,190,3,0.0155440414507772
SURESTE,2023-06-06,182,172,10,0.0549450549450549
SURESTE,2023-06-07,166,154,12,0.072289156626506
SURESTE,2023-06-08,183,181,2,0.0109289617486339
SURESTE,2023-06-09,180,173,7,0.0388888888888889
SURESTE,2023-06-10,221,208,13,0.0588235294117647
SURESTE,2023-06-11,217,210,7,0.032258064516129
SURESTE,2023-06-12,170,165,5,0.0294117647058824
SURESTE,2023-06-13,156,154,2,0.0128205128205128
SURESTE,2023-06-14,186,181,5,0.0268817204301075
SURESTE,2023-06-15,193,189,4,0.0207253886010363
SURESTE,2023-06-16,177,173,4,0.0225988700564972
SURESTE,2023-06-17,257,250,7,0.0272373540856031
SURESTE,2023-06-18,218,213,5,0.0229357798165138
SURESTE,2023-06-19,203,198,5,0.0246305418719212
SURESTE,2023-06-20,209,201,8,0.0382775119617225
SURESTE,2023-06-21,212,202,10,0.0471698113207547
SURESTE,2023-06-22,184,174,10,0.0543478260869565
SURESTE,2023-06-23,159,151,8,0.050314465408805
SURESTE,2023-06-24,182,180,2,0.010989010989011
SURESTE,2023-06-25,196,190,6,0.0306122448979592
SURESTE,2023-06-26,203,199,4,0.0197044334975369
SURESTE,2023-06-27,193,186,7,0.0362694300518135
SURESTE,2023-06-28,194,189,5,0.0257731958762887
SURESTE,2023-06-29,207,203,4,0.0193236714975845
SURESTE,2023-06-30,124,112,12,0.0967741935483871
SURESTE,2023-07-01,231,224,7,0.0303030303030303
SURESTE,2023-07-02,204,204,0,0
SURESTE,2023-07-03,206,199,7,0.0339805825242718
SURESTE,2023-07-04,187,183,4,0.0213903743315508
SURESTE,2023-07-05,174,169,5,0.028735632183908
SURESTE,2023-07-06,167,163,4,0.0239520958083832
SURESTE,2023-07-07,228,221,7,0.0307017543859649
SURESTE,2023-07-08,242,236,6,0.0247933884297521
SURESTE,2023-07-09,208,204,4,0.0192307692307692
SURESTE,2023-07-10,270,262,8,0.0296296296296296
SURESTE,2023-07-11,221,218,3,0.0135746606334842
SURESTE,2023-07-12,210,205,5,0.0238095238095238
SURESTE,2023-07-13,198,192,6,0.0303030303030303
SURESTE,2023-07-14,199,195,4,0.0201005025125628
SURESTE,2023-07-15,222,218,4,0.018018018018018
SURESTE,2023-07-16,207,205,2,0.00966183574879227
SURESTE,2023-07-17,222,217,5,0.0225225225225225
SURESTE,2023-07-18,196,192,4,0.0204081632653061
SURESTE,2023-07-19,172,167,5,0.0290697674418605
SURESTE,2023-07-20,235,229,6,0.025531914893617
SURESTE,2023-07-21,189,183,6,0.0317460317460317
SURESTE,2023-07-22,228,226,2,0.0087719298245614
SURESTE,2023-07-23,200,198,2,0.01
SURESTE,2023-07-24,207,206,1,0.00483091787439614
SURESTE,2023-07-25,216,208,8,0.037037037037037
SURESTE,2023-07-26,209,203,6,0.0287081339712919
SURESTE,2023-07-27,181,176,5,0.0276243093922652
SURESTE,2023-07-28,201,197,4,0.0199004975124378
SURESTE,2023-07-29,264,262,2,0.00757575757575758
SURESTE,2023-07-30,217,216,1,0.00460829493087558
SURESTE,2023-07-31,271,267,4,0.014760147601476
SURESTE,2023-08-01,213,206,7,0.0328638497652582
SURESTE,2023-08-02,214,211,3,0.014018691588785
SURESTE,2023-08-03,181,159,22,0.121546961325967
SURESTE,2023-08-04,191,186,5,0.0261780104712042
SURESTE,2023-08-05,201,190,11,0.054726368159204
SURESTE,2023-08-06,202,200,2,0.0099009900990099
SURESTE,2023-08-07,200,192,8,0.04
SURESTE,2023-08-08,181,175,6,0.0331491712707182
SURESTE,2023-08-09,205,202,3,0.0146341463414634
SURESTE,2023-08-10,198,194,4,0.0202020202020202
SURESTE,2023-08-11,178,165,13,0.0730337078651685
SURESTE,2023-08-12,201,193,8,0.0398009950248756
SURESTE,2023-08-13,217,210,7,0.032258064516129
SURESTE,2023-08-14,187,180,7,0.0374331550802139
SURESTE,2023-08-15,198,195,3,0.0151515151515152
SURESTE,2023-08-16,209,203,6,0.0287081339712919
SURESTE,2023-08-17,195,185,10,0.0512820512820513
SURESTE,2023-08-18,252,245,7,0.0277777777777778
SURESTE,2023-08-19,236,228,8,0.0338983050847458
SURESTE,2023-08-20,211,204,7,0.033175355450237
SURESTE,2023-08-21,199,199,0,0
SURESTE,2023-08-22,178,175,3,0.0168539325842697
SURESTE,2023-08-23,178,177,1,0.00561797752808989
SURESTE,2023-08-24,219,218,1,0.0045662100456621
SURESTE,2023-08-25,209,206,3,0.0143540669856459
SURESTE,2023-08-26,241,238,3,0.012448132780083
SURESTE,2023-08-27,199,199,0,0
SURESTE,2023-08-28,209,204,5,0.0239234449760766
SURESTE,2023-08-29,207,206,1,0.00483091787439614
SURESTE,2023-08-30,198,197,1,0.00505050505050505
SURESTE,2023-08-31,200,199,1,0.005
SURESTE,2023-09-01,191,191,0,0
SURESTE,2023-09-02,203,201,2,0.00985221674876847
SURESTE,2023-09-03,176,175,1,0.00568181818181818
SURESTE,2023-09-04,162,161,1,0.00617283950617284
SURESTE,2023-09-05,223,222,1,0.00448430493273543
SURESTE,2023-09-06,202,201,1,0.00495049504950495
SURESTE,2023-09-07,228,227,1,0.0043859649122807
SURESTE,2023-09-08,220,220,0,0
SURESTE,2023-09-09,225,224,1,0.00444444444444444
SURESTE,2023-09-10,180,180,0,0
SURESTE,2023-09-11,202,200,2,0.0099009900990099
SURESTE,2023-09-12,234,233,1,0.00427350427350427
SURESTE,2023-09-13,211,209,2,0.00947867298578199
SURESTE,2023-09-14,204,202,2,0.00980392156862745
SURESTE,2023-09-15,222,220,2,0.00900900900900901
SURESTE,2023-09-16,207,206,1,0.00483091787439614
SURESTE,2023-09-17,169,168,1,0.00591715976331361
SURESTE,2023-09-18,189,189,0,0
SURESTE,2023-09-19,189,188,1,0.00529100529100529
SURESTE,2023-09-20,182,179,3,0.0164835164835165
SURESTE,2023-09-21,187,186,1,0.0053475935828877
SURESTE,2023-09-22,196,195,1,0.00510204081632653
SURESTE,2023-09-23,224,222,2,0.00892857142857143
SURESTE,2023-09-24,180,178,2,0.0111111111111111
SURESTE,2023-09-25,192,190,2,0.0104166666666667
SURESTE,2023-09-26,205,204,1,0.0048780487804878
SURESTE,2023-09-27,212,212,0,0
SURESTE,2023-09-28,188,186,2,0.0106382978723404
SURESTE,2023-09-29,238,237,1,0.00420168067226891
SURESTE,2023-09-30,249,248,1,0.00401606425702811
SURESTE,2023-10-01,196,196,0,0
SURESTE,2023-10-02,198,198,0,0
SURESTE,2023-10-03,195,192,3,0.0153846153846154
SURESTE,2023-10-04,167,164,3,0.0179640718562874
SURESTE,2023-10-05,176,172,4,0.0227272727272727
SURESTE,2023-10-06,187,182,5,0.0267379679144385
SURESTE,2023-10-07,199,196,3,0.0150753768844221
SURESTE,2023-10-08,156,152,4,0.0256410256410256
SURESTE,2023-10-09,162,158,4,0.0246913580246914
SURESTE,2023-10-10,155,149,6,0.0387096774193548
SURESTE,2023-10-11,176,169,7,0.0397727272727273
SURESTE,2023-10-12,144,142,2,0.0138888888888889
SURESTE,2023-10-13,180,179,1,0.00555555555555556
SURESTE,2023-10-14,189,189,0,0
SURESTE,2023-10-15,174,170,4,0.0229885057471264
SURESTE,2023-10-16,179,177,2,0.0111731843575419
SURESTE,2023-10-17,189,182,7,0.037037037037037
SURESTE,2023-10-18,214,207,7,0.0327102803738318
SURESTE,2023-10-19,193,188,5,0.0259067357512953
SURESTE,2023-10-20,197,193,4,0.0203045685279188
SURESTE,2023-10-21,212,207,5,0.0235849056603774
SURESTE,2023-10-22,160,151,9,0.05625
SURESTE,2023-10-23,144,140,4,0.0277777777777778
SURESTE,2023-10-24,174,168,6,0.0344827586206897
SURESTE,2023-10-25,181,177,4,0.0220994475138122
SURESTE,2023-10-26,189,183,6,0.0317460317460317
SURESTE,2023-10-27,195,189,6,0.0307692307692308
SURESTE,2023-10-28,214,213,1,0.00467289719626168
SURESTE,2023-10-29,146,142,4,0.0273972602739726
SURESTE,2023-10-30,209,202,7,0.0334928229665072
SURESTE,2023-10-31,211,207,4,0.018957345971564
SURESTE,2023-11-01,202,199,3,0.0148514851485149
SURESTE,2023-11-02,184,181,3,0.016304347826087
SURESTE,2023-11-03,197,192,5,0.0253807106598985
SURESTE,2023-11-04,185,178,7,0.0378378378378378
SURESTE,2023-11-05,174,171,3,0.0172413793103448
SURESTE,2023-11-06,200,193,7,0.035
SURESTE,2023-11-07,211,209,2,0.00947867298578199
SURESTE,2023-11-08,229,220,9,0.0393013100436681
SURESTE,2023-11-09,217,214,3,0.0138248847926267
SURESTE,2023-11-10,190,187,3,0.0157894736842105
SURESTE,2023-11-11,223,220,3,0.0134529147982063
SURESTE,2023-11-12,218,215,3,0.0137614678899083
SURESTE,2023-11-13,203,195,8,0.0394088669950739
SURESTE,2023-11-14,229,223,6,0.0262008733624454
SURESTE,2023-11-15,275,260,15,0.0545454545454545
SURESTE,2023-11-16,240,233,7,0.0291666666666667
SURESTE,2023-11-17,232,224,8,0.0344827586206897
SURESTE,2023-11-18,285,279,6,0.0210526315789474
SURESTE,2023-11-19,246,238,8,0.032520325203252
SURESTE,2023-11-20,256,254,2,0.0078125
SURESTE,2023-11-21,234,229,5,0.0213675213675214
SURESTE,2023-11-22,212,206,6,0.0283018867924528
SURESTE,2023-11-23,228,225,3,0.0131578947368421
SURESTE,2023-11-24,201,196,5,0.0248756218905473
SURESTE,2023-11-25,237,230,7,0.029535864978903
SURESTE,2023-11-26,209,205,4,0.0191387559808612
SURESTE,2023-11-27,242,236,6,0.0247933884297521
SURESTE,2023-11-28,242,237,5,0.0206611570247934
SURESTE,2023-11-29,247,239,8,0.0323886639676113
SURESTE,2023-11-30,263,255,8,0.0304182509505703
SURESTE,2023-12-01,223,212,11,0.0493273542600897
SURESTE,2023-12-02,238,233,5,0.0210084033613445
SURESTE,2023-12-03,164,160,4,0.024390243902439
SURESTE,2023-12-04,180,179,1,0.00555555555555556
SURESTE,2023-12-05,199,192,7,0.0351758793969849
SURESTE,2023-12-06,209,204,5,0.0239234449760766
SURESTE,2023-12-07,227,222,5,0.0220264317180617
SURESTE,2023-12-08,232,224,8,0.0344827586206897
SURESTE,2023-12-09,248,242,6,0.0241935483870968
SURESTE,2023-12-10,195,188,7,0.0358974358974359
SURESTE,2023-12-11,196,191,5,0.0255102040816327
SURESTE,2023-12-12,198,191,7,0.0353535353535354
SURESTE,2023-12-13,197,194,3,0.0152284263959391
SURESTE,2023-12-14,213,205,8,0.0375586854460094
SURESTE,2023-12-15,177,174,3,0.0169491525423729
SURESTE,2023-12-16,212,210,2,0.00943396226415094
SURESTE,2023-12-17,199,197,2,0.0100502512562814
SURESTE,2023-12-18,210,202,8,0.0380952380952381
SURESTE,2023-12-19,240,238,2,0.00833333333333333
SURESTE,2023-12-20,210,203,7,0.0333333333333333
SURESTE,2023-12-21,224,218,6,0.0267857142857143
SURESTE,2023-12-22,202,200,2,0.0099009900990099
SURESTE,2023-12-23,246,240,6,0.024390243902439
SURESTE,2023-12-24,176,172,4,0.0227272727272727
SURESTE,2023-12-25,60,60,0,0
SURESTE,2023-12-26,203,200,3,0.0147783251231527
SURESTE,2023-12-27,250,244,6,0.024
SURESTE,2023-12-28,252,248,4,0.0158730158730159
SURESTE,2023-12-29,225,222,3,0.0133333333333333
SURESTE,2023-12-30,262,259,3,0.0114503816793893
SURESTE,2023-12-31,110,108,2,0.0181818181818182
SURESTE,2024-01-01,42,41,1,0.0238095238095238
SURESTE,2024-01-02,174,172,2,0.0114942528735632
SURESTE,2024-01-03,231,228,3,0.012987012987013
SURESTE,2024-01-04,219,214,5,0.0228310502283105
SURESTE,2024-01-05,214,210,4,0.0186915887850467
SURESTE,2024-01-06,242,237,5,0.0206611570247934
SURESTE,2024-01-07,170,166,4,0.0235294117647059
SURESTE,2024-01-08,220,214,6,0.0272727272727273
SURESTE,2024-01-09,208,205,3,0.0144230769230769
SURESTE,2024-01-10,209,208,1,0.00478468899521531
SURESTE,2024-01-11,229,224,5,0.0218340611353712
SURESTE,2024-01-12,217,213,4,0.0184331797235023
SURESTE,2024-01-13,241,236,5,0.020746887966805
SURESTE,2024-01-14,214,209,5,0.0233644859813084
SURESTE,2024-01-15,238,229,9,0.0378151260504202
SURESTE,2024-01-16,226,222,4,0.0176991150442478
SURESTE,2024-01-17,200,198,2,0.01
SURESTE,2024-01-18,192,190,2,0.0104166666666667
SURESTE,2024-01-19,235,230,5,0.0212765957446809
SURESTE,2024-01-20,219,216,3,0.0136986301369863
SURESTE,2024-01-21,176,171,5,0.0284090909090909
SURESTE,2024-01-22,184,183,1,0.00543478260869565
SURESTE,2024-01-23,226,218,8,0.0353982300884956
SURESTE,2024-01-24,268,256,12,0.0447761194029851
SURESTE,2024-01-25,215,210,5,0.0232558139534884
SURESTE,2024-01-26,235,230,5,0.0212765957446809
SURESTE,2024-01-27,233,226,7,0.0300429184549356
SURESTE,2024-01-28,193,188,5,0.0259067357512953
SURESTE,2024-01-29,186,180,6,0.032258064516129
SURESTE,2024-01-30,177,168,9,0.0508474576271186
SURESTE,2024-01-31,212,204,8,0.0377358490566038
SURESTE,2024-02-01,220,217,3,0.0136363636363636
SURESTE,2024-02-02,200,192,8,0.04
SURESTE,2024-02-03,242,232,10,0.0413223140495868
SURESTE,2024-02-04,186,182,4,0.021505376344086
SURESTE,2024-02-05,173,168,5,0.0289017341040462
SURESTE,2024-02-06,202,200,2,0.0099009900990099
SURESTE,2024-02-07,206,204,2,0.00970873786407767
SURESTE,2024-02-08,204,199,5,0.0245098039215686
SURESTE,2024-02-09,220,215,5,0.0227272727272727
SURESTE,2024-02-10,188,182,6,0.0319148936170213
SURESTE,2024-02-11,157,154,3,0.0191082802547771
SURESTE,2024-02-12,162,158,4,0.0246913580246914
SURESTE,2024-02-13,220,217,3,0.0136363636363636
SURESTE,2024-02-14,191,182,9,0.0471204188481675
SURESTE,2024-02-15,226,221,5,0.0221238938053097