REGION,Fecha,Instalaciones,Activaciones_automaticas,Activaciones_manuales,PorcAM
BAJIO,2023-07-03,127,125,2,0.015748031496063
BAJIO,2023-07-04,138,133,5,0.036231884057971
BAJIO,2023-07-05,122,117,5,0.040983606557377
BAJIO,2023-07-06,96,92,4,0.0416666666666667
BAJIO,2023-07-07,163,163,0,0
BAJIO,2023-07-08,204,202,2,0.00980392156862745
BAJIO,2023-07-09,133,127,6,0.0451127819548872
BAJIO,2023-07-10,155,150,5,0.032258064516129
BAJIO,2023-07-11,139,133,6,0.0431654676258993
BAJIO,2023-07-12,128,126,2,0.015625
BAJIO,2023-07-13,118,113,5,0.0423728813559322
BAJIO,2023-07-14,130,128,2,0.0153846153846154
BAJIO,2023-07-15,254,248,6,0.0236220472440945
BAJIO,2023-07-16,108,102,6,0.0555555555555556
BAJIO,2023-07-17,136,133,3,0.0220588235294118
BAJIO,2023-07-18,147,143,4,0.0272108843537415
BAJIO,2023-07-19,188,184,4,0.0212765957446809
BAJIO,2023-07-20,183,176,7,0.0382513661202186
BAJIO,2023-07-21,183,181,2,0.0109289617486339
BAJIO,2023-07-22,198,192,6,0.0303030303030303
BAJIO,2023-07-23,128,126,2,0.015625
BAJIO,2023-07-24,153,149,4,0.0261437908496732
BAJIO,2023-07-25,179,173,6,0.0335195530726257
BAJIO,2023-07-26,150,147,3,0.02
BAJIO,2023-07-27,160,158,2,0.0125
BAJIO,2023-07-28,170,165,5,0.0294117647058824
BAJIO,2023-07-29,248,244,4,0.0161290322580645
BAJIO,2023-07-30,122,118,4,0.0327868852459016
BAJIO,2023-07-31,186,180,6,0.032258064516129
BAJIO,2023-08-01,174,171,3,0.0172413793103448
BAJIO,2023-08-02,151,150,1,0.00662251655629139
BAJIO,2023-08-03,173,154,19,0.109826589595376
BAJIO,2023-08-04,134,132,2,0.0149253731343284
BAJIO,2023-08-05,174,171,3,0.0172413793103448
BAJIO,2023-08-06,126,123,3,0.0238095238095238
BAJIO,2023-08-07,130,128,2,0.0153846153846154
BAJIO,2023-08-08,149,148,1,0.00671140939597315
BAJIO,2023-08-09,163,160,3,0.0184049079754601
BAJIO,2023-08-10,183,177,6,0.0327868852459016
BAJIO,2023-08-11,184,182,2,0.0108695652173913
BAJIO,2023-08-12,199,194,5,0.0251256281407035
BAJIO,2023-08-13,121,116,5,0.0413223140495868
BAJIO,2023-08-14,134,130,4,0.0298507462686567
BAJIO,2023-08-15,206,199,7,0.0339805825242718
BAJIO,2023-08-16,190,186,4,0.0210526315789474
BAJIO,2023-08-17,161,157,4,0.0248447204968944
BAJIO,2023-08-18,180,174,6,0.0333333333333333
BAJIO,2023-08-19,192,189,3,0.015625
BAJIO,2023-08-20,129,124,5,0.0387596899224806
BAJIO,2023-08-21,139,135,4,0.0287769784172662
BAJIO,2023-08-22,162,157,5,0.0308641975308642
BAJIO,2023-08-23,162,158,4,0.0246913580246914
BAJIO,2023-08-24,152,152,0,0
BAJIO,2023-08-25,197,196,1,0.0050761421319797
BAJIO,2023-08-26,226,222,4,0.0176991150442478
BAJIO,2023-08-27,146,146,0,0
BAJIO,2023-08-28,151,151,0,0
BAJIO,2023-08-29,203,201,2,0.00985221674876847
BAJIO,2023-08-30,166,163,3,0.0180722891566265
BAJIO,2023-08-31,172,168,4,0.0232558139534884
BAJIO,2023-09-01,167,164,3,0.0179640718562874
BAJIO,2023-09-02,158,158,0,0
BAJIO,2023-09-03,115,114,1,0.00869565217391304
BAJIO,2023-09-04,123,123,0,0
BAJIO,2023-09-05,163,161,2,0.0122699386503067
BAJIO,2023-09-06,139,136,3,0.0215827338129496
BAJIO,2023-09-07,155,154,1,0.00645161290322581
BAJIO,2023-09-08,160,158,2,0.0125
BAJIO,2023-09-09,187,187,0,0
BAJIO,2023-09-10,129,126,3,0.0232558139534884
BAJIO,2023-09-11,150,148,2,0.0133333333333333
BAJIO,2023-09-12,176,174,2,0.0113636363636364
BAJIO,2023-09-13,164,164,0,0
BAJIO,2023-09-14,149,146,3,0.0201342281879195
BAJIO,2023-09-15,181,178,3,0.0165745856353591
BAJIO,2023-09-16,147,144,3,0.0204081632653061
BAJIO,2023-09-17,120,118,2,0.0166666666666667
BAJIO,2023-09-18,133,133,0,0
BAJIO,2023-09-19,138,131,7,0.0507246376811594
BAJIO,2023-09-20,116,115,1,0.00862068965517241
BAJIO,2023-09-21,137,135,2,0.0145985401459854
BAJIO,2023-09-22,134,130,4,0.0298507462686567
BAJIO,2023-09-23,201,197,4,0.0199004975124378
BAJIO,2023-09-24,101,99,2,0.0198019801980198
BAJIO,2023-09-25,161,160,1,0.0062111801242236
BAJIO,2023-09-26,137,135,2,0.0145985401459854
BAJIO,2023-09-27,150,149,1,0.00666666666666667
BAJIO,2023-09-28,169,169,0,0
BAJIO,2023-09-29,145,143,2,0.0137931034482759
BAJIO,2023-09-30,228,223,5,0.0219298245614035
BAJIO,2023-10-01,114,113,1,0.0087719298245614
BAJIO,2023-10-02,132,132,0,0
BAJIO,2023-10-03,132,126,6,0.0454545454545455
BAJIO,2023-10-04,126,123,3,0.0238095238095238
BAJIO,2023-10-05,126,123,3,0.0238095238095238
BAJIO,2023-10-06,167,163,4,0.0239520958083832
BAJIO,2023-10-07,209,204,5,0.0239234449760766
BAJIO,2023-10-08,115,107,8,0.0695652173913043
BAJIO,2023-10-09,142,135,7,0.0492957746478873
BAJIO,2023-10-10,124,117,7,0.0564516129032258
BAJIO,2023-10-11,109,104,5,0.0458715596330275
BAJIO,2023-10-12,137,134,3,0.0218978102189781
BAJIO,2023-10-13,114,108,6,0.0526315789473684
BAJIO,2023-10-14,146,140,6,0.0410958904109589
BAJIO,2023-10-15,121,115,6,0.0495867768595041
BAJIO,2023-10-16,156,149,7,0.0448717948717949
BAJIO,2023-10-17,135,134,1,0.00740740740740741
BAJIO,2023-10-18,134,128,6,0.0447761194029851
BAJIO,2023-10-19,139,134,5,0.0359712230215827
BAJIO,2023-10-20,153,147,6,0.0392156862745098
BAJIO,2023-10-21,224,216,8,0.0357142857142857
BAJIO,2023-10-22,137,134,3,0.0218978102189781
BAJIO,2023-10-23,154,148,6,0.038961038961039
BAJIO,2023-10-24,154,150,4,0.025974025974026
BAJIO,2023-10-25,153,149,4,0.0261437908496732
BAJIO,2023-10-26,154,151,3,0.0194805194805195
BAJIO,2023-10-27,151,147,4,0.0264900662251656
BAJIO,2023-10-28,175,167,8,0.0457142857142857
BAJIO,2023-10-29,120,117,3,0.025
BAJIO,2023-10-30,172,165,7,0.0406976744186047
BAJIO,2023-10-31,198,191,7,0.0353535353535354
BAJIO,2023-11-01,158,155,3,0.0189873417721519
BAJIO,2023-11-02,143,141,2,0.013986013986014
BAJIO,2023-11-03,142,138,4,0.028169014084507
BAJIO,2023-11-04,173,169,4,0.023121387283237
BAJIO,2023-11-05,115,112,3,0.0260869565217391
BAJIO,2023-11-06,155,150,5,0.032258064516129
BAJIO,2023-11-07,200,199,1,0.005
BAJIO,2023-11-08,149,141,8,0.0536912751677852
BAJIO,2023-11-09,124,118,6,0.0483870967741935
BAJIO,2023-11-10,137,134,3,0.0218978102189781
BAJIO,2023-11-11,189,183,6,0.0317460317460317
BAJIO,2023-11-12,135,132,3,0.0222222222222222
BAJIO,2023-11-13,182,173,9,0.0494505494505494
BAJIO,2023-11-14,194,188,6,0.0309278350515464
BAJIO,2023-11-15,189,185,4,0.0211640211640212
BAJIO,2023-11-16,185,182,3,0.0162162162162162
BAJIO,2023-11-17,184,182,2,0.0108695652173913
BAJIO,2023-11-18,264,259,5,0.0189393939393939
BAJIO,2023-11-19,135,132,3,0.0222222222222222
BAJIO,2023-11-20,173,167,6,0.0346820809248555
BAJIO,2023-11-21,189,182,7,0.037037037037037
BAJIO,2023-11-22,181,178,3,0.0165745856353591
BAJIO,2023-11-23,173,168,5,0.0289017341040462
BAJIO,2023-11-24,170,166,4,0.0235294117647059
BAJIO,2023-11-25,219,213,6,0.0273972602739726
BAJIO,2023-11-26,159,152,7,0.0440251572327044
BAJIO,2023-11-27,156,150,6,0.0384615384615385
BAJIO,2023-11-28,181,176,5,0.0276243093922652
BAJIO,2023-11-29,187,182,5,0.0267379679144385
BAJIO,2023-11-30,220,213,7,0.0318181818181818
BAJIO,2023-12-01,174,170,4,0.0229885057471264
BAJIO,2023-12-02,180,174,6,0.0333333333333333
BAJIO,2023-12-03,148,140,8,0.0540540540540541
BAJIO,2023-12-04,166,162,4,0.0240963855421687
BAJIO,2023-12-05,198,193,5,0.0252525252525253
BAJIO,2023-12-06,193,186,7,0.0362694300518135
BAJIO,2023-12-07,122,119,3,0.0245901639344262
BAJIO,2023-12-08,189,185,4,0.0211640211640212
BAJIO,2023-12-09,188,180,8,0.0425531914893617
BAJIO,2023-12-10,158,153,5,0.0316455696202532
BAJIO,2023-12-11,144,139,5,0.0347222222222222
BAJIO,2023-12-12,173,168,5,0.0289017341040462
BAJIO,2023-12-13,147,139,8,0.054421768707483
BAJIO,2023-12-14,172,167,5,0.0290697674418605
BAJIO,2023-12-15,127,125,2,0.015748031496063
BAJIO,2023-12-16,250,241,9,0.036
BAJIO,2023-12-17,156,154,2,0.0128205128205128
BAJIO,2023-12-18,196,189,7,0.0357142857142857
BAJIO,2023-12-19,168,163,5,0.0297619047619048
BAJIO,2023-12-20,204,193,11,0.053921568627451
BAJIO,2023-12-21,182,178,4,0.021978021978022
BAJIO,2023-12-22,177,170,7,0.0395480225988701
BAJIO,2023-12-23,196,191,5,0.0255102040816327
BAJIO,2023-12-24,109,107,2,0.018348623853211
BAJIO,2023-12-25,43,40,3,0.0697674418604651
BAJIO,2023-12-26,154,152,2,0.012987012987013
BAJIO,2023-12-27,204,197,7,0.0343137254901961
BAJIO,2023-12-28,199,193,6,0.0301507537688442
BAJIO,2023-12-29,208,203,5,0.0240384615384615
BAJIO,2023-12-30,198,197,1,0.00505050505050505
BAJIO,2023-12-31,94,93,1,0.0106382978723404
BAJIO,2024-01-01,43,42,1,0.0232558139534884
BAJIO,2024-01-02,138,134,4,0.0289855072463768
BAJIO,2024-01-03,211,204,7,0.033175355450237
BAJIO,2024-01-04,202,197,5,0.0247524752475248
BAJIO,2024-01-05,187,178,9,0.0481283422459893
BAJIO,2024-01-06,193,190,3,0.0155440414507772
BAJIO,2024-01-07,132,126,6,0.0454545454545455
BAJIO,2024-01-08,179,166,13,0.0726256983240224
BAJIO,2024-01-09,209,200,9,0.0430622009569378
BAJIO,2024-01-10,175,168,7,0.04
BAJIO,2024-01-11,192,183,9,0.046875
BAJIO,2024-01-12,167,164,3,0.0179640718562874
BAJIO,2024-01-13,233,224,9,0.0386266094420601
BAJIO,2024-01-14,182,178,4,0.021978021978022
BAJIO,2024-01-15,163,159,4,0.0245398773006135
BAJIO,2024-01-16,196,192,4,0.0204081632653061
BAJIO,2024-01-17,193,187,6,0.0310880829015544
BAJIO,2024-01-18,165,159,6,0.0363636363636364
BAJIO,2024-01-19,191,180,11,0.0575916230366492
BAJIO,2024-01-20,206,202,4,0.0194174757281553
BAJIO,2024-01-21,127,124,3,0.0236220472440945
BAJIO,2024-01-22,128,125,3,0.0234375
BAJIO,2024-01-23,171,170,1,0.00584795321637427
BAJIO,2024-01-24,169,161,8,0.0473372781065089
BAJIO,2024-01-25,173,167,6,0.0346820809248555
BAJIO,2024-01-26,187,184,3,0.0160427807486631
BAJIO,2024-01-27,228,221,7,0.0307017543859649
BAJIO,2024-01-28,126,124,2,0.0158730158730159
BAJIO,2024-01-29,169,168,1,0.00591715976331361
BAJIO,2024-01-30,185,178,7,0.0378378378378378
BAJIO,2024-01-31,196,189,7,0.0357142857142857
BAJIO,2024-02-01,148,142,6,0.0405405405405405
BAJIO,2024-02-02,175,171,4,0.0228571428571429
BAJIO,2024-02-03,188,180,8,0.0425531914893617
BAJIO,2024-02-04,124,123,1,0.00806451612903226
BAJIO,2024-02-05,160,154,6,0.0375
BAJIO,2024-02-06,164,162,2,0.0121951219512195
BAJIO,2024-02-07,197,192,5,0.0253807106598985
BAJIO,2024-02-08,164,162,2,0.0121951219512195
BAJIO,2024-02-09,190,188,2,0.0105263157894737
BAJIO,2024-02-10,209,203,6,0.0287081339712919
BAJIO,2024-02-11,119,115,4,0.0336134453781513
BAJIO,2024-02-12,121,116,5,0.0413223140495868
BAJIO,2024-02-13,201,190,11,0.054726368159204
BAJIO,2024-02-14,164,158,6,0.0365853658536585
BAJIO,2024-02-15,166,164,2,0.0120481927710843
BAJIO,2024-02-16,146,144,2,0.0136986301369863
BAJIO,2024-02-17,198,189,9,0.0454545454545455
BAJIO,2024-02-18,168,166,2,0.0119047619047619
BAJIO,2024-02-19,167,162,5,0.029940119760479
BAJIO,2024-02-20,173,166,7,0.0404624277456647
BAJIO,2024-02-21,191,182,9,0.0471204188481675
BAJIO,2024-02-22,152,147,5,0.0328947368421053
BAJIO,2024-02-23,137,108,29,0.211678832116788
BAJIO,2024-02-24,258,249,9,0.0348837209302326
BAJIO,2024-02-25,123,118,5,0.040650406504065
BAJIO,2024-02-26,164,161,3,0.0182926829268293
BAJIO,2024-02-27,217,210,7,0.032258064516129
BAJIO,2024-02-28,177,170,7,0.0395480225988701
BAJIO,2024-02-29,193,184,9,0.0466321243523316
BAJIO,2024-03-01,154,152,2,0.012987012987013
BAJIO,2024-03-02,193,186,7,0.0362694300518135
BAJIO,2024-03-03,151,146,5,0.033112582781457
BAJIO,2024-03-04,174,170,4,0.0229885057471264
BAJIO,2024-03-05,190,184,6,0.0315789473684211
BAJIO,2024-03-06,205,197,8,0.0390243902439024
BAJIO,2024-03-07,165,162,3,0.0181818181818182
BAJIO,2024-03-08,189,188,1,0.00529100529100529
BAJIO,2024-03-09,182,176,6,0.032967032967033
BAJIO,2024-03-10,139,137,2,0.0143884892086331
BAJIO,2024-03-11,184,181,3,0.016304347826087
BAJIO,2024-03-12,168,164,4,0.0238095238095238
BAJIO,2024-03-13,161,155,6,0.0372670807453416
BAJIO,2024-03-14,110,108,2,0.0181818181818182
BAJIO,2024-03-15,201,197,4,0.0199004975124378
BAJIO,2024-03-16,217,210,7,0.032258064516129
BAJIO,2024-03-17,124,118,6,0.0483870967741935
BAJIO,2024-03-18,171,167,4,0.0233918128654971
BAJIO,2024-03-19,149,144,5,0.0335570469798658
BAJIO,2024-03-20,179,172,7,0.0391061452513966
BAJIO,2024-03-21,144,138,6,0.0416666666666667
BAJIO,2024-03-22,165,163,2,0.0121212121212121
BAJIO,2024-03-23,201,195,6,0.0298507462686567
BAJIO,2024-03-24,156,155,1,0.00641025641025641
BAJIO,2024-03-25,149,144,5,0.0335570469798658
BAJIO,2024-03-26,198,189,9,0.0454545454545455
BAJIO,2024-03-27,177,175,2,0.0112994350282486
BAJIO,2024-03-28,180,175,5,0.0277777777777778
BAJIO,2024-03-29,130,126,4,0.0307692307692308
BAJIO,2024-03-30,159,152,7,0.0440251572327044
BAJIO,2024-03-31,120,119,1,0.00833333333333333
BAJIO,2024-04-01,165,163,2,0.0121212121212121
BAJIO,2024-04-02,165,161,4,0.0242424242424242
BAJIO,2024-04-03,160,160,0,0
BAJIO,2024-04-04,145,145,0,0
BAJIO,2024-04-05,147,144,3,0.0204081632653061
BAJIO,2024-04-06,182,177,5,0.0274725274725275
BAJIO,2024-04-07,111,104,7,0.0630630630630631
BAJIO,2024-04-08,132,127,5,0.0378787878787879
BAJIO,2024-04-09,159,150,9,0.0566037735849057
BAJIO,2024-04-10,178,171,7,0.0393258426966292
BAJIO,2024-04-11,152,147,5,0.0328947368421053
BAJIO,2024-04-12,198,194,4,0.0202020202020202
BAJIO,2024-04-13,224,220,4,0.0178571428571429
BAJIO,2024-04-14,123,120,3,0.024390243902439
BAJIO,2024-04-15,182,177,5,0.0274725274725275
BAJIO,2024-04-16,197,181,16,0.0812182741116751
BAJIO,2024-04-17,161,153,8,0.0496894409937888
BAJIO,2024-04-18,152,147,5,0.0328947368421053
BAJIO,2024-04-19,140,131,9,0.0642857142857143
BAJIO,2024-04-20,178,172,6,0.0337078651685393
BAJIO,2024-04-21,85,84,1,0.0117647058823529
BAJIO,2024-04-22,77,75,2,0.025974025974026
BAJIO,2024-04-23,206,187,19,0.0922330097087379
BAJIO,2024-04-24,158,150,8,0.0506329113924051
BAJIO,2024-04-25,126,123,3,0.0238095238095238
BAJIO,2024-04-26,159,153,6,0.0377358490566038
BAJIO,2024-04-27,188,181,7,0.0372340425531915
BAJIO,2024-04-28,137,137,0,0
BAJIO,2024-04-29,178,173,5,0.0280898876404494
BAJIO,2024-04-30,173,170,3,0.0173410404624277
BAJIO,2024-05-01,151,149,2,0.0132450331125828
BAJIO,2024-05-02,166,164,2,0.0120481927710843
BAJIO,2024-05-03,140,137,3,0.0214285714285714
BAJIO,2024-05-04,159,155,4,0.0251572327044025
BAJIO,2024-05-05,93,91,2,0.021505376344086
BAJIO,2024-05-06,150,150,0,0
BAJIO,2024-05-07,161,155,6,0.0372670807453416
BAJIO,2024-05-08,155,149,6,0.0387096774193548
BAJIO,2024-05-09,132,129,3,0.0227272727272727
BAJIO,2024-05-10,133,127,6,0.0451127819548872
BAJIO,2024-05-11,152,143,9,0.0592105263157895
BAJIO,2024-05-12,126,122,4,0.0317460317460317
BAJIO,2024-05-13,169,166,3,0.0177514792899408
BAJIO,2024-05-14,179,169,10,0.0558659217877095
BAJIO,2024-05-15,177,171,6,0.0338983050847458
BAJIO,2024-05-16,176,155,21,0.119318181818182
BAJIO,2024-05-17,175,170,5,0.0285714285714286
BAJIO,2024-05-18,197,191,6,0.0304568527918782
BAJIO,2024-05-19,93,88,5,0.0537634408602151
BAJIO,2024-05-20,165,161,4,0.0242424242424242
BAJIO,2024-05-21,171,168,3,0.0175438596491228
BAJIO,2024-05-22,161,158,3,0.0186335403726708
BAJIO,2024-05-23,152,144,8,0.0526315789473684
BAJIO,2024-05-24,149,143,6,0.0402684563758389
BAJIO,2024-05-25,173,168,5,0.0289017341040462
BAJIO,2024-05-26,126,124,2,0.0158730158730159
BAJIO,2024-05-27,126,118,8,0.0634920634920635
BAJIO,2024-05-28,149,143,6,0.0402684563758389
BAJIO,2024-05-29,170,164,6,0.0352941176470588
BAJIO,2024-05-30,165,161,4,0.0242424242424242
BAJIO,2024-05-31,191,185,6,0.031413612565445
BAJIO,2024-06-01,160,154,6,0.0375
BAJIO,2024-06-02,72,70,2,0.0277777777777778
BAJIO,2024-06-03,175,170,5,0.0285714285714286
BAJIO,2024-06-04,184,178,6,0.0326086956521739
BAJIO,2024-06-05,155,148,7,0.0451612903225806
BAJIO,2024-06-06,157,146,11,0.0700636942675159
BAJIO,2024-06-07,181,170,11,0.0607734806629834
BAJIO,2024-06-08,208,200,8,0.0384615384615385
BAJIO,2024-06-09,130,124,6,0.0461538461538462
BAJIO,2024-06-10,138,133,5,0.036231884057971
BAJIO,2024-06-11,162,156,6,0.037037037037037
BAJIO,2024-06-12,139,130,9,0.0647482014388489
BAJIO,2024-06-13,153,148,5,0.0326797385620915
BAJIO,2024-06-14,135,130,5,0.037037037037037
BAJIO,2024-06-15,184,183,1,0.00543478260869565
BAJIO,2024-06-16,95,93,2,0.0210526315789474
BAJIO,2024-06-17,145,141,4,0.0275862068965517
BAJIO,2024-06-18,152,151,1,0.00657894736842105
BAJIO,2024-06-19,172,170,2,0.0116279069767442
BAJIO,2024-06-20,124,121,3,0.0241935483870968
BAJIO,2024-06-21,188,182,6,0.0319148936170213
BAJIO,2024-06-22,207,198,9,0.0434782608695652
BAJIO,2024-06-23,127,124,3,0.0236220472440945
BAJIO,2024-06-24,139,136,3,0.0215827338129496
BAJIO,2024-06-25,161,158,3,0.0186335403726708
BAJIO,2024-06-26,150,145,5,0.0333333333333333
BAJIO,2024-06-27,156,151,5,0.032051282051282
BAJIO,2024-06-28,177,173,4,0.0225988700564972
BAJIO,2024-06-29,237,231,6,0.0253164556962025
BAJIO,2024-06-30,180,177,3,0.0166666666666667
BAJIO,2024-07-01,161,156,5,0.031055900621118
BAJIO,2024-07-02,185,182,3,0.0162162162162162
CDMX FORANEAS,2023-07-03,252,247,5,0.0198412698412698
CDMX FORANEAS,2023-07-04,211,206,5,0.023696682464455
CDMX FORANEAS,2023-07-05,236,230,6,0.0254237288135593
CDMX FORANEAS,2023-07-06,188,184,4,0.0212765957446809
CDMX FORANEAS,2023-07-07,300,291,9,0.03
CDMX FORANEAS,2023-07-08,246,242,4,0.016260162601626
CDMX FORANEAS,2023-07-09,245,235,10,0.0408163265306122
CDMX FORANEAS,2023-07-10,224,220,4,0.0178571428571429
CDMX FORANEAS,2023-07-11,217,209,8,0.0368663594470046
CDMX FORANEAS,2023-07-12,273,262,11,0.0402930402930403
CDMX FORANEAS,2023-07-13,210,203,7,0.0333333333333333
CDMX FORANEAS,2023-07-14,246,240,6,0.024390243902439
CDMX FORANEAS,2023-07-15,267,259,8,0.0299625468164794
CDMX FORANEAS,2023-07-16,201,196,5,0.0248756218905473
CDMX FORANEAS,2023-07-17,229,223,6,0.0262008733624454
CDMX FORANEAS,2023-07-18,249,244,5,0.0200803212851406
CDMX FORANEAS,2023-07-19,256,248,8,0.03125
CDMX FORANEAS,2023-07-20,266,257,9,0.0338345864661654
CDMX FORANEAS,2023-07-21,221,216,5,0.0226244343891403
CDMX FORANEAS,2023-07-22,266,262,4,0.0150375939849624
CDMX FORANEAS,2023-07-23,251,243,8,0.0318725099601594
CDMX FORANEAS,2023-07-24,217,214,3,0.0138248847926267
CDMX FORANEAS,2023-07-25,266,255,11,0.0413533834586466
CDMX FORANEAS,2023-07-26,306,296,10,0.0326797385620915
CDMX FORANEAS,2023-07-27,306,300,6,0.0196078431372549
CDMX FORANEAS,2023-07-28,301,296,5,0.0166112956810631
CDMX FORANEAS,2023-07-29,299,296,3,0.0100334448160535
CDMX FORANEAS,2023-07-30,268,263,5,0.0186567164179104
CDMX FORANEAS,2023-07-31,279,274,5,0.017921146953405
CDMX FORANEAS,2023-08-01,270,262,8,0.0296296296296296
CDMX FORANEAS,2023-08-02,264,259,5,0.0189393939393939
CDMX FORANEAS,2023-08-03,227,216,11,0.0484581497797357
CDMX FORANEAS,2023-08-04,266,261,5,0.018796992481203
CDMX FORANEAS,2023-08-05,259,252,7,0.027027027027027
CDMX FORANEAS,2023-08-06,263,258,5,0.0190114068441065
CDMX FORANEAS,2023-08-07,237,234,3,0.0126582278481013
CDMX FORANEAS,2023-08-08,249,244,5,0.0200803212851406
CDMX FORANEAS,2023-08-09,290,280,10,0.0344827586206897
CDMX FORANEAS,2023-08-10,266,255,11,0.0413533834586466
CDMX FORANEAS,2023-08-11,279,275,4,0.014336917562724
CDMX FORANEAS,2023-08-12,291,283,8,0.0274914089347079
CDMX FORANEAS,2023-08-13,274,263,11,0.0401459854014599
CDMX FORANEAS,2023-08-14,270,262,8,0.0296296296296296
CDMX FORANEAS,2023-08-15,312,306,6,0.0192307692307692
CDMX FORANEAS,2023-08-16,258,254,4,0.0155038759689922
CDMX FORANEAS,2023-08-17,236,229,7,0.0296610169491525
CDMX FORANEAS,2023-08-18,248,245,3,0.0120967741935484
CDMX FORANEAS,2023-08-19,284,277,7,0.0246478873239437
CDMX FORANEAS,2023-08-20,253,245,8,0.0316205533596838
CDMX FORANEAS,2023-08-21,229,228,1,0.00436681222707424
CDMX FORANEAS,2023-08-22,249,248,1,0.00401606425702811
CDMX FORANEAS,2023-08-23,272,270,2,0.00735294117647059
CDMX FORANEAS,2023-08-24,266,266,0,0
CDMX FORANEAS,2023-08-25,251,251,0,0
CDMX FORANEAS,2023-08-26,311,311,0,0
CDMX FORANEAS,2023-08-27,271,271,0,0
CDMX FORANEAS,2023-08-28,271,271,0,0
CDMX FORANEAS,2023-08-29,308,306,2,0.00649350649350649
CDMX FORANEAS,2023-08-30,260,260,0,0
CDMX FORANEAS,2023-08-31,259,258,1,0.00386100386100386
CDMX FORANEAS,2023-09-01,229,229,0,0
CDMX FORANEAS,2023-09-02,227,226,1,0.00440528634361234
CDMX FORANEAS,2023-09-03,245,244,1,0.00408163265306122
CDMX FORANEAS,2023-09-04,263,263,0,0
CDMX FORANEAS,2023-09-05,228,227,1,0.0043859649122807
CDMX FORANEAS,2023-09-06,254,253,1,0.00393700787401575
CDMX FORANEAS,2023-09-07,273,271,2,0.00732600732600733
CDMX FORANEAS,2023-09-08,234,234,0,0
CDMX FORANEAS,2023-09-09,251,251,0,0
CDMX FORANEAS,2023-09-10,230,229,1,0.00434782608695652
CDMX FORANEAS,2023-09-11,243,243,0,0
CDMX FORANEAS,2023-09-12,263,263,0,0
CDMX FORANEAS,2023-09-13,225,224,1,0.00444444444444444
CDMX FORANEAS,2023-09-14,228,228,0,0
CDMX FORANEAS,2023-09-15,207,206,1,0.00483091787439614
CDMX FORANEAS,2023-09-16,166,166,0,0
CDMX FORANEAS,2023-09-17,201,201,0,0
CDMX FORANEAS,2023-09-18,249,249,0,0
CDMX FORANEAS,2023-09-19,210,209,1,0.00476190476190476
CDMX FORANEAS,2023-09-20,218,218,0,0
CDMX FORANEAS,2023-09-21,215,215,0,0
CDMX FORANEAS,2023-09-22,278,277,1,0.00359712230215827
CDMX FORANEAS,2023-09-23,285,284,1,0.00350877192982456
CDMX FORANEAS,2023-09-24,247,247,0,0
CDMX FORANEAS,2023-09-25,233,233,0,0
CDMX FORANEAS,2023-09-26,260,258,2,0.00769230769230769
CDMX FORANEAS,2023-09-27,215,213,2,0.00930232558139535
CDMX FORANEAS,2023-09-28,283,282,1,0.00353356890459364
CDMX FORANEAS,2023-09-29,253,253,0,0
CDMX FORANEAS,2023-09-30,337,335,2,0.00593471810089021
CDMX FORANEAS,2023-10-01,222,221,1,0.0045045045045045
CDMX FORANEAS,2023-10-02,257,256,1,0.00389105058365759
CDMX FORANEAS,2023-10-03,216,211,5,0.0231481481481481
CDMX FORANEAS,2023-10-04,231,227,4,0.0173160173160173
CDMX FORANEAS,2023-10-05,210,202,8,0.0380952380952381
CDMX FORANEAS,2023-10-06,234,224,10,0.0427350427350427
CDMX FORANEAS,2023-10-07,263,254,9,0.0342205323193916
CDMX FORANEAS,2023-10-08,228,221,7,0.0307017543859649
CDMX FORANEAS,2023-10-09,247,238,9,0.0364372469635627
CDMX FORANEAS,2023-10-10,215,207,8,0.0372093023255814
CDMX FORANEAS,2023-10-11,211,206,5,0.023696682464455
CDMX FORANEAS,2023-10-12,211,202,9,0.042654028436019
CDMX FORANEAS,2023-10-13,222,216,6,0.027027027027027
CDMX FORANEAS,2023-10-14,302,293,9,0.0298013245033113
CDMX FORANEAS,2023-10-15,287,280,7,0.024390243902439
CDMX FORANEAS,2023-10-16,259,253,6,0.0231660231660232
CDMX FORANEAS,2023-10-17,247,240,7,0.0283400809716599
CDMX FORANEAS,2023-10-18,221,211,10,0.0452488687782805
CDMX FORANEAS,2023-10-19,255,249,6,0.0235294117647059
CDMX FORANEAS,2023-10-20,244,240,4,0.0163934426229508
CDMX FORANEAS,2023-10-21,306,298,8,0.0261437908496732
CDMX FORANEAS,2023-10-22,229,222,7,0.0305676855895196
CDMX FORANEAS,2023-10-23,235,229,6,0.025531914893617
CDMX FORANEAS,2023-10-24,261,250,11,0.0421455938697318
CDMX FORANEAS,2023-10-25,199,192,7,0.0351758793969849
CDMX FORANEAS,2023-10-26,229,222,7,0.0305676855895196
CDMX FORANEAS,2023-10-27,221,213,8,0.0361990950226244
CDMX FORANEAS,2023-10-28,258,249,9,0.0348837209302326
CDMX FORANEAS,2023-10-29,239,231,8,0.0334728033472803
CDMX FORANEAS,2023-10-30,223,205,18,0.0807174887892377
CDMX FORANEAS,2023-10-31,294,286,8,0.0272108843537415
CDMX FORANEAS,2023-11-01,263,255,8,0.0304182509505703
CDMX FORANEAS,2023-11-02,210,206,4,0.019047619047619
CDMX FORANEAS,2023-11-03,210,200,10,0.0476190476190476
CDMX FORANEAS,2023-11-04,268,263,5,0.0186567164179104
CDMX FORANEAS,2023-11-05,291,278,13,0.0446735395189003
CDMX FORANEAS,2023-11-06,302,292,10,0.033112582781457
CDMX FORANEAS,2023-11-07,303,291,12,0.0396039603960396
CDMX FORANEAS,2023-11-08,266,260,6,0.0225563909774436
CDMX FORANEAS,2023-11-09,245,233,12,0.0489795918367347
CDMX FORANEAS,2023-11-10,248,246,2,0.00806451612903226
CDMX FORANEAS,2023-11-11,306,303,3,0.00980392156862745
CDMX FORANEAS,2023-11-12,285,281,4,0.0140350877192982
CDMX FORANEAS,2023-11-13,298,284,14,0.0469798657718121
CDMX FORANEAS,2023-11-14,317,304,13,0.0410094637223975
CDMX FORANEAS,2023-11-15,319,310,9,0.0282131661442006
CDMX FORANEAS,2023-11-16,371,361,10,0.0269541778975741
CDMX FORANEAS,2023-11-17,371,363,8,0.0215633423180593
CDMX FORANEAS,2023-11-18,402,389,13,0.0323383084577114
CDMX FORANEAS,2023-11-19,396,381,15,0.0378787878787879
CDMX FORANEAS,2023-11-20,379,371,8,0.0211081794195251
CDMX FORANEAS,2023-11-21,369,360,9,0.024390243902439
CDMX FORANEAS,2023-11-22,299,291,8,0.0267558528428094
CDMX FORANEAS,2023-11-23,295,287,8,0.0271186440677966
CDMX FORANEAS,2023-11-24,315,302,13,0.0412698412698413
CDMX FORANEAS,2023-11-25,327,320,7,0.0214067278287462
CDMX FORANEAS,2023-11-26,293,278,15,0.0511945392491468
CDMX FORANEAS,2023-11-27,322,311,11,0.0341614906832298
CDMX FORANEAS,2023-11-28,314,307,7,0.0222929936305732
CDMX FORANEAS,2023-11-29,323,318,5,0.0154798761609907
CDMX FORANEAS,2023-11-30,408,381,27,0.0661764705882353
CDMX FORANEAS,2023-12-01,296,280,16,0.0540540540540541
CDMX FORANEAS,2023-12-02,320,305,15,0.046875
CDMX FORANEAS,2023-12-03,326,315,11,0.0337423312883436
CDMX FORANEAS,2023-12-04,341,325,16,0.0469208211143695
CDMX FORANEAS,2023-12-05,321,307,14,0.043613707165109
CDMX FORANEAS,2023-12-06,266,256,10,0.037593984962406
CDMX FORANEAS,2023-12-07,295,289,6,0.0203389830508475
CDMX FORANEAS,2023-12-08,272,268,4,0.0147058823529412
CDMX FORANEAS,2023-12-09,321,308,13,0.0404984423676012
CDMX FORANEAS,2023-12-10,303,292,11,0.0363036303630363
CDMX FORANEAS,2023-12-11,280,277,3,0.0107142857142857
CDMX FORANEAS,2023-12-12,321,315,6,0.0186915887850467
CDMX FORANEAS,2023-12-13,291,279,12,0.0412371134020619
CDMX FORANEAS,2023-12-14,259,251,8,0.0308880308880309
CDMX FORANEAS,2023-12-15,280,270,10,0.0357142857142857
CDMX FORANEAS,2023-12-16,343,327,16,0.0466472303206997
CDMX FORANEAS,2023-12-17,290,277,13,0.0448275862068966
CDMX FORANEAS,2023-12-18,305,295,10,0.0327868852459016
CDMX FORANEAS,2023-12-19,302,290,12,0.0397350993377483
CDMX FORANEAS,2023-12-20,316,302,14,0.0443037974683544
CDMX FORANEAS,2023-12-21,311,303,8,0.0257234726688103
CDMX FORANEAS,2023-12-22,261,253,8,0.0306513409961686
CDMX FORANEAS,2023-12-23,263,256,7,0.026615969581749
CDMX FORANEAS,2023-12-24,204,194,10,0.0490196078431373
CDMX FORANEAS,2023-12-25,96,91,5,0.0520833333333333
CDMX FORANEAS,2023-12-26,229,223,6,0.0262008733624454
CDMX FORANEAS,2023-12-27,304,297,7,0.0230263157894737
CDMX FORANEAS,2023-12-28,303,296,7,0.0231023102310231
CDMX FORANEAS,2023-12-29,306,298,8,0.0261437908496732
CDMX FORANEAS,2023-12-30,286,277,9,0.0314685314685315
CDMX FORANEAS,2023-12-31,166,163,3,0.0180722891566265
CDMX FORANEAS,2024-01-01,45,44,1,0.0222222222222222
CDMX FORANEAS,2024-01-02,226,219,7,0.0309734513274336
CDMX FORANEAS,2024-01-03,320,315,5,0.015625
CDMX FORANEAS,2024-01-04,355,345,10,0.028169014084507
CDMX FORANEAS,2024-01-05,259,255,4,0.0154440154440154
CDMX FORANEAS,2024-01-06,275,266,9,0.0327272727272727
CDMX FORANEAS,2024-01-07,261,255,6,0.0229885057471264
CDMX FORANEAS,2024-01-08,274,264,10,0.0364963503649635
CDMX FORANEAS,2024-01-09,313,303,10,0.0319488817891374
CDMX FORANEAS,2024-01-10,292,282,10,0.0342465753424658
CDMX FORANEAS,2024-01-11,307,296,11,0.0358306188925081
CDMX FORANEAS,2024-01-12,287,278,9,0.0313588850174216
CDMX FORANEAS,2024-01-13,341,337,4,0.0117302052785924
CDMX FORANEAS,2024-01-14,332,326,6,0.0180722891566265
CDMX FORANEAS,2024-01-15,282,277,5,0.0177304964539007
CDMX FORANEAS,2024-01-16,317,311,6,0.0189274447949527
CDMX FORANEAS,2024-01-17,277,266,11,0.0397111913357401
CDMX FORANEAS,2024-01-18,312,304,8,0.0256410256410256
CDMX FORANEAS,2024-01-19,294,285,9,0.0306122448979592
CDMX FORANEAS,2024-01-20,316,306,10,0.0316455696202532
CDMX FORANEAS,2024-01-21,257,251,6,0.0233463035019455
CDMX FORANEAS,2024-01-22,271,262,9,0.033210332103321
CDMX FORANEAS,2024-01-23,300,294,6,0.02
CDMX FORANEAS,2024-01-24,343,331,12,0.0349854227405248
CDMX FORANEAS,2024-01-25,291,278,13,0.0446735395189003
CDMX FORANEAS,2024-01-26,243,232,11,0.0452674897119342
CDMX FORANEAS,2024-01-27,327,318,9,0.0275229357798165
CDMX FORANEAS,2024-01-28,259,252,7,0.027027027027027
CDMX FORANEAS,2024-01-29,259,250,9,0.0347490347490347
CDMX FORANEAS,2024-01-30,274,262,12,0.0437956204379562
CDMX FORANEAS,2024-01-31,297,289,8,0.0269360269360269
CDMX FORANEAS,2024-02-01,312,301,11,0.0352564102564103
CDMX FORANEAS,2024-02-02,258,253,5,0.0193798449612403
CDMX FORANEAS,2024-02-03,324,320,4,0.0123456790123457
CDMX FORANEAS,2024-02-04,304,296,8,0.0263157894736842
CDMX FORANEAS,2024-02-05,300,293,7,0.0233333333333333
CDMX FORANEAS,2024-02-06,304,297,7,0.0230263157894737
CDMX FORANEAS,2024-02-07,264,256,8,0.0303030303030303
CDMX FORANEAS,2024-02-08,257,250,7,0.0272373540856031
CDMX FORANEAS,2024-02-09,268,258,10,0.0373134328358209
CDMX FORANEAS,2024-02-10,317,308,9,0.028391167192429
CDMX FORANEAS,2024-02-11,272,258,14,0.0514705882352941
CDMX FORANEAS,2024-02-12,224,216,8,0.0357142857142857
CDMX FORANEAS,2024-02-13,274,266,8,0.0291970802919708
CDMX FORANEAS,2024-02-14,224,216,8,0.0357142857142857
CDMX FORANEAS,2024-02-15,268,265,3,0.0111940298507463
CDMX FORANEAS,2024-02-16,269,264,5,0.0185873605947955
CDMX FORANEAS,2024-02-17,290,283,7,0.0241379310344828
CDMX FORANEAS,2024-02-18,307,301,6,0.0195439739413681
CDMX FORANEAS,2024-02-19,277,270,7,0.0252707581227437
CDMX FORANEAS,2024-02-20,286,280,6,0.020979020979021
CDMX FORANEAS,2024-02-21,273,266,7,0.0256410256410256
CDMX FORANEAS,2024-02-22,284,279,5,0.0176056338028169
CDMX FORANEAS,2024-02-23,204,193,11,0.053921568627451
CDMX FORANEAS,2024-02-24,336,330,6,0.0178571428571429
CDMX FORANEAS,2024-02-25,257,250,7,0.0272373540856031
CDMX FORANEAS,2024-02-26,327,313,14,0.0428134556574924
CDMX FORANEAS,2024-02-27,299,292,7,0.0234113712374582
CDMX FORANEAS,2024-02-28,283,272,11,0.03886925795053
CDMX FORANEAS,2024-02-29,279,275,4,0.014336917562724
CDMX FORANEAS,2024-03-01,313,311,2,0.00638977635782748
CDMX FORANEAS,2024-03-02,331,318,13,0.0392749244712991
CDMX FORANEAS,2024-03-03,294,288,6,0.0204081632653061
CDMX FORANEAS,2024-03-04,283,278,5,0.0176678445229682
CDMX FORANEAS,2024-03-05,291,284,7,0.0240549828178694
CDMX FORANEAS,2024-03-06,281,271,10,0.0355871886120996
CDMX FORANEAS,2024-03-07,292,283,9,0.0308219178082192
CDMX FORANEAS,2024-03-08,273,266,7,0.0256410256410256
CDMX FORANEAS,2024-03-09,308,303,5,0.0162337662337662
CDMX FORANEAS,2024-03-10,239,229,10,0.0418410041841004
CDMX FORANEAS,2024-03-11,315,307,8,0.0253968253968254
CDMX FORANEAS,2024-03-12,264,257,7,0.0265151515151515
CDMX FORANEAS,2024-03-13,257,249,8,0.0311284046692607
CDMX FORANEAS,2024-03-14,245,242,3,0.0122448979591837
CDMX FORANEAS,2024-03-15,276,266,10,0.036231884057971
CDMX FORANEAS,2024-03-16,325,319,6,0.0184615384615385
CDMX FORANEAS,2024-03-17,287,281,6,0.0209059233449477
CDMX FORANEAS,2024-03-18,294,285,9,0.0306122448979592
CDMX FORANEAS,2024-03-19,229,222,7,0.0305676855895196
CDMX FORANEAS,2024-03-20,268,265,3,0.0111940298507463
CDMX FORANEAS,2024-03-21,234,228,6,0.0256410256410256
CDMX FORANEAS,2024-03-22,249,243,6,0.0240963855421687
CDMX FORANEAS,2024-03-23,314,310,4,0.0127388535031847
CDMX FORANEAS,2024-03-24,210,202,8,0.0380952380952381
CDMX FORANEAS,2024-03-25,255,245,10,0.0392156862745098
CDMX FORANEAS,2024-03-26,291,282,9,0.0309278350515464
CDMX FORANEAS,2024-03-27,297,290,7,0.0235690235690236
CDMX FORANEAS,2024-03-28,358,345,13,0.0363128491620112
CDMX FORANEAS,2024-03-29,276,265,11,0.0398550724637681
CDMX FORANEAS,2024-03-30,245,233,12,0.0489795918367347
CDMX FORANEAS,2024-03-31,222,214,8,0.036036036036036
CDMX FORANEAS,2024-04-01,284,275,9,0.0316901408450704
CDMX FORANEAS,2024-04-02,290,278,12,0.0413793103448276
CDMX FORANEAS,2024-04-03,262,262,0,0
CDMX FORANEAS,2024-04-04,251,251,0,0
CDMX FORANEAS,2024-04-05,246,237,9,0.0365853658536585
CDMX FORANEAS,2024-04-06,296,288,8,0.027027027027027
CDMX FORANEAS,2024-04-07,221,211,10,0.0452488687782805
CDMX FORANEAS,2024-04-08,204,197,7,0.0343137254901961
CDMX FORANEAS,2024-04-09,260,252,8,0.0307692307692308
CDMX FORANEAS,2024-04-10,266,258,8,0.0300751879699248
CDMX FORANEAS,2024-04-11,224,219,5,0.0223214285714286
CDMX FORANEAS,2024-04-12,262,255,7,0.0267175572519084
CDMX FORANEAS,2024-04-13,271,263,8,0.029520295202952
CDMX FORANEAS,2024-04-14,243,238,5,0.0205761316872428
CDMX FORANEAS,2024-04-15,300,294,6,0.02
CDMX FORANEAS,2024-04-16,300,276,24,0.08
CDMX FORANEAS,2024-04-17,252,234,18,0.0714285714285714
CDMX FORANEAS,2024-04-18,224,213,11,0.0491071428571429
CDMX FORANEAS,2024-04-19,205,196,9,0.0439024390243902
CDMX FORANEAS,2024-04-20,276,266,10,0.036231884057971
CDMX FORANEAS,2024-04-21,226,224,2,0.00884955752212389
CDMX FORANEAS,2024-04-22,135,132,3,0.0222222222222222
CDMX FORANEAS,2024-04-23,308,281,27,0.0876623376623377
CDMX FORANEAS,2024-04-24,271,260,11,0.040590405904059
CDMX FORANEAS,2024-04-25,254,246,8,0.031496062992126
CDMX FORANEAS,2024-04-26,276,265,11,0.0398550724637681
CDMX FORANEAS,2024-04-27,275,258,17,0.0618181818181818
CDMX FORANEAS,2024-04-28,245,233,12,0.0489795918367347
CDMX FORANEAS,2024-04-29,290,283,7,0.0241379310344828
CDMX FORANEAS,2024-04-30,292,283,9,0.0308219178082192
CDMX FORANEAS,2024-05-01,263,252,11,0.0418250950570342
CDMX FORANEAS,2024-05-02,263,247,16,0.0608365019011407
CDMX FORANEAS,2024-05-03,232,222,10,0.0431034482758621
CDMX FORANEAS,2024-05-04,251,243,8,0.0318725099601594
CDMX FORANEAS,2024-05-05,210,202,8,0.0380952380952381
CDMX FORANEAS,2024-05-06,255,255,0,0
CDMX FORANEAS,2024-05-07,233,230,3,0.0128755364806867
CDMX FORANEAS,2024-05-08,221,208,13,0.0588235294117647
CDMX FORANEAS,2024-05-09,218,208,10,0.0458715596330275
CDMX FORANEAS,2024-05-10,187,179,8,0.0427807486631016
CDMX FORANEAS,2024-05-11,247,237,10,0.0404858299595142
CDMX FORANEAS,2024-05-12,208,203,5,0.0240384615384615
CDMX FORANEAS,2024-05-13,266,254,12,0.0451127819548872
CDMX FORANEAS,2024-05-14,268,255,13,0.0485074626865672
CDMX FORANEAS,2024-05-15,296,286,10,0.0337837837837838
CDMX FORANEAS,2024-05-16,272,234,38,0.139705882352941
CDMX FORANEAS,2024-05-17,257,245,12,0.0466926070038911
CDMX FORANEAS,2024-05-18,286,276,10,0.034965034965035
CDMX FORANEAS,2024-05-19,253,237,16,0.0632411067193676
CDMX FORANEAS,2024-05-20,257,248,9,0.0350194552529183
CDMX FORANEAS,2024-05-21,241,232,9,0.037344398340249
CDMX FORANEAS,2024-05-22,232,222,10,0.0431034482758621
CDMX FORANEAS,2024-05-23,230,221,9,0.0391304347826087
CDMX FORANEAS,2024-05-24,231,220,11,0.0476190476190476
CDMX FORANEAS,2024-05-25,305,299,6,0.019672131147541
CDMX FORANEAS,2024-05-26,254,250,4,0.015748031496063
CDMX FORANEAS,2024-05-27,255,246,9,0.0352941176470588
CDMX FORANEAS,2024-05-28,229,224,5,0.0218340611353712
CDMX FORANEAS,2024-05-29,239,226,13,0.0543933054393305
CDMX FORANEAS,2024-05-30,287,278,9,0.0313588850174216
CDMX FORANEAS,2024-05-31,320,309,11,0.034375
CDMX FORANEAS,2024-06-01,286,274,12,0.041958041958042
CDMX FORANEAS,2024-06-02,221,209,12,0.0542986425339367
CDMX FORANEAS,2024-06-03,228,220,8,0.0350877192982456
CDMX FORANEAS,2024-06-04,263,251,12,0.0456273764258555
CDMX FORANEAS,2024-06-05,247,233,14,0.0566801619433198
CDMX FORANEAS,2024-06-06,237,216,21,0.0886075949367089
CDMX FORANEAS,2024-06-07,257,251,6,0.0233463035019455
CDMX FORANEAS,2024-06-08,308,291,17,0.0551948051948052
CDMX FORANEAS,2024-06-09,237,230,7,0.029535864978903
CDMX FORANEAS,2024-06-10,227,216,11,0.0484581497797357
CDMX FORANEAS,2024-06-11,279,264,15,0.0537634408602151
CDMX FORANEAS,2024-06-12,249,245,4,0.0160642570281124
CDMX FORANEAS,2024-06-13,247,232,15,0.0607287449392713
CDMX FORANEAS,2024-06-14,242,224,18,0.0743801652892562
CDMX FORANEAS,2024-06-15,322,312,10,0.031055900621118
CDMX FORANEAS,2024-06-16,228,219,9,0.0394736842105263
CDMX FORANEAS,2024-06-17,264,248,16,0.0606060606060606
CDMX FORANEAS,2024-06-18,283,266,17,0.0600706713780919
CDMX FORANEAS,2024-06-19,269,256,13,0.0483271375464684
CDMX FORANEAS,2024-06-20,263,251,12,0.0456273764258555
CDMX FORANEAS,2024-06-21,279,269,10,0.03584229390681
CDMX FORANEAS,2024-06-22,328,314,14,0.0426829268292683
CDMX FORANEAS,2024-06-23,292,280,12,0.0410958904109589
CDMX FORANEAS,2024-06-24,275,256,19,0.0690909090909091
CDMX FORANEAS,2024-06-25,259,251,8,0.0308880308880309
CDMX FORANEAS,2024-06-26,243,227,16,0.065843621399177
CDMX FORANEAS,2024-06-27,223,218,5,0.0224215246636771
CDMX FORANEAS,2024-06-28,264,259,5,0.0189393939393939
CDMX FORANEAS,2024-06-29,352,336,16,0.0454545454545455
CDMX FORANEAS,2024-06-30,312,299,13,0.0416666666666667
CDMX FORANEAS,2024-07-01,252,239,13,0.0515873015873016
CDMX FORANEAS,2024-07-02,263,246,17,0.064638783269962
CDMX NORORIENTE,2023-07-03,243,239,4,0.0164609053497942
CDMX NORORIENTE,2023-07-04,224,219,5,0.0223214285714286
CDMX NORORIENTE,2023-07-05,241,239,2,0.00829875518672199
CDMX NORORIENTE,2023-07-06,176,168,8,0.0454545454545455
CDMX NORORIENTE,2023-07-07,205,204,1,0.0048780487804878
CDMX NORORIENTE,2023-07-08,236,227,9,0.038135593220339
CDMX NORORIENTE,2023-07-09,207,205,2,0.00966183574879227
CDMX NORORIENTE,2023-07-10,196,193,3,0.0153061224489796
CDMX NORORIENTE,2023-07-11,239,236,3,0.0125523012552301
CDMX NORORIENTE,2023-07-12,205,202,3,0.0146341463414634
CDMX NORORIENTE,2023-07-13,202,197,5,0.0247524752475248
CDMX NORORIENTE,2023-07-14,235,226,9,0.0382978723404255
CDMX NORORIENTE,2023-07-15,280,278,2,0.00714285714285714
CDMX NORORIENTE,2023-07-16,238,232,6,0.0252100840336134
CDMX NORORIENTE,2023-07-17,213,204,9,0.0422535211267606
CDMX NORORIENTE,2023-07-18,253,248,5,0.0197628458498024
CDMX NORORIENTE,2023-07-19,180,172,8,0.0444444444444444
CDMX NORORIENTE,2023-07-20,254,251,3,0.0118110236220472
CDMX NORORIENTE,2023-07-21,205,203,2,0.00975609756097561
CDMX NORORIENTE,2023-07-22,261,256,5,0.0191570881226054
CDMX NORORIENTE,2023-07-23,254,248,6,0.0236220472440945
CDMX NORORIENTE,2023-07-24,244,238,6,0.0245901639344262
CDMX NORORIENTE,2023-07-25,242,236,6,0.0247933884297521
CDMX NORORIENTE,2023-07-26,286,281,5,0.0174825174825175
CDMX NORORIENTE,2023-07-27,237,233,4,0.0168776371308017
CDMX NORORIENTE,2023-07-28,237,234,3,0.0126582278481013
CDMX NORORIENTE,2023-07-29,270,267,3,0.0111111111111111
CDMX NORORIENTE,2023-07-30,293,285,8,0.0273037542662116
CDMX NORORIENTE,2023-07-31,313,308,5,0.0159744408945687
CDMX NORORIENTE,2023-08-01,229,222,7,0.0305676855895196
CDMX NORORIENTE,2023-08-02,235,231,4,0.0170212765957447
CDMX NORORIENTE,2023-08-03,234,203,31,0.132478632478632
CDMX NORORIENTE,2023-08-04,277,265,12,0.0433212996389892
CDMX NORORIENTE,2023-08-05,284,279,5,0.0176056338028169
CDMX NORORIENTE,2023-08-06,222,215,7,0.0315315315315315
CDMX NORORIENTE,2023-08-07,250,246,4,0.016
CDMX NORORIENTE,2023-08-08,246,238,8,0.032520325203252
CDMX NORORIENTE,2023-08-09,214,204,10,0.0467289719626168
CDMX NORORIENTE,2023-08-10,212,208,4,0.0188679245283019
CDMX NORORIENTE,2023-08-11,254,247,7,0.0275590551181102
CDMX NORORIENTE,2023-08-12,251,242,9,0.0358565737051793
CDMX NORORIENTE,2023-08-13,276,259,17,0.0615942028985507
CDMX NORORIENTE,2023-08-14,235,229,6,0.025531914893617
CDMX NORORIENTE,2023-08-15,309,301,8,0.0258899676375405
CDMX NORORIENTE,2023-08-16,255,252,3,0.0117647058823529
CDMX NORORIENTE,2023-08-17,235,231,4,0.0170212765957447
CDMX NORORIENTE,2023-08-18,269,263,6,0.0223048327137546
CDMX NORORIENTE,2023-08-19,247,242,5,0.0202429149797571
CDMX NORORIENTE,2023-08-20,249,244,5,0.0200803212851406
CDMX NORORIENTE,2023-08-21,241,241,0,0
CDMX NORORIENTE,2023-08-22,252,252,0,0
CDMX NORORIENTE,2023-08-23,215,215,0,0
CDMX NORORIENTE,2023-08-24,249,247,2,0.00803212851405622
CDMX NORORIENTE,2023-08-25,263,263,0,0
CDMX NORORIENTE,2023-08-26,318,318,0,0
CDMX NORORIENTE,2023-08-27,312,311,1,0.00320512820512821
CDMX NORORIENTE,2023-08-28,314,312,2,0.00636942675159236
CDMX NORORIENTE,2023-08-29,273,273,0,0
CDMX NORORIENTE,2023-08-30,272,271,1,0.00367647058823529
CDMX NORORIENTE,2023-08-31,214,210,4,0.0186915887850467
CDMX NORORIENTE,2023-09-01,229,228,1,0.00436681222707424
CDMX NORORIENTE,2023-09-02,277,275,2,0.0072202166064982
CDMX NORORIENTE,2023-09-03,261,259,2,0.00766283524904215
CDMX NORORIENTE,2023-09-04,216,216,0,0
CDMX NORORIENTE,2023-09-05,220,220,0,0
CDMX NORORIENTE,2023-09-06,206,206,0,0
CDMX NORORIENTE,2023-09-07,231,230,1,0.00432900432900433
CDMX NORORIENTE,2023-09-08,191,191,0,0
CDMX NORORIENTE,2023-09-09,260,260,0,0
CDMX NORORIENTE,2023-09-10,258,257,1,0.00387596899224806
CDMX NORORIENTE,2023-09-11,209,208,1,0.00478468899521531
CDMX NORORIENTE,2023-09-12,197,195,2,0.0101522842639594
CDMX NORORIENTE,2023-09-13,223,223,0,0
CDMX NORORIENTE,2023-09-14,226,226,0,0
CDMX NORORIENTE,2023-09-15,201,197,4,0.0199004975124378
CDMX NORORIENTE,2023-09-16,213,212,1,0.00469483568075117
CDMX NORORIENTE,2023-09-17,200,199,1,0.005
CDMX NORORIENTE,2023-09-18,199,198,1,0.0050251256281407
CDMX NORORIENTE,2023-09-19,196,193,3,0.0153061224489796
CDMX NORORIENTE,2023-09-20,134,133,1,0.00746268656716418
CDMX NORORIENTE,2023-09-21,222,219,3,0.0135135135135135
CDMX NORORIENTE,2023-09-22,288,288,0,0
CDMX NORORIENTE,2023-09-23,266,266,0,0
CDMX NORORIENTE,2023-09-24,307,305,2,0.00651465798045603
CDMX NORORIENTE,2023-09-25,222,220,2,0.00900900900900901
CDMX NORORIENTE,2023-09-26,217,216,1,0.00460829493087558
CDMX NORORIENTE,2023-09-27,229,229,0,0
CDMX NORORIENTE,2023-09-28,241,236,5,0.020746887966805
CDMX NORORIENTE,2023-09-29,276,273,3,0.0108695652173913
CDMX NORORIENTE,2023-09-30,366,364,2,0.00546448087431694
CDMX NORORIENTE,2023-10-01,246,243,3,0.0121951219512195
CDMX NORORIENTE,2023-10-02,211,210,1,0.004739336492891
CDMX NORORIENTE,2023-10-03,205,198,7,0.0341463414634146
CDMX NORORIENTE,2023-10-04,188,182,6,0.0319148936170213
CDMX NORORIENTE,2023-10-05,202,195,7,0.0346534653465347
CDMX NORORIENTE,2023-10-06,239,225,14,0.0585774058577406
CDMX NORORIENTE,2023-10-07,291,280,11,0.0378006872852234
CDMX NORORIENTE,2023-10-08,243,238,5,0.0205761316872428
CDMX NORORIENTE,2023-10-09,221,214,7,0.0316742081447964
CDMX NORORIENTE,2023-10-10,182,178,4,0.021978021978022
CDMX NORORIENTE,2023-10-11,185,179,6,0.0324324324324324
CDMX NORORIENTE,2023-10-12,167,163,4,0.0239520958083832
CDMX NORORIENTE,2023-10-13,205,196,9,0.0439024390243902
CDMX NORORIENTE,2023-10-14,260,254,6,0.0230769230769231
CDMX NORORIENTE,2023-10-15,274,267,7,0.0255474452554745
CDMX NORORIENTE,2023-10-16,252,245,7,0.0277777777777778
CDMX NORORIENTE,2023-10-17,224,218,6,0.0267857142857143
CDMX NORORIENTE,2023-10-18,214,206,8,0.0373831775700935
CDMX NORORIENTE,2023-10-19,195,189,6,0.0307692307692308
CDMX NORORIENTE,2023-10-20,225,219,6,0.0266666666666667
CDMX NORORIENTE,2023-10-21,283,278,5,0.0176678445229682
CDMX NORORIENTE,2023-10-22,249,240,9,0.036144578313253
CDMX NORORIENTE,2023-10-23,255,248,7,0.0274509803921569
CDMX NORORIENTE,2023-10-24,218,214,4,0.018348623853211
CDMX NORORIENTE,2023-10-25,189,182,7,0.037037037037037
CDMX NORORIENTE,2023-10-26,157,154,3,0.0191082802547771
CDMX NORORIENTE,2023-10-27,201,194,7,0.0348258706467662
CDMX NORORIENTE,2023-10-28,237,232,5,0.0210970464135021
CDMX NORORIENTE,2023-10-29,237,231,6,0.0253164556962025
CDMX NORORIENTE,2023-10-30,249,238,11,0.0441767068273092
CDMX NORORIENTE,2023-10-31,304,295,9,0.0296052631578947
CDMX NORORIENTE,2023-11-01,222,212,10,0.045045045045045
CDMX NORORIENTE,2023-11-02,214,206,8,0.0373831775700935
CDMX NORORIENTE,2023-11-03,219,212,7,0.0319634703196347
CDMX NORORIENTE,2023-11-04,303,296,7,0.0231023102310231
CDMX NORORIENTE,2023-11-05,309,301,8,0.0258899676375405
CDMX NORORIENTE,2023-11-06,296,291,5,0.0168918918918919
CDMX NORORIENTE,2023-11-07,309,303,6,0.0194174757281553
CDMX NORORIENTE,2023-11-08,303,295,8,0.0264026402640264
CDMX NORORIENTE,2023-11-09,241,233,8,0.033195020746888
CDMX NORORIENTE,2023-11-10,265,261,4,0.0150943396226415
CDMX NORORIENTE,2023-11-11,324,317,7,0.0216049382716049
CDMX NORORIENTE,2023-11-12,276,266,10,0.036231884057971
CDMX NORORIENTE,2023-11-13,290,277,13,0.0448275862068966
CDMX NORORIENTE,2023-11-14,270,264,6,0.0222222222222222
CDMX NORORIENTE,2023-11-15,307,301,6,0.0195439739413681
CDMX NORORIENTE,2023-11-16,318,310,8,0.0251572327044025
CDMX NORORIENTE,2023-11-17,341,336,5,0.0146627565982405
CDMX NORORIENTE,2023-11-18,406,397,9,0.0221674876847291
CDMX NORORIENTE,2023-11-19,396,387,9,0.0227272727272727
CDMX NORORIENTE,2023-11-20,411,403,8,0.0194647201946472
CDMX NORORIENTE,2023-11-21,325,320,5,0.0153846153846154
CDMX NORORIENTE,2023-11-22,286,277,9,0.0314685314685315
CDMX NORORIENTE,2023-11-23,271,264,7,0.025830258302583
CDMX NORORIENTE,2023-11-24,275,265,10,0.0363636363636364
CDMX NORORIENTE,2023-11-25,346,341,5,0.0144508670520231
CDMX NORORIENTE,2023-11-26,293,288,5,0.0170648464163823
CDMX NORORIENTE,2023-11-27,290,282,8,0.0275862068965517
CDMX NORORIENTE,2023-11-28,305,299,6,0.019672131147541
CDMX NORORIENTE,2023-11-29,303,292,11,0.0363036303630363
CDMX NORORIENTE,2023-11-30,354,347,7,0.019774011299435
CDMX NORORIENTE,2023-12-01,279,265,14,0.0501792114695341
CDMX NORORIENTE,2023-12-02,320,307,13,0.040625
CDMX NORORIENTE,2023-12-03,343,329,14,0.0408163265306122
CDMX NORORIENTE,2023-12-04,263,253,10,0.0380228136882129
CDMX NORORIENTE,2023-12-05,263,255,8,0.0304182509505703
CDMX NORORIENTE,2023-12-06,253,247,6,0.0237154150197628
CDMX NORORIENTE,2023-12-07,256,247,9,0.03515625
CDMX NORORIENTE,2023-12-08,285,280,5,0.0175438596491228
CDMX NORORIENTE,2023-12-09,299,290,9,0.0301003344481605
CDMX NORORIENTE,2023-12-10,301,289,12,0.0398671096345515
CDMX NORORIENTE,2023-12-11,262,253,9,0.0343511450381679
CDMX NORORIENTE,2023-12-12,257,254,3,0.0116731517509728
CDMX NORORIENTE,2023-12-13,246,235,11,0.0447154471544715
CDMX NORORIENTE,2023-12-14,250,240,10,0.04
CDMX NORORIENTE,2023-12-15,246,241,5,0.0203252032520325
CDMX NORORIENTE,2023-12-16,298,292,6,0.0201342281879195
CDMX NORORIENTE,2023-12-17,294,283,11,0.0374149659863946
CDMX NORORIENTE,2023-12-18,283,274,9,0.0318021201413428
CDMX NORORIENTE,2023-12-19,282,268,14,0.049645390070922
CDMX NORORIENTE,2023-12-20,313,304,9,0.0287539936102236
CDMX NORORIENTE,2023-12-21,305,295,10,0.0327868852459016
CDMX NORORIENTE,2023-12-22,263,253,10,0.0380228136882129
CDMX NORORIENTE,2023-12-23,304,296,8,0.0263157894736842
CDMX NORORIENTE,2023-12-24,210,202,8,0.0380952380952381
CDMX NORORIENTE,2023-12-25,71,69,2,0.028169014084507
CDMX NORORIENTE,2023-12-26,245,239,6,0.0244897959183673
CDMX NORORIENTE,2023-12-27,308,300,8,0.025974025974026
CDMX NORORIENTE,2023-12-28,286,279,7,0.0244755244755245
CDMX NORORIENTE,2023-12-29,264,253,11,0.0416666666666667
CDMX NORORIENTE,2023-12-30,306,302,4,0.0130718954248366
CDMX NORORIENTE,2023-12-31,184,181,3,0.016304347826087
CDMX NORORIENTE,2024-01-01,62,60,2,0.032258064516129
CDMX NORORIENTE,2024-01-02,223,214,9,0.0403587443946188
CDMX NORORIENTE,2024-01-03,280,274,6,0.0214285714285714
CDMX NORORIENTE,2024-01-04,261,255,6,0.0229885057471264
CDMX NORORIENTE,2024-01-05,286,283,3,0.0104895104895105
CDMX NORORIENTE,2024-01-06,253,247,6,0.0237154150197628
CDMX NORORIENTE,2024-01-07,275,271,4,0.0145454545454545
CDMX NORORIENTE,2024-01-08,288,276,12,0.0416666666666667
CDMX NORORIENTE,2024-01-09,288,285,3,0.0104166666666667
CDMX NORORIENTE,2024-01-10,273,262,11,0.0402930402930403
CDMX NORORIENTE,2024-01-11,305,299,6,0.019672131147541
CDMX NORORIENTE,2024-01-12,309,305,4,0.0129449838187702
CDMX NORORIENTE,2024-01-13,324,315,9,0.0277777777777778
CDMX NORORIENTE,2024-01-14,344,338,6,0.0174418604651163
CDMX NORORIENTE,2024-01-15,313,300,13,0.0415335463258786
CDMX NORORIENTE,2024-01-16,304,295,9,0.0296052631578947
CDMX NORORIENTE,2024-01-17,277,270,7,0.0252707581227437
CDMX NORORIENTE,2024-01-18,281,278,3,0.0106761565836299
CDMX NORORIENTE,2024-01-19,260,252,8,0.0307692307692308
CDMX NORORIENTE,2024-01-20,315,305,10,0.0317460317460317
CDMX NORORIENTE,2024-01-21,278,275,3,0.0107913669064748
CDMX NORORIENTE,2024-01-22,253,248,5,0.0197628458498024
CDMX NORORIENTE,2024-01-23,290,277,13,0.0448275862068966
CDMX NORORIENTE,2024-01-24,265,255,10,0.0377358490566038
CDMX NORORIENTE,2024-01-25,235,229,6,0.025531914893617
CDMX NORORIENTE,2024-01-26,257,252,5,0.0194552529182879
CDMX NORORIENTE,2024-01-27,303,295,8,0.0264026402640264
CDMX NORORIENTE,2024-01-28,290,282,8,0.0275862068965517
CDMX NORORIENTE,2024-01-29,273,268,5,0.0183150183150183
CDMX NORORIENTE,2024-01-30,261,248,13,0.0498084291187739
CDMX NORORIENTE,2024-01-31,325,317,8,0.0246153846153846
CDMX NORORIENTE,2024-02-01,253,240,13,0.0513833992094862
CDMX NORORIENTE,2024-02-02,254,247,7,0.0275590551181102
CDMX NORORIENTE,2024-02-03,273,264,9,0.032967032967033
CDMX NORORIENTE,2024-02-04,257,251,6,0.0233463035019455
CDMX NORORIENTE,2024-02-05,278,275,3,0.0107913669064748
CDMX NORORIENTE,2024-02-06,274,268,6,0.0218978102189781
CDMX NORORIENTE,2024-02-07,292,283,9,0.0308219178082192
CDMX NORORIENTE,2024-02-08,244,237,7,0.0286885245901639
CDMX NORORIENTE,2024-02-09,255,246,9,0.0352941176470588
CDMX NORORIENTE,2024-02-10,296,289,7,0.0236486486486486
CDMX NORORIENTE,2024-02-11,224,219,5,0.0223214285714286
CDMX NORORIENTE,2024-02-12,208,203,5,0.0240384615384615
CDMX NORORIENTE,2024-02-13,237,233,4,0.0168776371308017
CDMX NORORIENTE,2024-02-14,209,204,5,0.0239234449760766
CDMX NORORIENTE,2024-02-15,254,243,11,0.0433070866141732
CDMX NORORIENTE,2024-02-16,298,289,9,0.0302013422818792
CDMX NORORIENTE,2024-02-17,323,316,7,0.021671826625387
CDMX NORORIENTE,2024-02-18,334,327,7,0.0209580838323353
CDMX NORORIENTE,2024-02-19,302,292,10,0.033112582781457
CDMX NORORIENTE,2024-02-20,288,282,6,0.0208333333333333
CDMX NORORIENTE,2024-02-21,251,244,7,0.0278884462151394
CDMX NORORIENTE,2024-02-22,275,266,9,0.0327272727272727
CDMX NORORIENTE,2024-02-23,188,168,20,0.106382978723404
CDMX NORORIENTE,2024-02-24,359,351,8,0.0222841225626741
CDMX NORORIENTE,2024-02-25,324,321,3,0.00925925925925926
CDMX NORORIENTE,2024-02-26,295,289,6,0.0203389830508475
CDMX NORORIENTE,2024-02-27,290,284,6,0.0206896551724138
CDMX NORORIENTE,2024-02-28,293,283,10,0.0341296928327645
CDMX NORORIENTE,2024-02-29,324,313,11,0.0339506172839506
CDMX NORORIENTE,2024-03-01,274,267,7,0.0255474452554745
CDMX NORORIENTE,2024-03-02,336,332,4,0.0119047619047619
CDMX NORORIENTE,2024-03-03,285,280,5,0.0175438596491228
CDMX NORORIENTE,2024-03-04,291,284,7,0.0240549828178694
CDMX NORORIENTE,2024-03-05,240,231,9,0.0375
CDMX NORORIENTE,2024-03-06,266,257,9,0.0338345864661654
CDMX NORORIENTE,2024-03-07,299,296,3,0.0100334448160535
CDMX NORORIENTE,2024-03-08,295,290,5,0.0169491525423729
CDMX NORORIENTE,2024-03-09,349,343,6,0.0171919770773639
CDMX NORORIENTE,2024-03-10,328,325,3,0.00914634146341463
CDMX NORORIENTE,2024-03-11,306,299,7,0.0228758169934641
CDMX NORORIENTE,2024-03-12,273,265,8,0.0293040293040293
CDMX NORORIENTE,2024-03-13,237,224,13,0.0548523206751055
CDMX NORORIENTE,2024-03-14,215,209,6,0.027906976744186
CDMX NORORIENTE,2024-03-15,316,309,7,0.0221518987341772
CDMX NORORIENTE,2024-03-16,340,327,13,0.0382352941176471
CDMX NORORIENTE,2024-03-17,322,311,11,0.0341614906832298
CDMX NORORIENTE,2024-03-18,336,327,9,0.0267857142857143
CDMX NORORIENTE,2024-03-19,223,220,3,0.0134529147982063
CDMX NORORIENTE,2024-03-20,230,225,5,0.0217391304347826
CDMX NORORIENTE,2024-03-21,250,243,7,0.028
CDMX NORORIENTE,2024-03-22,202,200,2,0.0099009900990099
CDMX NORORIENTE,2024-03-23,289,285,4,0.013840830449827
CDMX NORORIENTE,2024-03-24,255,250,5,0.0196078431372549
CDMX NORORIENTE,2024-03-25,229,223,6,0.0262008733624454
CDMX NORORIENTE,2024-03-26,274,266,8,0.0291970802919708
CDMX NORORIENTE,2024-03-27,296,291,5,0.0168918918918919
CDMX NORORIENTE,2024-03-28,317,312,5,0.0157728706624606
CDMX NORORIENTE,2024-03-29,270,255,15,0.0555555555555556
CDMX NORORIENTE,2024-03-30,268,260,8,0.0298507462686567
CDMX NORORIENTE,2024-03-31,233,227,6,0.0257510729613734
CDMX NORORIENTE,2024-04-01,282,273,9,0.0319148936170213
CDMX NORORIENTE,2024-04-02,231,227,4,0.0173160173160173
CDMX NORORIENTE,2024-04-03,241,241,0,0
CDMX NORORIENTE,2024-04-04,237,237,0,0
CDMX NORORIENTE,2024-04-05,256,247,9,0.03515625
CDMX NORORIENTE,2024-04-06,270,265,5,0.0185185185185185
CDMX NORORIENTE,2024-04-07,218,209,9,0.0412844036697248
CDMX NORORIENTE,2024-04-08,221,218,3,0.0135746606334842
CDMX NORORIENTE,2024-04-09,252,243,9,0.0357142857142857
CDMX NORORIENTE,2024-04-10,231,221,10,0.0432900432900433
CDMX NORORIENTE,2024-04-11,234,230,4,0.0170940170940171
CDMX NORORIENTE,2024-04-12,237,228,9,0.0379746835443038
CDMX NORORIENTE,2024-04-13,241,235,6,0.024896265560166
CDMX NORORIENTE,2024-04-14,293,290,3,0.0102389078498294
CDMX NORORIENTE,2024-04-15,284,280,4,0.0140845070422535
CDMX NORORIENTE,2024-04-16,311,285,26,0.0836012861736334
CDMX NORORIENTE,2024-04-17,286,274,12,0.041958041958042
CDMX NORORIENTE,2024-04-18,226,219,7,0.0309734513274336
CDMX NORORIENTE,2024-04-19,231,217,14,0.0606060606060606
CDMX NORORIENTE,2024-04-20,285,278,7,0.0245614035087719
CDMX NORORIENTE,2024-04-21,264,254,10,0.0378787878787879
CDMX NORORIENTE,2024-04-22,159,154,5,0.0314465408805031
CDMX NORORIENTE,2024-04-23,316,300,16,0.0506329113924051
CDMX NORORIENTE,2024-04-24,273,266,7,0.0256410256410256
CDMX NORORIENTE,2024-04-25,227,218,9,0.039647577092511
CDMX NORORIENTE,2024-04-26,233,230,3,0.0128755364806867
CDMX NORORIENTE,2024-04-27,277,259,18,0.0649819494584837
CDMX NORORIENTE,2024-04-28,257,248,9,0.0350194552529183
CDMX NORORIENTE,2024-04-29,262,252,10,0.0381679389312977
CDMX NORORIENTE,2024-04-30,301,293,8,0.026578073089701
CDMX NORORIENTE,2024-05-01,274,269,5,0.0182481751824818
CDMX NORORIENTE,2024-05-02,257,252,5,0.0194552529182879
CDMX NORORIENTE,2024-05-03,261,250,11,0.0421455938697318
CDMX NORORIENTE,2024-05-04,285,276,9,0.0315789473684211
CDMX NORORIENTE,2024-05-05,234,231,3,0.0128205128205128
CDMX NORORIENTE,2024-05-06,239,239,0,0
CDMX NORORIENTE,2024-05-07,242,233,9,0.0371900826446281
CDMX NORORIENTE,2024-05-08,221,213,8,0.0361990950226244
CDMX NORORIENTE,2024-05-09,209,203,6,0.0287081339712919
CDMX NORORIENTE,2024-05-10,191,183,8,0.0418848167539267
CDMX NORORIENTE,2024-05-11,247,237,10,0.0404858299595142
CDMX NORORIENTE,2024-05-12,210,203,7,0.0333333333333333
CDMX NORORIENTE,2024-05-13,262,248,14,0.0534351145038168
CDMX NORORIENTE,2024-05-14,263,254,9,0.0342205323193916
CDMX NORORIENTE,2024-05-15,278,269,9,0.0323741007194245
CDMX NORORIENTE,2024-05-16,274,235,39,0.142335766423358
CDMX NORORIENTE,2024-05-17,270,261,9,0.0333333333333333
CDMX NORORIENTE,2024-05-18,317,309,8,0.0252365930599369
CDMX NORORIENTE,2024-05-19,290,280,10,0.0344827586206897
CDMX NORORIENTE,2024-05-20,320,311,9,0.028125
CDMX NORORIENTE,2024-05-21,273,266,7,0.0256410256410256
CDMX NORORIENTE,2024-05-22,283,272,11,0.03886925795053
CDMX NORORIENTE,2024-05-23,253,245,8,0.0316205533596838
CDMX NORORIENTE,2024-05-24,253,245,8,0.0316205533596838
CDMX NORORIENTE,2024-05-25,357,346,11,0.030812324929972
CDMX NORORIENTE,2024-05-26,252,249,3,0.0119047619047619
CDMX NORORIENTE,2024-05-27,276,269,7,0.0253623188405797
CDMX NORORIENTE,2024-05-28,255,253,2,0.00784313725490196
CDMX NORORIENTE,2024-05-29,285,274,11,0.0385964912280702
CDMX NORORIENTE,2024-05-30,280,264,16,0.0571428571428571
CDMX NORORIENTE,2024-05-31,312,304,8,0.0256410256410256
CDMX NORORIENTE,2024-06-01,342,335,7,0.0204678362573099
CDMX NORORIENTE,2024-06-02,254,250,4,0.015748031496063
CDMX NORORIENTE,2024-06-03,264,262,2,0.00757575757575758
CDMX NORORIENTE,2024-06-04,273,265,8,0.0293040293040293
CDMX NORORIENTE,2024-06-05,234,224,10,0.0427350427350427
CDMX NORORIENTE,2024-06-06,233,225,8,0.0343347639484979
CDMX NORORIENTE,2024-06-07,233,226,7,0.0300429184549356
CDMX NORORIENTE,2024-06-08,297,291,6,0.0202020202020202
CDMX NORORIENTE,2024-06-09,260,253,7,0.0269230769230769
CDMX NORORIENTE,2024-06-10,234,228,6,0.0256410256410256
CDMX NORORIENTE,2024-06-11,259,249,10,0.0386100386100386
CDMX NORORIENTE,2024-06-12,249,241,8,0.0321285140562249
CDMX NORORIENTE,2024-06-13,233,227,6,0.0257510729613734
CDMX NORORIENTE,2024-06-14,261,252,9,0.0344827586206897
CDMX NORORIENTE,2024-06-15,302,288,14,0.0463576158940397
CDMX NORORIENTE,2024-06-16,258,252,6,0.0232558139534884
CDMX NORORIENTE,2024-06-17,259,248,11,0.0424710424710425
CDMX NORORIENTE,2024-06-18,313,300,13,0.0415335463258786
CDMX NORORIENTE,2024-06-19,274,268,6,0.0218978102189781
CDMX NORORIENTE,2024-06-20,260,256,4,0.0153846153846154
CDMX NORORIENTE,2024-06-21,282,277,5,0.0177304964539007
CDMX NORORIENTE,2024-06-22,313,307,6,0.0191693290734824
CDMX NORORIENTE,2024-06-23,297,289,8,0.0269360269360269
CDMX NORORIENTE,2024-06-24,290,284,6,0.0206896551724138
CDMX NORORIENTE,2024-06-25,240,232,8,0.0333333333333333
CDMX NORORIENTE,2024-06-26,252,242,10,0.0396825396825397
CDMX NORORIENTE,2024-06-27,248,240,8,0.032258064516129
CDMX NORORIENTE,2024-06-28,315,312,3,0.00952380952380952
CDMX NORORIENTE,2024-06-29,355,343,12,0.0338028169014084
CDMX NORORIENTE,2024-06-30,360,354,6,0.0166666666666667
CDMX NORORIENTE,2024-07-01,256,249,7,0.02734375
CDMX NORORIENTE,2024-07-02,273,261,12,0.043956043956044
CDMX NORPONIENTE,2023-07-03,393,382,11,0.0279898218829517
CDMX NORPONIENTE,2023-07-04,320,309,11,0.034375
CDMX NORPONIENTE,2023-07-05,249,242,7,0.0281124497991968
CDMX NORPONIENTE,2023-07-06,213,200,13,0.0610328638497653
CDMX NORPONIENTE,2023-07-07,354,345,9,0.0254237288135593
CDMX NORPONIENTE,2023-07-08,430,421,9,0.0209302325581395
CDMX NORPONIENTE,2023-07-09,305,291,14,0.0459016393442623
CDMX NORPONIENTE,2023-07-10,333,318,15,0.045045045045045
CDMX NORPONIENTE,2023-07-11,342,327,15,0.043859649122807
CDMX NORPONIENTE,2023-07-12,300,288,12,0.04
CDMX NORPONIENTE,2023-07-13,302,288,14,0.0463576158940397
CDMX NORPONIENTE,2023-07-14,327,312,15,0.0458715596330275
CDMX NORPONIENTE,2023-07-15,414,401,13,0.0314009661835749
CDMX NORPONIENTE,2023-07-16,311,298,13,0.0418006430868167
CDMX NORPONIENTE,2023-07-17,324,316,8,0.0246913580246914
CDMX NORPONIENTE,2023-07-18,350,340,10,0.0285714285714286
CDMX NORPONIENTE,2023-07-19,341,328,13,0.0381231671554252
CDMX NORPONIENTE,2023-07-20,403,388,15,0.0372208436724566
CDMX NORPONIENTE,2023-07-21,374,363,11,0.0294117647058824
CDMX NORPONIENTE,2023-07-22,417,403,14,0.0335731414868106
CDMX NORPONIENTE,2023-07-23,265,256,9,0.0339622641509434
CDMX NORPONIENTE,2023-07-24,321,311,10,0.0311526479750779
CDMX NORPONIENTE,2023-07-25,361,348,13,0.03601108033241
CDMX NORPONIENTE,2023-07-26,387,374,13,0.0335917312661499
CDMX NORPONIENTE,2023-07-27,361,349,12,0.0332409972299169
CDMX NORPONIENTE,2023-07-28,410,396,14,0.0341463414634146
CDMX NORPONIENTE,2023-07-29,456,446,10,0.0219298245614035
CDMX NORPONIENTE,2023-07-30,387,380,7,0.0180878552971576
CDMX NORPONIENTE,2023-07-31,426,417,9,0.0211267605633803
CDMX NORPONIENTE,2023-08-01,391,377,14,0.0358056265984655
CDMX NORPONIENTE,2023-08-02,371,355,16,0.0431266846361186
CDMX NORPONIENTE,2023-08-03,387,315,72,0.186046511627907
CDMX NORPONIENTE,2023-08-04,365,353,12,0.0328767123287671
CDMX NORPONIENTE,2023-08-05,474,456,18,0.0379746835443038
CDMX NORPONIENTE,2023-08-06,371,361,10,0.0269541778975741
CDMX NORPONIENTE,2023-08-07,374,364,10,0.0267379679144385
CDMX NORPONIENTE,2023-08-08,374,363,11,0.0294117647058824
CDMX NORPONIENTE,2023-08-09,348,334,14,0.0402298850574713
CDMX NORPONIENTE,2023-08-10,348,336,12,0.0344827586206897
CDMX NORPONIENTE,2023-08-11,380,361,19,0.05
CDMX NORPONIENTE,2023-08-12,448,437,11,0.0245535714285714
CDMX NORPONIENTE,2023-08-13,371,359,12,0.032345013477089
CDMX NORPONIENTE,2023-08-14,318,302,16,0.050314465408805
CDMX NORPONIENTE,2023-08-15,430,418,12,0.027906976744186
CDMX NORPONIENTE,2023-08-16,347,335,12,0.0345821325648415
CDMX NORPONIENTE,2023-08-17,335,320,15,0.0447761194029851
CDMX NORPONIENTE,2023-08-18,386,375,11,0.0284974093264249
CDMX NORPONIENTE,2023-08-19,476,464,12,0.0252100840336134
CDMX NORPONIENTE,2023-08-20,314,303,11,0.035031847133758
CDMX NORPONIENTE,2023-08-21,361,358,3,0.00831024930747922
CDMX NORPONIENTE,2023-08-22,338,338,0,0
CDMX NORPONIENTE,2023-08-23,343,338,5,0.0145772594752187
CDMX NORPONIENTE,2023-08-24,345,339,6,0.0173913043478261
CDMX NORPONIENTE,2023-08-25,413,409,4,0.00968523002421308
CDMX NORPONIENTE,2023-08-26,467,465,2,0.00428265524625268
CDMX NORPONIENTE,2023-08-27,380,379,1,0.00263157894736842
CDMX NORPONIENTE,2023-08-28,411,408,3,0.0072992700729927
CDMX NORPONIENTE,2023-08-29,368,361,7,0.0190217391304348
CDMX NORPONIENTE,2023-08-30,403,401,2,0.00496277915632754
CDMX NORPONIENTE,2023-08-31,331,326,5,0.0151057401812689
CDMX NORPONIENTE,2023-09-01,355,353,2,0.00563380281690141
CDMX NORPONIENTE,2023-09-02,412,409,3,0.00728155339805825
CDMX NORPONIENTE,2023-09-03,319,319,0,0
CDMX NORPONIENTE,2023-09-04,331,329,2,0.00604229607250755
CDMX NORPONIENTE,2023-09-05,366,366,0,0
CDMX NORPONIENTE,2023-09-06,329,325,4,0.0121580547112462
CDMX NORPONIENTE,2023-09-07,319,319,0,0
CDMX NORPONIENTE,2023-09-08,300,296,4,0.0133333333333333
CDMX NORPONIENTE,2023-09-09,404,404,0,0
CDMX NORPONIENTE,2023-09-10,331,331,0,0
CDMX NORPONIENTE,2023-09-11,315,312,3,0.00952380952380952
CDMX NORPONIENTE,2023-09-12,318,314,4,0.0125786163522013
CDMX NORPONIENTE,2023-09-13,243,236,7,0.0288065843621399
CDMX NORPONIENTE,2023-09-14,279,276,3,0.010752688172043
CDMX NORPONIENTE,2023-09-15,406,401,5,0.0123152709359606
CDMX NORPONIENTE,2023-09-16,263,262,1,0.00380228136882129
CDMX NORPONIENTE,2023-09-17,339,335,4,0.0117994100294985
CDMX NORPONIENTE,2023-09-18,365,364,1,0.00273972602739726
CDMX NORPONIENTE,2023-09-19,321,317,4,0.0124610591900312
CDMX NORPONIENTE,2023-09-20,319,316,3,0.00940438871473354
CDMX NORPONIENTE,2023-09-21,367,361,6,0.0163487738419619
CDMX NORPONIENTE,2023-09-22,370,365,5,0.0135135135135135
CDMX NORPONIENTE,2023-09-23,460,454,6,0.0130434782608696
CDMX NORPONIENTE,2023-09-24,340,337,3,0.00882352941176471
CDMX NORPONIENTE,2023-09-25,344,336,8,0.0232558139534884
CDMX NORPONIENTE,2023-09-26,351,347,4,0.0113960113960114
CDMX NORPONIENTE,2023-09-27,312,310,2,0.00641025641025641
CDMX NORPONIENTE,2023-09-28,387,381,6,0.0155038759689922
CDMX NORPONIENTE,2023-09-29,391,384,7,0.0179028132992327
CDMX NORPONIENTE,2023-09-30,517,505,12,0.02321083172147
CDMX NORPONIENTE,2023-10-01,300,295,5,0.0166666666666667
CDMX NORPONIENTE,2023-10-02,313,309,4,0.012779552715655
CDMX NORPONIENTE,2023-10-03,317,312,5,0.0157728706624606
CDMX NORPONIENTE,2023-10-04,302,290,12,0.0397350993377483
CDMX NORPONIENTE,2023-10-05,295,283,12,0.0406779661016949
CDMX NORPONIENTE,2023-10-06,334,323,11,0.0329341317365269
CDMX NORPONIENTE,2023-10-07,377,369,8,0.0212201591511936
CDMX NORPONIENTE,2023-10-08,313,299,14,0.0447284345047923
CDMX NORPONIENTE,2023-10-09,299,290,9,0.0301003344481605
CDMX NORPONIENTE,2023-10-10,276,271,5,0.0181159420289855
CDMX NORPONIENTE,2023-10-11,281,268,13,0.0462633451957295
CDMX NORPONIENTE,2023-10-12,260,250,10,0.0384615384615385
CDMX NORPONIENTE,2023-10-13,244,234,10,0.040983606557377
CDMX NORPONIENTE,2023-10-14,445,428,17,0.0382022471910112
CDMX NORPONIENTE,2023-10-15,345,334,11,0.0318840579710145
CDMX NORPONIENTE,2023-10-16,351,341,10,0.0284900284900285
CDMX NORPONIENTE,2023-10-17,347,340,7,0.0201729106628242
CDMX NORPONIENTE,2023-10-18,334,323,11,0.0329341317365269
CDMX NORPONIENTE,2023-10-19,296,288,8,0.027027027027027
CDMX NORPONIENTE,2023-10-20,296,292,4,0.0135135135135135
CDMX NORPONIENTE,2023-10-21,396,384,12,0.0303030303030303
CDMX NORPONIENTE,2023-10-22,290,281,9,0.0310344827586207
CDMX NORPONIENTE,2023-10-23,306,296,10,0.0326797385620915
CDMX NORPONIENTE,2023-10-24,304,299,5,0.0164473684210526
CDMX NORPONIENTE,2023-10-25,300,293,7,0.0233333333333333
CDMX NORPONIENTE,2023-10-26,327,318,9,0.0275229357798165
CDMX NORPONIENTE,2023-10-27,331,324,7,0.0211480362537764
CDMX NORPONIENTE,2023-10-28,390,377,13,0.0333333333333333
CDMX NORPONIENTE,2023-10-29,315,307,8,0.0253968253968254
CDMX NORPONIENTE,2023-10-30,311,299,12,0.0385852090032154
CDMX NORPONIENTE,2023-10-31,362,351,11,0.0303867403314917
CDMX NORPONIENTE,2023-11-01,358,346,12,0.0335195530726257
CDMX NORPONIENTE,2023-11-02,317,308,9,0.028391167192429
CDMX NORPONIENTE,2023-11-03,327,318,9,0.0275229357798165
CDMX NORPONIENTE,2023-11-04,369,361,8,0.021680216802168
CDMX NORPONIENTE,2023-11-05,343,333,10,0.0291545189504373
CDMX NORPONIENTE,2023-11-06,343,334,9,0.0262390670553936
CDMX NORPONIENTE,2023-11-07,365,350,15,0.0410958904109589
CDMX NORPONIENTE,2023-11-08,357,349,8,0.0224089635854342
CDMX NORPONIENTE,2023-11-09,356,349,7,0.0196629213483146
CDMX NORPONIENTE,2023-11-10,339,325,14,0.0412979351032448
CDMX NORPONIENTE,2023-11-11,395,385,10,0.0253164556962025
CDMX NORPONIENTE,2023-11-12,346,336,10,0.0289017341040462
CDMX NORPONIENTE,2023-11-13,348,337,11,0.0316091954022989
CDMX NORPONIENTE,2023-11-14,354,340,14,0.0395480225988701
CDMX NORPONIENTE,2023-11-15,365,359,6,0.0164383561643836
CDMX NORPONIENTE,2023-11-16,372,361,11,0.0295698924731183
CDMX NORPONIENTE,2023-11-17,430,413,17,0.0395348837209302
CDMX NORPONIENTE,2023-11-18,502,486,16,0.0318725099601594
CDMX NORPONIENTE,2023-11-19,361,353,8,0.0221606648199446
CDMX NORPONIENTE,2023-11-20,425,415,10,0.0235294117647059
CDMX NORPONIENTE,2023-11-21,386,376,10,0.0259067357512953
CDMX NORPONIENTE,2023-11-22,398,381,17,0.042713567839196
CDMX NORPONIENTE,2023-11-23,376,367,9,0.023936170212766
CDMX NORPONIENTE,2023-11-24,356,351,5,0.0140449438202247
CDMX NORPONIENTE,2023-11-25,452,438,14,0.0309734513274336
CDMX NORPONIENTE,2023-11-26,381,369,12,0.031496062992126
CDMX NORPONIENTE,2023-11-27,377,367,10,0.026525198938992
CDMX NORPONIENTE,2023-11-28,414,402,12,0.0289855072463768
CDMX NORPONIENTE,2023-11-29,349,321,28,0.0802292263610315
CDMX NORPONIENTE,2023-11-30,472,452,20,0.0423728813559322
CDMX NORPONIENTE,2023-12-01,386,370,16,0.0414507772020725
CDMX NORPONIENTE,2023-12-02,437,418,19,0.0434782608695652
CDMX NORPONIENTE,2023-12-03,366,346,20,0.0546448087431694
CDMX NORPONIENTE,2023-12-04,319,312,7,0.0219435736677116
CDMX NORPONIENTE,2023-12-05,339,315,24,0.0707964601769911
CDMX NORPONIENTE,2023-12-06,343,336,7,0.0204081632653061
CDMX NORPONIENTE,2023-12-07,299,289,10,0.0334448160535117
CDMX NORPONIENTE,2023-12-08,371,356,15,0.0404312668463612
CDMX NORPONIENTE,2023-12-09,430,413,17,0.0395348837209302
CDMX NORPONIENTE,2023-12-10,321,315,6,0.0186915887850467
CDMX NORPONIENTE,2023-12-11,331,320,11,0.0332326283987915
CDMX NORPONIENTE,2023-12-12,401,383,18,0.0448877805486284
CDMX NORPONIENTE,2023-12-13,304,295,9,0.0296052631578947
CDMX NORPONIENTE,2023-12-14,322,305,17,0.0527950310559006
CDMX NORPONIENTE,2023-12-15,342,330,12,0.0350877192982456
CDMX NORPONIENTE,2023-12-16,389,379,10,0.025706940874036
CDMX NORPONIENTE,2023-12-17,327,320,7,0.0214067278287462
CDMX NORPONIENTE,2023-12-18,361,351,10,0.0277008310249307
CDMX NORPONIENTE,2023-12-19,416,408,8,0.0192307692307692
CDMX NORPONIENTE,2023-12-20,418,404,14,0.0334928229665072
CDMX NORPONIENTE,2023-12-21,398,387,11,0.0276381909547739
CDMX NORPONIENTE,2023-12-22,390,379,11,0.0282051282051282
CDMX NORPONIENTE,2023-12-23,438,422,16,0.0365296803652968
CDMX NORPONIENTE,2023-12-24,226,221,5,0.0221238938053097
CDMX NORPONIENTE,2023-12-25,106,99,7,0.0660377358490566
CDMX NORPONIENTE,2023-12-26,308,303,5,0.0162337662337662
CDMX NORPONIENTE,2023-12-27,437,425,12,0.0274599542334096
CDMX NORPONIENTE,2023-12-28,476,465,11,0.023109243697479
CDMX NORPONIENTE,2023-12-29,419,412,7,0.0167064439140811
CDMX NORPONIENTE,2023-12-30,383,374,9,0.0234986945169713
CDMX NORPONIENTE,2023-12-31,197,195,2,0.0101522842639594
CDMX NORPONIENTE,2024-01-01,65,64,1,0.0153846153846154
CDMX NORPONIENTE,2024-01-02,322,316,6,0.0186335403726708
CDMX NORPONIENTE,2024-01-03,445,434,11,0.0247191011235955
CDMX NORPONIENTE,2024-01-04,411,395,16,0.0389294403892944
CDMX NORPONIENTE,2024-01-05,371,358,13,0.0350404312668464
CDMX NORPONIENTE,2024-01-06,390,384,6,0.0153846153846154
CDMX NORPONIENTE,2024-01-07,312,308,4,0.0128205128205128
CDMX NORPONIENTE,2024-01-08,365,357,8,0.0219178082191781
CDMX NORPONIENTE,2024-01-09,345,336,9,0.0260869565217391
CDMX NORPONIENTE,2024-01-10,410,400,10,0.024390243902439
CDMX NORPONIENTE,2024-01-11,369,361,8,0.021680216802168
CDMX NORPONIENTE,2024-01-12,350,338,12,0.0342857142857143
CDMX NORPONIENTE,2024-01-13,469,458,11,0.023454157782516
CDMX NORPONIENTE,2024-01-14,369,364,5,0.013550135501355
CDMX NORPONIENTE,2024-01-15,427,417,10,0.0234192037470726
CDMX NORPONIENTE,2024-01-16,453,436,17,0.0375275938189845
CDMX NORPONIENTE,2024-01-17,390,379,11,0.0282051282051282
CDMX NORPONIENTE,2024-01-18,429,421,8,0.0186480186480186
CDMX NORPONIENTE,2024-01-19,367,359,8,0.0217983651226158
CDMX NORPONIENTE,2024-01-20,439,423,16,0.0364464692482916
CDMX NORPONIENTE,2024-01-21,388,379,9,0.0231958762886598
CDMX NORPONIENTE,2024-01-22,374,364,10,0.0267379679144385
CDMX NORPONIENTE,2024-01-23,367,362,5,0.0136239782016349
CDMX NORPONIENTE,2024-01-24,347,338,9,0.0259365994236311
CDMX NORPONIENTE,2024-01-25,367,357,10,0.0272479564032698
CDMX NORPONIENTE,2024-01-26,377,369,8,0.0212201591511936
CDMX NORPONIENTE,2024-01-27,443,436,7,0.0158013544018059
CDMX NORPONIENTE,2024-01-28,349,340,9,0.0257879656160458
CDMX NORPONIENTE,2024-01-29,371,357,14,0.0377358490566038
CDMX NORPONIENTE,2024-01-30,370,359,11,0.0297297297297297
CDMX NORPONIENTE,2024-01-31,405,392,13,0.0320987654320988
CDMX NORPONIENTE,2024-02-01,364,356,8,0.021978021978022
CDMX NORPONIENTE,2024-02-02,354,346,8,0.0225988700564972
CDMX NORPONIENTE,2024-02-03,421,403,18,0.0427553444180523
CDMX NORPONIENTE,2024-02-04,305,298,7,0.0229508196721311
CDMX NORPONIENTE,2024-02-05,400,396,4,0.01
CDMX NORPONIENTE,2024-02-06,373,359,14,0.0375335120643432
CDMX NORPONIENTE,2024-02-07,366,357,9,0.0245901639344262
CDMX NORPONIENTE,2024-02-08,352,340,12,0.0340909090909091
CDMX NORPONIENTE,2024-02-09,328,318,10,0.0304878048780488
CDMX NORPONIENTE,2024-02-10,447,441,6,0.0134228187919463
CDMX NORPONIENTE,2024-02-11,300,291,9,0.03
CDMX NORPONIENTE,2024-02-12,281,270,11,0.0391459074733096
CDMX NORPONIENTE,2024-02-13,361,353,8,0.0221606648199446
CDMX NORPONIENTE,2024-02-14,295,289,6,0.0203389830508475
CDMX NORPONIENTE,2024-02-15,354,346,8,0.0225988700564972
CDMX NORPONIENTE,2024-02-16,350,334,16,0.0457142857142857
CDMX NORPONIENTE,2024-02-17,437,427,10,0.022883295194508
CDMX NORPONIENTE,2024-02-18,339,331,8,0.023598820058997
CDMX NORPONIENTE,2024-02-19,365,354,11,0.0301369863013699
CDMX NORPONIENTE,2024-02-20,317,312,5,0.0157728706624606
CDMX NORPONIENTE,2024-02-21,343,338,5,0.0145772594752187
CDMX NORPONIENTE,2024-02-22,402,397,5,0.0124378109452736
CDMX NORPONIENTE,2024-02-23,294,261,33,0.112244897959184
CDMX NORPONIENTE,2024-02-24,496,485,11,0.0221774193548387
CDMX NORPONIENTE,2024-02-25,331,326,5,0.0151057401812689
CDMX NORPONIENTE,2024-02-26,395,388,7,0.0177215189873418
CDMX NORPONIENTE,2024-02-27,396,389,7,0.0176767676767677
CDMX NORPONIENTE,2024-02-28,420,406,14,0.0333333333333333
CDMX NORPONIENTE,2024-02-29,422,411,11,0.0260663507109005
CDMX NORPONIENTE,2024-03-01,369,366,3,0.00813008130081301
CDMX NORPONIENTE,2024-03-02,482,477,5,0.0103734439834025
CDMX NORPONIENTE,2024-03-03,391,385,6,0.0153452685421995
CDMX NORPONIENTE,2024-03-04,398,392,6,0.0150753768844221
CDMX NORPONIENTE,2024-03-05,371,357,14,0.0377358490566038
CDMX NORPONIENTE,2024-03-06,377,367,10,0.026525198938992
CDMX NORPONIENTE,2024-03-07,349,340,9,0.0257879656160458
CDMX NORPONIENTE,2024-03-08,363,350,13,0.0358126721763085
CDMX NORPONIENTE,2024-03-09,421,415,6,0.0142517814726841
CDMX NORPONIENTE,2024-03-10,333,328,5,0.015015015015015
CDMX NORPONIENTE,2024-03-11,375,371,4,0.0106666666666667
CDMX NORPONIENTE,2024-03-12,327,319,8,0.0244648318042813
CDMX NORPONIENTE,2024-03-13,349,344,5,0.0143266475644699
CDMX NORPONIENTE,2024-03-14,349,342,7,0.0200573065902579
CDMX NORPONIENTE,2024-03-15,368,364,4,0.0108695652173913
CDMX NORPONIENTE,2024-03-16,487,472,15,0.0308008213552361
CDMX NORPONIENTE,2024-03-17,330,320,10,0.0303030303030303
CDMX NORPONIENTE,2024-03-18,378,372,6,0.0158730158730159
CDMX NORPONIENTE,2024-03-19,332,327,5,0.0150602409638554
CDMX NORPONIENTE,2024-03-20,330,326,4,0.0121212121212121
CDMX NORPONIENTE,2024-03-21,307,300,7,0.0228013029315961
CDMX NORPONIENTE,2024-03-22,307,294,13,0.0423452768729642
CDMX NORPONIENTE,2024-03-23,424,412,12,0.0283018867924528
CDMX NORPONIENTE,2024-03-24,291,284,7,0.0240549828178694
CDMX NORPONIENTE,2024-03-25,335,323,12,0.0358208955223881
CDMX NORPONIENTE,2024-03-26,353,341,12,0.0339943342776204
CDMX NORPONIENTE,2024-03-27,377,368,9,0.0238726790450928
CDMX NORPONIENTE,2024-03-28,479,469,10,0.0208768267223382
CDMX NORPONIENTE,2024-03-29,378,373,5,0.0132275132275132
CDMX NORPONIENTE,2024-03-30,331,321,10,0.0302114803625378
CDMX NORPONIENTE,2024-03-31,272,267,5,0.0183823529411765
CDMX NORPONIENTE,2024-04-01,354,343,11,0.0310734463276836
CDMX NORPONIENTE,2024-04-02,398,390,8,0.0201005025125628
CDMX NORPONIENTE,2024-04-03,335,335,0,0
CDMX NORPONIENTE,2024-04-04,366,366,0,0
CDMX NORPONIENTE,2024-04-05,341,327,14,0.0410557184750733
CDMX NORPONIENTE,2024-04-06,404,398,6,0.0148514851485149
CDMX NORPONIENTE,2024-04-07,255,250,5,0.0196078431372549
CDMX NORPONIENTE,2024-04-08,311,304,7,0.022508038585209
CDMX NORPONIENTE,2024-04-09,332,327,5,0.0150602409638554
CDMX NORPONIENTE,2024-04-10,328,319,9,0.0274390243902439
CDMX NORPONIENTE,2024-04-11,328,311,17,0.0518292682926829
CDMX NORPONIENTE,2024-04-12,304,295,9,0.0296052631578947
CDMX NORPONIENTE,2024-04-13,381,376,5,0.0131233595800525
CDMX NORPONIENTE,2024-04-14,310,301,9,0.0290322580645161
CDMX NORPONIENTE,2024-04-15,361,353,8,0.0221606648199446
CDMX NORPONIENTE,2024-04-16,392,367,25,0.0637755102040816
CDMX NORPONIENTE,2024-04-17,385,366,19,0.0493506493506494
CDMX NORPONIENTE,2024-04-18,334,318,16,0.0479041916167665
CDMX NORPONIENTE,2024-04-19,302,289,13,0.043046357615894
CDMX NORPONIENTE,2024-04-20,407,388,19,0.0466830466830467
CDMX NORPONIENTE,2024-04-21,284,281,3,0.0105633802816901
CDMX NORPONIENTE,2024-04-22,187,181,6,0.0320855614973262
CDMX NORPONIENTE,2024-04-23,413,389,24,0.0581113801452785
CDMX NORPONIENTE,2024-04-24,317,309,8,0.0252365930599369
CDMX NORPONIENTE,2024-04-25,292,282,10,0.0342465753424658
CDMX NORPONIENTE,2024-04-26,305,296,9,0.0295081967213115
CDMX NORPONIENTE,2024-04-27,379,368,11,0.029023746701847
CDMX NORPONIENTE,2024-04-28,314,304,10,0.0318471337579618
CDMX NORPONIENTE,2024-04-29,319,313,6,0.0188087774294671
CDMX NORPONIENTE,2024-04-30,353,340,13,0.0368271954674221
CDMX NORPONIENTE,2024-05-01,401,396,5,0.0124688279301746
CDMX NORPONIENTE,2024-05-02,314,305,9,0.0286624203821656
CDMX NORPONIENTE,2024-05-03,336,324,12,0.0357142857142857
CDMX NORPONIENTE,2024-05-04,428,416,12,0.0280373831775701
CDMX NORPONIENTE,2024-05-05,259,255,4,0.0154440154440154
CDMX NORPONIENTE,2024-05-06,306,306,0,0
CDMX NORPONIENTE,2024-05-07,321,309,12,0.0373831775700935
CDMX NORPONIENTE,2024-05-08,294,278,16,0.054421768707483
CDMX NORPONIENTE,2024-05-09,279,269,10,0.03584229390681
CDMX NORPONIENTE,2024-05-10,298,282,16,0.0536912751677852
CDMX NORPONIENTE,2024-05-11,330,320,10,0.0303030303030303
CDMX NORPONIENTE,2024-05-12,234,230,4,0.0170940170940171
CDMX NORPONIENTE,2024-05-13,310,303,7,0.0225806451612903
CDMX NORPONIENTE,2024-05-14,347,340,7,0.0201729106628242
CDMX NORPONIENTE,2024-05-15,367,361,6,0.0163487738419619
CDMX NORPONIENTE,2024-05-16,325,293,32,0.0984615384615385
CDMX NORPONIENTE,2024-05-17,372,366,6,0.0161290322580645
CDMX NORPONIENTE,2024-05-18,453,445,8,0.0176600441501104
CDMX NORPONIENTE,2024-05-19,304,299,5,0.0164473684210526
CDMX NORPONIENTE,2024-05-20,365,353,12,0.0328767123287671
CDMX NORPONIENTE,2024-05-21,378,369,9,0.0238095238095238
CDMX NORPONIENTE,2024-05-22,334,326,8,0.0239520958083832
CDMX NORPONIENTE,2024-05-23,312,306,6,0.0192307692307692
CDMX NORPONIENTE,2024-05-24,322,311,11,0.0341614906832298
CDMX NORPONIENTE,2024-05-25,421,412,9,0.0213776722090261
CDMX NORPONIENTE,2024-05-26,286,279,7,0.0244755244755245
CDMX NORPONIENTE,2024-05-27,330,326,4,0.0121212121212121
CDMX NORPONIENTE,2024-05-28,361,354,7,0.0193905817174515
CDMX NORPONIENTE,2024-05-29,315,304,11,0.0349206349206349
CDMX NORPONIENTE,2024-05-30,335,330,5,0.0149253731343284
CDMX NORPONIENTE,2024-05-31,410,404,6,0.0146341463414634
CDMX NORPONIENTE,2024-06-01,414,403,11,0.0265700483091787
CDMX NORPONIENTE,2024-06-02,253,245,8,0.0316205533596838
CDMX NORPONIENTE,2024-06-03,328,318,10,0.0304878048780488
CDMX NORPONIENTE,2024-06-04,374,365,9,0.0240641711229947
CDMX NORPONIENTE,2024-06-05,317,304,13,0.0410094637223975
CDMX NORPONIENTE,2024-06-06,335,315,20,0.0597014925373134
CDMX NORPONIENTE,2024-06-07,354,342,12,0.0338983050847458
CDMX NORPONIENTE,2024-06-08,403,387,16,0.0397022332506203
CDMX NORPONIENTE,2024-06-09,316,309,7,0.0221518987341772
CDMX NORPONIENTE,2024-06-10,309,297,12,0.0388349514563107
CDMX NORPONIENTE,2024-06-11,336,324,12,0.0357142857142857
CDMX NORPONIENTE,2024-06-12,290,286,4,0.0137931034482759
CDMX NORPONIENTE,2024-06-13,332,321,11,0.0331325301204819
CDMX NORPONIENTE,2024-06-14,323,310,13,0.0402476780185759
CDMX NORPONIENTE,2024-06-15,433,419,14,0.0323325635103926
CDMX NORPONIENTE,2024-06-16,312,300,12,0.0384615384615385
CDMX NORPONIENTE,2024-06-17,349,340,9,0.0257879656160458
CDMX NORPONIENTE,2024-06-18,392,382,10,0.0255102040816327
CDMX NORPONIENTE,2024-06-19,358,347,11,0.0307262569832402
CDMX NORPONIENTE,2024-06-20,345,334,11,0.0318840579710145
CDMX NORPONIENTE,2024-06-21,386,374,12,0.0310880829015544
CDMX NORPONIENTE,2024-06-22,452,441,11,0.0243362831858407
CDMX NORPONIENTE,2024-06-23,348,339,9,0.0258620689655172
CDMX NORPONIENTE,2024-06-24,359,353,6,0.0167130919220056
CDMX NORPONIENTE,2024-06-25,360,349,11,0.0305555555555556
CDMX NORPONIENTE,2024-06-26,388,373,15,0.038659793814433
CDMX NORPONIENTE,2024-06-27,350,339,11,0.0314285714285714
CDMX NORPONIENTE,2024-06-28,402,393,9,0.0223880597014925
CDMX NORPONIENTE,2024-06-29,489,478,11,0.0224948875255624
CDMX NORPONIENTE,2024-06-30,397,391,6,0.0151133501259446
CDMX NORPONIENTE,2024-07-01,335,328,7,0.0208955223880597
CDMX NORPONIENTE,2024-07-02,378,367,11,0.0291005291005291
CDMX PONIENTE CONDESA,2023-07-03,142,133,9,0.0633802816901408
CDMX PONIENTE CONDESA,2023-07-04,95,92,3,0.0315789473684211
CDMX PONIENTE CONDESA,2023-07-05,93,85,8,0.0860215053763441
CDMX PONIENTE CONDESA,2023-07-06,99,97,2,0.0202020202020202
CDMX PONIENTE CONDESA,2023-07-07,132,131,1,0.00757575757575758
CDMX PONIENTE CONDESA,2023-07-08,126,121,5,0.0396825396825397
CDMX PONIENTE CONDESA,2023-07-09,102,102,0,0
CDMX PONIENTE CONDESA,2023-07-10,129,123,6,0.0465116279069767
CDMX PONIENTE CONDESA,2023-07-11,123,114,9,0.0731707317073171
CDMX PONIENTE CONDESA,2023-07-12,115,104,11,0.0956521739130435
CDMX PONIENTE CONDESA,2023-07-13,97,85,12,0.123711340206186
CDMX PONIENTE CONDESA,2023-07-14,102,97,5,0.0490196078431373
CDMX PONIENTE CONDESA,2023-07-15,134,128,6,0.0447761194029851
CDMX PONIENTE CONDESA,2023-07-16,111,109,2,0.018018018018018
CDMX PONIENTE CONDESA,2023-07-17,133,125,8,0.0601503759398496
CDMX PONIENTE CONDESA,2023-07-18,107,103,4,0.0373831775700935
CDMX PONIENTE CONDESA,2023-07-19,121,120,1,0.00826446280991736
CDMX PONIENTE CONDESA,2023-07-20,129,119,10,0.0775193798449612
CDMX PONIENTE CONDESA,2023-07-21,93,83,10,0.10752688172043
CDMX PONIENTE CONDESA,2023-07-22,121,118,3,0.0247933884297521
CDMX PONIENTE CONDESA,2023-07-23,87,83,4,0.0459770114942529
CDMX PONIENTE CONDESA,2023-07-24,132,125,7,0.053030303030303
CDMX PONIENTE CONDESA,2023-07-25,133,128,5,0.037593984962406
CDMX PONIENTE CONDESA,2023-07-26,97,90,7,0.0721649484536082
CDMX PONIENTE CONDESA,2023-07-27,154,145,9,0.0584415584415584
CDMX PONIENTE CONDESA,2023-07-28,164,158,6,0.0365853658536585
CDMX PONIENTE CONDESA,2023-07-29,137,128,9,0.0656934306569343
CDMX PONIENTE CONDESA,2023-07-30,105,98,7,0.0666666666666667
CDMX PONIENTE CONDESA,2023-07-31,122,113,9,0.0737704918032787
CDMX PONIENTE CONDESA,2023-08-01,158,149,9,0.0569620253164557
CDMX PONIENTE CONDESA,2023-08-02,134,131,3,0.0223880597014925
CDMX PONIENTE CONDESA,2023-08-03,116,91,25,0.21551724137931
CDMX PONIENTE CONDESA,2023-08-04,116,110,6,0.0517241379310345
CDMX PONIENTE CONDESA,2023-08-05,135,124,11,0.0814814814814815
CDMX PONIENTE CONDESA,2023-08-06,108,105,3,0.0277777777777778
CDMX PONIENTE CONDESA,2023-08-07,129,126,3,0.0232558139534884
CDMX PONIENTE CONDESA,2023-08-08,139,129,10,0.0719424460431655
CDMX PONIENTE CONDESA,2023-08-09,160,148,12,0.075
CDMX PONIENTE CONDESA,2023-08-10,133,127,6,0.0451127819548872
CDMX PONIENTE CONDESA,2023-08-11,136,126,10,0.0735294117647059
CDMX PONIENTE CONDESA,2023-08-12,135,133,2,0.0148148148148148
CDMX PONIENTE CONDESA,2023-08-13,99,93,6,0.0606060606060606
CDMX PONIENTE CONDESA,2023-08-14,129,121,8,0.062015503875969
CDMX PONIENTE CONDESA,2023-08-15,168,162,6,0.0357142857142857
CDMX PONIENTE CONDESA,2023-08-16,131,127,4,0.0305343511450382
CDMX PONIENTE CONDESA,2023-08-17,159,148,11,0.0691823899371069
CDMX PONIENTE CONDESA,2023-08-18,141,132,9,0.0638297872340425
CDMX PONIENTE CONDESA,2023-08-19,131,124,7,0.0534351145038168
CDMX PONIENTE CONDESA,2023-08-20,110,105,5,0.0454545454545455
CDMX PONIENTE CONDESA,2023-08-21,124,123,1,0.00806451612903226
CDMX PONIENTE CONDESA,2023-08-22,120,120,0,0
CDMX PONIENTE CONDESA,2023-08-23,125,123,2,0.016
CDMX PONIENTE CONDESA,2023-08-24,139,134,5,0.0359712230215827
CDMX PONIENTE CONDESA,2023-08-25,129,124,5,0.0387596899224806
CDMX PONIENTE CONDESA,2023-08-26,152,150,2,0.0131578947368421
CDMX PONIENTE CONDESA,2023-08-27,108,106,2,0.0185185185185185
CDMX PONIENTE CONDESA,2023-08-28,138,135,3,0.0217391304347826
CDMX PONIENTE CONDESA,2023-08-29,141,139,2,0.0141843971631206
CDMX PONIENTE CONDESA,2023-08-30,109,106,3,0.0275229357798165
CDMX PONIENTE CONDESA,2023-08-31,136,134,2,0.0147058823529412
CDMX PONIENTE CONDESA,2023-09-01,127,126,1,0.0078740157480315
CDMX PONIENTE CONDESA,2023-09-02,163,163,0,0
CDMX PONIENTE CONDESA,2023-09-03,124,124,0,0
CDMX PONIENTE CONDESA,2023-09-04,127,126,1,0.0078740157480315
CDMX PONIENTE CONDESA,2023-09-05,132,132,0,0
CDMX PONIENTE CONDESA,2023-09-06,119,117,2,0.0168067226890756
CDMX PONIENTE CONDESA,2023-09-07,93,92,1,0.010752688172043
CDMX PONIENTE CONDESA,2023-09-08,108,108,0,0
CDMX PONIENTE CONDESA,2023-09-09,159,159,0,0
CDMX PONIENTE CONDESA,2023-09-10,116,115,1,0.00862068965517241
CDMX PONIENTE CONDESA,2023-09-11,115,112,3,0.0260869565217391
CDMX PONIENTE CONDESA,2023-09-12,124,124,0,0
CDMX PONIENTE CONDESA,2023-09-13,107,103,4,0.0373831775700935
CDMX PONIENTE CONDESA,2023-09-14,100,93,7,0.07
CDMX PONIENTE CONDESA,2023-09-15,66,62,4,0.0606060606060606
CDMX PONIENTE CONDESA,2023-09-16,118,115,3,0.0254237288135593
CDMX PONIENTE CONDESA,2023-09-17,99,98,1,0.0101010101010101
CDMX PONIENTE CONDESA,2023-09-18,102,101,1,0.00980392156862745
CDMX PONIENTE CONDESA,2023-09-19,131,128,3,0.0229007633587786
CDMX PONIENTE CONDESA,2023-09-20,125,120,5,0.04
CDMX PONIENTE CONDESA,2023-09-21,127,123,4,0.031496062992126
CDMX PONIENTE CONDESA,2023-09-22,155,149,6,0.0387096774193548
CDMX PONIENTE CONDESA,2023-09-23,146,146,0,0
CDMX PONIENTE CONDESA,2023-09-24,109,106,3,0.0275229357798165
CDMX PONIENTE CONDESA,2023-09-25,118,117,1,0.00847457627118644
CDMX PONIENTE CONDESA,2023-09-26,135,134,1,0.00740740740740741
CDMX PONIENTE CONDESA,2023-09-27,126,125,1,0.00793650793650794
CDMX PONIENTE CONDESA,2023-09-28,127,126,1,0.0078740157480315
CDMX PONIENTE CONDESA,2023-09-29,160,159,1,0.00625
CDMX PONIENTE CONDESA,2023-09-30,172,168,4,0.0232558139534884
CDMX PONIENTE CONDESA,2023-10-01,110,107,3,0.0272727272727273
CDMX PONIENTE CONDESA,2023-10-02,129,125,4,0.0310077519379845
CDMX PONIENTE CONDESA,2023-10-03,138,129,9,0.0652173913043478
CDMX PONIENTE CONDESA,2023-10-04,117,110,7,0.0598290598290598
CDMX PONIENTE CONDESA,2023-10-05,104,97,7,0.0673076923076923
CDMX PONIENTE CONDESA,2023-10-06,118,109,9,0.076271186440678
CDMX PONIENTE CONDESA,2023-10-07,99,97,2,0.0202020202020202
CDMX PONIENTE CONDESA,2023-10-08,78,74,4,0.0512820512820513
CDMX PONIENTE CONDESA,2023-10-09,114,106,8,0.0701754385964912
CDMX PONIENTE CONDESA,2023-10-10,128,123,5,0.0390625
CDMX PONIENTE CONDESA,2023-10-11,121,107,14,0.115702479338843
CDMX PONIENTE CONDESA,2023-10-12,99,94,5,0.0505050505050505
CDMX PONIENTE CONDESA,2023-10-13,97,91,6,0.0618556701030928
CDMX PONIENTE CONDESA,2023-10-14,120,115,5,0.0416666666666667
CDMX PONIENTE CONDESA,2023-10-15,79,79,0,0
CDMX PONIENTE CONDESA,2023-10-16,135,129,6,0.0444444444444444
CDMX PONIENTE CONDESA,2023-10-17,109,105,4,0.036697247706422
CDMX PONIENTE CONDESA,2023-10-18,115,109,6,0.0521739130434783
CDMX PONIENTE CONDESA,2023-10-19,115,108,7,0.0608695652173913
CDMX PONIENTE CONDESA,2023-10-20,116,110,6,0.0517241379310345
CDMX PONIENTE CONDESA,2023-10-21,107,104,3,0.0280373831775701
CDMX PONIENTE CONDESA,2023-10-22,83,81,2,0.0240963855421687
CDMX PONIENTE CONDESA,2023-10-23,115,105,10,0.0869565217391304
CDMX PONIENTE CONDESA,2023-10-24,117,113,4,0.0341880341880342
CDMX PONIENTE CONDESA,2023-10-25,95,92,3,0.0315789473684211
CDMX PONIENTE CONDESA,2023-10-26,116,115,1,0.00862068965517241
CDMX PONIENTE CONDESA,2023-10-27,105,103,2,0.019047619047619
CDMX PONIENTE CONDESA,2023-10-28,115,112,3,0.0260869565217391
CDMX PONIENTE CONDESA,2023-10-29,95,91,4,0.0421052631578947
CDMX PONIENTE CONDESA,2023-10-30,110,105,5,0.0454545454545455
CDMX PONIENTE CONDESA,2023-10-31,136,128,8,0.0588235294117647
CDMX PONIENTE CONDESA,2023-11-01,106,104,2,0.0188679245283019
CDMX PONIENTE CONDESA,2023-11-02,109,104,5,0.0458715596330275
CDMX PONIENTE CONDESA,2023-11-03,118,116,2,0.0169491525423729
CDMX PONIENTE CONDESA,2023-11-04,121,114,7,0.0578512396694215
CDMX PONIENTE CONDESA,2023-11-05,99,96,3,0.0303030303030303
CDMX PONIENTE CONDESA,2023-11-06,115,112,3,0.0260869565217391
CDMX PONIENTE CONDESA,2023-11-07,117,106,11,0.094017094017094
CDMX PONIENTE CONDESA,2023-11-08,141,135,6,0.0425531914893617
CDMX PONIENTE CONDESA,2023-11-09,98,94,4,0.0408163265306122
CDMX PONIENTE CONDESA,2023-11-10,112,105,7,0.0625
CDMX PONIENTE CONDESA,2023-11-11,130,125,5,0.0384615384615385
CDMX PONIENTE CONDESA,2023-11-12,89,86,3,0.0337078651685393
CDMX PONIENTE CONDESA,2023-11-13,126,119,7,0.0555555555555556
CDMX PONIENTE CONDESA,2023-11-14,139,135,4,0.0287769784172662
CDMX PONIENTE CONDESA,2023-11-15,146,138,8,0.0547945205479452
CDMX PONIENTE CONDESA,2023-11-16,142,135,7,0.0492957746478873
CDMX PONIENTE CONDESA,2023-11-17,149,146,3,0.0201342281879195
CDMX PONIENTE CONDESA,2023-11-18,173,167,6,0.0346820809248555
CDMX PONIENTE CONDESA,2023-11-19,108,106,2,0.0185185185185185
CDMX PONIENTE CONDESA,2023-11-20,159,155,4,0.0251572327044025
CDMX PONIENTE CONDESA,2023-11-21,162,154,8,0.0493827160493827
CDMX PONIENTE CONDESA,2023-11-22,141,140,1,0.00709219858156028
CDMX PONIENTE CONDESA,2023-11-23,141,137,4,0.0283687943262411
CDMX PONIENTE CONDESA,2023-11-24,126,115,11,0.0873015873015873
CDMX PONIENTE CONDESA,2023-11-25,143,142,1,0.00699300699300699
CDMX PONIENTE CONDESA,2023-11-26,79,77,2,0.0253164556962025
CDMX PONIENTE CONDESA,2023-11-27,132,127,5,0.0378787878787879
CDMX PONIENTE CONDESA,2023-11-28,134,127,7,0.0522388059701493
CDMX PONIENTE CONDESA,2023-11-29,139,128,11,0.079136690647482
CDMX PONIENTE CONDESA,2023-11-30,152,138,14,0.0921052631578947
CDMX PONIENTE CONDESA,2023-12-01,155,150,5,0.032258064516129
CDMX PONIENTE CONDESA,2023-12-02,113,106,7,0.0619469026548673
CDMX PONIENTE CONDESA,2023-12-03,115,112,3,0.0260869565217391
CDMX PONIENTE CONDESA,2023-12-04,142,133,9,0.0633802816901408
CDMX PONIENTE CONDESA,2023-12-05,150,146,4,0.0266666666666667
CDMX PONIENTE CONDESA,2023-12-06,113,103,10,0.0884955752212389
CDMX PONIENTE CONDESA,2023-12-07,127,123,4,0.031496062992126
CDMX PONIENTE CONDESA,2023-12-08,123,115,8,0.0650406504065041
CDMX PONIENTE CONDESA,2023-12-09,125,122,3,0.024
CDMX PONIENTE CONDESA,2023-12-10,90,89,1,0.0111111111111111
CDMX PONIENTE CONDESA,2023-12-11,125,119,6,0.048
CDMX PONIENTE CONDESA,2023-12-12,149,138,11,0.0738255033557047
CDMX PONIENTE CONDESA,2023-12-13,93,87,6,0.0645161290322581
CDMX PONIENTE CONDESA,2023-12-14,110,105,5,0.0454545454545455
CDMX PONIENTE CONDESA,2023-12-15,124,123,1,0.00806451612903226
CDMX PONIENTE CONDESA,2023-12-16,136,133,3,0.0220588235294118
CDMX PONIENTE CONDESA,2023-12-17,93,92,1,0.010752688172043
CDMX PONIENTE CONDESA,2023-12-18,117,116,1,0.00854700854700855
CDMX PONIENTE CONDESA,2023-12-19,130,124,6,0.0461538461538462
CDMX PONIENTE CONDESA,2023-12-20,135,131,4,0.0296296296296296
CDMX PONIENTE CONDESA,2023-12-21,122,119,3,0.0245901639344262
CDMX PONIENTE CONDESA,2023-12-22,113,111,2,0.0176991150442478
CDMX PONIENTE CONDESA,2023-12-23,118,112,6,0.0508474576271186
CDMX PONIENTE CONDESA,2023-12-24,57,55,2,0.0350877192982456
CDMX PONIENTE CONDESA,2023-12-25,27,27,0,0
CDMX PONIENTE CONDESA,2023-12-26,108,102,6,0.0555555555555556
CDMX PONIENTE CONDESA,2023-12-27,135,129,6,0.0444444444444444
CDMX PONIENTE CONDESA,2023-12-28,125,120,5,0.04
CDMX PONIENTE CONDESA,2023-12-29,119,112,7,0.0588235294117647
CDMX PONIENTE CONDESA,2023-12-30,129,127,2,0.0155038759689922
CDMX PONIENTE CONDESA,2023-12-31,42,42,0,0
CDMX PONIENTE CONDESA,2024-01-01,32,31,1,0.03125
CDMX PONIENTE CONDESA,2024-01-02,113,105,8,0.0707964601769911
CDMX PONIENTE CONDESA,2024-01-03,159,157,2,0.0125786163522013
CDMX PONIENTE CONDESA,2024-01-04,131,131,0,0
CDMX PONIENTE CONDESA,2024-01-05,127,123,4,0.031496062992126
CDMX PONIENTE CONDESA,2024-01-06,140,133,7,0.05
CDMX PONIENTE CONDESA,2024-01-07,80,77,3,0.0375
CDMX PONIENTE CONDESA,2024-01-08,131,125,6,0.0458015267175573
CDMX PONIENTE CONDESA,2024-01-09,132,124,8,0.0606060606060606
CDMX PONIENTE CONDESA,2024-01-10,129,127,2,0.0155038759689922
CDMX PONIENTE CONDESA,2024-01-11,122,118,4,0.0327868852459016
CDMX PONIENTE CONDESA,2024-01-12,149,142,7,0.0469798657718121
CDMX PONIENTE CONDESA,2024-01-13,144,139,5,0.0347222222222222
CDMX PONIENTE CONDESA,2024-01-14,130,125,5,0.0384615384615385
CDMX PONIENTE CONDESA,2024-01-15,145,140,5,0.0344827586206897
CDMX PONIENTE CONDESA,2024-01-16,127,120,7,0.0551181102362205
CDMX PONIENTE CONDESA,2024-01-17,153,148,5,0.0326797385620915
CDMX PONIENTE CONDESA,2024-01-18,109,105,4,0.036697247706422
CDMX PONIENTE CONDESA,2024-01-19,120,110,10,0.0833333333333333
CDMX PONIENTE CONDESA,2024-01-20,123,120,3,0.024390243902439
CDMX PONIENTE CONDESA,2024-01-21,75,73,2,0.0266666666666667
CDMX PONIENTE CONDESA,2024-01-22,123,119,4,0.032520325203252
CDMX PONIENTE CONDESA,2024-01-23,121,117,4,0.0330578512396694
CDMX PONIENTE CONDESA,2024-01-24,139,132,7,0.0503597122302158
CDMX PONIENTE CONDESA,2024-01-25,125,118,7,0.056
CDMX PONIENTE CONDESA,2024-01-26,117,108,9,0.0769230769230769
CDMX PONIENTE CONDESA,2024-01-27,160,156,4,0.025
CDMX PONIENTE CONDESA,2024-01-28,106,104,2,0.0188679245283019
CDMX PONIENTE CONDESA,2024-01-29,146,139,7,0.0479452054794521
CDMX PONIENTE CONDESA,2024-01-30,135,126,9,0.0666666666666667
CDMX PONIENTE CONDESA,2024-01-31,153,149,4,0.0261437908496732
CDMX PONIENTE CONDESA,2024-02-01,131,122,9,0.0687022900763359
CDMX PONIENTE CONDESA,2024-02-02,142,142,0,0
CDMX PONIENTE CONDESA,2024-02-03,150,148,2,0.0133333333333333
CDMX PONIENTE CONDESA,2024-02-04,130,127,3,0.0230769230769231
CDMX PONIENTE CONDESA,2024-02-05,93,90,3,0.032258064516129
CDMX PONIENTE CONDESA,2024-02-06,131,122,9,0.0687022900763359
CDMX PONIENTE CONDESA,2024-02-07,143,136,7,0.048951048951049
CDMX PONIENTE CONDESA,2024-02-08,141,133,8,0.0567375886524823
CDMX PONIENTE CONDESA,2024-02-09,146,138,8,0.0547945205479452
CDMX PONIENTE CONDESA,2024-02-10,149,149,0,0
CDMX PONIENTE CONDESA,2024-02-11,77,75,2,0.025974025974026
CDMX PONIENTE CONDESA,2024-02-12,94,83,11,0.117021276595745
CDMX PONIENTE CONDESA,2024-02-13,121,117,4,0.0330578512396694
CDMX PONIENTE CONDESA,2024-02-14,111,107,4,0.036036036036036
CDMX PONIENTE CONDESA,2024-02-15,108,103,5,0.0462962962962963
CDMX PONIENTE CONDESA,2024-02-16,132,126,6,0.0454545454545455
CDMX PONIENTE CONDESA,2024-02-17,143,138,5,0.034965034965035
CDMX PONIENTE CONDESA,2024-02-18,107,104,3,0.0280373831775701
CDMX PONIENTE CONDESA,2024-02-19,119,113,6,0.0504201680672269
CDMX PONIENTE CONDESA,2024-02-20,157,153,4,0.0254777070063694
CDMX PONIENTE CONDESA,2024-02-21,114,108,6,0.0526315789473684
CDMX PONIENTE CONDESA,2024-02-22,135,133,2,0.0148148148148148
CDMX PONIENTE CONDESA,2024-02-23,76,67,9,0.118421052631579
CDMX PONIENTE CONDESA,2024-02-24,143,141,2,0.013986013986014
CDMX PONIENTE CONDESA,2024-02-25,91,88,3,0.032967032967033
CDMX PONIENTE CONDESA,2024-02-26,130,124,6,0.0461538461538462
CDMX PONIENTE CONDESA,2024-02-27,143,136,7,0.048951048951049
CDMX PONIENTE CONDESA,2024-02-28,140,132,8,0.0571428571428571
CDMX PONIENTE CONDESA,2024-02-29,155,150,5,0.032258064516129
CDMX PONIENTE CONDESA,2024-03-01,134,126,8,0.0597014925373134
CDMX PONIENTE CONDESA,2024-03-02,145,144,1,0.00689655172413793
CDMX PONIENTE CONDESA,2024-03-03,112,111,1,0.00892857142857143
CDMX PONIENTE CONDESA,2024-03-04,130,127,3,0.0230769230769231
CDMX PONIENTE CONDESA,2024-03-05,184,179,5,0.0271739130434783
CDMX PONIENTE CONDESA,2024-03-06,133,128,5,0.037593984962406
CDMX PONIENTE CONDESA,2024-03-07,142,137,5,0.0352112676056338
CDMX PONIENTE CONDESA,2024-03-08,127,123,4,0.031496062992126
CDMX PONIENTE CONDESA,2024-03-09,148,145,3,0.0202702702702703
CDMX PONIENTE CONDESA,2024-03-10,129,126,3,0.0232558139534884
CDMX PONIENTE CONDESA,2024-03-11,113,110,3,0.0265486725663717
CDMX PONIENTE CONDESA,2024-03-12,130,128,2,0.0153846153846154
CDMX PONIENTE CONDESA,2024-03-13,132,131,1,0.00757575757575758
CDMX PONIENTE CONDESA,2024-03-14,125,121,4,0.032
CDMX PONIENTE CONDESA,2024-03-15,135,130,5,0.037037037037037
CDMX PONIENTE CONDESA,2024-03-16,144,142,2,0.0138888888888889
CDMX PONIENTE CONDESA,2024-03-17,114,109,5,0.043859649122807
CDMX PONIENTE CONDESA,2024-03-18,88,87,1,0.0113636363636364
CDMX PONIENTE CONDESA,2024-03-19,132,125,7,0.053030303030303
CDMX PONIENTE CONDESA,2024-03-20,141,135,6,0.0425531914893617
CDMX PONIENTE CONDESA,2024-03-21,121,117,4,0.0330578512396694
CDMX PONIENTE CONDESA,2024-03-22,118,109,9,0.076271186440678
CDMX PONIENTE CONDESA,2024-03-23,128,128,0,0
CDMX PONIENTE CONDESA,2024-03-24,82,79,3,0.0365853658536585
CDMX PONIENTE CONDESA,2024-03-25,118,112,6,0.0508474576271186
CDMX PONIENTE CONDESA,2024-03-26,137,130,7,0.0510948905109489
CDMX PONIENTE CONDESA,2024-03-27,160,156,4,0.025
CDMX PONIENTE CONDESA,2024-03-28,127,122,5,0.0393700787401575
CDMX PONIENTE CONDESA,2024-03-29,98,96,2,0.0204081632653061
CDMX PONIENTE CONDESA,2024-03-30,102,99,3,0.0294117647058824
CDMX PONIENTE CONDESA,2024-03-31,73,71,2,0.0273972602739726
CDMX PONIENTE CONDESA,2024-04-01,114,110,4,0.0350877192982456
CDMX PONIENTE CONDESA,2024-04-02,119,115,4,0.0336134453781513
CDMX PONIENTE CONDESA,2024-04-03,126,126,0,0
CDMX PONIENTE CONDESA,2024-04-04,117,117,0,0
CDMX PONIENTE CONDESA,2024-04-05,133,130,3,0.0225563909774436
CDMX PONIENTE CONDESA,2024-04-06,141,137,4,0.0283687943262411
CDMX PONIENTE CONDESA,2024-04-07,87,81,6,0.0689655172413793
CDMX PONIENTE CONDESA,2024-04-08,107,105,2,0.0186915887850467
CDMX PONIENTE CONDESA,2024-04-09,110,108,2,0.0181818181818182
CDMX PONIENTE CONDESA,2024-04-10,93,89,4,0.043010752688172
CDMX PONIENTE CONDESA,2024-04-11,121,119,2,0.0165289256198347
CDMX PONIENTE CONDESA,2024-04-12,139,134,5,0.0359712230215827
CDMX PONIENTE CONDESA,2024-04-13,117,112,5,0.0427350427350427
CDMX PONIENTE CONDESA,2024-04-14,75,74,1,0.0133333333333333
CDMX PONIENTE CONDESA,2024-04-15,125,121,4,0.032
CDMX PONIENTE CONDESA,2024-04-16,187,176,11,0.0588235294117647
CDMX PONIENTE CONDESA,2024-04-17,127,120,7,0.0551181102362205
CDMX PONIENTE CONDESA,2024-04-18,122,118,4,0.0327868852459016
CDMX PONIENTE CONDESA,2024-04-19,122,116,6,0.0491803278688525
CDMX PONIENTE CONDESA,2024-04-20,122,118,4,0.0327868852459016
CDMX PONIENTE CONDESA,2024-04-21,77,77,0,0
CDMX PONIENTE CONDESA,2024-04-22,56,54,2,0.0357142857142857
CDMX PONIENTE CONDESA,2024-04-23,149,142,7,0.0469798657718121
CDMX PONIENTE CONDESA,2024-04-24,106,104,2,0.0188679245283019
CDMX PONIENTE CONDESA,2024-04-25,106,102,4,0.0377358490566038
CDMX PONIENTE CONDESA,2024-04-26,100,95,5,0.05
CDMX PONIENTE CONDESA,2024-04-27,112,109,3,0.0267857142857143
CDMX PONIENTE CONDESA,2024-04-28,103,101,2,0.0194174757281553
CDMX PONIENTE CONDESA,2024-04-29,99,94,5,0.0505050505050505
CDMX PONIENTE CONDESA,2024-04-30,102,96,6,0.0588235294117647
CDMX PONIENTE CONDESA,2024-05-01,86,84,2,0.0232558139534884
CDMX PONIENTE CONDESA,2024-05-02,118,113,5,0.0423728813559322
CDMX PONIENTE CONDESA,2024-05-03,123,122,1,0.00813008130081301
CDMX PONIENTE CONDESA,2024-05-04,90,89,1,0.0111111111111111
CDMX PONIENTE CONDESA,2024-05-05,86,85,1,0.0116279069767442
CDMX PONIENTE CONDESA,2024-05-06,145,145,0,0
CDMX PONIENTE CONDESA,2024-05-07,134,132,2,0.0149253731343284
CDMX PONIENTE CONDESA,2024-05-08,105,99,6,0.0571428571428571
CDMX PONIENTE CONDESA,2024-05-09,102,97,5,0.0490196078431373
CDMX PONIENTE CONDESA,2024-05-10,106,102,4,0.0377358490566038
CDMX PONIENTE CONDESA,2024-05-11,98,97,1,0.0102040816326531
CDMX PONIENTE CONDESA,2024-05-12,72,71,1,0.0138888888888889
CDMX PONIENTE CONDESA,2024-05-13,126,123,3,0.0238095238095238
CDMX PONIENTE CONDESA,2024-05-14,96,91,5,0.0520833333333333
CDMX PONIENTE CONDESA,2024-05-15,126,120,6,0.0476190476190476
CDMX PONIENTE CONDESA,2024-05-16,106,90,16,0.150943396226415
CDMX PONIENTE CONDESA,2024-05-17,129,123,6,0.0465116279069767
CDMX PONIENTE CONDESA,2024-05-18,132,130,2,0.0151515151515152
CDMX PONIENTE CONDESA,2024-05-19,109,104,5,0.0458715596330275
CDMX PONIENTE CONDESA,2024-05-20,125,124,1,0.008
CDMX PONIENTE CONDESA,2024-05-21,124,116,8,0.0645161290322581
CDMX PONIENTE CONDESA,2024-05-22,119,113,6,0.0504201680672269
CDMX PONIENTE CONDESA,2024-05-23,115,113,2,0.0173913043478261
CDMX PONIENTE CONDESA,2024-05-24,113,104,9,0.079646017699115
CDMX PONIENTE CONDESA,2024-05-25,147,144,3,0.0204081632653061
CDMX PONIENTE CONDESA,2024-05-26,78,78,0,0
CDMX PONIENTE CONDESA,2024-05-27,117,111,6,0.0512820512820513
CDMX PONIENTE CONDESA,2024-05-28,118,116,2,0.0169491525423729
CDMX PONIENTE CONDESA,2024-05-29,113,113,0,0
CDMX PONIENTE CONDESA,2024-05-30,124,119,5,0.0403225806451613
CDMX PONIENTE CONDESA,2024-05-31,106,103,3,0.0283018867924528
CDMX PONIENTE CONDESA,2024-06-01,134,129,5,0.0373134328358209
CDMX PONIENTE CONDESA,2024-06-02,114,109,5,0.043859649122807
CDMX PONIENTE CONDESA,2024-06-03,117,116,1,0.00854700854700855
CDMX PONIENTE CONDESA,2024-06-04,130,128,2,0.0153846153846154
CDMX PONIENTE CONDESA,2024-06-05,130,125,5,0.0384615384615385
CDMX PONIENTE CONDESA,2024-06-06,140,133,7,0.05
CDMX PONIENTE CONDESA,2024-06-07,116,110,6,0.0517241379310345
CDMX PONIENTE CONDESA,2024-06-08,106,103,3,0.0283018867924528
CDMX PONIENTE CONDESA,2024-06-09,97,97,0,0
CDMX PONIENTE CONDESA,2024-06-10,113,105,8,0.0707964601769911
CDMX PONIENTE CONDESA,2024-06-11,95,92,3,0.0315789473684211
CDMX PONIENTE CONDESA,2024-06-12,134,131,3,0.0223880597014925
CDMX PONIENTE CONDESA,2024-06-13,126,116,10,0.0793650793650794
CDMX PONIENTE CONDESA,2024-06-14,126,119,7,0.0555555555555556
CDMX PONIENTE CONDESA,2024-06-15,141,135,6,0.0425531914893617
CDMX PONIENTE CONDESA,2024-06-16,88,85,3,0.0340909090909091
CDMX PONIENTE CONDESA,2024-06-17,107,104,3,0.0280373831775701
CDMX PONIENTE CONDESA,2024-06-18,150,144,6,0.04
CDMX PONIENTE CONDESA,2024-06-19,135,133,2,0.0148148148148148
CDMX PONIENTE CONDESA,2024-06-20,121,117,4,0.0330578512396694
CDMX PONIENTE CONDESA,2024-06-21,137,134,3,0.0218978102189781
CDMX PONIENTE CONDESA,2024-06-22,118,112,6,0.0508474576271186
CDMX PONIENTE CONDESA,2024-06-23,92,88,4,0.0434782608695652
CDMX PONIENTE CONDESA,2024-06-24,116,110,6,0.0517241379310345
CDMX PONIENTE CONDESA,2024-06-25,131,126,5,0.0381679389312977
CDMX PONIENTE CONDESA,2024-06-26,139,137,2,0.0143884892086331
CDMX PONIENTE CONDESA,2024-06-27,133,128,5,0.037593984962406
CDMX PONIENTE CONDESA,2024-06-28,107,105,2,0.0186915887850467
CDMX PONIENTE CONDESA,2024-06-29,125,119,6,0.048
CDMX PONIENTE CONDESA,2024-06-30,108,106,2,0.0185185185185185
CDMX PONIENTE CONDESA,2024-07-01,110,109,1,0.00909090909090909
CDMX PONIENTE CONDESA,2024-07-02,125,121,4,0.032
CDMX PONIENTE PEDREGAL,2023-07-03,102,96,6,0.0588235294117647
CDMX PONIENTE PEDREGAL,2023-07-04,125,115,10,0.08
CDMX PONIENTE PEDREGAL,2023-07-05,100,93,7,0.07
CDMX PONIENTE PEDREGAL,2023-07-06,135,129,6,0.0444444444444444
CDMX PONIENTE PEDREGAL,2023-07-07,156,147,9,0.0576923076923077
CDMX PONIENTE PEDREGAL,2023-07-08,185,174,11,0.0594594594594595
CDMX PONIENTE PEDREGAL,2023-07-09,140,132,8,0.0571428571428571
CDMX PONIENTE PEDREGAL,2023-07-10,137,132,5,0.0364963503649635
CDMX PONIENTE PEDREGAL,2023-07-11,158,153,5,0.0316455696202532
CDMX PONIENTE PEDREGAL,2023-07-12,140,133,7,0.05
CDMX PONIENTE PEDREGAL,2023-07-13,154,149,5,0.0324675324675325
CDMX PONIENTE PEDREGAL,2023-07-14,122,117,5,0.040983606557377
CDMX PONIENTE PEDREGAL,2023-07-15,148,142,6,0.0405405405405405
CDMX PONIENTE PEDREGAL,2023-07-16,139,137,2,0.0143884892086331
CDMX PONIENTE PEDREGAL,2023-07-17,159,153,6,0.0377358490566038
CDMX PONIENTE PEDREGAL,2023-07-18,147,141,6,0.0408163265306122
CDMX PONIENTE PEDREGAL,2023-07-19,158,149,9,0.0569620253164557
CDMX PONIENTE PEDREGAL,2023-07-20,162,155,7,0.0432098765432099
CDMX PONIENTE PEDREGAL,2023-07-21,153,150,3,0.0196078431372549
CDMX PONIENTE PEDREGAL,2023-07-22,168,163,5,0.0297619047619048
CDMX PONIENTE PEDREGAL,2023-07-23,153,149,4,0.0261437908496732
CDMX PONIENTE PEDREGAL,2023-07-24,157,148,9,0.0573248407643312
CDMX PONIENTE PEDREGAL,2023-07-25,150,144,6,0.04
CDMX PONIENTE PEDREGAL,2023-07-26,137,133,4,0.0291970802919708
CDMX PONIENTE PEDREGAL,2023-07-27,147,146,1,0.00680272108843537
CDMX PONIENTE PEDREGAL,2023-07-28,187,182,5,0.0267379679144385
CDMX PONIENTE PEDREGAL,2023-07-29,171,165,6,0.0350877192982456
CDMX PONIENTE PEDREGAL,2023-07-30,139,137,2,0.0143884892086331
CDMX PONIENTE PEDREGAL,2023-07-31,174,168,6,0.0344827586206897
CDMX PONIENTE PEDREGAL,2023-08-01,186,181,5,0.0268817204301075
CDMX PONIENTE PEDREGAL,2023-08-02,208,196,12,0.0576923076923077
CDMX PONIENTE PEDREGAL,2023-08-03,216,193,23,0.106481481481481
CDMX PONIENTE PEDREGAL,2023-08-04,176,167,9,0.0511363636363636
CDMX PONIENTE PEDREGAL,2023-08-05,177,170,7,0.0395480225988701
CDMX PONIENTE PEDREGAL,2023-08-06,150,147,3,0.02
CDMX PONIENTE PEDREGAL,2023-08-07,153,144,9,0.0588235294117647
CDMX PONIENTE PEDREGAL,2023-08-08,157,155,2,0.0127388535031847
CDMX PONIENTE PEDREGAL,2023-08-09,168,162,6,0.0357142857142857
CDMX PONIENTE PEDREGAL,2023-08-10,143,136,7,0.048951048951049
CDMX PONIENTE PEDREGAL,2023-08-11,181,177,4,0.0220994475138122
CDMX PONIENTE PEDREGAL,2023-08-12,166,161,5,0.0301204819277108
CDMX PONIENTE PEDREGAL,2023-08-13,148,146,2,0.0135135135135135
CDMX PONIENTE PEDREGAL,2023-08-14,137,132,5,0.0364963503649635
CDMX PONIENTE PEDREGAL,2023-08-15,205,197,8,0.0390243902439024
CDMX PONIENTE PEDREGAL,2023-08-16,175,169,6,0.0342857142857143
CDMX PONIENTE PEDREGAL,2023-08-17,155,149,6,0.0387096774193548
CDMX PONIENTE PEDREGAL,2023-08-18,193,182,11,0.0569948186528497
CDMX PONIENTE PEDREGAL,2023-08-19,166,158,8,0.0481927710843374
CDMX PONIENTE PEDREGAL,2023-08-20,154,148,6,0.038961038961039
CDMX PONIENTE PEDREGAL,2023-08-21,141,140,1,0.00709219858156028
CDMX PONIENTE PEDREGAL,2023-08-22,150,148,2,0.0133333333333333
CDMX PONIENTE PEDREGAL,2023-08-23,160,157,3,0.01875
CDMX PONIENTE PEDREGAL,2023-08-24,185,183,2,0.0108108108108108
CDMX PONIENTE PEDREGAL,2023-08-25,162,161,1,0.00617283950617284
CDMX PONIENTE PEDREGAL,2023-08-26,179,177,2,0.0111731843575419
CDMX PONIENTE PEDREGAL,2023-08-27,198,197,1,0.00505050505050505
CDMX PONIENTE PEDREGAL,2023-08-28,138,136,2,0.0144927536231884
CDMX PONIENTE PEDREGAL,2023-08-29,150,149,1,0.00666666666666667
CDMX PONIENTE PEDREGAL,2023-08-30,182,180,2,0.010989010989011
CDMX PONIENTE PEDREGAL,2023-08-31,168,166,2,0.0119047619047619
CDMX PONIENTE PEDREGAL,2023-09-01,167,165,2,0.0119760479041916
CDMX PONIENTE PEDREGAL,2023-09-02,179,176,3,0.0167597765363128
CDMX PONIENTE PEDREGAL,2023-09-03,147,145,2,0.0136054421768707
CDMX PONIENTE PEDREGAL,2023-09-04,136,136,0,0
CDMX PONIENTE PEDREGAL,2023-09-05,165,163,2,0.0121212121212121
CDMX PONIENTE PEDREGAL,2023-09-06,137,136,1,0.0072992700729927
CDMX PONIENTE PEDREGAL,2023-09-07,131,130,1,0.00763358778625954
CDMX PONIENTE PEDREGAL,2023-09-08,113,112,1,0.00884955752212389
CDMX PONIENTE PEDREGAL,2023-09-09,159,157,2,0.0125786163522013
CDMX PONIENTE PEDREGAL,2023-09-10,120,120,0,0
CDMX PONIENTE PEDREGAL,2023-09-11,151,148,3,0.0198675496688742
CDMX PONIENTE PEDREGAL,2023-09-12,172,170,2,0.0116279069767442
CDMX PONIENTE PEDREGAL,2023-09-13,135,134,1,0.00740740740740741
CDMX PONIENTE PEDREGAL,2023-09-14,140,138,2,0.0142857142857143
CDMX PONIENTE PEDREGAL,2023-09-15,171,169,2,0.0116959064327485
CDMX PONIENTE PEDREGAL,2023-09-16,103,101,2,0.0194174757281553
CDMX PONIENTE PEDREGAL,2023-09-17,114,111,3,0.0263157894736842
CDMX PONIENTE PEDREGAL,2023-09-18,155,153,2,0.0129032258064516
CDMX PONIENTE PEDREGAL,2023-09-19,152,151,1,0.00657894736842105
CDMX PONIENTE PEDREGAL,2023-09-20,140,139,1,0.00714285714285714
CDMX PONIENTE PEDREGAL,2023-09-21,163,158,5,0.0306748466257669
CDMX PONIENTE PEDREGAL,2023-09-22,142,138,4,0.028169014084507
CDMX PONIENTE PEDREGAL,2023-09-23,166,163,3,0.0180722891566265
CDMX PONIENTE PEDREGAL,2023-09-24,124,122,2,0.0161290322580645
CDMX PONIENTE PEDREGAL,2023-09-25,147,144,3,0.0204081632653061
CDMX PONIENTE PEDREGAL,2023-09-26,150,149,1,0.00666666666666667
CDMX PONIENTE PEDREGAL,2023-09-27,142,141,1,0.00704225352112676
CDMX PONIENTE PEDREGAL,2023-09-28,146,144,2,0.0136986301369863
CDMX PONIENTE PEDREGAL,2023-09-29,166,158,8,0.0481927710843374
CDMX PONIENTE PEDREGAL,2023-09-30,192,185,7,0.0364583333333333
CDMX PONIENTE PEDREGAL,2023-10-01,131,129,2,0.0152671755725191
CDMX PONIENTE PEDREGAL,2023-10-02,141,141,0,0
CDMX PONIENTE PEDREGAL,2023-10-03,145,140,5,0.0344827586206897
CDMX PONIENTE PEDREGAL,2023-10-04,126,124,2,0.0158730158730159
CDMX PONIENTE PEDREGAL,2023-10-05,127,124,3,0.0236220472440945
CDMX PONIENTE PEDREGAL,2023-10-06,138,135,3,0.0217391304347826
CDMX PONIENTE PEDREGAL,2023-10-07,159,157,2,0.0125786163522013
CDMX PONIENTE PEDREGAL,2023-10-08,106,99,7,0.0660377358490566
CDMX PONIENTE PEDREGAL,2023-10-09,128,124,4,0.03125
CDMX PONIENTE PEDREGAL,2023-10-10,134,130,4,0.0298507462686567
CDMX PONIENTE PEDREGAL,2023-10-11,130,125,5,0.0384615384615385
CDMX PONIENTE PEDREGAL,2023-10-12,113,109,4,0.0353982300884956
CDMX PONIENTE PEDREGAL,2023-10-13,126,120,6,0.0476190476190476
CDMX PONIENTE PEDREGAL,2023-10-14,133,129,4,0.0300751879699248
CDMX PONIENTE PEDREGAL,2023-10-15,138,136,2,0.0144927536231884
CDMX PONIENTE PEDREGAL,2023-10-16,154,151,3,0.0194805194805195
CDMX PONIENTE PEDREGAL,2023-10-17,136,134,2,0.0147058823529412
CDMX PONIENTE PEDREGAL,2023-10-18,129,124,5,0.0387596899224806
CDMX PONIENTE PEDREGAL,2023-10-19,159,152,7,0.0440251572327044
CDMX PONIENTE PEDREGAL,2023-10-20,140,135,5,0.0357142857142857
CDMX PONIENTE PEDREGAL,2023-10-21,132,128,4,0.0303030303030303
CDMX PONIENTE PEDREGAL,2023-10-22,132,130,2,0.0151515151515152
CDMX PONIENTE PEDREGAL,2023-10-23,110,106,4,0.0363636363636364
CDMX PONIENTE PEDREGAL,2023-10-24,121,115,6,0.0495867768595041
CDMX PONIENTE PEDREGAL,2023-10-25,136,131,5,0.0367647058823529
CDMX PONIENTE PEDREGAL,2023-10-26,126,122,4,0.0317460317460317
CDMX PONIENTE PEDREGAL,2023-10-27,131,129,2,0.0152671755725191
CDMX PONIENTE PEDREGAL,2023-10-28,165,162,3,0.0181818181818182
CDMX PONIENTE PEDREGAL,2023-10-29,126,124,2,0.0158730158730159
CDMX PONIENTE PEDREGAL,2023-10-30,147,145,2,0.0136054421768707
CDMX PONIENTE PEDREGAL,2023-10-31,178,174,4,0.0224719101123595
CDMX PONIENTE PEDREGAL,2023-11-01,153,151,2,0.0130718954248366
CDMX PONIENTE PEDREGAL,2023-11-02,120,119,1,0.00833333333333333
CDMX PONIENTE PEDREGAL,2023-11-03,124,121,3,0.0241935483870968
CDMX PONIENTE PEDREGAL,2023-11-04,154,154,0,0
CDMX PONIENTE PEDREGAL,2023-11-05,133,132,1,0.0075187969924812
CDMX PONIENTE PEDREGAL,2023-11-06,148,146,2,0.0135135135135135
CDMX PONIENTE PEDREGAL,2023-11-07,147,146,1,0.00680272108843537
CDMX PONIENTE PEDREGAL,2023-11-08,141,138,3,0.0212765957446809
CDMX PONIENTE PEDREGAL,2023-11-09,139,136,3,0.0215827338129496
CDMX PONIENTE PEDREGAL,2023-11-10,152,150,2,0.0131578947368421
CDMX PONIENTE PEDREGAL,2023-11-11,188,183,5,0.0265957446808511
CDMX PONIENTE PEDREGAL,2023-11-12,136,134,2,0.0147058823529412
CDMX PONIENTE PEDREGAL,2023-11-13,159,153,6,0.0377358490566038
CDMX PONIENTE PEDREGAL,2023-11-14,169,165,4,0.0236686390532544
CDMX PONIENTE PEDREGAL,2023-11-15,171,169,2,0.0116959064327485
CDMX PONIENTE PEDREGAL,2023-11-16,156,152,4,0.0256410256410256
CDMX PONIENTE PEDREGAL,2023-11-17,189,182,7,0.037037037037037
CDMX PONIENTE PEDREGAL,2023-11-18,240,236,4,0.0166666666666667
CDMX PONIENTE PEDREGAL,2023-11-19,174,169,5,0.028735632183908
CDMX PONIENTE PEDREGAL,2023-11-20,187,181,6,0.0320855614973262
CDMX PONIENTE PEDREGAL,2023-11-21,189,184,5,0.0264550264550265
CDMX PONIENTE PEDREGAL,2023-11-22,167,164,3,0.0179640718562874
CDMX PONIENTE PEDREGAL,2023-11-23,178,173,5,0.0280898876404494
CDMX PONIENTE PEDREGAL,2023-11-24,171,168,3,0.0175438596491228
CDMX PONIENTE PEDREGAL,2023-11-25,180,179,1,0.00555555555555556
CDMX PONIENTE PEDREGAL,2023-11-26,171,166,5,0.0292397660818713
CDMX PONIENTE PEDREGAL,2023-11-27,187,183,4,0.0213903743315508
CDMX PONIENTE PEDREGAL,2023-11-28,179,176,3,0.0167597765363128
CDMX PONIENTE PEDREGAL,2023-11-29,180,169,11,0.0611111111111111
CDMX PONIENTE PEDREGAL,2023-11-30,214,200,14,0.0654205607476635
CDMX PONIENTE PEDREGAL,2023-12-01,179,172,7,0.0391061452513966
CDMX PONIENTE PEDREGAL,2023-12-02,171,164,7,0.0409356725146199
CDMX PONIENTE PEDREGAL,2023-12-03,177,169,8,0.0451977401129944
CDMX PONIENTE PEDREGAL,2023-12-04,174,168,6,0.0344827586206897
CDMX PONIENTE PEDREGAL,2023-12-05,165,154,11,0.0666666666666667
CDMX PONIENTE PEDREGAL,2023-12-06,158,151,7,0.0443037974683544
CDMX PONIENTE PEDREGAL,2023-12-07,137,130,7,0.0510948905109489
CDMX PONIENTE PEDREGAL,2023-12-08,138,132,6,0.0434782608695652
CDMX PONIENTE PEDREGAL,2023-12-09,162,158,4,0.0246913580246914
CDMX PONIENTE PEDREGAL,2023-12-10,127,125,2,0.015748031496063
CDMX PONIENTE PEDREGAL,2023-12-11,153,149,4,0.0261437908496732
CDMX PONIENTE PEDREGAL,2023-12-12,157,152,5,0.0318471337579618
CDMX PONIENTE PEDREGAL,2023-12-13,150,149,1,0.00666666666666667
CDMX PONIENTE PEDREGAL,2023-12-14,135,131,4,0.0296296296296296
CDMX PONIENTE PEDREGAL,2023-12-15,149,148,1,0.00671140939597315
CDMX PONIENTE PEDREGAL,2023-12-16,168,167,1,0.00595238095238095
CDMX PONIENTE PEDREGAL,2023-12-17,124,121,3,0.0241935483870968
CDMX PONIENTE PEDREGAL,2023-12-18,192,187,5,0.0260416666666667
CDMX PONIENTE PEDREGAL,2023-12-19,171,166,5,0.0292397660818713
CDMX PONIENTE PEDREGAL,2023-12-20,171,163,8,0.0467836257309941
CDMX PONIENTE PEDREGAL,2023-12-21,162,158,4,0.0246913580246914
CDMX PONIENTE PEDREGAL,2023-12-22,145,142,3,0.0206896551724138
CDMX PONIENTE PEDREGAL,2023-12-23,149,146,3,0.0201342281879195
CDMX PONIENTE PEDREGAL,2023-12-24,97,95,2,0.0206185567010309
CDMX PONIENTE PEDREGAL,2023-12-25,41,41,0,0
CDMX PONIENTE PEDREGAL,2023-12-26,151,143,8,0.0529801324503311
CDMX PONIENTE PEDREGAL,2023-12-27,181,179,2,0.0110497237569061
CDMX PONIENTE PEDREGAL,2023-12-28,149,144,5,0.0335570469798658
CDMX PONIENTE PEDREGAL,2023-12-29,165,162,3,0.0181818181818182
CDMX PONIENTE PEDREGAL,2023-12-30,187,182,5,0.0267379679144385
CDMX PONIENTE PEDREGAL,2023-12-31,95,90,5,0.0526315789473684
CDMX PONIENTE PEDREGAL,2024-01-01,37,37,0,0
CDMX PONIENTE PEDREGAL,2024-01-02,152,151,1,0.00657894736842105
CDMX PONIENTE PEDREGAL,2024-01-03,169,166,3,0.0177514792899408
CDMX PONIENTE PEDREGAL,2024-01-04,165,163,2,0.0121212121212121
CDMX PONIENTE PEDREGAL,2024-01-05,151,146,5,0.033112582781457
CDMX PONIENTE PEDREGAL,2024-01-06,159,156,3,0.0188679245283019
CDMX PONIENTE PEDREGAL,2024-01-07,133,130,3,0.0225563909774436
CDMX PONIENTE PEDREGAL,2024-01-08,169,164,5,0.029585798816568
CDMX PONIENTE PEDREGAL,2024-01-09,168,166,2,0.0119047619047619
CDMX PONIENTE PEDREGAL,2024-01-10,134,130,4,0.0298507462686567
CDMX PONIENTE PEDREGAL,2024-01-11,151,146,5,0.033112582781457
CDMX PONIENTE PEDREGAL,2024-01-12,172,169,3,0.0174418604651163
CDMX PONIENTE PEDREGAL,2024-01-13,186,178,8,0.043010752688172
CDMX PONIENTE PEDREGAL,2024-01-14,160,155,5,0.03125
CDMX PONIENTE PEDREGAL,2024-01-15,189,179,10,0.0529100529100529
CDMX PONIENTE PEDREGAL,2024-01-16,175,172,3,0.0171428571428571
CDMX PONIENTE PEDREGAL,2024-01-17,162,156,6,0.037037037037037
CDMX PONIENTE PEDREGAL,2024-01-18,164,159,5,0.0304878048780488
CDMX PONIENTE PEDREGAL,2024-01-19,153,149,4,0.0261437908496732
CDMX PONIENTE PEDREGAL,2024-01-20,154,147,7,0.0454545454545455
CDMX PONIENTE PEDREGAL,2024-01-21,124,122,2,0.0161290322580645
CDMX PONIENTE PEDREGAL,2024-01-22,182,173,9,0.0494505494505494
CDMX PONIENTE PEDREGAL,2024-01-23,155,154,1,0.00645161290322581
CDMX PONIENTE PEDREGAL,2024-01-24,164,159,5,0.0304878048780488
CDMX PONIENTE PEDREGAL,2024-01-25,159,154,5,0.0314465408805031
CDMX PONIENTE PEDREGAL,2024-01-26,183,179,4,0.0218579234972678
CDMX PONIENTE PEDREGAL,2024-01-27,182,178,4,0.021978021978022
CDMX PONIENTE PEDREGAL,2024-01-28,150,146,4,0.0266666666666667
CDMX PONIENTE PEDREGAL,2024-01-29,189,185,4,0.0211640211640212
CDMX PONIENTE PEDREGAL,2024-01-30,156,151,5,0.032051282051282
CDMX PONIENTE PEDREGAL,2024-01-31,179,176,3,0.0167597765363128
CDMX PONIENTE PEDREGAL,2024-02-01,150,146,4,0.0266666666666667
CDMX PONIENTE PEDREGAL,2024-02-02,165,162,3,0.0181818181818182
CDMX PONIENTE PEDREGAL,2024-02-03,181,179,2,0.0110497237569061
CDMX PONIENTE PEDREGAL,2024-02-04,152,149,3,0.0197368421052632
CDMX PONIENTE PEDREGAL,2024-02-05,146,141,5,0.0342465753424658
CDMX PONIENTE PEDREGAL,2024-02-06,165,159,6,0.0363636363636364
CDMX PONIENTE PEDREGAL,2024-02-07,170,162,8,0.0470588235294118
CDMX PONIENTE PEDREGAL,2024-02-08,140,138,2,0.0142857142857143
CDMX PONIENTE PEDREGAL,2024-02-09,167,164,3,0.0179640718562874
CDMX PONIENTE PEDREGAL,2024-02-10,192,188,4,0.0208333333333333
CDMX PONIENTE PEDREGAL,2024-02-11,138,135,3,0.0217391304347826
CDMX PONIENTE PEDREGAL,2024-02-12,137,126,11,0.0802919708029197
CDMX PONIENTE PEDREGAL,2024-02-13,154,153,1,0.00649350649350649
CDMX PONIENTE PEDREGAL,2024-02-14,167,162,5,0.029940119760479
CDMX PONIENTE PEDREGAL,2024-02-15,143,139,4,0.027972027972028
CDMX PONIENTE PEDREGAL,2024-02-16,169,168,1,0.00591715976331361
CDMX PONIENTE PEDREGAL,2024-02-17,181,181,0,0
CDMX PONIENTE PEDREGAL,2024-02-18,176,172,4,0.0227272727272727
CDMX PONIENTE PEDREGAL,2024-02-19,152,144,8,0.0526315789473684
CDMX PONIENTE PEDREGAL,2024-02-20,160,157,3,0.01875
CDMX PONIENTE PEDREGAL,2024-02-21,160,154,6,0.0375
CDMX PONIENTE PEDREGAL,2024-02-22,129,125,4,0.0310077519379845
CDMX PONIENTE PEDREGAL,2024-02-23,112,103,9,0.0803571428571429
CDMX PONIENTE PEDREGAL,2024-02-24,147,147,0,0
CDMX PONIENTE PEDREGAL,2024-02-25,143,142,1,0.00699300699300699
CDMX PONIENTE PEDREGAL,2024-02-26,169,164,5,0.029585798816568
CDMX PONIENTE PEDREGAL,2024-02-27,168,166,2,0.0119047619047619
CDMX PONIENTE PEDREGAL,2024-02-28,173,170,3,0.0173410404624277
CDMX PONIENTE PEDREGAL,2024-02-29,185,182,3,0.0162162162162162
CDMX PONIENTE PEDREGAL,2024-03-01,157,151,6,0.0382165605095541
CDMX PONIENTE PEDREGAL,2024-03-02,179,174,5,0.0279329608938547
CDMX PONIENTE PEDREGAL,2024-03-03,146,144,2,0.0136986301369863
CDMX PONIENTE PEDREGAL,2024-03-04,162,155,7,0.0432098765432099
CDMX PONIENTE PEDREGAL,2024-03-05,166,163,3,0.0180722891566265
CDMX PONIENTE PEDREGAL,2024-03-06,168,165,3,0.0178571428571429
CDMX PONIENTE PEDREGAL,2024-03-07,154,151,3,0.0194805194805195
CDMX PONIENTE PEDREGAL,2024-03-08,167,164,3,0.0179640718562874
CDMX PONIENTE PEDREGAL,2024-03-09,197,192,5,0.0253807106598985
CDMX PONIENTE PEDREGAL,2024-03-10,132,131,1,0.00757575757575758
CDMX PONIENTE PEDREGAL,2024-03-11,160,157,3,0.01875
CDMX PONIENTE PEDREGAL,2024-03-12,166,164,2,0.0120481927710843
CDMX PONIENTE PEDREGAL,2024-03-13,131,127,4,0.0305343511450382
CDMX PONIENTE PEDREGAL,2024-03-14,142,137,5,0.0352112676056338
CDMX PONIENTE PEDREGAL,2024-03-15,160,156,4,0.025
CDMX PONIENTE PEDREGAL,2024-03-16,185,179,6,0.0324324324324324
CDMX PONIENTE PEDREGAL,2024-03-17,140,137,3,0.0214285714285714
CDMX PONIENTE PEDREGAL,2024-03-18,144,139,5,0.0347222222222222
CDMX PONIENTE PEDREGAL,2024-03-19,140,138,2,0.0142857142857143
CDMX PONIENTE PEDREGAL,2024-03-20,134,128,6,0.0447761194029851
CDMX PONIENTE PEDREGAL,2024-03-21,144,143,1,0.00694444444444444
CDMX PONIENTE PEDREGAL,2024-03-22,142,139,3,0.0211267605633803
CDMX PONIENTE PEDREGAL,2024-03-23,144,141,3,0.0208333333333333
CDMX PONIENTE PEDREGAL,2024-03-24,118,109,9,0.076271186440678
CDMX PONIENTE PEDREGAL,2024-03-25,147,144,3,0.0204081632653061
CDMX PONIENTE PEDREGAL,2024-03-26,160,155,5,0.03125
CDMX PONIENTE PEDREGAL,2024-03-27,145,141,4,0.0275862068965517
CDMX PONIENTE PEDREGAL,2024-03-28,189,187,2,0.0105820105820106
CDMX PONIENTE PEDREGAL,2024-03-29,165,160,5,0.0303030303030303
CDMX PONIENTE PEDREGAL,2024-03-30,132,130,2,0.0151515151515152
CDMX PONIENTE PEDREGAL,2024-03-31,116,114,2,0.0172413793103448
CDMX PONIENTE PEDREGAL,2024-04-01,150,144,6,0.04
CDMX PONIENTE PEDREGAL,2024-04-02,162,155,7,0.0432098765432099
CDMX PONIENTE PEDREGAL,2024-04-03,156,156,0,0
CDMX PONIENTE PEDREGAL,2024-04-04,133,133,0,0
CDMX PONIENTE PEDREGAL,2024-04-05,126,123,3,0.0238095238095238
CDMX PONIENTE PEDREGAL,2024-04-06,146,145,1,0.00684931506849315
CDMX PONIENTE PEDREGAL,2024-04-07,124,122,2,0.0161290322580645
CDMX PONIENTE PEDREGAL,2024-04-08,120,115,5,0.0416666666666667
CDMX PONIENTE PEDREGAL,2024-04-09,134,133,1,0.00746268656716418
CDMX PONIENTE PEDREGAL,2024-04-10,131,128,3,0.0229007633587786
CDMX PONIENTE PEDREGAL,2024-04-11,133,131,2,0.0150375939849624
CDMX PONIENTE PEDREGAL,2024-04-12,121,116,5,0.0413223140495868
CDMX PONIENTE PEDREGAL,2024-04-13,151,145,6,0.0397350993377483
CDMX PONIENTE PEDREGAL,2024-04-14,132,131,1,0.00757575757575758
CDMX PONIENTE PEDREGAL,2024-04-15,149,146,3,0.0201342281879195
CDMX PONIENTE PEDREGAL,2024-04-16,148,136,12,0.0810810810810811
CDMX PONIENTE PEDREGAL,2024-04-17,141,134,7,0.049645390070922
CDMX PONIENTE PEDREGAL,2024-04-18,141,137,4,0.0283687943262411
CDMX PONIENTE PEDREGAL,2024-04-19,128,121,7,0.0546875
CDMX PONIENTE PEDREGAL,2024-04-20,145,142,3,0.0206896551724138
CDMX PONIENTE PEDREGAL,2024-04-21,132,130,2,0.0151515151515152
CDMX PONIENTE PEDREGAL,2024-04-22,67,61,6,0.0895522388059701
CDMX PONIENTE PEDREGAL,2024-04-23,156,146,10,0.0641025641025641
CDMX PONIENTE PEDREGAL,2024-04-24,124,121,3,0.0241935483870968
CDMX PONIENTE PEDREGAL,2024-04-25,132,128,4,0.0303030303030303
CDMX PONIENTE PEDREGAL,2024-04-26,145,140,5,0.0344827586206897
CDMX PONIENTE PEDREGAL,2024-04-27,142,137,5,0.0352112676056338
CDMX PONIENTE PEDREGAL,2024-04-28,137,135,2,0.0145985401459854
CDMX PONIENTE PEDREGAL,2024-04-29,132,127,5,0.0378787878787879
CDMX PONIENTE PEDREGAL,2024-04-30,155,148,7,0.0451612903225806
CDMX PONIENTE PEDREGAL,2024-05-01,133,130,3,0.0225563909774436
CDMX PONIENTE PEDREGAL,2024-05-02,155,143,12,0.0774193548387097
CDMX PONIENTE PEDREGAL,2024-05-03,149,141,8,0.0536912751677852
CDMX PONIENTE PEDREGAL,2024-05-04,153,149,4,0.0261437908496732
CDMX PONIENTE PEDREGAL,2024-05-05,128,122,6,0.046875
CDMX PONIENTE PEDREGAL,2024-05-06,132,132,0,0
CDMX PONIENTE PEDREGAL,2024-05-07,153,143,10,0.065359477124183
CDMX PONIENTE PEDREGAL,2024-05-08,122,121,1,0.00819672131147541
CDMX PONIENTE PEDREGAL,2024-05-09,123,122,1,0.00813008130081301
CDMX PONIENTE PEDREGAL,2024-05-10,85,81,4,0.0470588235294118
CDMX PONIENTE PEDREGAL,2024-05-11,161,159,2,0.0124223602484472
CDMX PONIENTE PEDREGAL,2024-05-12,109,107,2,0.018348623853211
CDMX PONIENTE PEDREGAL,2024-05-13,112,108,4,0.0357142857142857
CDMX PONIENTE PEDREGAL,2024-05-14,129,118,11,0.0852713178294574
CDMX PONIENTE PEDREGAL,2024-05-15,150,141,9,0.06
CDMX PONIENTE PEDREGAL,2024-05-16,167,144,23,0.137724550898204
CDMX PONIENTE PEDREGAL,2024-05-17,162,156,6,0.037037037037037
CDMX PONIENTE PEDREGAL,2024-05-18,159,154,5,0.0314465408805031
CDMX PONIENTE PEDREGAL,2024-05-19,109,107,2,0.018348623853211
CDMX PONIENTE PEDREGAL,2024-05-20,156,148,8,0.0512820512820513
CDMX PONIENTE PEDREGAL,2024-05-21,151,144,7,0.0463576158940397
CDMX PONIENTE PEDREGAL,2024-05-22,165,160,5,0.0303030303030303
CDMX PONIENTE PEDREGAL,2024-05-23,158,150,8,0.0506329113924051
CDMX PONIENTE PEDREGAL,2024-05-24,131,130,1,0.00763358778625954
CDMX PONIENTE PEDREGAL,2024-05-25,173,167,6,0.0346820809248555
CDMX PONIENTE PEDREGAL,2024-05-26,106,102,4,0.0377358490566038
CDMX PONIENTE PEDREGAL,2024-05-27,122,118,4,0.0327868852459016
CDMX PONIENTE PEDREGAL,2024-05-28,144,142,2,0.0138888888888889
CDMX PONIENTE PEDREGAL,2024-05-29,159,155,4,0.0251572327044025
CDMX PONIENTE PEDREGAL,2024-05-30,150,146,4,0.0266666666666667
CDMX PONIENTE PEDREGAL,2024-05-31,141,137,4,0.0283687943262411
CDMX PONIENTE PEDREGAL,2024-06-01,165,158,7,0.0424242424242424
CDMX PONIENTE PEDREGAL,2024-06-02,129,126,3,0.0232558139534884
CDMX PONIENTE PEDREGAL,2024-06-03,157,153,4,0.0254777070063694
CDMX PONIENTE PEDREGAL,2024-06-04,156,143,13,0.0833333333333333
CDMX PONIENTE PEDREGAL,2024-06-05,149,143,6,0.0402684563758389
CDMX PONIENTE PEDREGAL,2024-06-06,156,150,6,0.0384615384615385
CDMX PONIENTE PEDREGAL,2024-06-07,149,144,5,0.0335570469798658
CDMX PONIENTE PEDREGAL,2024-06-08,167,162,5,0.029940119760479
CDMX PONIENTE PEDREGAL,2024-06-09,118,117,1,0.00847457627118644
CDMX PONIENTE PEDREGAL,2024-06-10,128,125,3,0.0234375
CDMX PONIENTE PEDREGAL,2024-06-11,166,160,6,0.036144578313253
CDMX PONIENTE PEDREGAL,2024-06-12,143,141,2,0.013986013986014
CDMX PONIENTE PEDREGAL,2024-06-13,147,140,7,0.0476190476190476
CDMX PONIENTE PEDREGAL,2024-06-14,150,146,4,0.0266666666666667
CDMX PONIENTE PEDREGAL,2024-06-15,171,165,6,0.0350877192982456
CDMX PONIENTE PEDREGAL,2024-06-16,145,142,3,0.0206896551724138
CDMX PONIENTE PEDREGAL,2024-06-17,157,149,8,0.0509554140127389
CDMX PONIENTE PEDREGAL,2024-06-18,167,163,4,0.0239520958083832
CDMX PONIENTE PEDREGAL,2024-06-19,142,139,3,0.0211267605633803
CDMX PONIENTE PEDREGAL,2024-06-20,159,152,7,0.0440251572327044
CDMX PONIENTE PEDREGAL,2024-06-21,139,135,4,0.0287769784172662
CDMX PONIENTE PEDREGAL,2024-06-22,167,164,3,0.0179640718562874
CDMX PONIENTE PEDREGAL,2024-06-23,116,114,2,0.0172413793103448
CDMX PONIENTE PEDREGAL,2024-06-24,141,138,3,0.0212765957446809
CDMX PONIENTE PEDREGAL,2024-06-25,158,156,2,0.0126582278481013
CDMX PONIENTE PEDREGAL,2024-06-26,155,151,4,0.0258064516129032
CDMX PONIENTE PEDREGAL,2024-06-27,128,126,2,0.015625
CDMX PONIENTE PEDREGAL,2024-06-28,164,162,2,0.0121951219512195
CDMX PONIENTE PEDREGAL,2024-06-29,165,159,6,0.0363636363636364
CDMX PONIENTE PEDREGAL,2024-06-30,141,137,4,0.0283687943262411
CDMX PONIENTE PEDREGAL,2024-07-01,119,113,6,0.0504201680672269
CDMX PONIENTE PEDREGAL,2024-07-02,156,153,3,0.0192307692307692
CDMX SUR ORIENTE,2023-07-03,245,240,5,0.0204081632653061
CDMX SUR ORIENTE,2023-07-04,237,231,6,0.0253164556962025
CDMX SUR ORIENTE,2023-07-05,254,251,3,0.0118110236220472
CDMX SUR ORIENTE,2023-07-06,237,232,5,0.0210970464135021
CDMX SUR ORIENTE,2023-07-07,258,251,7,0.0271317829457364
CDMX SUR ORIENTE,2023-07-08,315,307,8,0.0253968253968254
CDMX SUR ORIENTE,2023-07-09,245,244,1,0.00408163265306122
CDMX SUR ORIENTE,2023-07-10,295,287,8,0.0271186440677966
CDMX SUR ORIENTE,2023-07-11,256,249,7,0.02734375
CDMX SUR ORIENTE,2023-07-12,254,248,6,0.0236220472440945
CDMX SUR ORIENTE,2023-07-13,243,233,10,0.0411522633744856
CDMX SUR ORIENTE,2023-07-14,252,246,6,0.0238095238095238
CDMX SUR ORIENTE,2023-07-15,326,321,5,0.0153374233128834
CDMX SUR ORIENTE,2023-07-16,294,287,7,0.0238095238095238
CDMX SUR ORIENTE,2023-07-17,312,308,4,0.0128205128205128
CDMX SUR ORIENTE,2023-07-18,285,281,4,0.0140350877192982
CDMX SUR ORIENTE,2023-07-19,250,242,8,0.032
CDMX SUR ORIENTE,2023-07-20,271,270,1,0.003690036900369
CDMX SUR ORIENTE,2023-07-21,268,264,4,0.0149253731343284
CDMX SUR ORIENTE,2023-07-22,309,302,7,0.0226537216828479
CDMX SUR ORIENTE,2023-07-23,252,249,3,0.0119047619047619
CDMX SUR ORIENTE,2023-07-24,240,236,4,0.0166666666666667
CDMX SUR ORIENTE,2023-07-25,281,276,5,0.0177935943060498
CDMX SUR ORIENTE,2023-07-26,309,308,1,0.00323624595469256
CDMX SUR ORIENTE,2023-07-27,284,280,4,0.0140845070422535
CDMX SUR ORIENTE,2023-07-28,294,288,6,0.0204081632653061
CDMX SUR ORIENTE,2023-07-29,325,323,2,0.00615384615384615
CDMX SUR ORIENTE,2023-07-30,366,360,6,0.0163934426229508
CDMX SUR ORIENTE,2023-07-31,399,393,6,0.0150375939849624
CDMX SUR ORIENTE,2023-08-01,308,299,9,0.0292207792207792
CDMX SUR ORIENTE,2023-08-02,238,229,9,0.0378151260504202
CDMX SUR ORIENTE,2023-08-03,248,241,7,0.0282258064516129
CDMX SUR ORIENTE,2023-08-04,275,270,5,0.0181818181818182
CDMX SUR ORIENTE,2023-08-05,336,324,12,0.0357142857142857
CDMX SUR ORIENTE,2023-08-06,284,273,11,0.0387323943661972
CDMX SUR ORIENTE,2023-08-07,275,267,8,0.0290909090909091
CDMX SUR ORIENTE,2023-08-08,247,239,8,0.0323886639676113
CDMX SUR ORIENTE,2023-08-09,278,270,8,0.0287769784172662
CDMX SUR ORIENTE,2023-08-10,254,247,7,0.0275590551181102
CDMX SUR ORIENTE,2023-08-11,269,266,3,0.0111524163568773
CDMX SUR ORIENTE,2023-08-12,277,271,6,0.0216606498194946
CDMX SUR ORIENTE,2023-08-13,324,310,14,0.0432098765432099
CDMX SUR ORIENTE,2023-08-14,286,277,9,0.0314685314685315
CDMX SUR ORIENTE,2023-08-15,313,307,6,0.0191693290734824
CDMX SUR ORIENTE,2023-08-16,326,313,13,0.0398773006134969
CDMX SUR ORIENTE,2023-08-17,268,262,6,0.0223880597014925
CDMX SUR ORIENTE,2023-08-18,276,271,5,0.0181159420289855
CDMX SUR ORIENTE,2023-08-19,298,292,6,0.0201342281879195
CDMX SUR ORIENTE,2023-08-20,264,258,6,0.0227272727272727
CDMX SUR ORIENTE,2023-08-21,240,240,0,0
CDMX SUR ORIENTE,2023-08-22,245,245,0,0
CDMX SUR ORIENTE,2023-08-23,264,264,0,0
CDMX SUR ORIENTE,2023-08-24,247,247,0,0
CDMX SUR ORIENTE,2023-08-25,315,315,0,0
CDMX SUR ORIENTE,2023-08-26,380,378,2,0.00526315789473684
CDMX SUR ORIENTE,2023-08-27,369,369,0,0
CDMX SUR ORIENTE,2023-08-28,309,309,0,0
CDMX SUR ORIENTE,2023-08-29,332,332,0,0
CDMX SUR ORIENTE,2023-08-30,330,329,1,0.00303030303030303
CDMX SUR ORIENTE,2023-08-31,302,300,2,0.00662251655629139
CDMX SUR ORIENTE,2023-09-01,278,277,1,0.00359712230215827
CDMX SUR ORIENTE,2023-09-02,291,291,0,0
CDMX SUR ORIENTE,2023-09-03,237,237,0,0
CDMX SUR ORIENTE,2023-09-04,247,246,1,0.00404858299595142
CDMX SUR ORIENTE,2023-09-05,256,255,1,0.00390625
CDMX SUR ORIENTE,2023-09-06,256,256,0,0
CDMX SUR ORIENTE,2023-09-07,289,288,1,0.00346020761245675
CDMX SUR ORIENTE,2023-09-08,225,224,1,0.00444444444444444
CDMX SUR ORIENTE,2023-09-09,293,293,0,0
CDMX SUR ORIENTE,2023-09-10,280,280,0,0
CDMX SUR ORIENTE,2023-09-11,218,218,0,0
CDMX SUR ORIENTE,2023-09-12,159,158,1,0.00628930817610063
CDMX SUR ORIENTE,2023-09-13,177,177,0,0
CDMX SUR ORIENTE,2023-09-14,193,191,2,0.0103626943005181
CDMX SUR ORIENTE,2023-09-15,167,166,1,0.00598802395209581
CDMX SUR ORIENTE,2023-09-16,243,240,3,0.0123456790123457
CDMX SUR ORIENTE,2023-09-17,294,293,1,0.00340136054421769
CDMX SUR ORIENTE,2023-09-18,238,238,0,0
CDMX SUR ORIENTE,2023-09-19,241,241,0,0
CDMX SUR ORIENTE,2023-09-20,166,165,1,0.00602409638554217
CDMX SUR ORIENTE,2023-09-21,265,264,1,0.00377358490566038
CDMX SUR ORIENTE,2023-09-22,300,299,1,0.00333333333333333
CDMX SUR ORIENTE,2023-09-23,300,300,0,0
CDMX SUR ORIENTE,2023-09-24,321,321,0,0
CDMX SUR ORIENTE,2023-09-25,288,288,0,0
CDMX SUR ORIENTE,2023-09-26,254,254,0,0
CDMX SUR ORIENTE,2023-09-27,250,249,1,0.004
CDMX SUR ORIENTE,2023-09-28,293,293,0,0
CDMX SUR ORIENTE,2023-09-29,367,367,0,0
CDMX SUR ORIENTE,2023-09-30,385,382,3,0.00779220779220779
CDMX SUR ORIENTE,2023-10-01,277,277,0,0
CDMX SUR ORIENTE,2023-10-02,250,250,0,0
CDMX SUR ORIENTE,2023-10-03,242,234,8,0.0330578512396694
CDMX SUR ORIENTE,2023-10-04,241,236,5,0.020746887966805
CDMX SUR ORIENTE,2023-10-05,244,237,7,0.0286885245901639
CDMX SUR ORIENTE,2023-10-06,258,253,5,0.0193798449612403
CDMX SUR ORIENTE,2023-10-07,294,289,5,0.0170068027210884
CDMX SUR ORIENTE,2023-10-08,293,283,10,0.0341296928327645
CDMX SUR ORIENTE,2023-10-09,259,252,7,0.027027027027027
CDMX SUR ORIENTE,2023-10-10,206,201,5,0.0242718446601942
CDMX SUR ORIENTE,2023-10-11,223,219,4,0.0179372197309417
CDMX SUR ORIENTE,2023-10-12,205,203,2,0.00975609756097561
CDMX SUR ORIENTE,2023-10-13,248,245,3,0.0120967741935484
CDMX SUR ORIENTE,2023-10-14,302,298,4,0.0132450331125828
CDMX SUR ORIENTE,2023-10-15,301,289,12,0.0398671096345515
CDMX SUR ORIENTE,2023-10-16,309,304,5,0.0161812297734628
CDMX SUR ORIENTE,2023-10-17,291,279,12,0.0412371134020619
CDMX SUR ORIENTE,2023-10-18,243,238,5,0.0205761316872428
CDMX SUR ORIENTE,2023-10-19,259,252,7,0.027027027027027
CDMX SUR ORIENTE,2023-10-20,265,259,6,0.0226415094339623
CDMX SUR ORIENTE,2023-10-21,327,317,10,0.0305810397553517
CDMX SUR ORIENTE,2023-10-22,328,315,13,0.0396341463414634
CDMX SUR ORIENTE,2023-10-23,295,287,8,0.0271186440677966
CDMX SUR ORIENTE,2023-10-24,247,238,9,0.0364372469635627
CDMX SUR ORIENTE,2023-10-25,238,231,7,0.0294117647058824
CDMX SUR ORIENTE,2023-10-26,213,206,7,0.0328638497652582
CDMX SUR ORIENTE,2023-10-27,228,223,5,0.0219298245614035
CDMX SUR ORIENTE,2023-10-28,301,296,5,0.0166112956810631
CDMX SUR ORIENTE,2023-10-29,280,275,5,0.0178571428571429
CDMX SUR ORIENTE,2023-10-30,257,249,8,0.0311284046692607
CDMX SUR ORIENTE,2023-10-31,360,350,10,0.0277777777777778
CDMX SUR ORIENTE,2023-11-01,240,233,7,0.0291666666666667
CDMX SUR ORIENTE,2023-11-02,252,247,5,0.0198412698412698
CDMX SUR ORIENTE,2023-11-03,221,217,4,0.0180995475113122
CDMX SUR ORIENTE,2023-11-04,327,317,10,0.0305810397553517
CDMX SUR ORIENTE,2023-11-05,337,326,11,0.0326409495548961
CDMX SUR ORIENTE,2023-11-06,299,292,7,0.0234113712374582
CDMX SUR ORIENTE,2023-11-07,317,307,10,0.0315457413249211
CDMX SUR ORIENTE,2023-11-08,306,297,9,0.0294117647058824
CDMX SUR ORIENTE,2023-11-09,300,294,6,0.02
CDMX SUR ORIENTE,2023-11-10,294,286,8,0.0272108843537415
CDMX SUR ORIENTE,2023-11-11,373,361,12,0.032171581769437
CDMX SUR ORIENTE,2023-11-12,332,328,4,0.0120481927710843
CDMX SUR ORIENTE,2023-11-13,314,298,16,0.0509554140127389
CDMX SUR ORIENTE,2023-11-14,348,338,10,0.028735632183908
CDMX SUR ORIENTE,2023-11-15,359,350,9,0.0250696378830084
CDMX SUR ORIENTE,2023-11-16,396,384,12,0.0303030303030303
CDMX SUR ORIENTE,2023-11-17,427,422,5,0.0117096018735363
CDMX SUR ORIENTE,2023-11-18,479,466,13,0.0271398747390397
CDMX SUR ORIENTE,2023-11-19,509,499,10,0.0196463654223969
CDMX SUR ORIENTE,2023-11-20,500,489,11,0.022
CDMX SUR ORIENTE,2023-11-21,384,370,14,0.0364583333333333
CDMX SUR ORIENTE,2023-11-22,334,325,9,0.0269461077844311
CDMX SUR ORIENTE,2023-11-23,317,308,9,0.028391167192429
CDMX SUR ORIENTE,2023-11-24,326,319,7,0.0214723926380368
CDMX SUR ORIENTE,2023-11-25,373,366,7,0.0187667560321716
CDMX SUR ORIENTE,2023-11-26,357,351,6,0.0168067226890756
CDMX SUR ORIENTE,2023-11-27,366,349,17,0.046448087431694
CDMX SUR ORIENTE,2023-11-28,388,376,12,0.0309278350515464
CDMX SUR ORIENTE,2023-11-29,372,354,18,0.0483870967741935
CDMX SUR ORIENTE,2023-11-30,439,423,16,0.0364464692482916
CDMX SUR ORIENTE,2023-12-01,332,322,10,0.0301204819277108
CDMX SUR ORIENTE,2023-12-02,404,385,19,0.047029702970297
CDMX SUR ORIENTE,2023-12-03,370,358,12,0.0324324324324324
CDMX SUR ORIENTE,2023-12-04,343,335,8,0.0233236151603499
CDMX SUR ORIENTE,2023-12-05,269,254,15,0.0557620817843866
CDMX SUR ORIENTE,2023-12-06,337,322,15,0.0445103857566766
CDMX SUR ORIENTE,2023-12-07,350,336,14,0.04
CDMX SUR ORIENTE,2023-12-08,233,225,8,0.0343347639484979
CDMX SUR ORIENTE,2023-12-09,376,366,10,0.0265957446808511
CDMX SUR ORIENTE,2023-12-10,376,364,12,0.0319148936170213
CDMX SUR ORIENTE,2023-12-11,299,290,9,0.0301003344481605
CDMX SUR ORIENTE,2023-12-12,318,304,14,0.0440251572327044
CDMX SUR ORIENTE,2023-12-13,267,259,8,0.0299625468164794
CDMX SUR ORIENTE,2023-12-14,200,194,6,0.03
CDMX SUR ORIENTE,2023-12-15,419,405,14,0.0334128878281623
CDMX SUR ORIENTE,2023-12-16,434,425,9,0.0207373271889401
CDMX SUR ORIENTE,2023-12-17,340,328,12,0.0352941176470588
CDMX SUR ORIENTE,2023-12-18,366,356,10,0.0273224043715847
CDMX SUR ORIENTE,2023-12-19,347,341,6,0.0172910662824208
CDMX SUR ORIENTE,2023-12-20,322,312,10,0.031055900621118
CDMX SUR ORIENTE,2023-12-21,335,327,8,0.0238805970149254
CDMX SUR ORIENTE,2023-12-22,312,302,10,0.032051282051282
CDMX SUR ORIENTE,2023-12-23,344,330,14,0.0406976744186047
CDMX SUR ORIENTE,2023-12-24,253,245,8,0.0316205533596838
CDMX SUR ORIENTE,2023-12-25,93,89,4,0.043010752688172
CDMX SUR ORIENTE,2023-12-26,286,272,14,0.048951048951049
CDMX SUR ORIENTE,2023-12-27,352,345,7,0.0198863636363636
CDMX SUR ORIENTE,2023-12-28,366,358,8,0.0218579234972678
CDMX SUR ORIENTE,2023-12-29,367,352,15,0.0408719346049046
CDMX SUR ORIENTE,2023-12-30,347,336,11,0.031700288184438
CDMX SUR ORIENTE,2023-12-31,236,228,8,0.0338983050847458
CDMX SUR ORIENTE,2024-01-01,67,62,5,0.0746268656716418
CDMX SUR ORIENTE,2024-01-02,263,257,6,0.0228136882129278
CDMX SUR ORIENTE,2024-01-03,311,307,4,0.0128617363344051
CDMX SUR ORIENTE,2024-01-04,255,244,11,0.0431372549019608
CDMX SUR ORIENTE,2024-01-05,340,331,9,0.0264705882352941
CDMX SUR ORIENTE,2024-01-06,301,290,11,0.0365448504983389
CDMX SUR ORIENTE,2024-01-07,332,326,6,0.0180722891566265
CDMX SUR ORIENTE,2024-01-08,325,314,11,0.0338461538461538
CDMX SUR ORIENTE,2024-01-09,342,332,10,0.0292397660818713
CDMX SUR ORIENTE,2024-01-10,324,317,7,0.0216049382716049
CDMX SUR ORIENTE,2024-01-11,335,331,4,0.0119402985074627
CDMX SUR ORIENTE,2024-01-12,345,335,10,0.0289855072463768
CDMX SUR ORIENTE,2024-01-13,393,379,14,0.0356234096692112
CDMX SUR ORIENTE,2024-01-14,363,348,15,0.0413223140495868
CDMX SUR ORIENTE,2024-01-15,382,374,8,0.0209424083769634
CDMX SUR ORIENTE,2024-01-16,377,367,10,0.026525198938992
CDMX SUR ORIENTE,2024-01-17,305,294,11,0.0360655737704918
CDMX SUR ORIENTE,2024-01-18,355,349,6,0.0169014084507042
CDMX SUR ORIENTE,2024-01-19,301,298,3,0.00996677740863787
CDMX SUR ORIENTE,2024-01-20,340,332,8,0.0235294117647059
CDMX SUR ORIENTE,2024-01-21,333,324,9,0.027027027027027
CDMX SUR ORIENTE,2024-01-22,322,313,9,0.0279503105590062
CDMX SUR ORIENTE,2024-01-23,296,285,11,0.0371621621621622
CDMX SUR ORIENTE,2024-01-24,297,285,12,0.0404040404040404
CDMX SUR ORIENTE,2024-01-25,287,282,5,0.0174216027874564
CDMX SUR ORIENTE,2024-01-26,288,276,12,0.0416666666666667
CDMX SUR ORIENTE,2024-01-27,364,359,5,0.0137362637362637
CDMX SUR ORIENTE,2024-01-28,301,289,12,0.0398671096345515
CDMX SUR ORIENTE,2024-01-29,321,313,8,0.0249221183800623
CDMX SUR ORIENTE,2024-01-30,323,309,14,0.043343653250774
CDMX SUR ORIENTE,2024-01-31,396,386,10,0.0252525252525253
CDMX SUR ORIENTE,2024-02-01,319,309,10,0.0313479623824451
CDMX SUR ORIENTE,2024-02-02,287,284,3,0.0104529616724739
CDMX SUR ORIENTE,2024-02-03,340,332,8,0.0235294117647059
CDMX SUR ORIENTE,2024-02-04,313,307,6,0.0191693290734824
CDMX SUR ORIENTE,2024-02-05,315,304,11,0.0349206349206349
CDMX SUR ORIENTE,2024-02-06,334,321,13,0.0389221556886228
CDMX SUR ORIENTE,2024-02-07,262,252,10,0.0381679389312977
CDMX SUR ORIENTE,2024-02-08,290,280,10,0.0344827586206897
CDMX SUR ORIENTE,2024-02-09,269,264,5,0.0185873605947955
CDMX SUR ORIENTE,2024-02-10,333,325,8,0.024024024024024
CDMX SUR ORIENTE,2024-02-11,278,268,10,0.0359712230215827
CDMX SUR ORIENTE,2024-02-12,265,256,9,0.0339622641509434
CDMX SUR ORIENTE,2024-02-13,298,290,8,0.0268456375838926
CDMX SUR ORIENTE,2024-02-14,257,248,9,0.0350194552529183
CDMX SUR ORIENTE,2024-02-15,259,254,5,0.0193050193050193
CDMX SUR ORIENTE,2024-02-16,330,323,7,0.0212121212121212
CDMX SUR ORIENTE,2024-02-17,383,376,7,0.0182767624020888
CDMX SUR ORIENTE,2024-02-18,382,375,7,0.0183246073298429
CDMX SUR ORIENTE,2024-02-19,341,336,5,0.0146627565982405
CDMX SUR ORIENTE,2024-02-20,288,282,6,0.0208333333333333
CDMX SUR ORIENTE,2024-02-21,358,350,8,0.0223463687150838
CDMX SUR ORIENTE,2024-02-22,298,293,5,0.0167785234899329
CDMX SUR ORIENTE,2024-02-23,241,218,23,0.0954356846473029
CDMX SUR ORIENTE,2024-02-24,394,383,11,0.0279187817258883
CDMX SUR ORIENTE,2024-02-25,337,330,7,0.0207715133531157
CDMX SUR ORIENTE,2024-02-26,308,299,9,0.0292207792207792
CDMX SUR ORIENTE,2024-02-27,351,342,9,0.0256410256410256
CDMX SUR ORIENTE,2024-02-28,316,310,6,0.0189873417721519
CDMX SUR ORIENTE,2024-02-29,382,378,4,0.0104712041884817
CDMX SUR ORIENTE,2024-03-01,295,288,7,0.023728813559322
CDMX SUR ORIENTE,2024-03-02,360,356,4,0.0111111111111111
CDMX SUR ORIENTE,2024-03-03,335,329,6,0.017910447761194
CDMX SUR ORIENTE,2024-03-04,289,282,7,0.0242214532871972
CDMX SUR ORIENTE,2024-03-05,306,298,8,0.0261437908496732
CDMX SUR ORIENTE,2024-03-06,298,292,6,0.0201342281879195
CDMX SUR ORIENTE,2024-03-07,239,237,2,0.00836820083682008
CDMX SUR ORIENTE,2024-03-08,273,263,10,0.0366300366300366
CDMX SUR ORIENTE,2024-03-09,339,335,4,0.0117994100294985
CDMX SUR ORIENTE,2024-03-10,325,320,5,0.0153846153846154
CDMX SUR ORIENTE,2024-03-11,298,292,6,0.0201342281879195
CDMX SUR ORIENTE,2024-03-12,262,257,5,0.0190839694656489
CDMX SUR ORIENTE,2024-03-13,250,240,10,0.04
CDMX SUR ORIENTE,2024-03-14,230,227,3,0.0130434782608696
CDMX SUR ORIENTE,2024-03-15,304,295,9,0.0296052631578947
CDMX SUR ORIENTE,2024-03-16,395,387,8,0.020253164556962
CDMX SUR ORIENTE,2024-03-17,310,304,6,0.0193548387096774
CDMX SUR ORIENTE,2024-03-18,377,360,17,0.0450928381962865
CDMX SUR ORIENTE,2024-03-19,269,268,1,0.00371747211895911
CDMX SUR ORIENTE,2024-03-20,241,235,6,0.024896265560166
CDMX SUR ORIENTE,2024-03-21,210,205,5,0.0238095238095238
CDMX SUR ORIENTE,2024-03-22,265,255,10,0.0377358490566038
CDMX SUR ORIENTE,2024-03-23,330,327,3,0.00909090909090909
CDMX SUR ORIENTE,2024-03-24,232,227,5,0.021551724137931
CDMX SUR ORIENTE,2024-03-25,275,268,7,0.0254545454545455
CDMX SUR ORIENTE,2024-03-26,306,303,3,0.00980392156862745
CDMX SUR ORIENTE,2024-03-27,292,278,14,0.0479452054794521
CDMX SUR ORIENTE,2024-03-28,342,338,4,0.0116959064327485
CDMX SUR ORIENTE,2024-03-29,309,299,10,0.0323624595469256
CDMX SUR ORIENTE,2024-03-30,338,331,7,0.0207100591715976
CDMX SUR ORIENTE,2024-03-31,360,349,11,0.0305555555555556
CDMX SUR ORIENTE,2024-04-01,299,287,12,0.040133779264214
CDMX SUR ORIENTE,2024-04-02,246,238,8,0.032520325203252
CDMX SUR ORIENTE,2024-04-03,289,289,0,0
CDMX SUR ORIENTE,2024-04-04,272,272,0,0
CDMX SUR ORIENTE,2024-04-05,260,249,11,0.0423076923076923
CDMX SUR ORIENTE,2024-04-06,300,297,3,0.01
CDMX SUR ORIENTE,2024-04-07,236,228,8,0.0338983050847458
CDMX SUR ORIENTE,2024-04-08,251,243,8,0.0318725099601594
CDMX SUR ORIENTE,2024-04-09,215,207,8,0.0372093023255814
CDMX SUR ORIENTE,2024-04-10,254,244,10,0.0393700787401575
CDMX SUR ORIENTE,2024-04-11,224,221,3,0.0133928571428571
CDMX SUR ORIENTE,2024-04-12,270,264,6,0.0222222222222222
CDMX SUR ORIENTE,2024-04-13,324,318,6,0.0185185185185185
CDMX SUR ORIENTE,2024-04-14,299,290,9,0.0301003344481605
CDMX SUR ORIENTE,2024-04-15,313,305,8,0.0255591054313099
CDMX SUR ORIENTE,2024-04-16,339,318,21,0.0619469026548673
CDMX SUR ORIENTE,2024-04-17,264,251,13,0.0492424242424242
CDMX SUR ORIENTE,2024-04-18,248,243,5,0.0201612903225806
CDMX SUR ORIENTE,2024-04-19,235,217,18,0.0765957446808511
CDMX SUR ORIENTE,2024-04-20,309,295,14,0.0453074433656958
CDMX SUR ORIENTE,2024-04-21,279,268,11,0.039426523297491
CDMX SUR ORIENTE,2024-04-22,176,166,10,0.0568181818181818
CDMX SUR ORIENTE,2024-04-23,317,294,23,0.0725552050473186
CDMX SUR ORIENTE,2024-04-24,248,239,9,0.0362903225806452
CDMX SUR ORIENTE,2024-04-25,226,219,7,0.0309734513274336
CDMX SUR ORIENTE,2024-04-26,260,248,12,0.0461538461538462
CDMX SUR ORIENTE,2024-04-27,327,304,23,0.0703363914373089
CDMX SUR ORIENTE,2024-04-28,265,257,8,0.030188679245283
CDMX SUR ORIENTE,2024-04-29,297,289,8,0.0269360269360269
CDMX SUR ORIENTE,2024-04-30,340,323,17,0.05
CDMX SUR ORIENTE,2024-05-01,263,259,4,0.0152091254752852
CDMX SUR ORIENTE,2024-05-02,254,244,10,0.0393700787401575
CDMX SUR ORIENTE,2024-05-03,233,220,13,0.055793991416309
CDMX SUR ORIENTE,2024-05-04,281,271,10,0.0355871886120996
CDMX SUR ORIENTE,2024-05-05,252,248,4,0.0158730158730159
CDMX SUR ORIENTE,2024-05-06,271,271,0,0
CDMX SUR ORIENTE,2024-05-07,270,264,6,0.0222222222222222
CDMX SUR ORIENTE,2024-05-08,232,214,18,0.0775862068965517
CDMX SUR ORIENTE,2024-05-09,215,205,10,0.0465116279069767
CDMX SUR ORIENTE,2024-05-10,214,206,8,0.0373831775700935
CDMX SUR ORIENTE,2024-05-11,253,244,9,0.0355731225296443
CDMX SUR ORIENTE,2024-05-12,241,227,14,0.0580912863070539
CDMX SUR ORIENTE,2024-05-13,275,259,16,0.0581818181818182
CDMX SUR ORIENTE,2024-05-14,287,269,18,0.0627177700348432
CDMX SUR ORIENTE,2024-05-15,339,325,14,0.0412979351032448
CDMX SUR ORIENTE,2024-05-16,275,240,35,0.127272727272727
CDMX SUR ORIENTE,2024-05-17,299,292,7,0.0234113712374582
CDMX SUR ORIENTE,2024-05-18,324,312,12,0.037037037037037
CDMX SUR ORIENTE,2024-05-19,324,315,9,0.0277777777777778
CDMX SUR ORIENTE,2024-05-20,310,301,9,0.0290322580645161
CDMX SUR ORIENTE,2024-05-21,284,275,9,0.0316901408450704
CDMX SUR ORIENTE,2024-05-22,265,253,12,0.0452830188679245
CDMX SUR ORIENTE,2024-05-23,277,267,10,0.036101083032491
CDMX SUR ORIENTE,2024-05-24,253,246,7,0.0276679841897233
CDMX SUR ORIENTE,2024-05-25,317,310,7,0.0220820189274448
CDMX SUR ORIENTE,2024-05-26,257,247,10,0.0389105058365759
CDMX SUR ORIENTE,2024-05-27,252,243,9,0.0357142857142857
CDMX SUR ORIENTE,2024-05-28,272,267,5,0.0183823529411765
CDMX SUR ORIENTE,2024-05-29,273,265,8,0.0293040293040293
CDMX SUR ORIENTE,2024-05-30,295,287,8,0.0271186440677966
CDMX SUR ORIENTE,2024-05-31,353,341,12,0.0339943342776204
CDMX SUR ORIENTE,2024-06-01,325,312,13,0.04
CDMX SUR ORIENTE,2024-06-02,283,279,4,0.0141342756183746
CDMX SUR ORIENTE,2024-06-03,306,303,3,0.00980392156862745
CDMX SUR ORIENTE,2024-06-04,324,299,25,0.0771604938271605
CDMX SUR ORIENTE,2024-06-05,263,246,17,0.064638783269962
CDMX SUR ORIENTE,2024-06-06,238,228,10,0.0420168067226891
CDMX SUR ORIENTE,2024-06-07,247,237,10,0.0404858299595142
CDMX SUR ORIENTE,2024-06-08,330,322,8,0.0242424242424242
CDMX SUR ORIENTE,2024-06-09,327,316,11,0.0336391437308868
CDMX SUR ORIENTE,2024-06-10,295,285,10,0.0338983050847458
CDMX SUR ORIENTE,2024-06-11,252,246,6,0.0238095238095238
CDMX SUR ORIENTE,2024-06-12,230,225,5,0.0217391304347826
CDMX SUR ORIENTE,2024-06-13,247,234,13,0.0526315789473684
CDMX SUR ORIENTE,2024-06-14,280,270,10,0.0357142857142857
CDMX SUR ORIENTE,2024-06-15,383,372,11,0.0287206266318538
CDMX SUR ORIENTE,2024-06-16,302,291,11,0.0364238410596026
CDMX SUR ORIENTE,2024-06-17,311,299,12,0.0385852090032154
CDMX SUR ORIENTE,2024-06-18,330,317,13,0.0393939393939394
CDMX SUR ORIENTE,2024-06-19,267,256,11,0.0411985018726592
CDMX SUR ORIENTE,2024-06-20,297,285,12,0.0404040404040404
CDMX SUR ORIENTE,2024-06-21,325,320,5,0.0153846153846154
CDMX SUR ORIENTE,2024-06-22,322,305,17,0.0527950310559006
CDMX SUR ORIENTE,2024-06-23,319,308,11,0.0344827586206897
CDMX SUR ORIENTE,2024-06-24,298,288,10,0.0335570469798658
CDMX SUR ORIENTE,2024-06-25,292,284,8,0.0273972602739726
CDMX SUR ORIENTE,2024-06-26,279,268,11,0.039426523297491
CDMX SUR ORIENTE,2024-06-27,263,248,15,0.0570342205323194
CDMX SUR ORIENTE,2024-06-28,307,297,10,0.0325732899022801
CDMX SUR ORIENTE,2024-06-29,413,397,16,0.0387409200968523
CDMX SUR ORIENTE,2024-06-30,447,427,20,0.0447427293064877
CDMX SUR ORIENTE,2024-07-01,260,248,12,0.0461538461538462
CDMX SUR ORIENTE,2024-07-02,308,302,6,0.0194805194805195
FRONTERA,2023-07-03,254,248,6,0.0236220472440945
FRONTERA,2023-07-04,314,305,9,0.0286624203821656
FRONTERA,2023-07-05,249,242,7,0.0281124497991968
FRONTERA,2023-07-06,236,232,4,0.0169491525423729
FRONTERA,2023-07-07,292,288,4,0.0136986301369863
FRONTERA,2023-07-08,247,240,7,0.0283400809716599
FRONTERA,2023-07-09,211,210,1,0.004739336492891
FRONTERA,2023-07-10,249,242,7,0.0281124497991968
FRONTERA,2023-07-11,264,258,6,0.0227272727272727
FRONTERA,2023-07-12,267,261,6,0.0224719101123595
FRONTERA,2023-07-13,262,258,4,0.0152671755725191
FRONTERA,2023-07-14,260,257,3,0.0115384615384615
FRONTERA,2023-07-15,288,280,8,0.0277777777777778
FRONTERA,2023-07-16,192,192,0,0
FRONTERA,2023-07-17,274,269,5,0.0182481751824818
FRONTERA,2023-07-18,259,257,2,0.00772200772200772
FRONTERA,2023-07-19,263,259,4,0.0152091254752852
FRONTERA,2023-07-20,260,257,3,0.0115384615384615
FRONTERA,2023-07-21,291,288,3,0.0103092783505155
FRONTERA,2023-07-22,287,284,3,0.0104529616724739
FRONTERA,2023-07-23,189,189,0,0
FRONTERA,2023-07-24,244,240,4,0.0163934426229508
FRONTERA,2023-07-25,259,254,5,0.0193050193050193
FRONTERA,2023-07-26,270,264,6,0.0222222222222222
FRONTERA,2023-07-27,257,253,4,0.0155642023346304
FRONTERA,2023-07-28,282,279,3,0.0106382978723404
FRONTERA,2023-07-29,286,283,3,0.0104895104895105
FRONTERA,2023-07-30,219,217,2,0.0091324200913242
FRONTERA,2023-07-31,241,237,4,0.016597510373444
FRONTERA,2023-08-01,239,234,5,0.0209205020920502
FRONTERA,2023-08-02,307,302,5,0.0162866449511401
FRONTERA,2023-08-03,221,185,36,0.16289592760181
FRONTERA,2023-08-04,248,242,6,0.0241935483870968
FRONTERA,2023-08-05,212,210,2,0.00943396226415094
FRONTERA,2023-08-06,186,182,4,0.021505376344086
FRONTERA,2023-08-07,262,255,7,0.0267175572519084
FRONTERA,2023-08-08,258,254,4,0.0155038759689922
FRONTERA,2023-08-09,240,237,3,0.0125
FRONTERA,2023-08-10,216,211,5,0.0231481481481481
FRONTERA,2023-08-11,250,249,1,0.004
FRONTERA,2023-08-12,257,250,7,0.0272373540856031
FRONTERA,2023-08-13,186,185,1,0.00537634408602151
FRONTERA,2023-08-14,220,219,1,0.00454545454545455
FRONTERA,2023-08-15,224,220,4,0.0178571428571429
FRONTERA,2023-08-16,249,246,3,0.0120481927710843
FRONTERA,2023-08-17,248,239,9,0.0362903225806452
FRONTERA,2023-08-18,255,253,2,0.00784313725490196
FRONTERA,2023-08-19,311,286,25,0.0803858520900322
FRONTERA,2023-08-20,240,225,15,0.0625
FRONTERA,2023-08-21,233,220,13,0.055793991416309
FRONTERA,2023-08-22,192,179,13,0.0677083333333333
FRONTERA,2023-08-23,255,226,29,0.113725490196078
FRONTERA,2023-08-24,249,228,21,0.0843373493975904
FRONTERA,2023-08-25,304,271,33,0.108552631578947
FRONTERA,2023-08-26,329,307,22,0.0668693009118541
FRONTERA,2023-08-27,276,256,20,0.072463768115942
FRONTERA,2023-08-28,241,227,14,0.0580912863070539
FRONTERA,2023-08-29,238,229,9,0.0378151260504202
FRONTERA,2023-08-30,224,219,5,0.0223214285714286
FRONTERA,2023-08-31,224,221,3,0.0133928571428571
FRONTERA,2023-09-01,221,217,4,0.0180995475113122
FRONTERA,2023-09-02,229,226,3,0.0131004366812227
FRONTERA,2023-09-03,236,231,5,0.0211864406779661
FRONTERA,2023-09-04,242,241,1,0.00413223140495868
FRONTERA,2023-09-05,257,256,1,0.00389105058365759
FRONTERA,2023-09-06,271,269,2,0.00738007380073801
FRONTERA,2023-09-07,221,221,0,0
FRONTERA,2023-09-08,226,224,2,0.00884955752212389
FRONTERA,2023-09-09,248,242,6,0.0241935483870968
FRONTERA,2023-09-10,219,218,1,0.0045662100456621
FRONTERA,2023-09-11,222,221,1,0.0045045045045045
FRONTERA,2023-09-12,243,240,3,0.0123456790123457
FRONTERA,2023-09-13,263,261,2,0.00760456273764259
FRONTERA,2023-09-14,240,237,3,0.0125
FRONTERA,2023-09-15,244,242,2,0.00819672131147541
FRONTERA,2023-09-16,178,177,1,0.00561797752808989
FRONTERA,2023-09-17,200,197,3,0.015
FRONTERA,2023-09-18,234,233,1,0.00427350427350427
FRONTERA,2023-09-19,190,188,2,0.0105263157894737
FRONTERA,2023-09-20,155,155,0,0
FRONTERA,2023-09-21,175,169,6,0.0342857142857143
FRONTERA,2023-09-22,177,174,3,0.0169491525423729
FRONTERA,2023-09-23,226,223,3,0.0132743362831858
FRONTERA,2023-09-24,203,200,3,0.0147783251231527
FRONTERA,2023-09-25,198,195,3,0.0151515151515152
FRONTERA,2023-09-26,194,191,3,0.0154639175257732
FRONTERA,2023-09-27,232,227,5,0.021551724137931
FRONTERA,2023-09-28,258,255,3,0.0116279069767442
FRONTERA,2023-09-29,237,235,2,0.00843881856540084
FRONTERA,2023-09-30,241,240,1,0.004149377593361
FRONTERA,2023-10-01,169,168,1,0.00591715976331361
FRONTERA,2023-10-02,202,201,1,0.00495049504950495
FRONTERA,2023-10-03,209,208,1,0.00478468899521531
FRONTERA,2023-10-04,209,204,5,0.0239234449760766
FRONTERA,2023-10-05,168,166,2,0.0119047619047619
FRONTERA,2023-10-06,194,192,2,0.0103092783505155
FRONTERA,2023-10-07,247,241,6,0.0242914979757085
FRONTERA,2023-10-08,193,189,4,0.0207253886010363
FRONTERA,2023-10-09,186,185,1,0.00537634408602151
FRONTERA,2023-10-10,209,209,0,0
FRONTERA,2023-10-11,243,236,7,0.0288065843621399
FRONTERA,2023-10-12,198,192,6,0.0303030303030303
FRONTERA,2023-10-13,174,170,4,0.0229885057471264
FRONTERA,2023-10-14,255,250,5,0.0196078431372549
FRONTERA,2023-10-15,197,191,6,0.0304568527918782
FRONTERA,2023-10-16,205,202,3,0.0146341463414634
FRONTERA,2023-10-17,231,227,4,0.0173160173160173
FRONTERA,2023-10-18,215,211,4,0.0186046511627907
FRONTERA,2023-10-19,227,224,3,0.013215859030837
FRONTERA,2023-10-20,208,204,4,0.0192307692307692
FRONTERA,2023-10-21,236,234,2,0.00847457627118644
FRONTERA,2023-10-22,188,186,2,0.0106382978723404
FRONTERA,2023-10-23,189,184,5,0.0264550264550265
FRONTERA,2023-10-24,221,217,4,0.0180995475113122
FRONTERA,2023-10-25,225,219,6,0.0266666666666667
FRONTERA,2023-10-26,225,219,6,0.0266666666666667
FRONTERA,2023-10-27,208,203,5,0.0240384615384615
FRONTERA,2023-10-28,233,230,3,0.0128755364806867
FRONTERA,2023-10-29,155,152,3,0.0193548387096774
FRONTERA,2023-10-30,187,184,3,0.0160427807486631
FRONTERA,2023-10-31,190,189,1,0.00526315789473684
FRONTERA,2023-11-01,247,244,3,0.0121457489878543
FRONTERA,2023-11-02,207,205,2,0.00966183574879227
FRONTERA,2023-11-03,248,245,3,0.0120967741935484
FRONTERA,2023-11-04,259,255,4,0.0154440154440154
FRONTERA,2023-11-05,190,188,2,0.0105263157894737
FRONTERA,2023-11-06,258,256,2,0.00775193798449612
FRONTERA,2023-11-07,270,268,2,0.00740740740740741
FRONTERA,2023-11-08,223,221,2,0.00896860986547085
FRONTERA,2023-11-09,244,241,3,0.0122950819672131
FRONTERA,2023-11-10,245,242,3,0.0122448979591837
FRONTERA,2023-11-11,247,242,5,0.0202429149797571
FRONTERA,2023-11-12,175,172,3,0.0171428571428571
FRONTERA,2023-11-13,249,245,4,0.0160642570281124
FRONTERA,2023-11-14,306,301,5,0.0163398692810458
FRONTERA,2023-11-15,250,245,5,0.02
FRONTERA,2023-11-16,231,223,8,0.0346320346320346
FRONTERA,2023-11-17,287,284,3,0.0104529616724739
FRONTERA,2023-11-18,330,326,4,0.0121212121212121
FRONTERA,2023-11-19,278,273,5,0.0179856115107914
FRONTERA,2023-11-20,242,237,5,0.0206611570247934
FRONTERA,2023-11-21,297,293,4,0.0134680134680135
FRONTERA,2023-11-22,285,282,3,0.0105263157894737
FRONTERA,2023-11-23,298,295,3,0.0100671140939597
FRONTERA,2023-11-24,286,286,0,0
FRONTERA,2023-11-25,296,291,5,0.0168918918918919
FRONTERA,2023-11-26,264,262,2,0.00757575757575758
FRONTERA,2023-11-27,289,288,1,0.00346020761245675
FRONTERA,2023-11-28,320,319,1,0.003125
FRONTERA,2023-11-29,315,307,8,0.0253968253968254
FRONTERA,2023-11-30,320,318,2,0.00625
FRONTERA,2023-12-01,286,283,3,0.0104895104895105
FRONTERA,2023-12-02,309,304,5,0.0161812297734628
FRONTERA,2023-12-03,257,253,4,0.0155642023346304
FRONTERA,2023-12-04,300,295,5,0.0166666666666667
FRONTERA,2023-12-05,292,287,5,0.0171232876712329
FRONTERA,2023-12-06,311,305,6,0.0192926045016077
FRONTERA,2023-12-07,299,295,4,0.0133779264214047
FRONTERA,2023-12-08,361,354,7,0.0193905817174515
FRONTERA,2023-12-09,314,311,3,0.00955414012738853
FRONTERA,2023-12-10,267,260,7,0.0262172284644195
FRONTERA,2023-12-11,248,247,1,0.00403225806451613
FRONTERA,2023-12-12,259,250,9,0.0347490347490347
FRONTERA,2023-12-13,260,260,0,0
FRONTERA,2023-12-14,241,239,2,0.00829875518672199
FRONTERA,2023-12-15,225,220,5,0.0222222222222222
FRONTERA,2023-12-16,282,279,3,0.0106382978723404
FRONTERA,2023-12-17,230,226,4,0.0173913043478261
FRONTERA,2023-12-18,287,283,4,0.0139372822299652
FRONTERA,2023-12-19,317,311,6,0.0189274447949527
FRONTERA,2023-12-20,347,338,9,0.0259365994236311
FRONTERA,2023-12-21,296,289,7,0.0236486486486486
FRONTERA,2023-12-22,324,317,7,0.0216049382716049
FRONTERA,2023-12-23,299,295,4,0.0133779264214047
FRONTERA,2023-12-24,182,182,0,0
FRONTERA,2023-12-25,70,70,0,0
FRONTERA,2023-12-26,267,265,2,0.00749063670411985
FRONTERA,2023-12-27,324,318,6,0.0185185185185185
FRONTERA,2023-12-28,317,313,4,0.0126182965299685
FRONTERA,2023-12-29,328,323,5,0.0152439024390244
FRONTERA,2023-12-30,323,318,5,0.0154798761609907
FRONTERA,2023-12-31,156,152,4,0.0256410256410256
FRONTERA,2024-01-01,32,32,0,0
FRONTERA,2024-01-02,226,222,4,0.0176991150442478
FRONTERA,2024-01-03,338,333,5,0.014792899408284
FRONTERA,2024-01-04,295,292,3,0.0101694915254237
FRONTERA,2024-01-05,310,307,3,0.00967741935483871
FRONTERA,2024-01-06,325,317,8,0.0246153846153846
FRONTERA,2024-01-07,251,246,5,0.0199203187250996
FRONTERA,2024-01-08,273,268,5,0.0183150183150183
FRONTERA,2024-01-09,276,272,4,0.0144927536231884
FRONTERA,2024-01-10,263,259,4,0.0152091254752852
FRONTERA,2024-01-11,229,227,2,0.00873362445414847
FRONTERA,2024-01-12,281,276,5,0.0177935943060498
FRONTERA,2024-01-13,277,275,2,0.0072202166064982
FRONTERA,2024-01-14,223,222,1,0.00448430493273543
FRONTERA,2024-01-15,269,260,9,0.033457249070632
FRONTERA,2024-01-16,278,275,3,0.0107913669064748
FRONTERA,2024-01-17,305,298,7,0.0229508196721311
FRONTERA,2024-01-18,295,291,4,0.0135593220338983
FRONTERA,2024-01-19,281,277,4,0.0142348754448399
FRONTERA,2024-01-20,275,272,3,0.0109090909090909
FRONTERA,2024-01-21,239,237,2,0.00836820083682008
FRONTERA,2024-01-22,300,294,6,0.02
FRONTERA,2024-01-23,279,274,5,0.017921146953405
FRONTERA,2024-01-24,273,269,4,0.0146520146520147
FRONTERA,2024-01-25,282,280,2,0.00709219858156028
FRONTERA,2024-01-26,315,310,5,0.0158730158730159
FRONTERA,2024-01-27,314,308,6,0.0191082802547771
FRONTERA,2024-01-28,238,236,2,0.00840336134453781
FRONTERA,2024-01-29,274,271,3,0.0109489051094891
FRONTERA,2024-01-30,226,221,5,0.0221238938053097
FRONTERA,2024-01-31,306,297,9,0.0294117647058824
FRONTERA,2024-02-01,284,280,4,0.0140845070422535
FRONTERA,2024-02-02,270,264,6,0.0222222222222222
FRONTERA,2024-02-03,299,294,5,0.0167224080267559
FRONTERA,2024-02-04,243,242,1,0.00411522633744856
FRONTERA,2024-02-05,237,232,5,0.0210970464135021
FRONTERA,2024-02-06,285,280,5,0.0175438596491228
FRONTERA,2024-02-07,314,311,3,0.00955414012738853
FRONTERA,2024-02-08,299,298,1,0.00334448160535117
FRONTERA,2024-02-09,278,277,1,0.00359712230215827
FRONTERA,2024-02-10,306,304,2,0.0065359477124183
FRONTERA,2024-02-11,205,204,1,0.0048780487804878
FRONTERA,2024-02-12,243,237,6,0.0246913580246914
FRONTERA,2024-02-13,243,239,4,0.0164609053497942
FRONTERA,2024-02-14,249,247,2,0.00803212851405622
FRONTERA,2024-02-15,243,241,2,0.00823045267489712
FRONTERA,2024-02-16,286,285,1,0.0034965034965035
FRONTERA,2024-02-17,248,242,6,0.0241935483870968
FRONTERA,2024-02-18,259,256,3,0.0115830115830116
FRONTERA,2024-02-19,255,250,5,0.0196078431372549
FRONTERA,2024-02-20,297,294,3,0.0101010101010101
FRONTERA,2024-02-21,298,297,1,0.00335570469798658
FRONTERA,2024-02-22,301,298,3,0.00996677740863787
FRONTERA,2024-02-23,220,206,14,0.0636363636363636
FRONTERA,2024-02-24,311,309,2,0.00643086816720257
FRONTERA,2024-02-25,230,227,3,0.0130434782608696
FRONTERA,2024-02-26,319,316,3,0.00940438871473354
FRONTERA,2024-02-27,278,277,1,0.00359712230215827
FRONTERA,2024-02-28,286,284,2,0.00699300699300699
FRONTERA,2024-02-29,283,276,7,0.0247349823321555
FRONTERA,2024-03-01,269,266,3,0.0111524163568773
FRONTERA,2024-03-02,290,287,3,0.0103448275862069
FRONTERA,2024-03-03,211,209,2,0.00947867298578199
FRONTERA,2024-03-04,269,263,6,0.0223048327137546
FRONTERA,2024-03-05,254,250,4,0.015748031496063
FRONTERA,2024-03-06,304,300,4,0.0131578947368421
FRONTERA,2024-03-07,285,284,1,0.00350877192982456
FRONTERA,2024-03-08,260,257,3,0.0115384615384615
FRONTERA,2024-03-09,270,267,3,0.0111111111111111
FRONTERA,2024-03-10,242,240,2,0.00826446280991736
FRONTERA,2024-03-11,254,252,2,0.0078740157480315
FRONTERA,2024-03-12,259,258,1,0.00386100386100386
FRONTERA,2024-03-13,259,257,2,0.00772200772200772
FRONTERA,2024-03-14,249,247,2,0.00803212851405622
FRONTERA,2024-03-15,266,262,4,0.0150375939849624
FRONTERA,2024-03-16,293,290,3,0.0102389078498294
FRONTERA,2024-03-17,250,247,3,0.012
FRONTERA,2024-03-18,210,209,1,0.00476190476190476
FRONTERA,2024-03-19,241,239,2,0.00829875518672199
FRONTERA,2024-03-20,255,252,3,0.0117647058823529
FRONTERA,2024-03-21,261,259,2,0.00766283524904215
FRONTERA,2024-03-22,251,249,2,0.00796812749003984
FRONTERA,2024-03-23,264,258,6,0.0227272727272727
FRONTERA,2024-03-24,227,225,2,0.00881057268722467
FRONTERA,2024-03-25,257,254,3,0.0116731517509728
FRONTERA,2024-03-26,273,269,4,0.0146520146520147
FRONTERA,2024-03-27,307,305,2,0.00651465798045603
FRONTERA,2024-03-28,312,310,2,0.00641025641025641
FRONTERA,2024-03-29,300,295,5,0.0166666666666667
FRONTERA,2024-03-30,305,301,4,0.0131147540983607
FRONTERA,2024-03-31,188,183,5,0.0265957446808511
FRONTERA,2024-04-01,258,254,4,0.0155038759689922
FRONTERA,2024-04-02,269,268,1,0.00371747211895911
FRONTERA,2024-04-03,256,256,0,0
FRONTERA,2024-04-04,282,282,0,0
FRONTERA,2024-04-05,287,283,4,0.0139372822299652
FRONTERA,2024-04-06,297,297,0,0
FRONTERA,2024-04-07,233,228,5,0.0214592274678112
FRONTERA,2024-04-08,236,233,3,0.0127118644067797
FRONTERA,2024-04-09,252,250,2,0.00793650793650794
FRONTERA,2024-04-10,264,261,3,0.0113636363636364
FRONTERA,2024-04-11,244,243,1,0.00409836065573771
FRONTERA,2024-04-12,260,256,4,0.0153846153846154
FRONTERA,2024-04-13,291,287,4,0.013745704467354
FRONTERA,2024-04-14,250,246,4,0.016
FRONTERA,2024-04-15,296,294,2,0.00675675675675676
FRONTERA,2024-04-16,283,271,12,0.0424028268551237
FRONTERA,2024-04-17,304,286,18,0.0592105263157895
FRONTERA,2024-04-18,242,239,3,0.012396694214876
FRONTERA,2024-04-19,268,258,10,0.0373134328358209
FRONTERA,2024-04-20,286,283,3,0.0104895104895105
FRONTERA,2024-04-21,242,239,3,0.012396694214876
FRONTERA,2024-04-22,162,157,5,0.0308641975308642
FRONTERA,2024-04-23,336,324,12,0.0357142857142857
FRONTERA,2024-04-24,258,244,14,0.0542635658914729
FRONTERA,2024-04-25,269,263,6,0.0223048327137546
FRONTERA,2024-04-26,272,268,4,0.0147058823529412
FRONTERA,2024-04-27,252,241,11,0.0436507936507936
FRONTERA,2024-04-28,231,226,5,0.0216450216450216
FRONTERA,2024-04-29,247,244,3,0.0121457489878543
FRONTERA,2024-04-30,280,277,3,0.0107142857142857
FRONTERA,2024-05-01,159,155,4,0.0251572327044025
FRONTERA,2024-05-02,289,285,4,0.013840830449827
FRONTERA,2024-05-03,272,267,5,0.0183823529411765
FRONTERA,2024-05-04,287,282,5,0.0174216027874564
FRONTERA,2024-05-05,237,233,4,0.0168776371308017
FRONTERA,2024-05-06,254,254,0,0
FRONTERA,2024-05-07,253,247,6,0.0237154150197628
FRONTERA,2024-05-08,231,228,3,0.012987012987013
FRONTERA,2024-05-09,243,233,10,0.0411522633744856
FRONTERA,2024-05-10,212,206,6,0.0283018867924528
FRONTERA,2024-05-11,233,227,6,0.0257510729613734
FRONTERA,2024-05-12,147,145,2,0.0136054421768707
FRONTERA,2024-05-13,217,209,8,0.0368663594470046
FRONTERA,2024-05-14,236,231,5,0.0211864406779661
FRONTERA,2024-05-15,240,232,8,0.0333333333333333
FRONTERA,2024-05-16,262,250,12,0.0458015267175573
FRONTERA,2024-05-17,297,293,4,0.0134680134680135
FRONTERA,2024-05-18,313,308,5,0.0159744408945687
FRONTERA,2024-05-19,231,228,3,0.012987012987013
FRONTERA,2024-05-20,282,277,5,0.0177304964539007
FRONTERA,2024-05-21,263,262,1,0.00380228136882129
FRONTERA,2024-05-22,292,282,10,0.0342465753424658
FRONTERA,2024-05-23,257,252,5,0.0194552529182879
FRONTERA,2024-05-24,229,224,5,0.0218340611353712
FRONTERA,2024-05-25,279,274,5,0.017921146953405
FRONTERA,2024-05-26,172,172,0,0
FRONTERA,2024-05-27,240,234,6,0.025
FRONTERA,2024-05-28,221,218,3,0.0135746606334842
FRONTERA,2024-05-29,194,191,3,0.0154639175257732
FRONTERA,2024-05-30,186,181,5,0.0268817204301075
FRONTERA,2024-05-31,215,209,6,0.027906976744186
FRONTERA,2024-06-01,156,154,2,0.0128205128205128
FRONTERA,2024-06-02,98,97,1,0.0102040816326531
FRONTERA,2024-06-03,193,192,1,0.00518134715025907
FRONTERA,2024-06-04,251,244,7,0.0278884462151394
FRONTERA,2024-06-05,262,250,12,0.0458015267175573
FRONTERA,2024-06-06,222,216,6,0.027027027027027
FRONTERA,2024-06-07,259,251,8,0.0308880308880309
FRONTERA,2024-06-08,249,243,6,0.0240963855421687
FRONTERA,2024-06-09,232,228,4,0.0172413793103448
FRONTERA,2024-06-10,222,217,5,0.0225225225225225
FRONTERA,2024-06-11,272,268,4,0.0147058823529412
FRONTERA,2024-06-12,271,269,2,0.00738007380073801
FRONTERA,2024-06-13,246,242,4,0.016260162601626
FRONTERA,2024-06-14,236,231,5,0.0211864406779661
FRONTERA,2024-06-15,246,242,4,0.016260162601626
FRONTERA,2024-06-16,164,162,2,0.0121951219512195
FRONTERA,2024-06-17,188,183,5,0.0265957446808511
FRONTERA,2024-06-18,249,245,4,0.0160642570281124
FRONTERA,2024-06-19,198,193,5,0.0252525252525253
FRONTERA,2024-06-20,221,219,2,0.00904977375565611
FRONTERA,2024-06-21,278,276,2,0.00719424460431655
FRONTERA,2024-06-22,257,249,8,0.0311284046692607
FRONTERA,2024-06-23,279,272,7,0.025089605734767
FRONTERA,2024-06-24,261,258,3,0.0114942528735632
FRONTERA,2024-06-25,253,249,4,0.0158102766798419
FRONTERA,2024-06-26,233,229,4,0.0171673819742489
FRONTERA,2024-06-27,270,267,3,0.0111111111111111
FRONTERA,2024-06-28,255,251,4,0.0156862745098039
FRONTERA,2024-06-29,262,259,3,0.0114503816793893
FRONTERA,2024-06-30,208,206,2,0.00961538461538462
FRONTERA,2024-07-01,134,132,2,0.0149253731343284
FRONTERA,2024-07-02,186,184,2,0.010752688172043
NORESTE 1,2023-07-03,144,140,4,0.0277777777777778
NORESTE 1,2023-07-04,133,129,4,0.0300751879699248
NORESTE 1,2023-07-05,82,81,1,0.0121951219512195
NORESTE 1,2023-07-06,115,109,6,0.0521739130434783
NORESTE 1,2023-07-07,143,142,1,0.00699300699300699
NORESTE 1,2023-07-08,202,201,1,0.00495049504950495
NORESTE 1,2023-07-09,159,157,2,0.0125786163522013
NORESTE 1,2023-07-10,136,135,1,0.00735294117647059
NORESTE 1,2023-07-11,114,113,1,0.0087719298245614
NORESTE 1,2023-07-12,142,141,1,0.00704225352112676
NORESTE 1,2023-07-13,149,141,8,0.0536912751677852
NORESTE 1,2023-07-14,153,151,2,0.0130718954248366
NORESTE 1,2023-07-15,201,192,9,0.0447761194029851
NORESTE 1,2023-07-16,119,119,0,0
NORESTE 1,2023-07-17,148,144,4,0.027027027027027
NORESTE 1,2023-07-18,173,171,2,0.0115606936416185
NORESTE 1,2023-07-19,141,139,2,0.0141843971631206
NORESTE 1,2023-07-20,185,179,6,0.0324324324324324
NORESTE 1,2023-07-21,217,213,4,0.0184331797235023
NORESTE 1,2023-07-22,201,198,3,0.0149253731343284
NORESTE 1,2023-07-23,112,112,0,0
NORESTE 1,2023-07-24,138,134,4,0.0289855072463768
NORESTE 1,2023-07-25,169,167,2,0.0118343195266272
NORESTE 1,2023-07-26,154,152,2,0.012987012987013
NORESTE 1,2023-07-27,201,198,3,0.0149253731343284
NORESTE 1,2023-07-28,235,231,4,0.0170212765957447
NORESTE 1,2023-07-29,244,241,3,0.0122950819672131
NORESTE 1,2023-07-30,89,86,3,0.0337078651685393
NORESTE 1,2023-07-31,173,171,2,0.0115606936416185
NORESTE 1,2023-08-01,158,151,7,0.0443037974683544
NORESTE 1,2023-08-02,173,165,8,0.046242774566474
NORESTE 1,2023-08-03,191,165,26,0.136125654450262
NORESTE 1,2023-08-04,203,193,10,0.0492610837438424
NORESTE 1,2023-08-05,241,235,6,0.024896265560166
NORESTE 1,2023-08-06,163,156,7,0.0429447852760736
NORESTE 1,2023-08-07,143,133,10,0.0699300699300699
NORESTE 1,2023-08-08,173,166,7,0.0404624277456647
NORESTE 1,2023-08-09,140,134,6,0.0428571428571429
NORESTE 1,2023-08-10,171,158,13,0.0760233918128655
NORESTE 1,2023-08-11,198,184,14,0.0707070707070707
NORESTE 1,2023-08-12,187,176,11,0.0588235294117647
NORESTE 1,2023-08-13,101,94,7,0.0693069306930693
NORESTE 1,2023-08-14,148,140,8,0.0540540540540541
NORESTE 1,2023-08-15,212,205,7,0.0330188679245283
NORESTE 1,2023-08-16,193,182,11,0.0569948186528497
NORESTE 1,2023-08-17,209,201,8,0.0382775119617225
NORESTE 1,2023-08-18,237,231,6,0.0253164556962025
NORESTE 1,2023-08-19,244,233,11,0.0450819672131148
NORESTE 1,2023-08-20,144,140,4,0.0277777777777778
NORESTE 1,2023-08-21,156,155,1,0.00641025641025641
NORESTE 1,2023-08-22,172,169,3,0.0174418604651163
NORESTE 1,2023-08-23,206,205,1,0.00485436893203883
NORESTE 1,2023-08-24,198,197,1,0.00505050505050505
NORESTE 1,2023-08-25,220,216,4,0.0181818181818182
NORESTE 1,2023-08-26,266,262,4,0.0150375939849624
NORESTE 1,2023-08-27,145,142,3,0.0206896551724138
NORESTE 1,2023-08-28,170,167,3,0.0176470588235294
NORESTE 1,2023-08-29,176,175,1,0.00568181818181818
NORESTE 1,2023-08-30,176,176,0,0
NORESTE 1,2023-08-31,186,182,4,0.021505376344086
NORESTE 1,2023-09-01,172,172,0,0
NORESTE 1,2023-09-02,189,189,0,0
NORESTE 1,2023-09-03,152,151,1,0.00657894736842105
NORESTE 1,2023-09-04,150,149,1,0.00666666666666667
NORESTE 1,2023-09-05,193,191,2,0.0103626943005181
NORESTE 1,2023-09-06,192,190,2,0.0104166666666667
NORESTE 1,2023-09-07,165,165,0,0
NORESTE 1,2023-09-08,153,153,0,0
NORESTE 1,2023-09-09,212,211,1,0.00471698113207547
NORESTE 1,2023-09-10,137,136,1,0.0072992700729927
NORESTE 1,2023-09-11,159,157,2,0.0125786163522013
NORESTE 1,2023-09-12,184,183,1,0.00543478260869565
NORESTE 1,2023-09-13,172,172,0,0
NORESTE 1,2023-09-14,146,146,0,0
NORESTE 1,2023-09-15,199,195,4,0.0201005025125628
NORESTE 1,2023-09-16,165,162,3,0.0181818181818182
NORESTE 1,2023-09-17,152,151,1,0.00657894736842105
NORESTE 1,2023-09-18,165,164,1,0.00606060606060606
NORESTE 1,2023-09-19,151,151,0,0
NORESTE 1,2023-09-20,124,123,1,0.00806451612903226
NORESTE 1,2023-09-21,140,135,5,0.0357142857142857
NORESTE 1,2023-09-22,194,187,7,0.0360824742268041
NORESTE 1,2023-09-23,212,211,1,0.00471698113207547
NORESTE 1,2023-09-24,133,133,0,0
NORESTE 1,2023-09-25,177,174,3,0.0169491525423729
NORESTE 1,2023-09-26,164,158,6,0.0365853658536585
NORESTE 1,2023-09-27,173,170,3,0.0173410404624277
NORESTE 1,2023-09-28,170,166,4,0.0235294117647059
NORESTE 1,2023-09-29,195,187,8,0.041025641025641
NORESTE 1,2023-09-30,221,216,5,0.0226244343891403
NORESTE 1,2023-10-01,146,144,2,0.0136986301369863
NORESTE 1,2023-10-02,146,143,3,0.0205479452054795
NORESTE 1,2023-10-03,126,120,6,0.0476190476190476
NORESTE 1,2023-10-04,197,187,10,0.050761421319797
NORESTE 1,2023-10-05,151,142,9,0.0596026490066225
NORESTE 1,2023-10-06,184,176,8,0.0434782608695652
NORESTE 1,2023-10-07,187,182,5,0.0267379679144385
NORESTE 1,2023-10-08,124,120,4,0.032258064516129
NORESTE 1,2023-10-09,177,168,9,0.0508474576271186
NORESTE 1,2023-10-10,127,125,2,0.015748031496063
NORESTE 1,2023-10-11,148,144,4,0.027027027027027
NORESTE 1,2023-10-12,115,111,4,0.0347826086956522
NORESTE 1,2023-10-13,121,116,5,0.0413223140495868
NORESTE 1,2023-10-14,144,136,8,0.0555555555555556
NORESTE 1,2023-10-15,122,122,0,0
NORESTE 1,2023-10-16,167,161,6,0.0359281437125748
NORESTE 1,2023-10-17,158,156,2,0.0126582278481013
NORESTE 1,2023-10-18,190,184,6,0.0315789473684211
NORESTE 1,2023-10-19,146,144,2,0.0136986301369863
NORESTE 1,2023-10-20,180,172,8,0.0444444444444444
NORESTE 1,2023-10-21,177,174,3,0.0169491525423729
NORESTE 1,2023-10-22,130,127,3,0.0230769230769231
NORESTE 1,2023-10-23,141,133,8,0.0567375886524823
NORESTE 1,2023-10-24,150,143,7,0.0466666666666667
NORESTE 1,2023-10-25,144,138,6,0.0416666666666667
NORESTE 1,2023-10-26,174,167,7,0.0402298850574713
NORESTE 1,2023-10-27,154,149,5,0.0324675324675325
NORESTE 1,2023-10-28,191,186,5,0.0261780104712042
NORESTE 1,2023-10-29,112,110,2,0.0178571428571429
NORESTE 1,2023-10-30,115,113,2,0.0173913043478261
NORESTE 1,2023-10-31,110,107,3,0.0272727272727273
NORESTE 1,2023-11-01,153,145,8,0.0522875816993464
NORESTE 1,2023-11-02,179,172,7,0.0391061452513966
NORESTE 1,2023-11-03,200,192,8,0.04
NORESTE 1,2023-11-04,171,161,10,0.0584795321637427
NORESTE 1,2023-11-05,148,145,3,0.0202702702702703
NORESTE 1,2023-11-06,166,162,4,0.0240963855421687
NORESTE 1,2023-11-07,176,174,2,0.0113636363636364
NORESTE 1,2023-11-08,196,194,2,0.0102040816326531
NORESTE 1,2023-11-09,192,187,5,0.0260416666666667
NORESTE 1,2023-11-10,169,168,1,0.00591715976331361
NORESTE 1,2023-11-11,226,221,5,0.0221238938053097
NORESTE 1,2023-11-12,138,136,2,0.0144927536231884
NORESTE 1,2023-11-13,172,167,5,0.0290697674418605
NORESTE 1,2023-11-14,183,176,7,0.0382513661202186
NORESTE 1,2023-11-15,169,166,3,0.0177514792899408
NORESTE 1,2023-11-16,174,167,7,0.0402298850574713
NORESTE 1,2023-11-17,228,223,5,0.0219298245614035
NORESTE 1,2023-11-18,236,231,5,0.0211864406779661
NORESTE 1,2023-11-19,155,153,2,0.0129032258064516
NORESTE 1,2023-11-20,163,156,7,0.0429447852760736
NORESTE 1,2023-11-21,164,160,4,0.024390243902439
NORESTE 1,2023-11-22,149,145,4,0.0268456375838926
NORESTE 1,2023-11-23,194,187,7,0.0360824742268041
NORESTE 1,2023-11-24,196,189,7,0.0357142857142857
NORESTE 1,2023-11-25,231,226,5,0.0216450216450216
NORESTE 1,2023-11-26,227,220,7,0.0308370044052863
NORESTE 1,2023-11-27,145,141,4,0.0275862068965517
NORESTE 1,2023-11-28,163,162,1,0.00613496932515337
NORESTE 1,2023-11-29,212,196,16,0.0754716981132075
NORESTE 1,2023-11-30,208,193,15,0.0721153846153846
NORESTE 1,2023-12-01,159,150,9,0.0566037735849057
NORESTE 1,2023-12-02,229,213,16,0.0698689956331878
NORESTE 1,2023-12-03,240,230,10,0.0416666666666667
NORESTE 1,2023-12-04,172,165,7,0.0406976744186047
NORESTE 1,2023-12-05,205,195,10,0.0487804878048781
NORESTE 1,2023-12-06,190,178,12,0.0631578947368421
NORESTE 1,2023-12-07,206,196,10,0.0485436893203883
NORESTE 1,2023-12-08,232,224,8,0.0344827586206897
NORESTE 1,2023-12-09,236,225,11,0.0466101694915254
NORESTE 1,2023-12-10,184,176,8,0.0434782608695652
NORESTE 1,2023-12-11,162,152,10,0.0617283950617284
NORESTE 1,2023-12-12,193,184,9,0.0466321243523316
NORESTE 1,2023-12-13,184,176,8,0.0434782608695652
NORESTE 1,2023-12-14,165,157,8,0.0484848484848485
NORESTE 1,2023-12-15,176,166,10,0.0568181818181818
NORESTE 1,2023-12-16,214,204,10,0.0467289719626168
NORESTE 1,2023-12-17,164,159,5,0.0304878048780488
NORESTE 1,2023-12-18,166,159,7,0.0421686746987952
NORESTE 1,2023-12-19,191,185,6,0.031413612565445
NORESTE 1,2023-12-20,189,181,8,0.0423280423280423
NORESTE 1,2023-12-21,199,189,10,0.050251256281407
NORESTE 1,2023-12-22,205,201,4,0.0195121951219512
NORESTE 1,2023-12-23,240,234,6,0.025
NORESTE 1,2023-12-24,146,144,2,0.0136986301369863
NORESTE 1,2023-12-25,52,52,0,0
NORESTE 1,2023-12-26,153,149,4,0.0261437908496732
NORESTE 1,2023-12-27,218,213,5,0.0229357798165138
NORESTE 1,2023-12-28,213,205,8,0.0375586854460094
NORESTE 1,2023-12-29,232,226,6,0.0258620689655172
NORESTE 1,2023-12-30,199,196,3,0.0150753768844221
NORESTE 1,2023-12-31,116,116,0,0
NORESTE 1,2024-01-01,21,21,0,0
NORESTE 1,2024-01-02,130,128,2,0.0153846153846154
NORESTE 1,2024-01-03,215,211,4,0.0186046511627907
NORESTE 1,2024-01-04,208,202,6,0.0288461538461538
NORESTE 1,2024-01-05,232,227,5,0.021551724137931
NORESTE 1,2024-01-06,268,263,5,0.0186567164179104
NORESTE 1,2024-01-07,168,166,2,0.0119047619047619
NORESTE 1,2024-01-08,162,161,1,0.00617283950617284
NORESTE 1,2024-01-09,174,168,6,0.0344827586206897
NORESTE 1,2024-01-10,219,216,3,0.0136986301369863
NORESTE 1,2024-01-11,210,207,3,0.0142857142857143
NORESTE 1,2024-01-12,235,230,5,0.0212765957446809
NORESTE 1,2024-01-13,254,247,7,0.0275590551181102
NORESTE 1,2024-01-14,188,183,5,0.0265957446808511
NORESTE 1,2024-01-15,213,206,7,0.0328638497652582
NORESTE 1,2024-01-16,200,191,9,0.045
NORESTE 1,2024-01-17,205,195,10,0.0487804878048781
NORESTE 1,2024-01-18,200,196,4,0.02
NORESTE 1,2024-01-19,193,184,9,0.0466321243523316
NORESTE 1,2024-01-20,236,231,5,0.0211864406779661
NORESTE 1,2024-01-21,166,158,8,0.0481927710843374
NORESTE 1,2024-01-22,174,167,7,0.0402298850574713
NORESTE 1,2024-01-23,198,189,9,0.0454545454545455
NORESTE 1,2024-01-24,173,171,2,0.0115606936416185
NORESTE 1,2024-01-25,197,191,6,0.0304568527918782
NORESTE 1,2024-01-26,175,164,11,0.0628571428571429
NORESTE 1,2024-01-27,231,223,8,0.0346320346320346
NORESTE 1,2024-01-28,142,137,5,0.0352112676056338
NORESTE 1,2024-01-29,183,179,4,0.0218579234972678
NORESTE 1,2024-01-30,160,154,6,0.0375
NORESTE 1,2024-01-31,176,172,4,0.0227272727272727
NORESTE 1,2024-02-01,166,162,4,0.0240963855421687
NORESTE 1,2024-02-02,166,162,4,0.0240963855421687
NORESTE 1,2024-02-03,190,186,4,0.0210526315789474
NORESTE 1,2024-02-04,147,144,3,0.0204081632653061
NORESTE 1,2024-02-05,133,132,1,0.0075187969924812
NORESTE 1,2024-02-06,170,165,5,0.0294117647058824
NORESTE 1,2024-02-07,173,167,6,0.0346820809248555
NORESTE 1,2024-02-08,199,197,2,0.0100502512562814
NORESTE 1,2024-02-09,177,173,4,0.0225988700564972
NORESTE 1,2024-02-10,236,231,5,0.0211864406779661
NORESTE 1,2024-02-11,159,157,2,0.0125786163522013
NORESTE 1,2024-02-12,143,140,3,0.020979020979021
NORESTE 1,2024-02-13,209,207,2,0.00956937799043062
NORESTE 1,2024-02-14,195,189,6,0.0307692307692308
NORESTE 1,2024-02-15,176,174,2,0.0113636363636364
NORESTE 1,2024-02-16,165,160,5,0.0303030303030303
NORESTE 1,2024-02-17,185,183,2,0.0108108108108108
NORESTE 1,2024-02-18,186,185,1,0.00537634408602151
NORESTE 1,2024-02-19,159,156,3,0.0188679245283019
NORESTE 1,2024-02-20,190,186,4,0.0210526315789474
NORESTE 1,2024-02-21,160,152,8,0.05
NORESTE 1,2024-02-22,229,226,3,0.0131004366812227
NORESTE 1,2024-02-23,131,113,18,0.137404580152672
NORESTE 1,2024-02-24,246,243,3,0.0121951219512195
NORESTE 1,2024-02-25,191,190,1,0.00523560209424084
NORESTE 1,2024-02-26,169,167,2,0.0118343195266272
NORESTE 1,2024-02-27,179,175,4,0.0223463687150838
NORESTE 1,2024-02-28,156,154,2,0.0128205128205128
NORESTE 1,2024-02-29,217,216,1,0.00460829493087558
NORESTE 1,2024-03-01,177,168,9,0.0508474576271186
NORESTE 1,2024-03-02,201,199,2,0.00995024875621891
NORESTE 1,2024-03-03,177,176,1,0.00564971751412429
NORESTE 1,2024-03-04,147,145,2,0.0136054421768707
NORESTE 1,2024-03-05,146,140,6,0.0410958904109589
NORESTE 1,2024-03-06,180,176,4,0.0222222222222222
NORESTE 1,2024-03-07,198,194,4,0.0202020202020202
NORESTE 1,2024-03-08,209,203,6,0.0287081339712919
NORESTE 1,2024-03-09,248,243,5,0.0201612903225806
NORESTE 1,2024-03-10,153,148,5,0.0326797385620915
NORESTE 1,2024-03-11,134,133,1,0.00746268656716418
NORESTE 1,2024-03-12,146,144,2,0.0136986301369863
NORESTE 1,2024-03-13,173,168,5,0.0289017341040462
NORESTE 1,2024-03-14,195,191,4,0.0205128205128205
NORESTE 1,2024-03-15,184,183,1,0.00543478260869565
NORESTE 1,2024-03-16,241,236,5,0.020746887966805
NORESTE 1,2024-03-17,148,145,3,0.0202702702702703
NORESTE 1,2024-03-18,99,96,3,0.0303030303030303
NORESTE 1,2024-03-19,159,154,5,0.0314465408805031
NORESTE 1,2024-03-20,190,185,5,0.0263157894736842
NORESTE 1,2024-03-21,140,137,3,0.0214285714285714
NORESTE 1,2024-03-22,178,171,7,0.0393258426966292
NORESTE 1,2024-03-23,199,194,5,0.0251256281407035
NORESTE 1,2024-03-24,130,128,2,0.0153846153846154
NORESTE 1,2024-03-25,153,149,4,0.0261437908496732
NORESTE 1,2024-03-26,173,169,4,0.023121387283237
NORESTE 1,2024-03-27,164,160,4,0.024390243902439
NORESTE 1,2024-03-28,236,228,8,0.0338983050847458
NORESTE 1,2024-03-29,199,197,2,0.0100502512562814
NORESTE 1,2024-03-30,156,153,3,0.0192307692307692
NORESTE 1,2024-03-31,136,134,2,0.0147058823529412
NORESTE 1,2024-04-01,154,150,4,0.025974025974026
NORESTE 1,2024-04-02,159,151,8,0.050314465408805
NORESTE 1,2024-04-03,177,177,0,0
NORESTE 1,2024-04-04,158,158,0,0
NORESTE 1,2024-04-05,201,196,5,0.0248756218905473
NORESTE 1,2024-04-06,201,198,3,0.0149253731343284
NORESTE 1,2024-04-07,140,138,2,0.0142857142857143
NORESTE 1,2024-04-08,146,144,2,0.0136986301369863
NORESTE 1,2024-04-09,176,170,6,0.0340909090909091
NORESTE 1,2024-04-10,150,143,7,0.0466666666666667
NORESTE 1,2024-04-11,180,176,4,0.0222222222222222
NORESTE 1,2024-04-12,193,188,5,0.0259067357512953
NORESTE 1,2024-04-13,231,227,4,0.0173160173160173
NORESTE 1,2024-04-14,155,153,2,0.0129032258064516
NORESTE 1,2024-04-15,151,146,5,0.033112582781457
NORESTE 1,2024-04-16,161,148,13,0.0807453416149068
NORESTE 1,2024-04-17,204,189,15,0.0735294117647059
NORESTE 1,2024-04-18,169,165,4,0.0236686390532544
NORESTE 1,2024-04-19,158,146,12,0.0759493670886076
NORESTE 1,2024-04-20,197,189,8,0.0406091370558376
NORESTE 1,2024-04-21,106,101,5,0.0471698113207547
NORESTE 1,2024-04-22,70,64,6,0.0857142857142857
NORESTE 1,2024-04-23,230,213,17,0.0739130434782609
NORESTE 1,2024-04-24,166,161,5,0.0301204819277108
NORESTE 1,2024-04-25,157,154,3,0.0191082802547771
NORESTE 1,2024-04-26,199,193,6,0.0301507537688442
NORESTE 1,2024-04-27,183,173,10,0.0546448087431694
NORESTE 1,2024-04-28,144,144,0,0
NORESTE 1,2024-04-29,173,170,3,0.0173410404624277
NORESTE 1,2024-04-30,140,136,4,0.0285714285714286
NORESTE 1,2024-05-01,139,136,3,0.0215827338129496
NORESTE 1,2024-05-02,119,117,2,0.0168067226890756
NORESTE 1,2024-05-03,194,187,7,0.0360824742268041
NORESTE 1,2024-05-04,198,192,6,0.0303030303030303
NORESTE 1,2024-05-05,137,130,7,0.0510948905109489
NORESTE 1,2024-05-06,136,136,0,0
NORESTE 1,2024-05-07,153,150,3,0.0196078431372549
NORESTE 1,2024-05-08,153,147,6,0.0392156862745098
NORESTE 1,2024-05-09,165,155,10,0.0606060606060606
NORESTE 1,2024-05-10,155,150,5,0.032258064516129
NORESTE 1,2024-05-11,196,193,3,0.0153061224489796
NORESTE 1,2024-05-12,121,117,4,0.0330578512396694
NORESTE 1,2024-05-13,146,139,7,0.0479452054794521
NORESTE 1,2024-05-14,168,163,5,0.0297619047619048
NORESTE 1,2024-05-15,187,180,7,0.0374331550802139
NORESTE 1,2024-05-16,174,158,16,0.0919540229885057
NORESTE 1,2024-05-17,196,185,11,0.0561224489795918
NORESTE 1,2024-05-18,199,195,4,0.0201005025125628
NORESTE 1,2024-05-19,165,163,2,0.0121212121212121
NORESTE 1,2024-05-20,174,164,10,0.0574712643678161
NORESTE 1,2024-05-21,152,149,3,0.0197368421052632
NORESTE 1,2024-05-22,158,153,5,0.0316455696202532
NORESTE 1,2024-05-23,170,164,6,0.0352941176470588
NORESTE 1,2024-05-24,161,158,3,0.0186335403726708
NORESTE 1,2024-05-25,177,173,4,0.0225988700564972
NORESTE 1,2024-05-26,119,116,3,0.0252100840336134
NORESTE 1,2024-05-27,142,137,5,0.0352112676056338
NORESTE 1,2024-05-28,172,171,1,0.00581395348837209
NORESTE 1,2024-05-29,162,157,5,0.0308641975308642
NORESTE 1,2024-05-30,152,149,3,0.0197368421052632
NORESTE 1,2024-05-31,170,164,6,0.0352941176470588
NORESTE 1,2024-06-01,179,176,3,0.0167597765363128
NORESTE 1,2024-06-02,51,51,0,0
NORESTE 1,2024-06-03,97,95,2,0.0206185567010309
NORESTE 1,2024-06-04,181,180,1,0.00552486187845304
NORESTE 1,2024-06-05,157,150,7,0.0445859872611465
NORESTE 1,2024-06-06,148,144,4,0.027027027027027
NORESTE 1,2024-06-07,161,157,4,0.0248447204968944
NORESTE 1,2024-06-08,192,185,7,0.0364583333333333
NORESTE 1,2024-06-09,135,131,4,0.0296296296296296
NORESTE 1,2024-06-10,121,111,10,0.0826446280991736
NORESTE 1,2024-06-11,191,189,2,0.0104712041884817
NORESTE 1,2024-06-12,179,175,4,0.0223463687150838
NORESTE 1,2024-06-13,156,152,4,0.0256410256410256
NORESTE 1,2024-06-14,90,87,3,0.0333333333333333
NORESTE 1,2024-06-15,71,66,5,0.0704225352112676
NORESTE 1,2024-06-16,70,70,0,0
NORESTE 1,2024-06-17,58,58,0,0
NORESTE 1,2024-06-18,176,174,2,0.0113636363636364
NORESTE 1,2024-06-19,111,107,4,0.036036036036036
NORESTE 1,2024-06-20,58,57,1,0.0172413793103448
NORESTE 1,2024-06-21,72,71,1,0.0138888888888889
NORESTE 1,2024-06-22,93,91,2,0.021505376344086
NORESTE 1,2024-06-23,59,57,2,0.0338983050847458
NORESTE 1,2024-06-24,44,44,0,0
NORESTE 1,2024-06-25,115,110,5,0.0434782608695652
NORESTE 1,2024-06-26,113,111,2,0.0176991150442478
NORESTE 1,2024-06-27,172,168,4,0.0232558139534884
NORESTE 1,2024-06-28,168,160,8,0.0476190476190476
NORESTE 1,2024-06-29,150,150,0,0
NORESTE 1,2024-06-30,95,94,1,0.0105263157894737
NORESTE 1,2024-07-01,76,76,0,0
NORESTE 1,2024-07-02,106,100,6,0.0566037735849057
NORESTE 2,2023-07-03,157,153,4,0.0254777070063694
NORESTE 2,2023-07-04,174,168,6,0.0344827586206897
NORESTE 2,2023-07-05,66,64,2,0.0303030303030303
NORESTE 2,2023-07-06,140,136,4,0.0285714285714286
NORESTE 2,2023-07-07,158,152,6,0.0379746835443038
NORESTE 2,2023-07-08,196,190,6,0.0306122448979592
NORESTE 2,2023-07-09,171,171,0,0
NORESTE 2,2023-07-10,152,146,6,0.0394736842105263
NORESTE 2,2023-07-11,216,208,8,0.037037037037037
NORESTE 2,2023-07-12,203,196,7,0.0344827586206897
NORESTE 2,2023-07-13,224,219,5,0.0223214285714286
NORESTE 2,2023-07-14,204,195,9,0.0441176470588235
NORESTE 2,2023-07-15,244,237,7,0.0286885245901639
NORESTE 2,2023-07-16,155,153,2,0.0129032258064516
NORESTE 2,2023-07-17,196,191,5,0.0255102040816327
NORESTE 2,2023-07-18,209,206,3,0.0143540669856459
NORESTE 2,2023-07-19,175,172,3,0.0171428571428571
NORESTE 2,2023-07-20,192,188,4,0.0208333333333333
NORESTE 2,2023-07-21,220,211,9,0.0409090909090909
NORESTE 2,2023-07-22,276,268,8,0.0289855072463768
NORESTE 2,2023-07-23,203,200,3,0.0147783251231527
NORESTE 2,2023-07-24,187,178,9,0.0481283422459893
NORESTE 2,2023-07-25,214,208,6,0.0280373831775701
NORESTE 2,2023-07-26,227,221,6,0.026431718061674
NORESTE 2,2023-07-27,222,219,3,0.0135135135135135
NORESTE 2,2023-07-28,220,212,8,0.0363636363636364
NORESTE 2,2023-07-29,214,206,8,0.0373831775700935
NORESTE 2,2023-07-30,199,196,3,0.0150753768844221
NORESTE 2,2023-07-31,179,168,11,0.0614525139664804
NORESTE 2,2023-08-01,199,188,11,0.0552763819095477
NORESTE 2,2023-08-02,239,230,9,0.0376569037656904
NORESTE 2,2023-08-03,228,194,34,0.149122807017544
NORESTE 2,2023-08-04,208,195,13,0.0625
NORESTE 2,2023-08-05,279,260,19,0.0681003584229391
NORESTE 2,2023-08-06,148,138,10,0.0675675675675676
NORESTE 2,2023-08-07,180,173,7,0.0388888888888889
NORESTE 2,2023-08-08,170,160,10,0.0588235294117647
NORESTE 2,2023-08-09,206,195,11,0.0533980582524272
NORESTE 2,2023-08-10,186,180,6,0.032258064516129
NORESTE 2,2023-08-11,243,233,10,0.0411522633744856
NORESTE 2,2023-08-12,187,173,14,0.0748663101604278
NORESTE 2,2023-08-13,137,127,10,0.072992700729927
NORESTE 2,2023-08-14,175,165,10,0.0571428571428571
NORESTE 2,2023-08-15,221,214,7,0.0316742081447964
NORESTE 2,2023-08-16,211,205,6,0.028436018957346
NORESTE 2,2023-08-17,248,238,10,0.0403225806451613
NORESTE 2,2023-08-18,304,297,7,0.0230263157894737
NORESTE 2,2023-08-19,331,314,17,0.0513595166163142
NORESTE 2,2023-08-20,205,201,4,0.0195121951219512
NORESTE 2,2023-08-21,181,176,5,0.0276243093922652
NORESTE 2,2023-08-22,208,203,5,0.0240384615384615
NORESTE 2,2023-08-23,225,216,9,0.04
NORESTE 2,2023-08-24,199,187,12,0.0603015075376884
NORESTE 2,2023-08-25,268,263,5,0.0186567164179104
NORESTE 2,2023-08-26,299,290,9,0.0301003344481605
NORESTE 2,2023-08-27,246,236,10,0.040650406504065
NORESTE 2,2023-08-28,229,217,12,0.0524017467248908
NORESTE 2,2023-08-29,215,202,13,0.0604651162790698
NORESTE 2,2023-08-30,178,172,6,0.0337078651685393
NORESTE 2,2023-08-31,212,206,6,0.0283018867924528
NORESTE 2,2023-09-01,192,188,4,0.0208333333333333
NORESTE 2,2023-09-02,223,219,4,0.0179372197309417
NORESTE 2,2023-09-03,161,158,3,0.0186335403726708
NORESTE 2,2023-09-04,191,187,4,0.0209424083769634
NORESTE 2,2023-09-05,218,212,6,0.0275229357798165
NORESTE 2,2023-09-06,200,199,1,0.005
NORESTE 2,2023-09-07,183,179,4,0.0218579234972678
NORESTE 2,2023-09-08,220,217,3,0.0136363636363636
NORESTE 2,2023-09-09,242,234,8,0.0330578512396694
NORESTE 2,2023-09-10,154,153,1,0.00649350649350649
NORESTE 2,2023-09-11,177,174,3,0.0169491525423729
NORESTE 2,2023-09-12,197,191,6,0.0304568527918782
NORESTE 2,2023-09-13,181,175,6,0.0331491712707182
NORESTE 2,2023-09-14,129,128,1,0.00775193798449612
NORESTE 2,2023-09-15,222,213,9,0.0405405405405405
NORESTE 2,2023-09-16,145,143,2,0.0137931034482759
NORESTE 2,2023-09-17,146,143,3,0.0205479452054795
NORESTE 2,2023-09-18,165,160,5,0.0303030303030303
NORESTE 2,2023-09-19,100,100,0,0
NORESTE 2,2023-09-20,93,91,2,0.021505376344086
NORESTE 2,2023-09-21,75,70,5,0.0666666666666667
NORESTE 2,2023-09-22,253,252,1,0.00395256916996047
NORESTE 2,2023-09-23,255,247,8,0.0313725490196078
NORESTE 2,2023-09-24,186,182,4,0.021505376344086
NORESTE 2,2023-09-25,195,191,4,0.0205128205128205
NORESTE 2,2023-09-26,223,217,6,0.0269058295964126
NORESTE 2,2023-09-27,175,170,5,0.0285714285714286
NORESTE 2,2023-09-28,210,201,9,0.0428571428571429
NORESTE 2,2023-09-29,209,193,16,0.076555023923445
NORESTE 2,2023-09-30,255,241,14,0.0549019607843137
NORESTE 2,2023-10-01,165,150,15,0.0909090909090909
NORESTE 2,2023-10-02,182,174,8,0.043956043956044
NORESTE 2,2023-10-03,90,84,6,0.0666666666666667
NORESTE 2,2023-10-04,228,215,13,0.0570175438596491
NORESTE 2,2023-10-05,177,170,7,0.0395480225988701
NORESTE 2,2023-10-06,192,185,7,0.0364583333333333
NORESTE 2,2023-10-07,217,203,14,0.0645161290322581
NORESTE 2,2023-10-08,156,145,11,0.0705128205128205
NORESTE 2,2023-10-09,175,164,11,0.0628571428571429
NORESTE 2,2023-10-10,137,131,6,0.0437956204379562
NORESTE 2,2023-10-11,144,140,4,0.0277777777777778
NORESTE 2,2023-10-12,135,129,6,0.0444444444444444
NORESTE 2,2023-10-13,126,124,2,0.0158730158730159
NORESTE 2,2023-10-14,172,169,3,0.0174418604651163
NORESTE 2,2023-10-15,157,151,6,0.0382165605095541
NORESTE 2,2023-10-16,195,190,5,0.0256410256410256
NORESTE 2,2023-10-17,193,188,5,0.0259067357512953
NORESTE 2,2023-10-18,235,228,7,0.0297872340425532
NORESTE 2,2023-10-19,215,209,6,0.027906976744186
NORESTE 2,2023-10-20,193,188,5,0.0259067357512953
NORESTE 2,2023-10-21,269,259,10,0.0371747211895911
NORESTE 2,2023-10-22,160,157,3,0.01875
NORESTE 2,2023-10-23,214,206,8,0.0373831775700935
NORESTE 2,2023-10-24,169,163,6,0.0355029585798817
NORESTE 2,2023-10-25,194,193,1,0.00515463917525773
NORESTE 2,2023-10-26,201,196,5,0.0248756218905473
NORESTE 2,2023-10-27,209,204,5,0.0239234449760766
NORESTE 2,2023-10-28,262,258,4,0.0152671755725191
NORESTE 2,2023-10-29,191,184,7,0.0366492146596859
NORESTE 2,2023-10-30,157,153,4,0.0254777070063694
NORESTE 2,2023-10-31,188,183,5,0.0265957446808511
NORESTE 2,2023-11-01,155,152,3,0.0193548387096774
NORESTE 2,2023-11-02,188,185,3,0.0159574468085106
NORESTE 2,2023-11-03,193,190,3,0.0155440414507772
NORESTE 2,2023-11-04,264,259,5,0.0189393939393939
NORESTE 2,2023-11-05,184,178,6,0.0326086956521739
NORESTE 2,2023-11-06,168,162,6,0.0357142857142857
NORESTE 2,2023-11-07,188,178,10,0.0531914893617021
NORESTE 2,2023-11-08,222,216,6,0.027027027027027
NORESTE 2,2023-11-09,218,213,5,0.0229357798165138
NORESTE 2,2023-11-10,201,199,2,0.00995024875621891
NORESTE 2,2023-11-11,293,285,8,0.0273037542662116
NORESTE 2,2023-11-12,101,96,5,0.0495049504950495
NORESTE 2,2023-11-13,200,191,9,0.045
NORESTE 2,2023-11-14,190,188,2,0.0105263157894737
NORESTE 2,2023-11-15,188,182,6,0.0319148936170213
NORESTE 2,2023-11-16,193,186,7,0.0362694300518135
NORESTE 2,2023-11-17,253,245,8,0.0316205533596838
NORESTE 2,2023-11-18,312,307,5,0.016025641025641
NORESTE 2,2023-11-19,190,186,4,0.0210526315789474
NORESTE 2,2023-11-20,200,198,2,0.01
NORESTE 2,2023-11-21,169,163,6,0.0355029585798817
NORESTE 2,2023-11-22,180,171,9,0.05
NORESTE 2,2023-11-23,235,229,6,0.025531914893617
NORESTE 2,2023-11-24,267,255,12,0.0449438202247191
NORESTE 2,2023-11-25,269,263,6,0.0223048327137546
NORESTE 2,2023-11-26,254,245,9,0.0354330708661417
NORESTE 2,2023-11-27,171,167,4,0.0233918128654971
NORESTE 2,2023-11-28,231,225,6,0.025974025974026
NORESTE 2,2023-11-29,202,187,15,0.0742574257425743
NORESTE 2,2023-11-30,224,208,16,0.0714285714285714
NORESTE 2,2023-12-01,186,179,7,0.0376344086021505
NORESTE 2,2023-12-02,292,285,7,0.023972602739726
NORESTE 2,2023-12-03,194,190,4,0.0206185567010309
NORESTE 2,2023-12-04,190,174,16,0.0842105263157895
NORESTE 2,2023-12-05,199,189,10,0.050251256281407
NORESTE 2,2023-12-06,177,168,9,0.0508474576271186
NORESTE 2,2023-12-07,219,211,8,0.0365296803652968
NORESTE 2,2023-12-08,207,201,6,0.0289855072463768
NORESTE 2,2023-12-09,276,265,11,0.0398550724637681
NORESTE 2,2023-12-10,224,213,11,0.0491071428571429
NORESTE 2,2023-12-11,121,115,6,0.0495867768595041
NORESTE 2,2023-12-12,222,213,9,0.0405405405405405
NORESTE 2,2023-12-13,158,153,5,0.0316455696202532
NORESTE 2,2023-12-14,194,186,8,0.0412371134020619
NORESTE 2,2023-12-15,206,200,6,0.029126213592233
NORESTE 2,2023-12-16,219,210,9,0.0410958904109589
NORESTE 2,2023-12-17,158,152,6,0.0379746835443038
NORESTE 2,2023-12-18,168,161,7,0.0416666666666667
NORESTE 2,2023-12-19,212,206,6,0.0283018867924528
NORESTE 2,2023-12-20,243,237,6,0.0246913580246914
NORESTE 2,2023-12-21,196,185,11,0.0561224489795918
NORESTE 2,2023-12-22,219,213,6,0.0273972602739726
NORESTE 2,2023-12-23,244,235,9,0.0368852459016393
NORESTE 2,2023-12-24,134,132,2,0.0149253731343284
NORESTE 2,2023-12-25,48,48,0,0
NORESTE 2,2023-12-26,168,163,5,0.0297619047619048
NORESTE 2,2023-12-27,218,208,10,0.0458715596330275
NORESTE 2,2023-12-28,219,213,6,0.0273972602739726
NORESTE 2,2023-12-29,263,253,10,0.0380228136882129
NORESTE 2,2023-12-30,249,246,3,0.0120481927710843
NORESTE 2,2023-12-31,124,119,5,0.0403225806451613
NORESTE 2,2024-01-01,30,29,1,0.0333333333333333
NORESTE 2,2024-01-02,143,137,6,0.041958041958042
NORESTE 2,2024-01-03,217,209,8,0.0368663594470046
NORESTE 2,2024-01-04,199,193,6,0.0301507537688442
NORESTE 2,2024-01-05,227,214,13,0.0572687224669604
NORESTE 2,2024-01-06,301,285,16,0.053156146179402
NORESTE 2,2024-01-07,167,164,3,0.0179640718562874
NORESTE 2,2024-01-08,153,148,5,0.0326797385620915
NORESTE 2,2024-01-09,189,179,10,0.0529100529100529
NORESTE 2,2024-01-10,189,179,10,0.0529100529100529
NORESTE 2,2024-01-11,216,213,3,0.0138888888888889
NORESTE 2,2024-01-12,260,253,7,0.0269230769230769
NORESTE 2,2024-01-13,275,273,2,0.00727272727272727
NORESTE 2,2024-01-14,216,214,2,0.00925925925925926
NORESTE 2,2024-01-15,186,180,6,0.032258064516129
NORESTE 2,2024-01-16,219,215,4,0.0182648401826484
NORESTE 2,2024-01-17,219,212,7,0.0319634703196347
NORESTE 2,2024-01-18,240,231,9,0.0375
NORESTE 2,2024-01-19,208,204,4,0.0192307692307692
NORESTE 2,2024-01-20,250,240,10,0.04
NORESTE 2,2024-01-21,208,202,6,0.0288461538461538
NORESTE 2,2024-01-22,181,179,2,0.0110497237569061
NORESTE 2,2024-01-23,226,213,13,0.0575221238938053
NORESTE 2,2024-01-24,213,204,9,0.0422535211267606
NORESTE 2,2024-01-25,254,246,8,0.031496062992126
NORESTE 2,2024-01-26,237,226,11,0.0464135021097046
NORESTE 2,2024-01-27,250,246,4,0.016
NORESTE 2,2024-01-28,190,183,7,0.0368421052631579
NORESTE 2,2024-01-29,196,182,14,0.0714285714285714
NORESTE 2,2024-01-30,179,172,7,0.0391061452513966
NORESTE 2,2024-01-31,211,207,4,0.018957345971564
NORESTE 2,2024-02-01,189,179,10,0.0529100529100529
NORESTE 2,2024-02-02,221,211,10,0.0452488687782805
NORESTE 2,2024-02-03,240,226,14,0.0583333333333333
NORESTE 2,2024-02-04,161,156,5,0.031055900621118
NORESTE 2,2024-02-05,118,117,1,0.00847457627118644
NORESTE 2,2024-02-06,161,159,2,0.0124223602484472
NORESTE 2,2024-02-07,175,168,7,0.04
NORESTE 2,2024-02-08,226,226,0,0
NORESTE 2,2024-02-09,209,201,8,0.0382775119617225
NORESTE 2,2024-02-10,234,228,6,0.0256410256410256
NORESTE 2,2024-02-11,170,167,3,0.0176470588235294
NORESTE 2,2024-02-12,130,125,5,0.0384615384615385
NORESTE 2,2024-02-13,226,222,4,0.0176991150442478
NORESTE 2,2024-02-14,176,170,6,0.0340909090909091
NORESTE 2,2024-02-15,188,181,7,0.0372340425531915
NORESTE 2,2024-02-16,214,206,8,0.0373831775700935
NORESTE 2,2024-02-17,166,162,4,0.0240963855421687
NORESTE 2,2024-02-18,201,198,3,0.0149253731343284
NORESTE 2,2024-02-19,181,177,4,0.0220994475138122
NORESTE 2,2024-02-20,191,188,3,0.0157068062827225
NORESTE 2,2024-02-21,215,213,2,0.00930232558139535
NORESTE 2,2024-02-22,224,222,2,0.00892857142857143
NORESTE 2,2024-02-23,198,169,29,0.146464646464646
NORESTE 2,2024-02-24,276,269,7,0.0253623188405797
NORESTE 2,2024-02-25,168,165,3,0.0178571428571429
NORESTE 2,2024-02-26,187,178,9,0.0481283422459893
NORESTE 2,2024-02-27,219,213,6,0.0273972602739726
NORESTE 2,2024-02-28,167,160,7,0.0419161676646707
NORESTE 2,2024-02-29,197,188,9,0.0456852791878173
NORESTE 2,2024-03-01,212,206,6,0.0283018867924528
NORESTE 2,2024-03-02,223,218,5,0.0224215246636771
NORESTE 2,2024-03-03,168,164,4,0.0238095238095238
NORESTE 2,2024-03-04,189,183,6,0.0317460317460317
NORESTE 2,2024-03-05,201,198,3,0.0149253731343284
NORESTE 2,2024-03-06,193,188,5,0.0259067357512953
NORESTE 2,2024-03-07,195,190,5,0.0256410256410256
NORESTE 2,2024-03-08,175,170,5,0.0285714285714286
NORESTE 2,2024-03-09,238,232,6,0.0252100840336134
NORESTE 2,2024-03-10,174,171,3,0.0172413793103448
NORESTE 2,2024-03-11,196,191,5,0.0255102040816327
NORESTE 2,2024-03-12,161,161,0,0
NORESTE 2,2024-03-13,196,192,4,0.0204081632653061
NORESTE 2,2024-03-14,204,202,2,0.00980392156862745
NORESTE 2,2024-03-15,219,214,5,0.0228310502283105
NORESTE 2,2024-03-16,229,227,2,0.00873362445414847
NORESTE 2,2024-03-17,177,171,6,0.0338983050847458
NORESTE 2,2024-03-18,160,156,4,0.025
NORESTE 2,2024-03-19,193,187,6,0.0310880829015544
NORESTE 2,2024-03-20,181,177,4,0.0220994475138122
NORESTE 2,2024-03-21,179,175,4,0.0223463687150838
NORESTE 2,2024-03-22,205,199,6,0.0292682926829268
NORESTE 2,2024-03-23,249,243,6,0.0240963855421687
NORESTE 2,2024-03-24,134,130,4,0.0298507462686567
NORESTE 2,2024-03-25,201,195,6,0.0298507462686567
NORESTE 2,2024-03-26,231,226,5,0.0216450216450216
NORESTE 2,2024-03-27,232,225,7,0.0301724137931034
NORESTE 2,2024-03-28,261,252,9,0.0344827586206897
NORESTE 2,2024-03-29,229,218,11,0.0480349344978166
NORESTE 2,2024-03-30,192,184,8,0.0416666666666667
NORESTE 2,2024-03-31,148,140,8,0.0540540540540541
NORESTE 2,2024-04-01,195,191,4,0.0205128205128205
NORESTE 2,2024-04-02,216,210,6,0.0277777777777778
NORESTE 2,2024-04-03,198,198,0,0
NORESTE 2,2024-04-04,182,182,0,0
NORESTE 2,2024-04-05,199,194,5,0.0251256281407035
NORESTE 2,2024-04-06,235,234,1,0.00425531914893617
NORESTE 2,2024-04-07,154,152,2,0.012987012987013
NORESTE 2,2024-04-08,147,145,2,0.0136054421768707
NORESTE 2,2024-04-09,166,162,4,0.0240963855421687
NORESTE 2,2024-04-10,192,188,4,0.0208333333333333
NORESTE 2,2024-04-11,185,184,1,0.00540540540540541
NORESTE 2,2024-04-12,191,188,3,0.0157068062827225
NORESTE 2,2024-04-13,267,261,6,0.0224719101123595
NORESTE 2,2024-04-14,176,176,0,0
NORESTE 2,2024-04-15,194,189,5,0.0257731958762887
NORESTE 2,2024-04-16,199,182,17,0.085427135678392
NORESTE 2,2024-04-17,213,203,10,0.0469483568075117
NORESTE 2,2024-04-18,198,192,6,0.0303030303030303
NORESTE 2,2024-04-19,187,176,11,0.0588235294117647
NORESTE 2,2024-04-20,223,210,13,0.0582959641255605
NORESTE 2,2024-04-21,124,120,4,0.032258064516129
NORESTE 2,2024-04-22,74,71,3,0.0405405405405405
NORESTE 2,2024-04-23,253,239,14,0.0553359683794466
NORESTE 2,2024-04-24,193,191,2,0.0103626943005181
NORESTE 2,2024-04-25,169,165,4,0.0236686390532544
NORESTE 2,2024-04-26,206,203,3,0.0145631067961165
NORESTE 2,2024-04-27,226,215,11,0.0486725663716814
NORESTE 2,2024-04-28,167,157,10,0.0598802395209581
NORESTE 2,2024-04-29,200,190,10,0.05
NORESTE 2,2024-04-30,150,145,5,0.0333333333333333
NORESTE 2,2024-05-01,122,119,3,0.0245901639344262
NORESTE 2,2024-05-02,157,152,5,0.0318471337579618
NORESTE 2,2024-05-03,185,179,6,0.0324324324324324
NORESTE 2,2024-05-04,208,203,5,0.0240384615384615
NORESTE 2,2024-05-05,141,139,2,0.0141843971631206
NORESTE 2,2024-05-06,180,180,0,0
NORESTE 2,2024-05-07,185,181,4,0.0216216216216216
NORESTE 2,2024-05-08,170,166,4,0.0235294117647059
NORESTE 2,2024-05-09,175,170,5,0.0285714285714286
NORESTE 2,2024-05-10,166,161,5,0.0301204819277108
NORESTE 2,2024-05-11,191,186,5,0.0261780104712042
NORESTE 2,2024-05-12,116,112,4,0.0344827586206897
NORESTE 2,2024-05-13,171,165,6,0.0350877192982456
NORESTE 2,2024-05-14,181,168,13,0.0718232044198895
NORESTE 2,2024-05-15,179,176,3,0.0167597765363128
NORESTE 2,2024-05-16,196,183,13,0.0663265306122449
NORESTE 2,2024-05-17,207,200,7,0.0338164251207729
NORESTE 2,2024-05-18,254,248,6,0.0236220472440945
NORESTE 2,2024-05-19,189,180,9,0.0476190476190476
NORESTE 2,2024-05-20,196,195,1,0.00510204081632653
NORESTE 2,2024-05-21,165,158,7,0.0424242424242424
NORESTE 2,2024-05-22,199,196,3,0.0150753768844221
NORESTE 2,2024-05-23,157,154,3,0.0191082802547771
NORESTE 2,2024-05-24,188,182,6,0.0319148936170213
NORESTE 2,2024-05-25,247,243,4,0.0161943319838057
NORESTE 2,2024-05-26,168,161,7,0.0416666666666667
NORESTE 2,2024-05-27,154,153,1,0.00649350649350649
NORESTE 2,2024-05-28,183,178,5,0.0273224043715847
NORESTE 2,2024-05-29,181,179,2,0.0110497237569061
NORESTE 2,2024-05-30,198,193,5,0.0252525252525253
NORESTE 2,2024-05-31,191,185,6,0.031413612565445
NORESTE 2,2024-06-01,177,170,7,0.0395480225988701
NORESTE 2,2024-06-02,49,49,0,0
NORESTE 2,2024-06-03,83,82,1,0.0120481927710843
NORESTE 2,2024-06-04,189,178,11,0.0582010582010582
NORESTE 2,2024-06-05,190,181,9,0.0473684210526316
NORESTE 2,2024-06-06,149,139,10,0.0671140939597315
NORESTE 2,2024-06-07,136,129,7,0.0514705882352941
NORESTE 2,2024-06-08,190,180,10,0.0526315789473684
NORESTE 2,2024-06-09,152,146,6,0.0394736842105263
NORESTE 2,2024-06-10,197,190,7,0.0355329949238579
NORESTE 2,2024-06-11,237,233,4,0.0168776371308017
NORESTE 2,2024-06-12,201,198,3,0.0149253731343284
NORESTE 2,2024-06-13,208,196,12,0.0576923076923077
NORESTE 2,2024-06-14,56,55,1,0.0178571428571429
NORESTE 2,2024-06-15,48,42,6,0.125
NORESTE 2,2024-06-16,24,23,1,0.0416666666666667
NORESTE 2,2024-06-17,120,119,1,0.00833333333333333
NORESTE 2,2024-06-18,182,177,5,0.0274725274725275
NORESTE 2,2024-06-19,143,139,4,0.027972027972028
NORESTE 2,2024-06-20,33,28,5,0.151515151515152
NORESTE 2,2024-06-21,64,59,5,0.078125
NORESTE 2,2024-06-22,78,75,3,0.0384615384615385
NORESTE 2,2024-06-23,72,69,3,0.0416666666666667
NORESTE 2,2024-06-24,54,51,3,0.0555555555555556
NORESTE 2,2024-06-25,91,85,6,0.0659340659340659
NORESTE 2,2024-06-26,104,98,6,0.0576923076923077
NORESTE 2,2024-06-27,166,155,11,0.0662650602409639
NORESTE 2,2024-06-28,121,115,6,0.0495867768595041
NORESTE 2,2024-06-29,133,127,6,0.0451127819548872
NORESTE 2,2024-06-30,100,96,4,0.04
NORESTE 2,2024-07-01,61,55,6,0.0983606557377049
NORESTE 2,2024-07-02,74,71,3,0.0405405405405405
NORTE BARRANCA,2023-07-03,162,158,4,0.0246913580246914
NORTE BARRANCA,2023-07-04,139,134,5,0.0359712230215827
NORTE BARRANCA,2023-07-05,120,114,6,0.05
NORTE BARRANCA,2023-07-06,77,76,1,0.012987012987013
NORTE BARRANCA,2023-07-07,52,52,0,0
NORTE BARRANCA,2023-07-08,127,127,0,0
NORTE BARRANCA,2023-07-09,88,87,1,0.0113636363636364
NORTE BARRANCA,2023-07-10,123,117,6,0.0487804878048781
NORTE BARRANCA,2023-07-11,84,80,4,0.0476190476190476
NORTE BARRANCA,2023-07-12,116,115,1,0.00862068965517241
NORTE BARRANCA,2023-07-13,74,73,1,0.0135135135135135
NORTE BARRANCA,2023-07-14,138,134,4,0.0289855072463768
NORTE BARRANCA,2023-07-15,108,103,5,0.0462962962962963
NORTE BARRANCA,2023-07-16,53,51,2,0.0377358490566038
NORTE BARRANCA,2023-07-17,118,113,5,0.0423728813559322
NORTE BARRANCA,2023-07-18,115,115,0,0
NORTE BARRANCA,2023-07-19,116,114,2,0.0172413793103448
NORTE BARRANCA,2023-07-20,168,167,1,0.00595238095238095
NORTE BARRANCA,2023-07-21,159,158,1,0.00628930817610063
NORTE BARRANCA,2023-07-22,181,178,3,0.0165745856353591
NORTE BARRANCA,2023-07-23,73,72,1,0.0136986301369863
NORTE BARRANCA,2023-07-24,139,137,2,0.0143884892086331
NORTE BARRANCA,2023-07-25,161,159,2,0.0124223602484472
NORTE BARRANCA,2023-07-26,133,131,2,0.0150375939849624
NORTE BARRANCA,2023-07-27,150,147,3,0.02
NORTE BARRANCA,2023-07-28,181,179,2,0.0110497237569061
NORTE BARRANCA,2023-07-29,155,151,4,0.0258064516129032
NORTE BARRANCA,2023-07-30,92,91,1,0.0108695652173913
NORTE BARRANCA,2023-07-31,126,126,0,0
NORTE BARRANCA,2023-08-01,147,145,2,0.0136054421768707
NORTE BARRANCA,2023-08-02,151,145,6,0.0397350993377483
NORTE BARRANCA,2023-08-03,134,116,18,0.134328358208955
NORTE BARRANCA,2023-08-04,188,182,6,0.0319148936170213
NORTE BARRANCA,2023-08-05,169,167,2,0.0118343195266272
NORTE BARRANCA,2023-08-06,99,96,3,0.0303030303030303
NORTE BARRANCA,2023-08-07,126,124,2,0.0158730158730159
NORTE BARRANCA,2023-08-08,112,107,5,0.0446428571428571
NORTE BARRANCA,2023-08-09,137,136,1,0.0072992700729927
NORTE BARRANCA,2023-08-10,140,138,2,0.0142857142857143
NORTE BARRANCA,2023-08-11,162,159,3,0.0185185185185185
NORTE BARRANCA,2023-08-12,145,142,3,0.0206896551724138
NORTE BARRANCA,2023-08-13,114,113,1,0.0087719298245614
NORTE BARRANCA,2023-08-14,113,111,2,0.0176991150442478
NORTE BARRANCA,2023-08-15,122,119,3,0.0245901639344262
NORTE BARRANCA,2023-08-16,77,75,2,0.025974025974026
NORTE BARRANCA,2023-08-17,112,109,3,0.0267857142857143
NORTE BARRANCA,2023-08-18,106,102,4,0.0377358490566038
NORTE BARRANCA,2023-08-19,121,120,1,0.00826446280991736
NORTE BARRANCA,2023-08-20,58,58,0,0
NORTE BARRANCA,2023-08-21,154,154,0,0
NORTE BARRANCA,2023-08-22,126,126,0,0
NORTE BARRANCA,2023-08-23,146,144,2,0.0136986301369863
NORTE BARRANCA,2023-08-24,116,116,0,0
NORTE BARRANCA,2023-08-25,148,147,1,0.00675675675675676
NORTE BARRANCA,2023-08-26,204,203,1,0.00490196078431373
NORTE BARRANCA,2023-08-27,122,122,0,0
NORTE BARRANCA,2023-08-28,150,150,0,0
NORTE BARRANCA,2023-08-29,145,145,0,0
NORTE BARRANCA,2023-08-30,142,142,0,0
NORTE BARRANCA,2023-08-31,146,146,0,0
NORTE BARRANCA,2023-09-01,133,133,0,0
NORTE BARRANCA,2023-09-02,153,153,0,0
NORTE BARRANCA,2023-09-03,102,102,0,0
NORTE BARRANCA,2023-09-04,154,154,0,0
NORTE BARRANCA,2023-09-05,155,154,1,0.00645161290322581
NORTE BARRANCA,2023-09-06,146,146,0,0
NORTE BARRANCA,2023-09-07,131,131,0,0
NORTE BARRANCA,2023-09-08,176,175,1,0.00568181818181818
NORTE BARRANCA,2023-09-09,159,159,0,0
NORTE BARRANCA,2023-09-10,88,87,1,0.0113636363636364
NORTE BARRANCA,2023-09-11,141,141,0,0
NORTE BARRANCA,2023-09-12,132,132,0,0
NORTE BARRANCA,2023-09-13,139,138,1,0.00719424460431655
NORTE BARRANCA,2023-09-14,111,111,0,0
NORTE BARRANCA,2023-09-15,137,137,0,0
NORTE BARRANCA,2023-09-16,93,93,0,0
NORTE BARRANCA,2023-09-17,100,100,0,0
NORTE BARRANCA,2023-09-18,182,182,0,0
NORTE BARRANCA,2023-09-19,159,159,0,0
NORTE BARRANCA,2023-09-20,143,143,0,0
NORTE BARRANCA,2023-09-21,129,128,1,0.00775193798449612
NORTE BARRANCA,2023-09-22,165,164,1,0.00606060606060606
NORTE BARRANCA,2023-09-23,198,197,1,0.00505050505050505
NORTE BARRANCA,2023-09-24,95,94,1,0.0105263157894737
NORTE BARRANCA,2023-09-25,137,137,0,0
NORTE BARRANCA,2023-09-26,145,145,0,0
NORTE BARRANCA,2023-09-27,124,124,0,0
NORTE BARRANCA,2023-09-28,147,147,0,0
NORTE BARRANCA,2023-09-29,116,115,1,0.00862068965517241
NORTE BARRANCA,2023-09-30,172,171,1,0.00581395348837209
NORTE BARRANCA,2023-10-01,90,89,1,0.0111111111111111
NORTE BARRANCA,2023-10-02,120,119,1,0.00833333333333333
NORTE BARRANCA,2023-10-03,133,130,3,0.0225563909774436
NORTE BARRANCA,2023-10-04,141,138,3,0.0212765957446809
NORTE BARRANCA,2023-10-05,132,129,3,0.0227272727272727
NORTE BARRANCA,2023-10-06,163,159,4,0.0245398773006135
NORTE BARRANCA,2023-10-07,184,182,2,0.0108695652173913
NORTE BARRANCA,2023-10-08,105,104,1,0.00952380952380952
NORTE BARRANCA,2023-10-09,136,134,2,0.0147058823529412
NORTE BARRANCA,2023-10-10,134,130,4,0.0298507462686567
NORTE BARRANCA,2023-10-11,126,125,1,0.00793650793650794
NORTE BARRANCA,2023-10-12,121,119,2,0.0165289256198347
NORTE BARRANCA,2023-10-13,134,128,6,0.0447761194029851
NORTE BARRANCA,2023-10-14,153,151,2,0.0130718954248366
NORTE BARRANCA,2023-10-15,117,117,0,0
NORTE BARRANCA,2023-10-16,144,142,2,0.0138888888888889
NORTE BARRANCA,2023-10-17,126,124,2,0.0158730158730159
NORTE BARRANCA,2023-10-18,125,122,3,0.024
NORTE BARRANCA,2023-10-19,134,130,4,0.0298507462686567
NORTE BARRANCA,2023-10-20,145,143,2,0.0137931034482759
NORTE BARRANCA,2023-10-21,204,200,4,0.0196078431372549
NORTE BARRANCA,2023-10-22,103,99,4,0.0388349514563107
NORTE BARRANCA,2023-10-23,141,137,4,0.0283687943262411
NORTE BARRANCA,2023-10-24,131,128,3,0.0229007633587786
NORTE BARRANCA,2023-10-25,131,124,7,0.0534351145038168
NORTE BARRANCA,2023-10-26,159,155,4,0.0251572327044025
NORTE BARRANCA,2023-10-27,150,149,1,0.00666666666666667
NORTE BARRANCA,2023-10-28,159,158,1,0.00628930817610063
NORTE BARRANCA,2023-10-29,90,89,1,0.0111111111111111
NORTE BARRANCA,2023-10-30,123,120,3,0.024390243902439
NORTE BARRANCA,2023-10-31,110,108,2,0.0181818181818182
NORTE BARRANCA,2023-11-01,134,132,2,0.0149253731343284
NORTE BARRANCA,2023-11-02,165,162,3,0.0181818181818182
NORTE BARRANCA,2023-11-03,122,119,3,0.0245901639344262
NORTE BARRANCA,2023-11-04,173,172,1,0.00578034682080925
NORTE BARRANCA,2023-11-05,130,129,1,0.00769230769230769
NORTE BARRANCA,2023-11-06,134,132,2,0.0149253731343284
NORTE BARRANCA,2023-11-07,163,159,4,0.0245398773006135
NORTE BARRANCA,2023-11-08,164,161,3,0.0182926829268293
NORTE BARRANCA,2023-11-09,173,170,3,0.0173410404624277
NORTE BARRANCA,2023-11-10,156,152,4,0.0256410256410256
NORTE BARRANCA,2023-11-11,212,209,3,0.0141509433962264
NORTE BARRANCA,2023-11-12,117,115,2,0.0170940170940171
NORTE BARRANCA,2023-11-13,147,144,3,0.0204081632653061
NORTE BARRANCA,2023-11-14,161,159,2,0.0124223602484472
NORTE BARRANCA,2023-11-15,176,176,0,0
NORTE BARRANCA,2023-11-16,151,145,6,0.0397350993377483
NORTE BARRANCA,2023-11-17,178,175,3,0.0168539325842697
NORTE BARRANCA,2023-11-18,212,209,3,0.0141509433962264
NORTE BARRANCA,2023-11-19,146,143,3,0.0205479452054795
NORTE BARRANCA,2023-11-20,154,152,2,0.012987012987013
NORTE BARRANCA,2023-11-21,178,172,6,0.0337078651685393
NORTE BARRANCA,2023-11-22,176,174,2,0.0113636363636364
NORTE BARRANCA,2023-11-23,179,175,4,0.0223463687150838
NORTE BARRANCA,2023-11-24,198,193,5,0.0252525252525253
NORTE BARRANCA,2023-11-25,202,200,2,0.0099009900990099
NORTE BARRANCA,2023-11-26,117,117,0,0
NORTE BARRANCA,2023-11-27,165,164,1,0.00606060606060606
NORTE BARRANCA,2023-11-28,157,151,6,0.0382165605095541
NORTE BARRANCA,2023-11-29,157,151,6,0.0382165605095541
NORTE BARRANCA,2023-11-30,159,158,1,0.00628930817610063
NORTE BARRANCA,2023-12-01,166,161,5,0.0301204819277108
NORTE BARRANCA,2023-12-02,215,209,6,0.027906976744186
NORTE BARRANCA,2023-12-03,156,153,3,0.0192307692307692
NORTE BARRANCA,2023-12-04,171,161,10,0.0584795321637427
NORTE BARRANCA,2023-12-05,171,165,6,0.0350877192982456
NORTE BARRANCA,2023-12-06,174,172,2,0.0114942528735632
NORTE BARRANCA,2023-12-07,185,180,5,0.027027027027027
NORTE BARRANCA,2023-12-08,180,176,4,0.0222222222222222
NORTE BARRANCA,2023-12-09,197,195,2,0.0101522842639594
NORTE BARRANCA,2023-12-10,140,135,5,0.0357142857142857
NORTE BARRANCA,2023-12-11,159,157,2,0.0125786163522013
NORTE BARRANCA,2023-12-12,166,164,2,0.0120481927710843
NORTE BARRANCA,2023-12-13,159,155,4,0.0251572327044025
NORTE BARRANCA,2023-12-14,157,155,2,0.0127388535031847
NORTE BARRANCA,2023-12-15,162,158,4,0.0246913580246914
NORTE BARRANCA,2023-12-16,177,175,2,0.0112994350282486
NORTE BARRANCA,2023-12-17,135,133,2,0.0148148148148148
NORTE BARRANCA,2023-12-18,142,139,3,0.0211267605633803
NORTE BARRANCA,2023-12-19,198,191,7,0.0353535353535354
NORTE BARRANCA,2023-12-20,160,152,8,0.05
NORTE BARRANCA,2023-12-21,168,165,3,0.0178571428571429
NORTE BARRANCA,2023-12-22,147,145,2,0.0136054421768707
NORTE BARRANCA,2023-12-23,157,157,0,0
NORTE BARRANCA,2023-12-24,72,70,2,0.0277777777777778
NORTE BARRANCA,2023-12-25,8,7,1,0.125
NORTE BARRANCA,2023-12-26,161,158,3,0.0186335403726708
NORTE BARRANCA,2023-12-27,172,168,4,0.0232558139534884
NORTE BARRANCA,2023-12-28,181,177,4,0.0220994475138122
NORTE BARRANCA,2023-12-29,174,172,2,0.0114942528735632
NORTE BARRANCA,2023-12-30,177,173,4,0.0225988700564972
NORTE BARRANCA,2023-12-31,67,65,2,0.0298507462686567
NORTE BARRANCA,2024-01-01,5,5,0,0
NORTE BARRANCA,2024-01-02,131,130,1,0.00763358778625954
NORTE BARRANCA,2024-01-03,184,182,2,0.0108695652173913
NORTE BARRANCA,2024-01-04,178,175,3,0.0168539325842697
NORTE BARRANCA,2024-01-05,186,182,4,0.021505376344086
NORTE BARRANCA,2024-01-06,215,213,2,0.00930232558139535
NORTE BARRANCA,2024-01-07,127,127,0,0
NORTE BARRANCA,2024-01-08,109,104,5,0.0458715596330275
NORTE BARRANCA,2024-01-09,205,202,3,0.0146341463414634
NORTE BARRANCA,2024-01-10,199,195,4,0.0201005025125628
NORTE BARRANCA,2024-01-11,89,85,4,0.0449438202247191
NORTE BARRANCA,2024-01-12,182,179,3,0.0164835164835165
NORTE BARRANCA,2024-01-13,219,216,3,0.0136986301369863
NORTE BARRANCA,2024-01-14,133,132,1,0.0075187969924812
NORTE BARRANCA,2024-01-15,92,88,4,0.0434782608695652
NORTE BARRANCA,2024-01-16,200,197,3,0.015
NORTE BARRANCA,2024-01-17,168,166,2,0.0119047619047619
NORTE BARRANCA,2024-01-18,195,192,3,0.0153846153846154
NORTE BARRANCA,2024-01-19,168,163,5,0.0297619047619048
NORTE BARRANCA,2024-01-20,187,183,4,0.0213903743315508
NORTE BARRANCA,2024-01-21,151,151,0,0
NORTE BARRANCA,2024-01-22,175,170,5,0.0285714285714286
NORTE BARRANCA,2024-01-23,166,163,3,0.0180722891566265
NORTE BARRANCA,2024-01-24,144,138,6,0.0416666666666667
NORTE BARRANCA,2024-01-25,149,147,2,0.0134228187919463
NORTE BARRANCA,2024-01-26,204,202,2,0.00980392156862745
NORTE BARRANCA,2024-01-27,215,212,3,0.013953488372093
NORTE BARRANCA,2024-01-28,129,129,0,0
NORTE BARRANCA,2024-01-29,154,151,3,0.0194805194805195
NORTE BARRANCA,2024-01-30,146,142,4,0.0273972602739726
NORTE BARRANCA,2024-01-31,151,149,2,0.0132450331125828
NORTE BARRANCA,2024-02-01,173,167,6,0.0346820809248555
NORTE BARRANCA,2024-02-02,164,161,3,0.0182926829268293
NORTE BARRANCA,2024-02-03,178,176,2,0.0112359550561798
NORTE BARRANCA,2024-02-04,164,162,2,0.0121951219512195
NORTE BARRANCA,2024-02-05,156,156,0,0
NORTE BARRANCA,2024-02-06,185,182,3,0.0162162162162162
NORTE BARRANCA,2024-02-07,170,162,8,0.0470588235294118
NORTE BARRANCA,2024-02-08,162,157,5,0.0308641975308642
NORTE BARRANCA,2024-02-09,175,174,1,0.00571428571428571
NORTE BARRANCA,2024-02-10,207,206,1,0.00483091787439614
NORTE BARRANCA,2024-02-11,141,140,1,0.00709219858156028
NORTE BARRANCA,2024-02-12,112,107,5,0.0446428571428571
NORTE BARRANCA,2024-02-13,162,161,1,0.00617283950617284
NORTE BARRANCA,2024-02-14,166,165,1,0.00602409638554217
NORTE BARRANCA,2024-02-15,144,142,2,0.0138888888888889
NORTE BARRANCA,2024-02-16,189,186,3,0.0158730158730159
NORTE BARRANCA,2024-02-17,207,205,2,0.00966183574879227
NORTE BARRANCA,2024-02-18,119,119,0,0
NORTE BARRANCA,2024-02-19,160,158,2,0.0125
NORTE BARRANCA,2024-02-20,157,155,2,0.0127388535031847
NORTE BARRANCA,2024-02-21,174,172,2,0.0114942528735632
NORTE BARRANCA,2024-02-22,191,189,2,0.0104712041884817
NORTE BARRANCA,2024-02-23,103,84,19,0.184466019417476
NORTE BARRANCA,2024-02-24,211,209,2,0.00947867298578199
NORTE BARRANCA,2024-02-25,121,121,0,0
NORTE BARRANCA,2024-02-26,137,135,2,0.0145985401459854
NORTE BARRANCA,2024-02-27,143,139,4,0.027972027972028
NORTE BARRANCA,2024-02-28,136,132,4,0.0294117647058824
NORTE BARRANCA,2024-02-29,166,162,4,0.0240963855421687
NORTE BARRANCA,2024-03-01,162,161,1,0.00617283950617284
NORTE BARRANCA,2024-03-02,188,187,1,0.00531914893617021
NORTE BARRANCA,2024-03-03,127,127,0,0
NORTE BARRANCA,2024-03-04,140,137,3,0.0214285714285714
NORTE BARRANCA,2024-03-05,163,163,0,0
NORTE BARRANCA,2024-03-06,148,146,2,0.0135135135135135
NORTE BARRANCA,2024-03-07,159,157,2,0.0125786163522013
NORTE BARRANCA,2024-03-08,165,162,3,0.0181818181818182
NORTE BARRANCA,2024-03-09,176,175,1,0.00568181818181818
NORTE BARRANCA,2024-03-10,105,105,0,0
NORTE BARRANCA,2024-03-11,127,126,1,0.0078740157480315
NORTE BARRANCA,2024-03-12,162,160,2,0.0123456790123457
NORTE BARRANCA,2024-03-13,125,123,2,0.016
NORTE BARRANCA,2024-03-14,153,152,1,0.0065359477124183
NORTE BARRANCA,2024-03-15,140,139,1,0.00714285714285714
NORTE BARRANCA,2024-03-16,192,190,2,0.0104166666666667
NORTE BARRANCA,2024-03-17,123,122,1,0.00813008130081301
NORTE BARRANCA,2024-03-18,113,110,3,0.0265486725663717
NORTE BARRANCA,2024-03-19,140,140,0,0
NORTE BARRANCA,2024-03-20,135,134,1,0.00740740740740741
NORTE BARRANCA,2024-03-21,160,159,1,0.00625
NORTE BARRANCA,2024-03-22,134,132,2,0.0149253731343284
NORTE BARRANCA,2024-03-23,204,200,4,0.0196078431372549
NORTE BARRANCA,2024-03-24,84,83,1,0.0119047619047619
NORTE BARRANCA,2024-03-25,137,134,3,0.0218978102189781
NORTE BARRANCA,2024-03-26,160,157,3,0.01875
NORTE BARRANCA,2024-03-27,145,143,2,0.0137931034482759
NORTE BARRANCA,2024-03-28,188,184,4,0.0212765957446809
NORTE BARRANCA,2024-03-29,179,176,3,0.0167597765363128
NORTE BARRANCA,2024-03-30,147,146,1,0.00680272108843537
NORTE BARRANCA,2024-03-31,88,88,0,0
NORTE BARRANCA,2024-04-01,124,123,1,0.00806451612903226
NORTE BARRANCA,2024-04-02,166,161,5,0.0301204819277108
NORTE BARRANCA,2024-04-03,133,133,0,0
NORTE BARRANCA,2024-04-04,143,143,0,0
NORTE BARRANCA,2024-04-05,162,161,1,0.00617283950617284
NORTE BARRANCA,2024-04-06,161,159,2,0.0124223602484472
NORTE BARRANCA,2024-04-07,103,100,3,0.029126213592233
NORTE BARRANCA,2024-04-08,147,143,4,0.0272108843537415
NORTE BARRANCA,2024-04-09,140,139,1,0.00714285714285714
NORTE BARRANCA,2024-04-10,93,89,4,0.043010752688172
NORTE BARRANCA,2024-04-11,166,162,4,0.0240963855421687
NORTE BARRANCA,2024-04-12,162,158,4,0.0246913580246914
NORTE BARRANCA,2024-04-13,181,177,4,0.0220994475138122
NORTE BARRANCA,2024-04-14,99,98,1,0.0101010101010101
NORTE BARRANCA,2024-04-15,133,130,3,0.0225563909774436
NORTE BARRANCA,2024-04-16,165,155,10,0.0606060606060606
NORTE BARRANCA,2024-04-17,145,135,10,0.0689655172413793
NORTE BARRANCA,2024-04-18,129,127,2,0.0155038759689922
NORTE BARRANCA,2024-04-19,146,140,6,0.0410958904109589
NORTE BARRANCA,2024-04-20,180,175,5,0.0277777777777778
NORTE BARRANCA,2024-04-21,106,104,2,0.0188679245283019
NORTE BARRANCA,2024-04-22,57,52,5,0.087719298245614
NORTE BARRANCA,2024-04-23,189,179,10,0.0529100529100529
NORTE BARRANCA,2024-04-24,137,130,7,0.0510948905109489
NORTE BARRANCA,2024-04-25,112,108,4,0.0357142857142857
NORTE BARRANCA,2024-04-26,169,167,2,0.0118343195266272
NORTE BARRANCA,2024-04-27,158,149,9,0.0569620253164557
NORTE BARRANCA,2024-04-28,99,96,3,0.0303030303030303
NORTE BARRANCA,2024-04-29,125,124,1,0.008
NORTE BARRANCA,2024-04-30,132,127,5,0.0378787878787879
NORTE BARRANCA,2024-05-01,128,127,1,0.0078125
NORTE BARRANCA,2024-05-02,141,136,5,0.0354609929078014
NORTE BARRANCA,2024-05-03,160,157,3,0.01875
NORTE BARRANCA,2024-05-04,179,173,6,0.0335195530726257
NORTE BARRANCA,2024-05-05,90,86,4,0.0444444444444444
NORTE BARRANCA,2024-05-06,128,128,0,0
NORTE BARRANCA,2024-05-07,133,126,7,0.0526315789473684
NORTE BARRANCA,2024-05-08,124,116,8,0.0645161290322581
NORTE BARRANCA,2024-05-09,153,147,6,0.0392156862745098
NORTE BARRANCA,2024-05-10,123,120,3,0.024390243902439
NORTE BARRANCA,2024-05-11,136,132,4,0.0294117647058824
NORTE BARRANCA,2024-05-12,90,86,4,0.0444444444444444
NORTE BARRANCA,2024-05-13,130,124,6,0.0461538461538462
NORTE BARRANCA,2024-05-14,134,132,2,0.0149253731343284
NORTE BARRANCA,2024-05-15,146,142,4,0.0273972602739726
NORTE BARRANCA,2024-05-16,150,126,24,0.16
NORTE BARRANCA,2024-05-17,158,151,7,0.0443037974683544
NORTE BARRANCA,2024-05-18,198,191,7,0.0353535353535354
NORTE BARRANCA,2024-05-19,124,116,8,0.0645161290322581
NORTE BARRANCA,2024-05-20,118,116,2,0.0169491525423729
NORTE BARRANCA,2024-05-21,149,146,3,0.0201342281879195
NORTE BARRANCA,2024-05-22,129,124,5,0.0387596899224806
NORTE BARRANCA,2024-05-23,136,134,2,0.0147058823529412
NORTE BARRANCA,2024-05-24,138,135,3,0.0217391304347826
NORTE BARRANCA,2024-05-25,187,181,6,0.0320855614973262
NORTE BARRANCA,2024-05-26,103,103,0,0
NORTE BARRANCA,2024-05-27,130,125,5,0.0384615384615385
NORTE BARRANCA,2024-05-28,130,130,0,0
NORTE BARRANCA,2024-05-29,116,111,5,0.0431034482758621
NORTE BARRANCA,2024-05-30,116,114,2,0.0172413793103448
NORTE BARRANCA,2024-05-31,141,139,2,0.0141843971631206
NORTE BARRANCA,2024-06-01,161,158,3,0.0186335403726708
NORTE BARRANCA,2024-06-02,81,78,3,0.037037037037037
NORTE BARRANCA,2024-06-03,143,140,3,0.020979020979021
NORTE BARRANCA,2024-06-04,158,155,3,0.0189873417721519
NORTE BARRANCA,2024-06-05,158,155,3,0.0189873417721519
NORTE BARRANCA,2024-06-06,134,129,5,0.0373134328358209
NORTE BARRANCA,2024-06-07,140,139,1,0.00714285714285714
NORTE BARRANCA,2024-06-08,166,161,5,0.0301204819277108
NORTE BARRANCA,2024-06-09,116,111,5,0.0431034482758621
NORTE BARRANCA,2024-06-10,123,119,4,0.032520325203252
NORTE BARRANCA,2024-06-11,139,134,5,0.0359712230215827
NORTE BARRANCA,2024-06-12,122,118,4,0.0327868852459016
NORTE BARRANCA,2024-06-13,130,130,0,0
NORTE BARRANCA,2024-06-14,143,141,2,0.013986013986014
NORTE BARRANCA,2024-06-15,146,145,1,0.00684931506849315
NORTE BARRANCA,2024-06-16,73,72,1,0.0136986301369863
NORTE BARRANCA,2024-06-17,107,104,3,0.0280373831775701
NORTE BARRANCA,2024-06-18,150,147,3,0.02
NORTE BARRANCA,2024-06-19,58,57,1,0.0172413793103448
NORTE BARRANCA,2024-06-20,47,46,1,0.0212765957446809
NORTE BARRANCA,2024-06-21,99,96,3,0.0303030303030303
NORTE BARRANCA,2024-06-22,217,213,4,0.0184331797235023
NORTE BARRANCA,2024-06-23,124,122,2,0.0161290322580645
NORTE BARRANCA,2024-06-24,165,161,4,0.0242424242424242
NORTE BARRANCA,2024-06-25,138,137,1,0.0072463768115942
NORTE BARRANCA,2024-06-26,154,149,5,0.0324675324675325
NORTE BARRANCA,2024-06-27,136,132,4,0.0294117647058824
NORTE BARRANCA,2024-06-28,136,135,1,0.00735294117647059
NORTE BARRANCA,2024-06-29,166,161,5,0.0301204819277108
NORTE BARRANCA,2024-06-30,101,99,2,0.0198019801980198
NORTE BARRANCA,2024-07-01,55,54,1,0.0181818181818182
NORTE BARRANCA,2024-07-02,117,117,0,0
NORTE LA BAJA,2023-07-03,162,153,9,0.0555555555555556
NORTE LA BAJA,2023-07-04,181,178,3,0.0165745856353591
NORTE LA BAJA,2023-07-05,103,101,2,0.0194174757281553
NORTE LA BAJA,2023-07-06,111,104,7,0.0630630630630631
NORTE LA BAJA,2023-07-07,135,134,1,0.00740740740740741
NORTE LA BAJA,2023-07-08,188,186,2,0.0106382978723404
NORTE LA BAJA,2023-07-09,189,189,0,0
NORTE LA BAJA,2023-07-10,201,189,12,0.0597014925373134
NORTE LA BAJA,2023-07-11,160,156,4,0.025
NORTE LA BAJA,2023-07-12,192,182,10,0.0520833333333333
NORTE LA BAJA,2023-07-13,191,184,7,0.0366492146596859
NORTE LA BAJA,2023-07-14,153,149,4,0.0261437908496732
NORTE LA BAJA,2023-07-15,182,176,6,0.032967032967033
NORTE LA BAJA,2023-07-16,146,139,7,0.0479452054794521
NORTE LA BAJA,2023-07-17,185,181,4,0.0216216216216216
NORTE LA BAJA,2023-07-18,185,178,7,0.0378378378378378
NORTE LA BAJA,2023-07-19,177,169,8,0.0451977401129944
NORTE LA BAJA,2023-07-20,189,186,3,0.0158730158730159
NORTE LA BAJA,2023-07-21,180,176,4,0.0222222222222222
NORTE LA BAJA,2023-07-22,204,198,6,0.0294117647058824
NORTE LA BAJA,2023-07-23,159,154,5,0.0314465408805031
NORTE LA BAJA,2023-07-24,174,171,3,0.0172413793103448
NORTE LA BAJA,2023-07-25,170,165,5,0.0294117647058824
NORTE LA BAJA,2023-07-26,189,181,8,0.0423280423280423
NORTE LA BAJA,2023-07-27,151,150,1,0.00662251655629139
NORTE LA BAJA,2023-07-28,191,185,6,0.031413612565445
NORTE LA BAJA,2023-07-29,219,213,6,0.0273972602739726
NORTE LA BAJA,2023-07-30,159,154,5,0.0314465408805031
NORTE LA BAJA,2023-07-31,176,171,5,0.0284090909090909
NORTE LA BAJA,2023-08-01,193,180,13,0.0673575129533679
NORTE LA BAJA,2023-08-02,165,157,8,0.0484848484848485
NORTE LA BAJA,2023-08-03,200,169,31,0.155
NORTE LA BAJA,2023-08-04,155,142,13,0.0838709677419355
NORTE LA BAJA,2023-08-05,172,159,13,0.0755813953488372
NORTE LA BAJA,2023-08-06,174,160,14,0.0804597701149425
NORTE LA BAJA,2023-08-07,153,147,6,0.0392156862745098
NORTE LA BAJA,2023-08-08,191,185,6,0.031413612565445
NORTE LA BAJA,2023-08-09,170,163,7,0.0411764705882353
NORTE LA BAJA,2023-08-10,174,154,20,0.114942528735632
NORTE LA BAJA,2023-08-11,224,213,11,0.0491071428571429
NORTE LA BAJA,2023-08-12,217,188,29,0.133640552995392
NORTE LA BAJA,2023-08-13,177,157,20,0.112994350282486
NORTE LA BAJA,2023-08-14,171,158,13,0.0760233918128655
NORTE LA BAJA,2023-08-15,184,176,8,0.0434782608695652
NORTE LA BAJA,2023-08-16,148,138,10,0.0675675675675676
NORTE LA BAJA,2023-08-17,161,155,6,0.0372670807453416
NORTE LA BAJA,2023-08-18,213,204,9,0.0422535211267606
NORTE LA BAJA,2023-08-19,240,231,9,0.0375
NORTE LA BAJA,2023-08-20,7,7,0,0
NORTE LA BAJA,2023-08-21,35,31,4,0.114285714285714
NORTE LA BAJA,2023-08-22,167,158,9,0.0538922155688623
NORTE LA BAJA,2023-08-23,148,141,7,0.0472972972972973
NORTE LA BAJA,2023-08-24,184,181,3,0.016304347826087
NORTE LA BAJA,2023-08-25,161,150,11,0.0683229813664596
NORTE LA BAJA,2023-08-26,168,159,9,0.0535714285714286
NORTE LA BAJA,2023-08-27,179,175,4,0.0223463687150838
NORTE LA BAJA,2023-08-28,211,202,9,0.042654028436019
NORTE LA BAJA,2023-08-29,187,187,0,0
NORTE LA BAJA,2023-08-30,217,217,0,0
NORTE LA BAJA,2023-08-31,218,217,1,0.00458715596330275
NORTE LA BAJA,2023-09-01,167,164,3,0.0179640718562874
NORTE LA BAJA,2023-09-02,220,217,3,0.0136363636363636
NORTE LA BAJA,2023-09-03,178,176,2,0.0112359550561798
NORTE LA BAJA,2023-09-04,165,164,1,0.00606060606060606
NORTE LA BAJA,2023-09-05,172,171,1,0.00581395348837209
NORTE LA BAJA,2023-09-06,161,158,3,0.0186335403726708
NORTE LA BAJA,2023-09-07,173,173,0,0
NORTE LA BAJA,2023-09-08,199,198,1,0.0050251256281407
NORTE LA BAJA,2023-09-09,245,240,5,0.0204081632653061
NORTE LA BAJA,2023-09-10,204,202,2,0.00980392156862745
NORTE LA BAJA,2023-09-11,178,173,5,0.0280898876404494
NORTE LA BAJA,2023-09-12,177,177,0,0
NORTE LA BAJA,2023-09-13,166,165,1,0.00602409638554217
NORTE LA BAJA,2023-09-14,169,168,1,0.00591715976331361
NORTE LA BAJA,2023-09-15,184,183,1,0.00543478260869565
NORTE LA BAJA,2023-09-16,148,146,2,0.0135135135135135
NORTE LA BAJA,2023-09-17,202,201,1,0.00495049504950495
NORTE LA BAJA,2023-09-18,206,206,0,0
NORTE LA BAJA,2023-09-19,206,203,3,0.0145631067961165
NORTE LA BAJA,2023-09-20,173,170,3,0.0173410404624277
NORTE LA BAJA,2023-09-21,216,212,4,0.0185185185185185
NORTE LA BAJA,2023-09-22,199,192,7,0.0351758793969849
NORTE LA BAJA,2023-09-23,226,218,8,0.0353982300884956
NORTE LA BAJA,2023-09-24,207,205,2,0.00966183574879227
NORTE LA BAJA,2023-09-25,158,156,2,0.0126582278481013
NORTE LA BAJA,2023-09-26,199,194,5,0.0251256281407035
NORTE LA BAJA,2023-09-27,198,195,3,0.0151515151515152
NORTE LA BAJA,2023-09-28,184,183,1,0.00543478260869565
NORTE LA BAJA,2023-09-29,232,228,4,0.0172413793103448
NORTE LA BAJA,2023-09-30,224,222,2,0.00892857142857143
NORTE LA BAJA,2023-10-01,184,182,2,0.0108695652173913
NORTE LA BAJA,2023-10-02,152,151,1,0.00657894736842105
NORTE LA BAJA,2023-10-03,196,191,5,0.0255102040816327
NORTE LA BAJA,2023-10-04,170,166,4,0.0235294117647059
NORTE LA BAJA,2023-10-05,206,205,1,0.00485436893203883
NORTE LA BAJA,2023-10-06,212,201,11,0.0518867924528302
NORTE LA BAJA,2023-10-07,203,198,5,0.0246305418719212
NORTE LA BAJA,2023-10-08,207,202,5,0.0241545893719807
NORTE LA BAJA,2023-10-09,170,165,5,0.0294117647058824
NORTE LA BAJA,2023-10-10,188,184,4,0.0212765957446809
NORTE LA BAJA,2023-10-11,149,147,2,0.0134228187919463
NORTE LA BAJA,2023-10-12,198,194,4,0.0202020202020202
NORTE LA BAJA,2023-10-13,177,170,7,0.0395480225988701
NORTE LA BAJA,2023-10-14,205,199,6,0.0292682926829268
NORTE LA BAJA,2023-10-15,195,190,5,0.0256410256410256
NORTE LA BAJA,2023-10-16,189,185,4,0.0211640211640212
NORTE LA BAJA,2023-10-17,188,186,2,0.0106382978723404
NORTE LA BAJA,2023-10-18,159,152,7,0.0440251572327044
NORTE LA BAJA,2023-10-19,185,183,2,0.0108108108108108
NORTE LA BAJA,2023-10-20,211,207,4,0.018957345971564
NORTE LA BAJA,2023-10-21,257,251,6,0.0233463035019455
NORTE LA BAJA,2023-10-22,187,182,5,0.0267379679144385
NORTE LA BAJA,2023-10-23,171,168,3,0.0175438596491228
NORTE LA BAJA,2023-10-24,187,181,6,0.0320855614973262
NORTE LA BAJA,2023-10-25,189,184,5,0.0264550264550265
NORTE LA BAJA,2023-10-26,160,158,2,0.0125
NORTE LA BAJA,2023-10-27,200,194,6,0.03
NORTE LA BAJA,2023-10-28,201,200,1,0.00497512437810945
NORTE LA BAJA,2023-10-29,175,170,5,0.0285714285714286
NORTE LA BAJA,2023-10-30,160,154,6,0.0375
NORTE LA BAJA,2023-10-31,164,161,3,0.0182926829268293
NORTE LA BAJA,2023-11-01,180,176,4,0.0222222222222222
NORTE LA BAJA,2023-11-02,194,190,4,0.0206185567010309
NORTE LA BAJA,2023-11-03,192,186,6,0.03125
NORTE LA BAJA,2023-11-04,255,245,10,0.0392156862745098
NORTE LA BAJA,2023-11-05,197,194,3,0.0152284263959391
NORTE LA BAJA,2023-11-06,203,197,6,0.0295566502463054
NORTE LA BAJA,2023-11-07,195,192,3,0.0153846153846154
NORTE LA BAJA,2023-11-08,213,206,7,0.0328638497652582
NORTE LA BAJA,2023-11-09,189,185,4,0.0211640211640212
NORTE LA BAJA,2023-11-10,231,228,3,0.012987012987013
NORTE LA BAJA,2023-11-11,245,240,5,0.0204081632653061
NORTE LA BAJA,2023-11-12,237,227,10,0.0421940928270042
NORTE LA BAJA,2023-11-13,171,167,4,0.0233918128654971
NORTE LA BAJA,2023-11-14,216,207,9,0.0416666666666667
NORTE LA BAJA,2023-11-15,150,146,4,0.0266666666666667
NORTE LA BAJA,2023-11-16,208,205,3,0.0144230769230769
NORTE LA BAJA,2023-11-17,202,200,2,0.0099009900990099
NORTE LA BAJA,2023-11-18,285,277,8,0.0280701754385965
NORTE LA BAJA,2023-11-19,231,225,6,0.025974025974026
NORTE LA BAJA,2023-11-20,142,136,6,0.0422535211267606
NORTE LA BAJA,2023-11-21,247,241,6,0.0242914979757085
NORTE LA BAJA,2023-11-22,174,169,5,0.028735632183908
NORTE LA BAJA,2023-11-23,223,216,7,0.031390134529148
NORTE LA BAJA,2023-11-24,228,226,2,0.0087719298245614
NORTE LA BAJA,2023-11-25,258,251,7,0.0271317829457364
NORTE LA BAJA,2023-11-26,227,225,2,0.00881057268722467
NORTE LA BAJA,2023-11-27,183,178,5,0.0273224043715847
NORTE LA BAJA,2023-11-28,237,237,0,0
NORTE LA BAJA,2023-11-29,192,184,8,0.0416666666666667
NORTE LA BAJA,2023-11-30,161,158,3,0.0186335403726708
NORTE LA BAJA,2023-12-01,210,202,8,0.0380952380952381
NORTE LA BAJA,2023-12-02,246,243,3,0.0121951219512195
NORTE LA BAJA,2023-12-03,198,194,4,0.0202020202020202
NORTE LA BAJA,2023-12-04,211,206,5,0.023696682464455
NORTE LA BAJA,2023-12-05,216,210,6,0.0277777777777778
NORTE LA BAJA,2023-12-06,197,191,6,0.0304568527918782
NORTE LA BAJA,2023-12-07,181,173,8,0.0441988950276243
NORTE LA BAJA,2023-12-08,209,207,2,0.00956937799043062
NORTE LA BAJA,2023-12-09,213,209,4,0.0187793427230047
NORTE LA BAJA,2023-12-10,209,205,4,0.0191387559808612
NORTE LA BAJA,2023-12-11,183,180,3,0.0163934426229508
NORTE LA BAJA,2023-12-12,194,191,3,0.0154639175257732
NORTE LA BAJA,2023-12-13,201,195,6,0.0298507462686567
NORTE LA BAJA,2023-12-14,183,176,7,0.0382513661202186
NORTE LA BAJA,2023-12-15,178,174,4,0.0224719101123595
NORTE LA BAJA,2023-12-16,220,216,4,0.0181818181818182
NORTE LA BAJA,2023-12-17,206,203,3,0.0145631067961165
NORTE LA BAJA,2023-12-18,191,188,3,0.0157068062827225
NORTE LA BAJA,2023-12-19,206,205,1,0.00485436893203883
NORTE LA BAJA,2023-12-20,232,223,9,0.0387931034482759
NORTE LA BAJA,2023-12-21,239,233,6,0.0251046025104603
NORTE LA BAJA,2023-12-22,213,207,6,0.028169014084507
NORTE LA BAJA,2023-12-23,245,240,5,0.0204081632653061
NORTE LA BAJA,2023-12-24,83,80,3,0.036144578313253
NORTE LA BAJA,2023-12-25,8,8,0,0
NORTE LA BAJA,2023-12-26,223,218,5,0.0224215246636771
NORTE LA BAJA,2023-12-27,204,197,7,0.0343137254901961
NORTE LA BAJA,2023-12-28,232,224,8,0.0344827586206897
NORTE LA BAJA,2023-12-29,232,230,2,0.00862068965517241
NORTE LA BAJA,2023-12-30,208,203,5,0.0240384615384615
NORTE LA BAJA,2023-12-31,93,92,1,0.010752688172043
NORTE LA BAJA,2024-01-01,6,6,0,0
NORTE LA BAJA,2024-01-02,206,201,5,0.0242718446601942
NORTE LA BAJA,2024-01-03,152,147,5,0.0328947368421053
NORTE LA BAJA,2024-01-04,224,218,6,0.0267857142857143
NORTE LA BAJA,2024-01-05,248,242,6,0.0241935483870968
NORTE LA BAJA,2024-01-06,249,243,6,0.0240963855421687
NORTE LA BAJA,2024-01-07,241,236,5,0.020746887966805
NORTE LA BAJA,2024-01-08,184,180,4,0.0217391304347826
NORTE LA BAJA,2024-01-09,227,220,7,0.0308370044052863
NORTE LA BAJA,2024-01-10,226,221,5,0.0221238938053097
NORTE LA BAJA,2024-01-11,230,224,6,0.0260869565217391
NORTE LA BAJA,2024-01-12,225,219,6,0.0266666666666667
NORTE LA BAJA,2024-01-13,269,263,6,0.0223048327137546
NORTE LA BAJA,2024-01-14,234,232,2,0.00854700854700855
NORTE LA BAJA,2024-01-15,175,167,8,0.0457142857142857
NORTE LA BAJA,2024-01-16,257,251,6,0.0233463035019455
NORTE LA BAJA,2024-01-17,226,222,4,0.0176991150442478
NORTE LA BAJA,2024-01-18,258,255,3,0.0116279069767442
NORTE LA BAJA,2024-01-19,213,208,5,0.0234741784037559
NORTE LA BAJA,2024-01-20,186,182,4,0.021505376344086
NORTE LA BAJA,2024-01-21,220,214,6,0.0272727272727273
NORTE LA BAJA,2024-01-22,36,35,1,0.0277777777777778
NORTE LA BAJA,2024-01-23,206,204,2,0.00970873786407767
NORTE LA BAJA,2024-01-24,255,240,15,0.0588235294117647
NORTE LA BAJA,2024-01-25,197,194,3,0.0152284263959391
NORTE LA BAJA,2024-01-26,215,210,5,0.0232558139534884
NORTE LA BAJA,2024-01-27,282,275,7,0.024822695035461
NORTE LA BAJA,2024-01-28,220,218,2,0.00909090909090909
NORTE LA BAJA,2024-01-29,152,147,5,0.0328947368421053
NORTE LA BAJA,2024-01-30,219,213,6,0.0273972602739726
NORTE LA BAJA,2024-01-31,234,230,4,0.0170940170940171
NORTE LA BAJA,2024-02-01,52,51,1,0.0192307692307692
NORTE LA BAJA,2024-02-02,249,242,7,0.0281124497991968
NORTE LA BAJA,2024-02-03,287,277,10,0.0348432055749129
NORTE LA BAJA,2024-02-04,256,247,9,0.03515625
NORTE LA BAJA,2024-02-05,64,60,4,0.0625
NORTE LA BAJA,2024-02-06,156,150,6,0.0384615384615385
NORTE LA BAJA,2024-02-07,213,208,5,0.0234741784037559
NORTE LA BAJA,2024-02-08,219,219,0,0
NORTE LA BAJA,2024-02-09,213,207,6,0.028169014084507
NORTE LA BAJA,2024-02-10,297,288,9,0.0303030303030303
NORTE LA BAJA,2024-02-11,213,209,4,0.0187793427230047
NORTE LA BAJA,2024-02-12,165,161,4,0.0242424242424242
NORTE LA BAJA,2024-02-13,270,268,2,0.00740740740740741
NORTE LA BAJA,2024-02-14,221,220,1,0.00452488687782805
NORTE LA BAJA,2024-02-15,159,157,2,0.0125786163522013
NORTE LA BAJA,2024-02-16,259,254,5,0.0193050193050193
NORTE LA BAJA,2024-02-17,292,290,2,0.00684931506849315
NORTE LA BAJA,2024-02-18,261,257,4,0.0153256704980843
NORTE LA BAJA,2024-02-19,214,212,2,0.00934579439252336
NORTE LA BAJA,2024-02-20,236,229,7,0.0296610169491525
NORTE LA BAJA,2024-02-21,225,221,4,0.0177777777777778
NORTE LA BAJA,2024-02-22,193,185,8,0.0414507772020725
NORTE LA BAJA,2024-02-23,140,126,14,0.1
NORTE LA BAJA,2024-02-24,297,293,4,0.0134680134680135
NORTE LA BAJA,2024-02-25,220,216,4,0.0181818181818182
NORTE LA BAJA,2024-02-26,205,203,2,0.00975609756097561
NORTE LA BAJA,2024-02-27,233,224,9,0.0386266094420601
NORTE LA BAJA,2024-02-28,210,199,11,0.0523809523809524
NORTE LA BAJA,2024-02-29,196,193,3,0.0153061224489796
NORTE LA BAJA,2024-03-01,207,203,4,0.0193236714975845
NORTE LA BAJA,2024-03-02,230,225,5,0.0217391304347826
NORTE LA BAJA,2024-03-03,218,214,4,0.018348623853211
NORTE LA BAJA,2024-03-04,208,203,5,0.0240384615384615
NORTE LA BAJA,2024-03-05,189,184,5,0.0264550264550265
NORTE LA BAJA,2024-03-06,195,193,2,0.0102564102564103
NORTE LA BAJA,2024-03-07,213,210,3,0.0140845070422535
NORTE LA BAJA,2024-03-08,229,223,6,0.0262008733624454
NORTE LA BAJA,2024-03-09,266,262,4,0.0150375939849624
NORTE LA BAJA,2024-03-10,246,242,4,0.016260162601626
NORTE LA BAJA,2024-03-11,204,197,7,0.0343137254901961
NORTE LA BAJA,2024-03-12,220,214,6,0.0272727272727273
NORTE LA BAJA,2024-03-13,200,191,9,0.045
NORTE LA BAJA,2024-03-14,209,203,6,0.0287081339712919
NORTE LA BAJA,2024-03-15,220,215,5,0.0227272727272727
NORTE LA BAJA,2024-03-16,247,246,1,0.00404858299595142
NORTE LA BAJA,2024-03-17,215,212,3,0.013953488372093
NORTE LA BAJA,2024-03-18,127,123,4,0.031496062992126
NORTE LA BAJA,2024-03-19,221,214,7,0.0316742081447964
NORTE LA BAJA,2024-03-20,222,217,5,0.0225225225225225
NORTE LA BAJA,2024-03-21,191,188,3,0.0157068062827225
NORTE LA BAJA,2024-03-22,220,214,6,0.0272727272727273
NORTE LA BAJA,2024-03-23,232,228,4,0.0172413793103448
NORTE LA BAJA,2024-03-24,146,143,3,0.0205479452054795
NORTE LA BAJA,2024-03-25,147,141,6,0.0408163265306122
NORTE LA BAJA,2024-03-26,245,238,7,0.0285714285714286
NORTE LA BAJA,2024-03-27,233,226,7,0.0300429184549356
NORTE LA BAJA,2024-03-28,249,247,2,0.00803212851405622
NORTE LA BAJA,2024-03-29,263,258,5,0.0190114068441065
NORTE LA BAJA,2024-03-30,134,131,3,0.0223880597014925
NORTE LA BAJA,2024-03-31,181,176,5,0.0276243093922652
NORTE LA BAJA,2024-04-01,232,223,9,0.0387931034482759
NORTE LA BAJA,2024-04-02,218,216,2,0.00917431192660551
NORTE LA BAJA,2024-04-03,178,178,0,0
NORTE LA BAJA,2024-04-04,180,180,0,0
NORTE LA BAJA,2024-04-05,215,212,3,0.013953488372093
NORTE LA BAJA,2024-04-06,244,242,2,0.00819672131147541
NORTE LA BAJA,2024-04-07,187,181,6,0.0320855614973262
NORTE LA BAJA,2024-04-08,177,173,4,0.0225988700564972
NORTE LA BAJA,2024-04-09,211,202,9,0.042654028436019
NORTE LA BAJA,2024-04-10,191,187,4,0.0209424083769634
NORTE LA BAJA,2024-04-11,203,202,1,0.00492610837438424
NORTE LA BAJA,2024-04-12,211,205,6,0.028436018957346
NORTE LA BAJA,2024-04-13,243,237,6,0.0246913580246914
NORTE LA BAJA,2024-04-14,184,180,4,0.0217391304347826
NORTE LA BAJA,2024-04-15,188,187,1,0.00531914893617021
NORTE LA BAJA,2024-04-16,195,183,12,0.0615384615384615
NORTE LA BAJA,2024-04-17,175,168,7,0.04
NORTE LA BAJA,2024-04-18,196,190,6,0.0306122448979592
NORTE LA BAJA,2024-04-19,224,215,9,0.0401785714285714
NORTE LA BAJA,2024-04-20,237,232,5,0.0210970464135021
NORTE LA BAJA,2024-04-21,192,190,2,0.0104166666666667
NORTE LA BAJA,2024-04-22,88,86,2,0.0227272727272727
NORTE LA BAJA,2024-04-23,260,231,29,0.111538461538462
NORTE LA BAJA,2024-04-24,188,178,10,0.0531914893617021
NORTE LA BAJA,2024-04-25,204,202,2,0.00980392156862745
NORTE LA BAJA,2024-04-26,227,222,5,0.0220264317180617
NORTE LA BAJA,2024-04-27,253,247,6,0.0237154150197628
NORTE LA BAJA,2024-04-28,184,183,1,0.00543478260869565
NORTE LA BAJA,2024-04-29,205,198,7,0.0341463414634146
NORTE LA BAJA,2024-04-30,177,173,4,0.0225988700564972
NORTE LA BAJA,2024-05-01,166,162,4,0.0240963855421687
NORTE LA BAJA,2024-05-02,205,200,5,0.024390243902439
NORTE LA BAJA,2024-05-03,232,228,4,0.0172413793103448
NORTE LA BAJA,2024-05-04,273,267,6,0.021978021978022
NORTE LA BAJA,2024-05-05,171,167,4,0.0233918128654971
NORTE LA BAJA,2024-05-06,203,203,0,0
NORTE LA BAJA,2024-05-07,170,162,8,0.0470588235294118
NORTE LA BAJA,2024-05-08,192,182,10,0.0520833333333333
NORTE LA BAJA,2024-05-09,195,189,6,0.0307692307692308
NORTE LA BAJA,2024-05-10,173,164,9,0.0520231213872832
NORTE LA BAJA,2024-05-11,241,236,5,0.020746887966805
NORTE LA BAJA,2024-05-12,189,184,5,0.0264550264550265
NORTE LA BAJA,2024-05-13,189,181,8,0.0423280423280423
NORTE LA BAJA,2024-05-14,204,201,3,0.0147058823529412
NORTE LA BAJA,2024-05-15,200,193,7,0.035
NORTE LA BAJA,2024-05-16,196,175,21,0.107142857142857
NORTE LA BAJA,2024-05-17,220,214,6,0.0272727272727273
NORTE LA BAJA,2024-05-18,268,258,10,0.0373134328358209
NORTE LA BAJA,2024-05-19,214,208,6,0.0280373831775701
NORTE LA BAJA,2024-05-20,180,175,5,0.0277777777777778
NORTE LA BAJA,2024-05-21,219,216,3,0.0136986301369863
NORTE LA BAJA,2024-05-22,192,187,5,0.0260416666666667
NORTE LA BAJA,2024-05-23,197,195,2,0.0101522842639594
NORTE LA BAJA,2024-05-24,217,213,4,0.0184331797235023
NORTE LA BAJA,2024-05-25,284,280,4,0.0140845070422535
NORTE LA BAJA,2024-05-26,196,190,6,0.0306122448979592
NORTE LA BAJA,2024-05-27,196,192,4,0.0204081632653061
NORTE LA BAJA,2024-05-28,226,221,5,0.0221238938053097
NORTE LA BAJA,2024-05-29,185,178,7,0.0378378378378378
NORTE LA BAJA,2024-05-30,178,173,5,0.0280898876404494
NORTE LA BAJA,2024-05-31,202,197,5,0.0247524752475248
NORTE LA BAJA,2024-06-01,243,240,3,0.0123456790123457
NORTE LA BAJA,2024-06-02,190,188,2,0.0105263157894737
NORTE LA BAJA,2024-06-03,188,180,8,0.0425531914893617
NORTE LA BAJA,2024-06-04,226,219,7,0.0309734513274336
NORTE LA BAJA,2024-06-05,215,211,4,0.0186046511627907
NORTE LA BAJA,2024-06-06,197,193,4,0.0203045685279188
NORTE LA BAJA,2024-06-07,204,195,9,0.0441176470588235
NORTE LA BAJA,2024-06-08,221,209,12,0.0542986425339367
NORTE LA BAJA,2024-06-09,166,161,5,0.0301204819277108
NORTE LA BAJA,2024-06-10,191,184,7,0.0366492146596859
NORTE LA BAJA,2024-06-11,233,226,7,0.0300429184549356
NORTE LA BAJA,2024-06-12,215,211,4,0.0186046511627907
NORTE LA BAJA,2024-06-13,205,203,2,0.00975609756097561
NORTE LA BAJA,2024-06-14,197,190,7,0.0355329949238579
NORTE LA BAJA,2024-06-15,246,238,8,0.032520325203252
NORTE LA BAJA,2024-06-16,175,169,6,0.0342857142857143
NORTE LA BAJA,2024-06-17,197,191,6,0.0304568527918782
NORTE LA BAJA,2024-06-18,218,208,10,0.0458715596330275
NORTE LA BAJA,2024-06-19,231,224,7,0.0303030303030303
NORTE LA BAJA,2024-06-20,208,204,4,0.0192307692307692
NORTE LA BAJA,2024-06-21,258,248,10,0.0387596899224806
NORTE LA BAJA,2024-06-22,287,277,10,0.0348432055749129
NORTE LA BAJA,2024-06-23,184,175,9,0.0489130434782609
NORTE LA BAJA,2024-06-24,232,221,11,0.0474137931034483
NORTE LA BAJA,2024-06-25,241,227,14,0.0580912863070539
NORTE LA BAJA,2024-06-26,190,181,9,0.0473684210526316
NORTE LA BAJA,2024-06-27,196,185,11,0.0561224489795918
NORTE LA BAJA,2024-06-28,205,197,8,0.0390243902439024
NORTE LA BAJA,2024-06-29,268,258,10,0.0373134328358209
NORTE LA BAJA,2024-06-30,194,187,7,0.0360824742268041
NORTE LA BAJA,2024-07-01,203,198,5,0.0246305418719212
NORTE LA BAJA,2024-07-02,230,223,7,0.0304347826086957
OCCIDENTE 1,2023-07-03,183,176,7,0.0382513661202186
OCCIDENTE 1,2023-07-04,215,205,10,0.0465116279069767
OCCIDENTE 1,2023-07-05,127,119,8,0.062992125984252
OCCIDENTE 1,2023-07-06,107,101,6,0.0560747663551402
OCCIDENTE 1,2023-07-07,155,148,7,0.0451612903225806
OCCIDENTE 1,2023-07-08,289,273,16,0.055363321799308
OCCIDENTE 1,2023-07-09,157,149,8,0.0509554140127389
OCCIDENTE 1,2023-07-10,150,140,10,0.0666666666666667
OCCIDENTE 1,2023-07-11,190,174,16,0.0842105263157895
OCCIDENTE 1,2023-07-12,203,188,15,0.0738916256157636
OCCIDENTE 1,2023-07-13,189,177,12,0.0634920634920635
OCCIDENTE 1,2023-07-14,173,160,13,0.0751445086705202
OCCIDENTE 1,2023-07-15,278,256,22,0.079136690647482
OCCIDENTE 1,2023-07-16,130,127,3,0.0230769230769231
OCCIDENTE 1,2023-07-17,172,162,10,0.0581395348837209
OCCIDENTE 1,2023-07-18,173,167,6,0.0346820809248555
OCCIDENTE 1,2023-07-19,158,144,14,0.0886075949367089
OCCIDENTE 1,2023-07-20,208,196,12,0.0576923076923077
OCCIDENTE 1,2023-07-21,166,158,8,0.0481927710843374
OCCIDENTE 1,2023-07-22,238,224,14,0.0588235294117647
OCCIDENTE 1,2023-07-23,135,130,5,0.037037037037037
OCCIDENTE 1,2023-07-24,139,134,5,0.0359712230215827
OCCIDENTE 1,2023-07-25,200,183,17,0.085
OCCIDENTE 1,2023-07-26,211,191,20,0.0947867298578199
OCCIDENTE 1,2023-07-27,190,181,9,0.0473684210526316
OCCIDENTE 1,2023-07-28,191,174,17,0.0890052356020942
OCCIDENTE 1,2023-07-29,235,213,22,0.0936170212765957
OCCIDENTE 1,2023-07-30,166,147,19,0.114457831325301
OCCIDENTE 1,2023-07-31,197,183,14,0.0710659898477157
OCCIDENTE 1,2023-08-01,210,183,27,0.128571428571429
OCCIDENTE 1,2023-08-02,204,184,20,0.0980392156862745
OCCIDENTE 1,2023-08-03,163,122,41,0.251533742331288
OCCIDENTE 1,2023-08-04,171,147,24,0.140350877192982
OCCIDENTE 1,2023-08-05,224,205,19,0.0848214285714286
OCCIDENTE 1,2023-08-06,141,129,12,0.0851063829787234
OCCIDENTE 1,2023-08-07,170,162,8,0.0470588235294118
OCCIDENTE 1,2023-08-08,210,205,5,0.0238095238095238
OCCIDENTE 1,2023-08-09,185,168,17,0.0918918918918919
OCCIDENTE 1,2023-08-10,205,186,19,0.0926829268292683
OCCIDENTE 1,2023-08-11,227,214,13,0.0572687224669604
OCCIDENTE 1,2023-08-12,217,202,15,0.0691244239631336
OCCIDENTE 1,2023-08-13,155,142,13,0.0838709677419355
OCCIDENTE 1,2023-08-14,196,183,13,0.0663265306122449
OCCIDENTE 1,2023-08-15,223,211,12,0.0538116591928251
OCCIDENTE 1,2023-08-16,219,210,9,0.0410958904109589
OCCIDENTE 1,2023-08-17,226,209,17,0.0752212389380531
OCCIDENTE 1,2023-08-18,199,190,9,0.0452261306532663
OCCIDENTE 1,2023-08-19,253,236,17,0.0671936758893281
OCCIDENTE 1,2023-08-20,155,149,6,0.0387096774193548
OCCIDENTE 1,2023-08-21,192,185,7,0.0364583333333333
OCCIDENTE 1,2023-08-22,188,183,5,0.0265957446808511
OCCIDENTE 1,2023-08-23,182,169,13,0.0714285714285714
OCCIDENTE 1,2023-08-24,188,180,8,0.0425531914893617
OCCIDENTE 1,2023-08-25,190,184,6,0.0315789473684211
OCCIDENTE 1,2023-08-26,235,227,8,0.0340425531914894
OCCIDENTE 1,2023-08-27,171,161,10,0.0584795321637427
OCCIDENTE 1,2023-08-28,175,170,5,0.0285714285714286
OCCIDENTE 1,2023-08-29,193,188,5,0.0259067357512953
OCCIDENTE 1,2023-08-30,177,176,1,0.00564971751412429
OCCIDENTE 1,2023-08-31,186,180,6,0.032258064516129
OCCIDENTE 1,2023-09-01,170,167,3,0.0176470588235294
OCCIDENTE 1,2023-09-02,194,187,7,0.0360824742268041
OCCIDENTE 1,2023-09-03,134,132,2,0.0149253731343284
OCCIDENTE 1,2023-09-04,176,173,3,0.0170454545454545
OCCIDENTE 1,2023-09-05,201,198,3,0.0149253731343284
OCCIDENTE 1,2023-09-06,182,175,7,0.0384615384615385
OCCIDENTE 1,2023-09-07,213,207,6,0.028169014084507
OCCIDENTE 1,2023-09-08,169,168,1,0.00591715976331361
OCCIDENTE 1,2023-09-09,209,206,3,0.0143540669856459
OCCIDENTE 1,2023-09-10,117,117,0,0
OCCIDENTE 1,2023-09-11,168,165,3,0.0178571428571429
OCCIDENTE 1,2023-09-12,167,165,2,0.0119760479041916
OCCIDENTE 1,2023-09-13,174,173,1,0.00574712643678161
OCCIDENTE 1,2023-09-14,179,177,2,0.0111731843575419
OCCIDENTE 1,2023-09-15,207,201,6,0.0289855072463768
OCCIDENTE 1,2023-09-16,175,172,3,0.0171428571428571
OCCIDENTE 1,2023-09-17,155,154,1,0.00645161290322581
OCCIDENTE 1,2023-09-18,178,177,1,0.00561797752808989
OCCIDENTE 1,2023-09-19,182,178,4,0.021978021978022
OCCIDENTE 1,2023-09-20,149,148,1,0.00671140939597315
OCCIDENTE 1,2023-09-21,156,153,3,0.0192307692307692
OCCIDENTE 1,2023-09-22,197,193,4,0.0203045685279188
OCCIDENTE 1,2023-09-23,198,195,3,0.0151515151515152
OCCIDENTE 1,2023-09-24,124,123,1,0.00806451612903226
OCCIDENTE 1,2023-09-25,146,143,3,0.0205479452054795
OCCIDENTE 1,2023-09-26,174,168,6,0.0344827586206897
OCCIDENTE 1,2023-09-27,170,166,4,0.0235294117647059
OCCIDENTE 1,2023-09-28,177,174,3,0.0169491525423729
OCCIDENTE 1,2023-09-29,207,204,3,0.0144927536231884
OCCIDENTE 1,2023-09-30,237,234,3,0.0126582278481013
OCCIDENTE 1,2023-10-01,147,144,3,0.0204081632653061
OCCIDENTE 1,2023-10-02,160,156,4,0.025
OCCIDENTE 1,2023-10-03,164,162,2,0.0121951219512195
OCCIDENTE 1,2023-10-04,158,152,6,0.0379746835443038
OCCIDENTE 1,2023-10-05,167,160,7,0.0419161676646707
OCCIDENTE 1,2023-10-06,148,139,9,0.0608108108108108
OCCIDENTE 1,2023-10-07,178,170,8,0.0449438202247191
OCCIDENTE 1,2023-10-08,129,126,3,0.0232558139534884
OCCIDENTE 1,2023-10-09,176,172,4,0.0227272727272727
OCCIDENTE 1,2023-10-10,148,142,6,0.0405405405405405
OCCIDENTE 1,2023-10-11,144,135,9,0.0625
OCCIDENTE 1,2023-10-12,137,132,5,0.0364963503649635
OCCIDENTE 1,2023-10-13,131,123,8,0.0610687022900763
OCCIDENTE 1,2023-10-14,199,191,8,0.0402010050251256
OCCIDENTE 1,2023-10-15,136,131,5,0.0367647058823529
OCCIDENTE 1,2023-10-16,180,174,6,0.0333333333333333
OCCIDENTE 1,2023-10-17,146,144,2,0.0136986301369863
OCCIDENTE 1,2023-10-18,158,154,4,0.0253164556962025
OCCIDENTE 1,2023-10-19,146,138,8,0.0547945205479452
OCCIDENTE 1,2023-10-20,170,165,5,0.0294117647058824
OCCIDENTE 1,2023-10-21,193,186,7,0.0362694300518135
OCCIDENTE 1,2023-10-22,131,130,1,0.00763358778625954
OCCIDENTE 1,2023-10-23,159,155,4,0.0251572327044025
OCCIDENTE 1,2023-10-24,165,162,3,0.0181818181818182
OCCIDENTE 1,2023-10-25,159,156,3,0.0188679245283019
OCCIDENTE 1,2023-10-26,138,133,5,0.036231884057971
OCCIDENTE 1,2023-10-27,155,151,4,0.0258064516129032
OCCIDENTE 1,2023-10-28,172,170,2,0.0116279069767442
OCCIDENTE 1,2023-10-29,98,97,1,0.0102040816326531
OCCIDENTE 1,2023-10-30,136,134,2,0.0147058823529412
OCCIDENTE 1,2023-10-31,176,170,6,0.0340909090909091
OCCIDENTE 1,2023-11-01,186,180,6,0.032258064516129
OCCIDENTE 1,2023-11-02,198,191,7,0.0353535353535354
OCCIDENTE 1,2023-11-03,144,141,3,0.0208333333333333
OCCIDENTE 1,2023-11-04,190,187,3,0.0157894736842105
OCCIDENTE 1,2023-11-05,127,124,3,0.0236220472440945
OCCIDENTE 1,2023-11-06,162,159,3,0.0185185185185185
OCCIDENTE 1,2023-11-07,181,180,1,0.00552486187845304
OCCIDENTE 1,2023-11-08,183,172,11,0.0601092896174863
OCCIDENTE 1,2023-11-09,182,176,6,0.032967032967033
OCCIDENTE 1,2023-11-10,158,151,7,0.0443037974683544
OCCIDENTE 1,2023-11-11,205,193,12,0.0585365853658537
OCCIDENTE 1,2023-11-12,124,122,2,0.0161290322580645
OCCIDENTE 1,2023-11-13,153,147,6,0.0392156862745098
OCCIDENTE 1,2023-11-14,180,177,3,0.0166666666666667
OCCIDENTE 1,2023-11-15,180,178,2,0.0111111111111111
OCCIDENTE 1,2023-11-16,159,152,7,0.0440251572327044
OCCIDENTE 1,2023-11-17,175,168,7,0.04
OCCIDENTE 1,2023-11-18,211,205,6,0.028436018957346
OCCIDENTE 1,2023-11-19,166,163,3,0.0180722891566265
OCCIDENTE 1,2023-11-20,181,179,2,0.0110497237569061
OCCIDENTE 1,2023-11-21,196,184,12,0.0612244897959184
OCCIDENTE 1,2023-11-22,153,148,5,0.0326797385620915
OCCIDENTE 1,2023-11-23,176,169,7,0.0397727272727273
OCCIDENTE 1,2023-11-24,207,201,6,0.0289855072463768
OCCIDENTE 1,2023-11-25,211,208,3,0.014218009478673
OCCIDENTE 1,2023-11-26,125,121,4,0.032
OCCIDENTE 1,2023-11-27,184,176,8,0.0434782608695652
OCCIDENTE 1,2023-11-28,201,192,9,0.0447761194029851
OCCIDENTE 1,2023-11-29,185,172,13,0.0702702702702703
OCCIDENTE 1,2023-11-30,193,188,5,0.0259067357512953
OCCIDENTE 1,2023-12-01,168,156,12,0.0714285714285714
OCCIDENTE 1,2023-12-02,184,178,6,0.0326086956521739
OCCIDENTE 1,2023-12-03,149,142,7,0.0469798657718121
OCCIDENTE 1,2023-12-04,146,142,4,0.0273972602739726
OCCIDENTE 1,2023-12-05,175,168,7,0.04
OCCIDENTE 1,2023-12-06,185,179,6,0.0324324324324324
OCCIDENTE 1,2023-12-07,183,180,3,0.0163934426229508
OCCIDENTE 1,2023-12-08,164,158,6,0.0365853658536585
OCCIDENTE 1,2023-12-09,208,200,8,0.0384615384615385
OCCIDENTE 1,2023-12-10,112,110,2,0.0178571428571429
OCCIDENTE 1,2023-12-11,151,148,3,0.0198675496688742
OCCIDENTE 1,2023-12-12,191,187,4,0.0209424083769634
OCCIDENTE 1,2023-12-13,164,160,4,0.024390243902439
OCCIDENTE 1,2023-12-14,168,161,7,0.0416666666666667
OCCIDENTE 1,2023-12-15,165,159,6,0.0363636363636364
OCCIDENTE 1,2023-12-16,186,185,1,0.00537634408602151
OCCIDENTE 1,2023-12-17,132,128,4,0.0303030303030303
OCCIDENTE 1,2023-12-18,189,188,1,0.00529100529100529
OCCIDENTE 1,2023-12-19,185,177,8,0.0432432432432432
OCCIDENTE 1,2023-12-20,167,160,7,0.0419161676646707
OCCIDENTE 1,2023-12-21,170,159,11,0.0647058823529412
OCCIDENTE 1,2023-12-22,179,176,3,0.0167597765363128
OCCIDENTE 1,2023-12-23,165,162,3,0.0181818181818182
OCCIDENTE 1,2023-12-24,91,88,3,0.032967032967033
OCCIDENTE 1,2023-12-25,39,39,0,0
OCCIDENTE 1,2023-12-26,153,148,5,0.0326797385620915
OCCIDENTE 1,2023-12-27,191,187,4,0.0209424083769634
OCCIDENTE 1,2023-12-28,211,204,7,0.033175355450237
OCCIDENTE 1,2023-12-29,191,184,7,0.0366492146596859
OCCIDENTE 1,2023-12-30,245,239,6,0.0244897959183673
OCCIDENTE 1,2023-12-31,112,111,1,0.00892857142857143
OCCIDENTE 1,2024-01-01,35,34,1,0.0285714285714286
OCCIDENTE 1,2024-01-02,160,158,2,0.0125
OCCIDENTE 1,2024-01-03,232,227,5,0.021551724137931
OCCIDENTE 1,2024-01-04,174,168,6,0.0344827586206897
OCCIDENTE 1,2024-01-05,177,173,4,0.0225988700564972
OCCIDENTE 1,2024-01-06,198,197,1,0.00505050505050505
OCCIDENTE 1,2024-01-07,133,131,2,0.0150375939849624
OCCIDENTE 1,2024-01-08,215,210,5,0.0232558139534884
OCCIDENTE 1,2024-01-09,201,199,2,0.00995024875621891
OCCIDENTE 1,2024-01-10,174,172,2,0.0114942528735632
OCCIDENTE 1,2024-01-11,211,209,2,0.00947867298578199
OCCIDENTE 1,2024-01-12,220,215,5,0.0227272727272727
OCCIDENTE 1,2024-01-13,193,187,6,0.0310880829015544
OCCIDENTE 1,2024-01-14,139,134,5,0.0359712230215827
OCCIDENTE 1,2024-01-15,196,189,7,0.0357142857142857
OCCIDENTE 1,2024-01-16,223,216,7,0.031390134529148
OCCIDENTE 1,2024-01-17,193,189,4,0.0207253886010363
OCCIDENTE 1,2024-01-18,188,184,4,0.0212765957446809
OCCIDENTE 1,2024-01-19,171,166,5,0.0292397660818713
OCCIDENTE 1,2024-01-20,190,188,2,0.0105263157894737
OCCIDENTE 1,2024-01-21,119,114,5,0.0420168067226891
OCCIDENTE 1,2024-01-22,167,160,7,0.0419161676646707
OCCIDENTE 1,2024-01-23,184,176,8,0.0434782608695652
OCCIDENTE 1,2024-01-24,194,191,3,0.0154639175257732
OCCIDENTE 1,2024-01-25,169,168,1,0.00591715976331361
OCCIDENTE 1,2024-01-26,183,178,5,0.0273224043715847
OCCIDENTE 1,2024-01-27,205,200,5,0.024390243902439
OCCIDENTE 1,2024-01-28,151,148,3,0.0198675496688742
OCCIDENTE 1,2024-01-29,154,151,3,0.0194805194805195
OCCIDENTE 1,2024-01-30,199,194,5,0.0251256281407035
OCCIDENTE 1,2024-01-31,189,184,5,0.0264550264550265
OCCIDENTE 1,2024-02-01,169,166,3,0.0177514792899408
OCCIDENTE 1,2024-02-02,163,159,4,0.0245398773006135
OCCIDENTE 1,2024-02-03,220,214,6,0.0272727272727273
OCCIDENTE 1,2024-02-04,149,146,3,0.0201342281879195
OCCIDENTE 1,2024-02-05,155,153,2,0.0129032258064516
OCCIDENTE 1,2024-02-06,187,182,5,0.0267379679144385
OCCIDENTE 1,2024-02-07,175,171,4,0.0228571428571429
OCCIDENTE 1,2024-02-08,176,176,0,0
OCCIDENTE 1,2024-02-09,153,150,3,0.0196078431372549
OCCIDENTE 1,2024-02-10,192,190,2,0.0104166666666667
OCCIDENTE 1,2024-02-11,114,111,3,0.0263157894736842
OCCIDENTE 1,2024-02-12,135,129,6,0.0444444444444444
OCCIDENTE 1,2024-02-13,158,151,7,0.0443037974683544
OCCIDENTE 1,2024-02-14,145,142,3,0.0206896551724138
OCCIDENTE 1,2024-02-15,166,162,4,0.0240963855421687
OCCIDENTE 1,2024-02-16,155,151,4,0.0258064516129032
OCCIDENTE 1,2024-02-17,194,190,4,0.0206185567010309
OCCIDENTE 1,2024-02-18,126,126,0,0
OCCIDENTE 1,2024-02-19,179,174,5,0.0279329608938547
OCCIDENTE 1,2024-02-20,194,191,3,0.0154639175257732
OCCIDENTE 1,2024-02-21,185,183,2,0.0108108108108108
OCCIDENTE 1,2024-02-22,191,190,1,0.00523560209424084
OCCIDENTE 1,2024-02-23,129,114,15,0.116279069767442
OCCIDENTE 1,2024-02-24,234,226,8,0.0341880341880342
OCCIDENTE 1,2024-02-25,142,142,0,0
OCCIDENTE 1,2024-02-26,175,171,4,0.0228571428571429
OCCIDENTE 1,2024-02-27,191,182,9,0.0471204188481675
OCCIDENTE 1,2024-02-28,178,173,5,0.0280898876404494
OCCIDENTE 1,2024-02-29,215,212,3,0.013953488372093
OCCIDENTE 1,2024-03-01,197,193,4,0.0203045685279188
OCCIDENTE 1,2024-03-02,246,240,6,0.024390243902439
OCCIDENTE 1,2024-03-03,139,138,1,0.00719424460431655
OCCIDENTE 1,2024-03-04,171,170,1,0.00584795321637427
OCCIDENTE 1,2024-03-05,195,194,1,0.00512820512820513
OCCIDENTE 1,2024-03-06,170,166,4,0.0235294117647059
OCCIDENTE 1,2024-03-07,186,184,2,0.010752688172043
OCCIDENTE 1,2024-03-08,214,206,8,0.0373831775700935
OCCIDENTE 1,2024-03-09,211,210,1,0.004739336492891
OCCIDENTE 1,2024-03-10,156,152,4,0.0256410256410256
OCCIDENTE 1,2024-03-11,175,173,2,0.0114285714285714
OCCIDENTE 1,2024-03-12,178,176,2,0.0112359550561798
OCCIDENTE 1,2024-03-13,166,163,3,0.0180722891566265
OCCIDENTE 1,2024-03-14,172,168,4,0.0232558139534884
OCCIDENTE 1,2024-03-15,207,201,6,0.0289855072463768
OCCIDENTE 1,2024-03-16,210,207,3,0.0142857142857143
OCCIDENTE 1,2024-03-17,164,164,0,0
OCCIDENTE 1,2024-03-18,134,131,3,0.0223880597014925
OCCIDENTE 1,2024-03-19,186,182,4,0.021505376344086
OCCIDENTE 1,2024-03-20,201,196,5,0.0248756218905473
OCCIDENTE 1,2024-03-21,163,158,5,0.0306748466257669
OCCIDENTE 1,2024-03-22,170,164,6,0.0352941176470588
OCCIDENTE 1,2024-03-23,194,192,2,0.0103092783505155
OCCIDENTE 1,2024-03-24,131,129,2,0.0152671755725191
OCCIDENTE 1,2024-03-25,187,180,7,0.0374331550802139
OCCIDENTE 1,2024-03-26,197,193,4,0.0203045685279188
OCCIDENTE 1,2024-03-27,201,195,6,0.0298507462686567
OCCIDENTE 1,2024-03-28,225,222,3,0.0133333333333333
OCCIDENTE 1,2024-03-29,153,147,6,0.0392156862745098
OCCIDENTE 1,2024-03-30,160,157,3,0.01875
OCCIDENTE 1,2024-03-31,152,147,5,0.0328947368421053
OCCIDENTE 1,2024-04-01,168,164,4,0.0238095238095238
OCCIDENTE 1,2024-04-02,203,199,4,0.0197044334975369
OCCIDENTE 1,2024-04-03,179,179,0,0
OCCIDENTE 1,2024-04-04,174,174,0,0
OCCIDENTE 1,2024-04-05,176,170,6,0.0340909090909091
OCCIDENTE 1,2024-04-06,188,183,5,0.0265957446808511
OCCIDENTE 1,2024-04-07,111,110,1,0.00900900900900901
OCCIDENTE 1,2024-04-08,168,164,4,0.0238095238095238
OCCIDENTE 1,2024-04-09,168,163,5,0.0297619047619048
OCCIDENTE 1,2024-04-10,153,146,7,0.0457516339869281
OCCIDENTE 1,2024-04-11,153,153,0,0
OCCIDENTE 1,2024-04-12,161,158,3,0.0186335403726708
OCCIDENTE 1,2024-04-13,200,199,1,0.005
OCCIDENTE 1,2024-04-14,130,129,1,0.00769230769230769
OCCIDENTE 1,2024-04-15,169,166,3,0.0177514792899408
OCCIDENTE 1,2024-04-16,197,180,17,0.0862944162436548
OCCIDENTE 1,2024-04-17,183,171,12,0.0655737704918033
OCCIDENTE 1,2024-04-18,180,172,8,0.0444444444444444
OCCIDENTE 1,2024-04-19,161,156,5,0.031055900621118
OCCIDENTE 1,2024-04-20,219,214,5,0.0228310502283105
OCCIDENTE 1,2024-04-21,119,116,3,0.0252100840336134
OCCIDENTE 1,2024-04-22,88,82,6,0.0681818181818182
OCCIDENTE 1,2024-04-23,219,202,17,0.0776255707762557
OCCIDENTE 1,2024-04-24,162,155,7,0.0432098765432099
OCCIDENTE 1,2024-04-25,160,152,8,0.05
OCCIDENTE 1,2024-04-26,164,157,7,0.0426829268292683
OCCIDENTE 1,2024-04-27,163,159,4,0.0245398773006135
OCCIDENTE 1,2024-04-28,120,117,3,0.025
OCCIDENTE 1,2024-04-29,145,134,11,0.0758620689655172
OCCIDENTE 1,2024-04-30,202,196,6,0.0297029702970297
OCCIDENTE 1,2024-05-01,194,189,5,0.0257731958762887
OCCIDENTE 1,2024-05-02,161,158,3,0.0186335403726708
OCCIDENTE 1,2024-05-03,189,186,3,0.0158730158730159
OCCIDENTE 1,2024-05-04,190,184,6,0.0315789473684211
OCCIDENTE 1,2024-05-05,124,123,1,0.00806451612903226
OCCIDENTE 1,2024-05-06,151,151,0,0
OCCIDENTE 1,2024-05-07,166,162,4,0.0240963855421687
OCCIDENTE 1,2024-05-08,174,166,8,0.0459770114942529
OCCIDENTE 1,2024-05-09,156,152,4,0.0256410256410256
OCCIDENTE 1,2024-05-10,158,150,8,0.0506329113924051
OCCIDENTE 1,2024-05-11,179,171,8,0.0446927374301676
OCCIDENTE 1,2024-05-12,81,79,2,0.0246913580246914
OCCIDENTE 1,2024-05-13,165,159,6,0.0363636363636364
OCCIDENTE 1,2024-05-14,176,167,9,0.0511363636363636
OCCIDENTE 1,2024-05-15,183,176,7,0.0382513661202186
OCCIDENTE 1,2024-05-16,183,168,15,0.0819672131147541
OCCIDENTE 1,2024-05-17,184,176,8,0.0434782608695652
OCCIDENTE 1,2024-05-18,208,201,7,0.0336538461538462
OCCIDENTE 1,2024-05-19,139,137,2,0.0143884892086331
OCCIDENTE 1,2024-05-20,180,175,5,0.0277777777777778
OCCIDENTE 1,2024-05-21,173,169,4,0.023121387283237
OCCIDENTE 1,2024-05-22,164,160,4,0.024390243902439
OCCIDENTE 1,2024-05-23,157,156,1,0.00636942675159236
OCCIDENTE 1,2024-05-24,166,164,2,0.0120481927710843
OCCIDENTE 1,2024-05-25,200,196,4,0.02
OCCIDENTE 1,2024-05-26,103,102,1,0.00970873786407767
OCCIDENTE 1,2024-05-27,167,165,2,0.0119760479041916
OCCIDENTE 1,2024-05-28,182,180,2,0.010989010989011
OCCIDENTE 1,2024-05-29,179,174,5,0.0279329608938547
OCCIDENTE 1,2024-05-30,185,180,5,0.027027027027027
OCCIDENTE 1,2024-05-31,173,168,5,0.0289017341040462
OCCIDENTE 1,2024-06-01,196,189,7,0.0357142857142857
OCCIDENTE 1,2024-06-02,106,102,4,0.0377358490566038
OCCIDENTE 1,2024-06-03,137,133,4,0.0291970802919708
OCCIDENTE 1,2024-06-04,174,161,13,0.0747126436781609
OCCIDENTE 1,2024-06-05,182,176,6,0.032967032967033
OCCIDENTE 1,2024-06-06,201,197,4,0.0199004975124378
OCCIDENTE 1,2024-06-07,160,155,5,0.03125
OCCIDENTE 1,2024-06-08,191,185,6,0.031413612565445
OCCIDENTE 1,2024-06-09,118,115,3,0.0254237288135593
OCCIDENTE 1,2024-06-10,165,159,6,0.0363636363636364
OCCIDENTE 1,2024-06-11,178,174,4,0.0224719101123595
OCCIDENTE 1,2024-06-12,170,166,4,0.0235294117647059
OCCIDENTE 1,2024-06-13,176,173,3,0.0170454545454545
OCCIDENTE 1,2024-06-14,166,161,5,0.0301204819277108
OCCIDENTE 1,2024-06-15,183,178,5,0.0273224043715847
OCCIDENTE 1,2024-06-16,97,96,1,0.0103092783505155
OCCIDENTE 1,2024-06-17,173,167,6,0.0346820809248555
OCCIDENTE 1,2024-06-18,208,194,14,0.0673076923076923
OCCIDENTE 1,2024-06-19,188,186,2,0.0106382978723404
OCCIDENTE 1,2024-06-20,170,167,3,0.0176470588235294
OCCIDENTE 1,2024-06-21,177,167,10,0.0564971751412429
OCCIDENTE 1,2024-06-22,198,193,5,0.0252525252525253
OCCIDENTE 1,2024-06-23,135,131,4,0.0296296296296296
OCCIDENTE 1,2024-06-24,151,142,9,0.0596026490066225
OCCIDENTE 1,2024-06-25,174,165,9,0.0517241379310345
OCCIDENTE 1,2024-06-26,161,158,3,0.0186335403726708
OCCIDENTE 1,2024-06-27,173,165,8,0.046242774566474
OCCIDENTE 1,2024-06-28,162,156,6,0.037037037037037
OCCIDENTE 1,2024-06-29,205,194,11,0.0536585365853659
OCCIDENTE 1,2024-06-30,172,169,3,0.0174418604651163
OCCIDENTE 1,2024-07-01,163,161,2,0.0122699386503067
OCCIDENTE 1,2024-07-02,191,189,2,0.0104712041884817
OCCIDENTE 2,2023-07-03,192,183,9,0.046875
OCCIDENTE 2,2023-07-04,207,189,18,0.0869565217391304
OCCIDENTE 2,2023-07-05,151,132,19,0.125827814569536
OCCIDENTE 2,2023-07-06,95,82,13,0.136842105263158
OCCIDENTE 2,2023-07-07,179,163,16,0.0893854748603352
OCCIDENTE 2,2023-07-08,317,297,20,0.0630914826498423
OCCIDENTE 2,2023-07-09,145,136,9,0.0620689655172414
OCCIDENTE 2,2023-07-10,216,204,12,0.0555555555555556
OCCIDENTE 2,2023-07-11,222,204,18,0.0810810810810811
OCCIDENTE 2,2023-07-12,220,202,18,0.0818181818181818
OCCIDENTE 2,2023-07-13,197,177,20,0.101522842639594
OCCIDENTE 2,2023-07-14,173,162,11,0.0635838150289017
OCCIDENTE 2,2023-07-15,304,290,14,0.0460526315789474
OCCIDENTE 2,2023-07-16,120,112,8,0.0666666666666667
OCCIDENTE 2,2023-07-17,201,183,18,0.0895522388059701
OCCIDENTE 2,2023-07-18,177,162,15,0.0847457627118644
OCCIDENTE 2,2023-07-19,168,161,7,0.0416666666666667
OCCIDENTE 2,2023-07-20,241,229,12,0.0497925311203319
OCCIDENTE 2,2023-07-21,218,203,15,0.0688073394495413
OCCIDENTE 2,2023-07-22,334,314,20,0.0598802395209581
OCCIDENTE 2,2023-07-23,137,129,8,0.0583941605839416
OCCIDENTE 2,2023-07-24,162,152,10,0.0617283950617284
OCCIDENTE 2,2023-07-25,210,195,15,0.0714285714285714
OCCIDENTE 2,2023-07-26,219,196,23,0.105022831050228
OCCIDENTE 2,2023-07-27,202,196,6,0.0297029702970297
OCCIDENTE 2,2023-07-28,241,223,18,0.0746887966804979
OCCIDENTE 2,2023-07-29,255,242,13,0.0509803921568627
OCCIDENTE 2,2023-07-30,159,145,14,0.0880503144654088
OCCIDENTE 2,2023-07-31,242,232,10,0.0413223140495868
OCCIDENTE 2,2023-08-01,240,224,16,0.0666666666666667
OCCIDENTE 2,2023-08-02,258,244,14,0.0542635658914729
OCCIDENTE 2,2023-08-03,213,157,56,0.262910798122066
OCCIDENTE 2,2023-08-04,233,213,20,0.0858369098712446
OCCIDENTE 2,2023-08-05,247,234,13,0.0526315789473684
OCCIDENTE 2,2023-08-06,159,152,7,0.0440251572327044
OCCIDENTE 2,2023-08-07,217,209,8,0.0368663594470046
OCCIDENTE 2,2023-08-08,206,198,8,0.0388349514563107
OCCIDENTE 2,2023-08-09,228,217,11,0.0482456140350877
OCCIDENTE 2,2023-08-10,235,228,7,0.0297872340425532
OCCIDENTE 2,2023-08-11,232,215,17,0.0732758620689655
OCCIDENTE 2,2023-08-12,271,252,19,0.0701107011070111
OCCIDENTE 2,2023-08-13,165,154,11,0.0666666666666667
OCCIDENTE 2,2023-08-14,203,193,10,0.0492610837438424
OCCIDENTE 2,2023-08-15,249,228,21,0.0843373493975904
OCCIDENTE 2,2023-08-16,220,205,15,0.0681818181818182
OCCIDENTE 2,2023-08-17,205,190,15,0.0731707317073171
OCCIDENTE 2,2023-08-18,225,211,14,0.0622222222222222
OCCIDENTE 2,2023-08-19,251,232,19,0.0756972111553785
OCCIDENTE 2,2023-08-20,159,148,11,0.0691823899371069
OCCIDENTE 2,2023-08-21,218,209,9,0.0412844036697248
OCCIDENTE 2,2023-08-22,234,226,8,0.0341880341880342
OCCIDENTE 2,2023-08-23,222,214,8,0.036036036036036
OCCIDENTE 2,2023-08-24,251,236,15,0.0597609561752988
OCCIDENTE 2,2023-08-25,250,243,7,0.028
OCCIDENTE 2,2023-08-26,272,259,13,0.0477941176470588
OCCIDENTE 2,2023-08-27,161,155,6,0.0372670807453416
OCCIDENTE 2,2023-08-28,224,211,13,0.0580357142857143
OCCIDENTE 2,2023-08-29,250,238,12,0.048
OCCIDENTE 2,2023-08-30,211,204,7,0.033175355450237
OCCIDENTE 2,2023-08-31,238,228,10,0.0420168067226891
OCCIDENTE 2,2023-09-01,204,195,9,0.0441176470588235
OCCIDENTE 2,2023-09-02,242,239,3,0.012396694214876
OCCIDENTE 2,2023-09-03,165,160,5,0.0303030303030303
OCCIDENTE 2,2023-09-04,182,175,7,0.0384615384615385
OCCIDENTE 2,2023-09-05,220,216,4,0.0181818181818182
OCCIDENTE 2,2023-09-06,223,217,6,0.0269058295964126
OCCIDENTE 2,2023-09-07,202,192,10,0.0495049504950495
OCCIDENTE 2,2023-09-08,202,197,5,0.0247524752475248
OCCIDENTE 2,2023-09-09,202,193,9,0.0445544554455446
OCCIDENTE 2,2023-09-10,140,135,5,0.0357142857142857
OCCIDENTE 2,2023-09-11,192,184,8,0.0416666666666667
OCCIDENTE 2,2023-09-12,200,196,4,0.02
OCCIDENTE 2,2023-09-13,204,194,10,0.0490196078431373
OCCIDENTE 2,2023-09-14,206,196,10,0.0485436893203883
OCCIDENTE 2,2023-09-15,226,223,3,0.0132743362831858
OCCIDENTE 2,2023-09-16,215,211,4,0.0186046511627907
OCCIDENTE 2,2023-09-17,135,131,4,0.0296296296296296
OCCIDENTE 2,2023-09-18,214,205,9,0.0420560747663551
OCCIDENTE 2,2023-09-19,223,216,7,0.031390134529148
OCCIDENTE 2,2023-09-20,181,174,7,0.0386740331491713
OCCIDENTE 2,2023-09-21,199,191,8,0.0402010050251256
OCCIDENTE 2,2023-09-22,209,200,9,0.0430622009569378
OCCIDENTE 2,2023-09-23,242,232,10,0.0413223140495868
OCCIDENTE 2,2023-09-24,151,147,4,0.0264900662251656
OCCIDENTE 2,2023-09-25,179,172,7,0.0391061452513966
OCCIDENTE 2,2023-09-26,214,208,6,0.0280373831775701
OCCIDENTE 2,2023-09-27,198,191,7,0.0353535353535354
OCCIDENTE 2,2023-09-28,218,203,15,0.0688073394495413
OCCIDENTE 2,2023-09-29,251,236,15,0.0597609561752988
OCCIDENTE 2,2023-09-30,271,251,20,0.0738007380073801
OCCIDENTE 2,2023-10-01,171,163,8,0.0467836257309941
OCCIDENTE 2,2023-10-02,208,198,10,0.0480769230769231
OCCIDENTE 2,2023-10-03,203,190,13,0.0640394088669951
OCCIDENTE 2,2023-10-04,177,163,14,0.0790960451977401
OCCIDENTE 2,2023-10-05,178,162,16,0.0898876404494382
OCCIDENTE 2,2023-10-06,175,161,14,0.08
OCCIDENTE 2,2023-10-07,229,219,10,0.0436681222707424
OCCIDENTE 2,2023-10-08,142,136,6,0.0422535211267606
OCCIDENTE 2,2023-10-09,197,184,13,0.065989847715736
OCCIDENTE 2,2023-10-10,160,149,11,0.06875
OCCIDENTE 2,2023-10-11,161,147,14,0.0869565217391304
OCCIDENTE 2,2023-10-12,175,159,16,0.0914285714285714
OCCIDENTE 2,2023-10-13,170,157,13,0.0764705882352941
OCCIDENTE 2,2023-10-14,171,161,10,0.0584795321637427
OCCIDENTE 2,2023-10-15,147,139,8,0.054421768707483
OCCIDENTE 2,2023-10-16,181,173,8,0.0441988950276243
OCCIDENTE 2,2023-10-17,163,156,7,0.0429447852760736
OCCIDENTE 2,2023-10-18,188,174,14,0.074468085106383
OCCIDENTE 2,2023-10-19,169,162,7,0.0414201183431953
OCCIDENTE 2,2023-10-20,200,189,11,0.055
OCCIDENTE 2,2023-10-21,188,184,4,0.0212765957446809
OCCIDENTE 2,2023-10-22,134,131,3,0.0223880597014925
OCCIDENTE 2,2023-10-23,155,151,4,0.0258064516129032
OCCIDENTE 2,2023-10-24,172,164,8,0.0465116279069767
OCCIDENTE 2,2023-10-25,186,179,7,0.0376344086021505
OCCIDENTE 2,2023-10-26,182,166,16,0.0879120879120879
OCCIDENTE 2,2023-10-27,178,172,6,0.0337078651685393
OCCIDENTE 2,2023-10-28,186,181,5,0.0268817204301075
OCCIDENTE 2,2023-10-29,110,108,2,0.0181818181818182
OCCIDENTE 2,2023-10-30,172,163,9,0.0523255813953488
OCCIDENTE 2,2023-10-31,226,217,9,0.0398230088495575
OCCIDENTE 2,2023-11-01,201,194,7,0.0348258706467662
OCCIDENTE 2,2023-11-02,197,192,5,0.0253807106598985
OCCIDENTE 2,2023-11-03,205,195,10,0.0487804878048781
OCCIDENTE 2,2023-11-04,225,216,9,0.04
OCCIDENTE 2,2023-11-05,176,173,3,0.0170454545454545
OCCIDENTE 2,2023-11-06,196,182,14,0.0714285714285714
OCCIDENTE 2,2023-11-07,214,208,6,0.0280373831775701
OCCIDENTE 2,2023-11-08,200,193,7,0.035
OCCIDENTE 2,2023-11-09,188,179,9,0.0478723404255319
OCCIDENTE 2,2023-11-10,204,196,8,0.0392156862745098
OCCIDENTE 2,2023-11-11,266,260,6,0.0225563909774436
OCCIDENTE 2,2023-11-12,156,151,5,0.032051282051282
OCCIDENTE 2,2023-11-13,215,212,3,0.013953488372093
OCCIDENTE 2,2023-11-14,220,207,13,0.0590909090909091
OCCIDENTE 2,2023-11-15,225,216,9,0.04
OCCIDENTE 2,2023-11-16,209,195,14,0.0669856459330144
OCCIDENTE 2,2023-11-17,222,213,9,0.0405405405405405
OCCIDENTE 2,2023-11-18,257,252,5,0.0194552529182879
OCCIDENTE 2,2023-11-19,171,166,5,0.0292397660818713
OCCIDENTE 2,2023-11-20,233,221,12,0.0515021459227468
OCCIDENTE 2,2023-11-21,231,227,4,0.0173160173160173
OCCIDENTE 2,2023-11-22,214,206,8,0.0373831775700935
OCCIDENTE 2,2023-11-23,213,205,8,0.0375586854460094
OCCIDENTE 2,2023-11-24,236,227,9,0.038135593220339
OCCIDENTE 2,2023-11-25,222,216,6,0.027027027027027
OCCIDENTE 2,2023-11-26,157,154,3,0.0191082802547771
OCCIDENTE 2,2023-11-27,182,177,5,0.0274725274725275
OCCIDENTE 2,2023-11-28,223,211,12,0.0538116591928251
OCCIDENTE 2,2023-11-29,235,216,19,0.0808510638297872
OCCIDENTE 2,2023-11-30,225,215,10,0.0444444444444444
OCCIDENTE 2,2023-12-01,215,203,12,0.0558139534883721
OCCIDENTE 2,2023-12-02,255,238,17,0.0666666666666667
OCCIDENTE 2,2023-12-03,146,138,8,0.0547945205479452
OCCIDENTE 2,2023-12-04,231,216,15,0.0649350649350649
OCCIDENTE 2,2023-12-05,222,205,17,0.0765765765765766
OCCIDENTE 2,2023-12-06,227,214,13,0.0572687224669604
OCCIDENTE 2,2023-12-07,205,193,12,0.0585365853658537
OCCIDENTE 2,2023-12-08,215,204,11,0.0511627906976744
OCCIDENTE 2,2023-12-09,224,207,17,0.0758928571428571
OCCIDENTE 2,2023-12-10,171,165,6,0.0350877192982456
OCCIDENTE 2,2023-12-11,181,167,14,0.0773480662983425
OCCIDENTE 2,2023-12-12,208,191,17,0.0817307692307692
OCCIDENTE 2,2023-12-13,202,192,10,0.0495049504950495
OCCIDENTE 2,2023-12-14,187,176,11,0.0588235294117647
OCCIDENTE 2,2023-12-15,192,180,12,0.0625
OCCIDENTE 2,2023-12-16,222,211,11,0.0495495495495495
OCCIDENTE 2,2023-12-17,161,157,4,0.0248447204968944
OCCIDENTE 2,2023-12-18,209,195,14,0.0669856459330144
OCCIDENTE 2,2023-12-19,226,213,13,0.0575221238938053
OCCIDENTE 2,2023-12-20,243,231,12,0.0493827160493827
OCCIDENTE 2,2023-12-21,215,206,9,0.0418604651162791
OCCIDENTE 2,2023-12-22,224,216,8,0.0357142857142857
OCCIDENTE 2,2023-12-23,245,237,8,0.0326530612244898
OCCIDENTE 2,2023-12-24,124,119,5,0.0403225806451613
OCCIDENTE 2,2023-12-25,30,29,1,0.0333333333333333
OCCIDENTE 2,2023-12-26,163,157,6,0.0368098159509202
OCCIDENTE 2,2023-12-27,211,203,8,0.037914691943128
OCCIDENTE 2,2023-12-28,239,231,8,0.0334728033472803
OCCIDENTE 2,2023-12-29,240,231,9,0.0375
OCCIDENTE 2,2023-12-30,225,218,7,0.0311111111111111
OCCIDENTE 2,2023-12-31,141,140,1,0.00709219858156028
OCCIDENTE 2,2024-01-01,38,35,3,0.0789473684210526
OCCIDENTE 2,2024-01-02,185,180,5,0.027027027027027
OCCIDENTE 2,2024-01-03,241,237,4,0.016597510373444
OCCIDENTE 2,2024-01-04,232,223,9,0.0387931034482759
OCCIDENTE 2,2024-01-05,246,237,9,0.0365853658536585
OCCIDENTE 2,2024-01-06,250,239,11,0.044
OCCIDENTE 2,2024-01-07,147,141,6,0.0408163265306122
OCCIDENTE 2,2024-01-08,222,212,10,0.045045045045045
OCCIDENTE 2,2024-01-09,268,255,13,0.0485074626865672
OCCIDENTE 2,2024-01-10,256,246,10,0.0390625
OCCIDENTE 2,2024-01-11,230,223,7,0.0304347826086957
OCCIDENTE 2,2024-01-12,220,216,4,0.0181818181818182
OCCIDENTE 2,2024-01-13,267,253,14,0.052434456928839
OCCIDENTE 2,2024-01-14,161,153,8,0.0496894409937888
OCCIDENTE 2,2024-01-15,228,218,10,0.043859649122807
OCCIDENTE 2,2024-01-16,229,222,7,0.0305676855895196
OCCIDENTE 2,2024-01-17,241,231,10,0.04149377593361
OCCIDENTE 2,2024-01-18,225,219,6,0.0266666666666667
OCCIDENTE 2,2024-01-19,218,208,10,0.0458715596330275
OCCIDENTE 2,2024-01-20,258,252,6,0.0232558139534884
OCCIDENTE 2,2024-01-21,166,160,6,0.036144578313253
OCCIDENTE 2,2024-01-22,179,170,9,0.0502793296089385
OCCIDENTE 2,2024-01-23,206,195,11,0.0533980582524272
OCCIDENTE 2,2024-01-24,229,213,16,0.0698689956331878
OCCIDENTE 2,2024-01-25,208,199,9,0.0432692307692308
OCCIDENTE 2,2024-01-26,220,209,11,0.05
OCCIDENTE 2,2024-01-27,219,213,6,0.0273972602739726
OCCIDENTE 2,2024-01-28,146,139,7,0.0479452054794521
OCCIDENTE 2,2024-01-29,211,196,15,0.0710900473933649
OCCIDENTE 2,2024-01-30,209,194,15,0.0717703349282297
OCCIDENTE 2,2024-01-31,227,216,11,0.0484581497797357
OCCIDENTE 2,2024-02-01,201,194,7,0.0348258706467662
OCCIDENTE 2,2024-02-02,216,196,20,0.0925925925925926
OCCIDENTE 2,2024-02-03,249,239,10,0.0401606425702811
OCCIDENTE 2,2024-02-04,157,154,3,0.0191082802547771
OCCIDENTE 2,2024-02-05,134,127,7,0.0522388059701493
OCCIDENTE 2,2024-02-06,237,226,11,0.0464135021097046
OCCIDENTE 2,2024-02-07,232,224,8,0.0344827586206897
OCCIDENTE 2,2024-02-08,201,197,4,0.0199004975124378
OCCIDENTE 2,2024-02-09,221,216,5,0.0226244343891403
OCCIDENTE 2,2024-02-10,227,222,5,0.0220264317180617
OCCIDENTE 2,2024-02-11,146,143,3,0.0205479452054795
OCCIDENTE 2,2024-02-12,152,144,8,0.0526315789473684
OCCIDENTE 2,2024-02-13,205,198,7,0.0341463414634146
OCCIDENTE 2,2024-02-14,181,177,4,0.0220994475138122
OCCIDENTE 2,2024-02-15,193,189,4,0.0207253886010363
OCCIDENTE 2,2024-02-16,178,175,3,0.0168539325842697
OCCIDENTE 2,2024-02-17,261,252,9,0.0344827586206897
OCCIDENTE 2,2024-02-18,173,167,6,0.0346820809248555
OCCIDENTE 2,2024-02-19,222,217,5,0.0225225225225225
OCCIDENTE 2,2024-02-20,198,192,6,0.0303030303030303
OCCIDENTE 2,2024-02-21,214,205,9,0.0420560747663551
OCCIDENTE 2,2024-02-22,240,235,5,0.0208333333333333
OCCIDENTE 2,2024-02-23,156,124,32,0.205128205128205
OCCIDENTE 2,2024-02-24,249,241,8,0.0321285140562249
OCCIDENTE 2,2024-02-25,184,181,3,0.016304347826087
OCCIDENTE 2,2024-02-26,196,188,8,0.0408163265306122
OCCIDENTE 2,2024-02-27,251,243,8,0.0318725099601594
OCCIDENTE 2,2024-02-28,194,187,7,0.0360824742268041
OCCIDENTE 2,2024-02-29,235,223,12,0.051063829787234
OCCIDENTE 2,2024-03-01,266,256,10,0.037593984962406
OCCIDENTE 2,2024-03-02,304,296,8,0.0263157894736842
OCCIDENTE 2,2024-03-03,161,158,3,0.0186335403726708
OCCIDENTE 2,2024-03-04,225,220,5,0.0222222222222222
OCCIDENTE 2,2024-03-05,227,213,14,0.0616740088105727
OCCIDENTE 2,2024-03-06,235,230,5,0.0212765957446809
OCCIDENTE 2,2024-03-07,225,221,4,0.0177777777777778
OCCIDENTE 2,2024-03-08,221,211,10,0.0452488687782805
OCCIDENTE 2,2024-03-09,262,256,6,0.0229007633587786
OCCIDENTE 2,2024-03-10,140,136,4,0.0285714285714286
OCCIDENTE 2,2024-03-11,188,173,15,0.0797872340425532
OCCIDENTE 2,2024-03-12,227,220,7,0.0308370044052863
OCCIDENTE 2,2024-03-13,202,193,9,0.0445544554455446
OCCIDENTE 2,2024-03-14,204,195,9,0.0441176470588235
OCCIDENTE 2,2024-03-15,227,221,6,0.026431718061674
OCCIDENTE 2,2024-03-16,247,240,7,0.0283400809716599
OCCIDENTE 2,2024-03-17,162,159,3,0.0185185185185185
OCCIDENTE 2,2024-03-18,171,166,5,0.0292397660818713
OCCIDENTE 2,2024-03-19,208,200,8,0.0384615384615385
OCCIDENTE 2,2024-03-20,212,205,7,0.0330188679245283
OCCIDENTE 2,2024-03-21,193,182,11,0.0569948186528497
OCCIDENTE 2,2024-03-22,199,187,12,0.0603015075376884
OCCIDENTE 2,2024-03-23,200,195,5,0.025
OCCIDENTE 2,2024-03-24,132,126,6,0.0454545454545455
OCCIDENTE 2,2024-03-25,189,178,11,0.0582010582010582
OCCIDENTE 2,2024-03-26,250,236,14,0.056
OCCIDENTE 2,2024-03-27,237,232,5,0.0210970464135021
OCCIDENTE 2,2024-03-28,257,250,7,0.0272373540856031
OCCIDENTE 2,2024-03-29,167,162,5,0.029940119760479
OCCIDENTE 2,2024-03-30,214,209,5,0.0233644859813084
OCCIDENTE 2,2024-03-31,131,127,4,0.0305343511450382
OCCIDENTE 2,2024-04-01,231,226,5,0.0216450216450216
OCCIDENTE 2,2024-04-02,216,208,8,0.037037037037037
OCCIDENTE 2,2024-04-03,191,191,0,0
OCCIDENTE 2,2024-04-04,218,218,0,0
OCCIDENTE 2,2024-04-05,223,213,10,0.0448430493273543
OCCIDENTE 2,2024-04-06,246,238,8,0.032520325203252
OCCIDENTE 2,2024-04-07,125,121,4,0.032
OCCIDENTE 2,2024-04-08,186,181,5,0.0268817204301075
OCCIDENTE 2,2024-04-09,212,200,12,0.0566037735849057
OCCIDENTE 2,2024-04-10,224,213,11,0.0491071428571429
OCCIDENTE 2,2024-04-11,192,185,7,0.0364583333333333
OCCIDENTE 2,2024-04-12,222,211,11,0.0495495495495495
OCCIDENTE 2,2024-04-13,256,248,8,0.03125
OCCIDENTE 2,2024-04-14,147,144,3,0.0204081632653061
OCCIDENTE 2,2024-04-15,229,222,7,0.0305676855895196
OCCIDENTE 2,2024-04-16,225,210,15,0.0666666666666667
OCCIDENTE 2,2024-04-17,211,199,12,0.0568720379146919
OCCIDENTE 2,2024-04-18,206,196,10,0.0485436893203883
OCCIDENTE 2,2024-04-19,191,173,18,0.0942408376963351
OCCIDENTE 2,2024-04-20,216,205,11,0.0509259259259259
OCCIDENTE 2,2024-04-21,156,153,3,0.0192307692307692
OCCIDENTE 2,2024-04-22,106,98,8,0.0754716981132075
OCCIDENTE 2,2024-04-23,309,285,24,0.0776699029126214
OCCIDENTE 2,2024-04-24,191,181,10,0.0523560209424084
OCCIDENTE 2,2024-04-25,218,208,10,0.0458715596330275
OCCIDENTE 2,2024-04-26,188,181,7,0.0372340425531915
OCCIDENTE 2,2024-04-27,194,179,15,0.077319587628866
OCCIDENTE 2,2024-04-28,120,116,4,0.0333333333333333
OCCIDENTE 2,2024-04-29,182,172,10,0.0549450549450549
OCCIDENTE 2,2024-04-30,229,218,11,0.0480349344978166
OCCIDENTE 2,2024-05-01,236,229,7,0.0296610169491525
OCCIDENTE 2,2024-05-02,184,176,8,0.0434782608695652
OCCIDENTE 2,2024-05-03,184,178,6,0.0326086956521739
OCCIDENTE 2,2024-05-04,219,206,13,0.0593607305936073
OCCIDENTE 2,2024-05-05,127,118,9,0.0708661417322835
OCCIDENTE 2,2024-05-06,196,196,0,0
OCCIDENTE 2,2024-05-07,194,187,7,0.0360824742268041
OCCIDENTE 2,2024-05-08,195,185,10,0.0512820512820513
OCCIDENTE 2,2024-05-09,173,162,11,0.0635838150289017
OCCIDENTE 2,2024-05-10,154,145,9,0.0584415584415584
OCCIDENTE 2,2024-05-11,196,186,10,0.0510204081632653
OCCIDENTE 2,2024-05-12,108,106,2,0.0185185185185185
OCCIDENTE 2,2024-05-13,203,193,10,0.0492610837438424
OCCIDENTE 2,2024-05-14,231,220,11,0.0476190476190476
OCCIDENTE 2,2024-05-15,240,233,7,0.0291666666666667
OCCIDENTE 2,2024-05-16,205,177,28,0.136585365853659
OCCIDENTE 2,2024-05-17,179,174,5,0.0279329608938547
OCCIDENTE 2,2024-05-18,227,219,8,0.0352422907488987
OCCIDENTE 2,2024-05-19,133,128,5,0.037593984962406
OCCIDENTE 2,2024-05-20,208,203,5,0.0240384615384615
OCCIDENTE 2,2024-05-21,204,189,15,0.0735294117647059
OCCIDENTE 2,2024-05-22,197,192,5,0.0253807106598985
OCCIDENTE 2,2024-05-23,204,197,7,0.0343137254901961
OCCIDENTE 2,2024-05-24,189,184,5,0.0264550264550265
OCCIDENTE 2,2024-05-25,243,235,8,0.0329218106995885
OCCIDENTE 2,2024-05-26,143,141,2,0.013986013986014
OCCIDENTE 2,2024-05-27,172,165,7,0.0406976744186047
OCCIDENTE 2,2024-05-28,208,203,5,0.0240384615384615
OCCIDENTE 2,2024-05-29,216,212,4,0.0185185185185185
OCCIDENTE 2,2024-05-30,227,216,11,0.0484581497797357
OCCIDENTE 2,2024-05-31,234,227,7,0.0299145299145299
OCCIDENTE 2,2024-06-01,229,219,10,0.0436681222707424
OCCIDENTE 2,2024-06-02,123,122,1,0.00813008130081301
OCCIDENTE 2,2024-06-03,193,185,8,0.0414507772020725
OCCIDENTE 2,2024-06-04,213,199,14,0.0657276995305164
OCCIDENTE 2,2024-06-05,208,201,7,0.0336538461538462
OCCIDENTE 2,2024-06-06,197,186,11,0.0558375634517767
OCCIDENTE 2,2024-06-07,199,189,10,0.050251256281407
OCCIDENTE 2,2024-06-08,216,209,7,0.0324074074074074
OCCIDENTE 2,2024-06-09,148,146,2,0.0135135135135135
OCCIDENTE 2,2024-06-10,213,209,4,0.0187793427230047
OCCIDENTE 2,2024-06-11,213,207,6,0.028169014084507
OCCIDENTE 2,2024-06-12,210,205,5,0.0238095238095238
OCCIDENTE 2,2024-06-13,208,199,9,0.0432692307692308
OCCIDENTE 2,2024-06-14,193,187,6,0.0310880829015544
OCCIDENTE 2,2024-06-15,262,256,6,0.0229007633587786
OCCIDENTE 2,2024-06-16,120,118,2,0.0166666666666667
OCCIDENTE 2,2024-06-17,190,186,4,0.0210526315789474
OCCIDENTE 2,2024-06-18,204,202,2,0.00980392156862745
OCCIDENTE 2,2024-06-19,200,194,6,0.03
OCCIDENTE 2,2024-06-20,193,187,6,0.0310880829015544
OCCIDENTE 2,2024-06-21,212,204,8,0.0377358490566038
OCCIDENTE 2,2024-06-22,241,237,4,0.016597510373444
OCCIDENTE 2,2024-06-23,163,160,3,0.0184049079754601
OCCIDENTE 2,2024-06-24,168,161,7,0.0416666666666667
OCCIDENTE 2,2024-06-25,206,198,8,0.0388349514563107
OCCIDENTE 2,2024-06-26,187,180,7,0.0374331550802139
OCCIDENTE 2,2024-06-27,193,191,2,0.0103626943005181
OCCIDENTE 2,2024-06-28,202,202,0,0
OCCIDENTE 2,2024-06-29,268,258,10,0.0373134328358209
OCCIDENTE 2,2024-06-30,185,180,5,0.027027027027027
OCCIDENTE 2,2024-07-01,198,194,4,0.0202020202020202
OCCIDENTE 2,2024-07-02,209,204,5,0.0239234449760766
ORIENTE GOLFO,2023-07-03,164,160,4,0.024390243902439
ORIENTE GOLFO,2023-07-04,156,149,7,0.0448717948717949
ORIENTE GOLFO,2023-07-05,145,140,5,0.0344827586206897
ORIENTE GOLFO,2023-07-06,164,151,13,0.0792682926829268
ORIENTE GOLFO,2023-07-07,160,147,13,0.08125
ORIENTE GOLFO,2023-07-08,187,182,5,0.0267379679144385
ORIENTE GOLFO,2023-07-09,143,140,3,0.020979020979021
ORIENTE GOLFO,2023-07-10,152,148,4,0.0263157894736842
ORIENTE GOLFO,2023-07-11,174,166,8,0.0459770114942529
ORIENTE GOLFO,2023-07-12,143,140,3,0.020979020979021
ORIENTE GOLFO,2023-07-13,160,153,7,0.04375
ORIENTE GOLFO,2023-07-14,156,150,6,0.0384615384615385
ORIENTE GOLFO,2023-07-15,195,189,6,0.0307692307692308
ORIENTE GOLFO,2023-07-16,142,139,3,0.0211267605633803
ORIENTE GOLFO,2023-07-17,145,138,7,0.0482758620689655
ORIENTE GOLFO,2023-07-18,154,148,6,0.038961038961039
ORIENTE GOLFO,2023-07-19,145,142,3,0.0206896551724138
ORIENTE GOLFO,2023-07-20,165,161,4,0.0242424242424242
ORIENTE GOLFO,2023-07-21,157,153,4,0.0254777070063694
ORIENTE GOLFO,2023-07-22,147,144,3,0.0204081632653061
ORIENTE GOLFO,2023-07-23,118,113,5,0.0423728813559322
ORIENTE GOLFO,2023-07-24,154,149,5,0.0324675324675325
ORIENTE GOLFO,2023-07-25,154,147,7,0.0454545454545455
ORIENTE GOLFO,2023-07-26,158,150,8,0.0506329113924051
ORIENTE GOLFO,2023-07-27,148,143,5,0.0337837837837838
ORIENTE GOLFO,2023-07-28,175,170,5,0.0285714285714286
ORIENTE GOLFO,2023-07-29,213,203,10,0.0469483568075117
ORIENTE GOLFO,2023-07-30,161,157,4,0.0248447204968944
ORIENTE GOLFO,2023-07-31,228,222,6,0.0263157894736842
ORIENTE GOLFO,2023-08-01,200,182,18,0.09
ORIENTE GOLFO,2023-08-02,157,148,9,0.0573248407643312
ORIENTE GOLFO,2023-08-03,175,148,27,0.154285714285714
ORIENTE GOLFO,2023-08-04,148,144,4,0.027027027027027
ORIENTE GOLFO,2023-08-05,165,163,2,0.0121212121212121
ORIENTE GOLFO,2023-08-06,112,109,3,0.0267857142857143
ORIENTE GOLFO,2023-08-07,163,163,0,0
ORIENTE GOLFO,2023-08-08,173,165,8,0.046242774566474
ORIENTE GOLFO,2023-08-09,168,164,4,0.0238095238095238
ORIENTE GOLFO,2023-08-10,183,181,2,0.0109289617486339
ORIENTE GOLFO,2023-08-11,159,156,3,0.0188679245283019
ORIENTE GOLFO,2023-08-12,185,175,10,0.0540540540540541
ORIENTE GOLFO,2023-08-13,124,120,4,0.032258064516129
ORIENTE GOLFO,2023-08-14,172,171,1,0.00581395348837209
ORIENTE GOLFO,2023-08-15,167,164,3,0.0179640718562874
ORIENTE GOLFO,2023-08-16,201,194,7,0.0348258706467662
ORIENTE GOLFO,2023-08-17,190,175,15,0.0789473684210526
ORIENTE GOLFO,2023-08-18,190,182,8,0.0421052631578947
ORIENTE GOLFO,2023-08-19,196,187,9,0.0459183673469388
ORIENTE GOLFO,2023-08-20,138,132,6,0.0434782608695652
ORIENTE GOLFO,2023-08-21,150,148,2,0.0133333333333333
ORIENTE GOLFO,2023-08-22,174,173,1,0.00574712643678161
ORIENTE GOLFO,2023-08-23,167,164,3,0.0179640718562874
ORIENTE GOLFO,2023-08-24,182,177,5,0.0274725274725275
ORIENTE GOLFO,2023-08-25,196,190,6,0.0306122448979592
ORIENTE GOLFO,2023-08-26,193,190,3,0.0155440414507772
ORIENTE GOLFO,2023-08-27,118,115,3,0.0254237288135593
ORIENTE GOLFO,2023-08-28,155,153,2,0.0129032258064516
ORIENTE GOLFO,2023-08-29,156,155,1,0.00641025641025641
ORIENTE GOLFO,2023-08-30,164,162,2,0.0121951219512195
ORIENTE GOLFO,2023-08-31,182,182,0,0
ORIENTE GOLFO,2023-09-01,158,151,7,0.0443037974683544
ORIENTE GOLFO,2023-09-02,152,152,0,0
ORIENTE GOLFO,2023-09-03,126,125,1,0.00793650793650794
ORIENTE GOLFO,2023-09-04,162,161,1,0.00617283950617284
ORIENTE GOLFO,2023-09-05,199,198,1,0.0050251256281407
ORIENTE GOLFO,2023-09-06,163,162,1,0.00613496932515337
ORIENTE GOLFO,2023-09-07,144,141,3,0.0208333333333333
ORIENTE GOLFO,2023-09-08,157,155,2,0.0127388535031847
ORIENTE GOLFO,2023-09-09,166,164,2,0.0120481927710843
ORIENTE GOLFO,2023-09-10,106,105,1,0.00943396226415094
ORIENTE GOLFO,2023-09-11,110,109,1,0.00909090909090909
ORIENTE GOLFO,2023-09-12,184,181,3,0.016304347826087
ORIENTE GOLFO,2023-09-13,143,140,3,0.020979020979021
ORIENTE GOLFO,2023-09-14,161,159,2,0.0124223602484472
ORIENTE GOLFO,2023-09-15,199,195,4,0.0201005025125628
ORIENTE GOLFO,2023-09-16,157,154,3,0.0191082802547771
ORIENTE GOLFO,2023-09-17,122,121,1,0.00819672131147541
ORIENTE GOLFO,2023-09-18,165,165,0,0
ORIENTE GOLFO,2023-09-19,157,155,2,0.0127388535031847
ORIENTE GOLFO,2023-09-20,125,125,0,0
ORIENTE GOLFO,2023-09-21,143,141,2,0.013986013986014
ORIENTE GOLFO,2023-09-22,146,145,1,0.00684931506849315
ORIENTE GOLFO,2023-09-23,145,144,1,0.00689655172413793
ORIENTE GOLFO,2023-09-24,128,126,2,0.015625
ORIENTE GOLFO,2023-09-25,148,148,0,0
ORIENTE GOLFO,2023-09-26,159,156,3,0.0188679245283019
ORIENTE GOLFO,2023-09-27,138,137,1,0.0072463768115942
ORIENTE GOLFO,2023-09-28,157,157,0,0
ORIENTE GOLFO,2023-09-29,195,192,3,0.0153846153846154
ORIENTE GOLFO,2023-09-30,213,211,2,0.00938967136150235
ORIENTE GOLFO,2023-10-01,132,131,1,0.00757575757575758
ORIENTE GOLFO,2023-10-02,149,146,3,0.0201342281879195
ORIENTE GOLFO,2023-10-03,151,147,4,0.0264900662251656
ORIENTE GOLFO,2023-10-04,130,126,4,0.0307692307692308
ORIENTE GOLFO,2023-10-05,146,144,2,0.0136986301369863
ORIENTE GOLFO,2023-10-06,155,147,8,0.0516129032258065
ORIENTE GOLFO,2023-10-07,161,157,4,0.0248447204968944
ORIENTE GOLFO,2023-10-08,122,119,3,0.0245901639344262
ORIENTE GOLFO,2023-10-09,129,123,6,0.0465116279069767
ORIENTE GOLFO,2023-10-10,112,106,6,0.0535714285714286
ORIENTE GOLFO,2023-10-11,132,126,6,0.0454545454545455
ORIENTE GOLFO,2023-10-12,137,135,2,0.0145985401459854
ORIENTE GOLFO,2023-10-13,170,165,5,0.0294117647058824
ORIENTE GOLFO,2023-10-14,183,175,8,0.0437158469945355
ORIENTE GOLFO,2023-10-15,131,128,3,0.0229007633587786
ORIENTE GOLFO,2023-10-16,156,154,2,0.0128205128205128
ORIENTE GOLFO,2023-10-17,129,125,4,0.0310077519379845
ORIENTE GOLFO,2023-10-18,138,136,2,0.0144927536231884
ORIENTE GOLFO,2023-10-19,144,142,2,0.0138888888888889
ORIENTE GOLFO,2023-10-20,147,143,4,0.0272108843537415
ORIENTE GOLFO,2023-10-21,191,190,1,0.00523560209424084
ORIENTE GOLFO,2023-10-22,144,140,4,0.0277777777777778
ORIENTE GOLFO,2023-10-23,164,160,4,0.024390243902439
ORIENTE GOLFO,2023-10-24,132,130,2,0.0151515151515152
ORIENTE GOLFO,2023-10-25,146,140,6,0.0410958904109589
ORIENTE GOLFO,2023-10-26,173,167,6,0.0346820809248555
ORIENTE GOLFO,2023-10-27,143,138,5,0.034965034965035
ORIENTE GOLFO,2023-10-28,184,177,7,0.0380434782608696
ORIENTE GOLFO,2023-10-29,130,127,3,0.0230769230769231
ORIENTE GOLFO,2023-10-30,159,157,2,0.0125786163522013
ORIENTE GOLFO,2023-10-31,202,198,4,0.0198019801980198
ORIENTE GOLFO,2023-11-01,157,152,5,0.0318471337579618
ORIENTE GOLFO,2023-11-02,128,127,1,0.0078125
ORIENTE GOLFO,2023-11-03,135,131,4,0.0296296296296296
ORIENTE GOLFO,2023-11-04,144,141,3,0.0208333333333333
ORIENTE GOLFO,2023-11-05,135,133,2,0.0148148148148148
ORIENTE GOLFO,2023-11-06,170,160,10,0.0588235294117647
ORIENTE GOLFO,2023-11-07,163,159,4,0.0245398773006135
ORIENTE GOLFO,2023-11-08,166,161,5,0.0301204819277108
ORIENTE GOLFO,2023-11-09,175,168,7,0.04
ORIENTE GOLFO,2023-11-10,175,169,6,0.0342857142857143
ORIENTE GOLFO,2023-11-11,173,169,4,0.023121387283237
ORIENTE GOLFO,2023-11-12,136,131,5,0.0367647058823529
ORIENTE GOLFO,2023-11-13,164,159,5,0.0304878048780488
ORIENTE GOLFO,2023-11-14,195,191,4,0.0205128205128205
ORIENTE GOLFO,2023-11-15,208,201,7,0.0336538461538462
ORIENTE GOLFO,2023-11-16,194,191,3,0.0154639175257732
ORIENTE GOLFO,2023-11-17,200,193,7,0.035
ORIENTE GOLFO,2023-11-18,218,216,2,0.00917431192660551
ORIENTE GOLFO,2023-11-19,169,160,9,0.0532544378698225
ORIENTE GOLFO,2023-11-20,180,175,5,0.0277777777777778
ORIENTE GOLFO,2023-11-21,157,153,4,0.0254777070063694
ORIENTE GOLFO,2023-11-22,159,156,3,0.0188679245283019
ORIENTE GOLFO,2023-11-23,173,169,4,0.023121387283237
ORIENTE GOLFO,2023-11-24,171,165,6,0.0350877192982456
ORIENTE GOLFO,2023-11-25,186,184,2,0.010752688172043
ORIENTE GOLFO,2023-11-26,136,132,4,0.0294117647058824
ORIENTE GOLFO,2023-11-27,160,157,3,0.01875
ORIENTE GOLFO,2023-11-28,182,179,3,0.0164835164835165
ORIENTE GOLFO,2023-11-29,183,169,14,0.0765027322404372
ORIENTE GOLFO,2023-11-30,235,222,13,0.0553191489361702
ORIENTE GOLFO,2023-12-01,206,198,8,0.0388349514563107
ORIENTE GOLFO,2023-12-02,193,189,4,0.0207253886010363
ORIENTE GOLFO,2023-12-03,170,164,6,0.0352941176470588
ORIENTE GOLFO,2023-12-04,153,149,4,0.0261437908496732
ORIENTE GOLFO,2023-12-05,162,157,5,0.0308641975308642
ORIENTE GOLFO,2023-12-06,186,181,5,0.0268817204301075
ORIENTE GOLFO,2023-12-07,198,189,9,0.0454545454545455
ORIENTE GOLFO,2023-12-08,215,211,4,0.0186046511627907
ORIENTE GOLFO,2023-12-09,197,190,7,0.0355329949238579
ORIENTE GOLFO,2023-12-10,112,107,5,0.0446428571428571
ORIENTE GOLFO,2023-12-11,156,155,1,0.00641025641025641
ORIENTE GOLFO,2023-12-12,148,146,2,0.0135135135135135
ORIENTE GOLFO,2023-12-13,160,156,4,0.025
ORIENTE GOLFO,2023-12-14,156,148,8,0.0512820512820513
ORIENTE GOLFO,2023-12-15,170,163,7,0.0411764705882353
ORIENTE GOLFO,2023-12-16,171,167,4,0.0233918128654971
ORIENTE GOLFO,2023-12-17,150,144,6,0.04
ORIENTE GOLFO,2023-12-18,191,186,5,0.0261780104712042
ORIENTE GOLFO,2023-12-19,206,197,9,0.0436893203883495
ORIENTE GOLFO,2023-12-20,159,154,5,0.0314465408805031
ORIENTE GOLFO,2023-12-21,203,198,5,0.0246305418719212
ORIENTE GOLFO,2023-12-22,193,188,5,0.0259067357512953
ORIENTE GOLFO,2023-12-23,215,207,8,0.0372093023255814
ORIENTE GOLFO,2023-12-24,107,103,4,0.0373831775700935
ORIENTE GOLFO,2023-12-25,42,42,0,0
ORIENTE GOLFO,2023-12-26,158,155,3,0.0189873417721519
ORIENTE GOLFO,2023-12-27,190,186,4,0.0210526315789474
ORIENTE GOLFO,2023-12-28,203,198,5,0.0246305418719212
ORIENTE GOLFO,2023-12-29,174,168,6,0.0344827586206897
ORIENTE GOLFO,2023-12-30,184,179,5,0.0271739130434783
ORIENTE GOLFO,2023-12-31,77,73,4,0.051948051948052
ORIENTE GOLFO,2024-01-01,37,36,1,0.027027027027027
ORIENTE GOLFO,2024-01-02,145,140,5,0.0344827586206897
ORIENTE GOLFO,2024-01-03,178,176,2,0.0112359550561798
ORIENTE GOLFO,2024-01-04,160,158,2,0.0125
ORIENTE GOLFO,2024-01-05,170,165,5,0.0294117647058824
ORIENTE GOLFO,2024-01-06,163,158,5,0.0306748466257669
ORIENTE GOLFO,2024-01-07,114,111,3,0.0263157894736842
ORIENTE GOLFO,2024-01-08,163,155,8,0.049079754601227
ORIENTE GOLFO,2024-01-09,188,180,8,0.0425531914893617
ORIENTE GOLFO,2024-01-10,190,186,4,0.0210526315789474
ORIENTE GOLFO,2024-01-11,170,165,5,0.0294117647058824
ORIENTE GOLFO,2024-01-12,176,172,4,0.0227272727272727
ORIENTE GOLFO,2024-01-13,173,167,6,0.0346820809248555
ORIENTE GOLFO,2024-01-14,163,160,3,0.0184049079754601
ORIENTE GOLFO,2024-01-15,198,193,5,0.0252525252525253
ORIENTE GOLFO,2024-01-16,185,179,6,0.0324324324324324
ORIENTE GOLFO,2024-01-17,200,196,4,0.02
ORIENTE GOLFO,2024-01-18,187,183,4,0.0213903743315508
ORIENTE GOLFO,2024-01-19,148,145,3,0.0202702702702703
ORIENTE GOLFO,2024-01-20,178,174,4,0.0224719101123595
ORIENTE GOLFO,2024-01-21,120,118,2,0.0166666666666667
ORIENTE GOLFO,2024-01-22,188,183,5,0.0265957446808511
ORIENTE GOLFO,2024-01-23,156,152,4,0.0256410256410256
ORIENTE GOLFO,2024-01-24,165,161,4,0.0242424242424242
ORIENTE GOLFO,2024-01-25,158,153,5,0.0316455696202532
ORIENTE GOLFO,2024-01-26,157,153,4,0.0254777070063694
ORIENTE GOLFO,2024-01-27,181,174,7,0.0386740331491713
ORIENTE GOLFO,2024-01-28,118,115,3,0.0254237288135593
ORIENTE GOLFO,2024-01-29,157,155,2,0.0127388535031847
ORIENTE GOLFO,2024-01-30,193,186,7,0.0362694300518135
ORIENTE GOLFO,2024-01-31,227,222,5,0.0220264317180617
ORIENTE GOLFO,2024-02-01,178,171,7,0.0393258426966292
ORIENTE GOLFO,2024-02-02,175,167,8,0.0457142857142857
ORIENTE GOLFO,2024-02-03,164,158,6,0.0365853658536585
ORIENTE GOLFO,2024-02-04,130,128,2,0.0153846153846154
ORIENTE GOLFO,2024-02-05,150,148,2,0.0133333333333333
ORIENTE GOLFO,2024-02-06,174,168,6,0.0344827586206897
ORIENTE GOLFO,2024-02-07,173,169,4,0.023121387283237
ORIENTE GOLFO,2024-02-08,169,166,3,0.0177514792899408
ORIENTE GOLFO,2024-02-09,167,164,3,0.0179640718562874
ORIENTE GOLFO,2024-02-10,165,161,4,0.0242424242424242
ORIENTE GOLFO,2024-02-11,93,89,4,0.043010752688172
ORIENTE GOLFO,2024-02-12,159,156,3,0.0188679245283019
ORIENTE GOLFO,2024-02-13,163,158,5,0.0306748466257669
ORIENTE GOLFO,2024-02-14,166,163,3,0.0180722891566265
ORIENTE GOLFO,2024-02-15,182,181,1,0.00549450549450549
ORIENTE GOLFO,2024-02-16,168,167,1,0.00595238095238095
ORIENTE GOLFO,2024-02-17,162,158,4,0.0246913580246914
ORIENTE GOLFO,2024-02-18,145,140,5,0.0344827586206897
ORIENTE GOLFO,2024-02-19,161,154,7,0.0434782608695652
ORIENTE GOLFO,2024-02-20,181,179,2,0.0110497237569061
ORIENTE GOLFO,2024-02-21,203,200,3,0.0147783251231527
ORIENTE GOLFO,2024-02-22,154,151,3,0.0194805194805195
ORIENTE GOLFO,2024-02-23,101,89,12,0.118811881188119
ORIENTE GOLFO,2024-02-24,200,192,8,0.04
ORIENTE GOLFO,2024-02-25,126,121,5,0.0396825396825397
ORIENTE GOLFO,2024-02-26,152,149,3,0.0197368421052632
ORIENTE GOLFO,2024-02-27,177,172,5,0.0282485875706215
ORIENTE GOLFO,2024-02-28,195,189,6,0.0307692307692308
ORIENTE GOLFO,2024-02-29,179,173,6,0.0335195530726257
ORIENTE GOLFO,2024-03-01,175,173,2,0.0114285714285714
ORIENTE GOLFO,2024-03-02,173,170,3,0.0173410404624277
ORIENTE GOLFO,2024-03-03,125,122,3,0.024
ORIENTE GOLFO,2024-03-04,176,172,4,0.0227272727272727
ORIENTE GOLFO,2024-03-05,160,153,7,0.04375
ORIENTE GOLFO,2024-03-06,160,157,3,0.01875
ORIENTE GOLFO,2024-03-07,178,177,1,0.00561797752808989
ORIENTE GOLFO,2024-03-08,152,150,2,0.0131578947368421
ORIENTE GOLFO,2024-03-09,158,156,2,0.0126582278481013
ORIENTE GOLFO,2024-03-10,122,117,5,0.040983606557377
ORIENTE GOLFO,2024-03-11,161,160,1,0.0062111801242236
ORIENTE GOLFO,2024-03-12,159,155,4,0.0251572327044025
ORIENTE GOLFO,2024-03-13,128,124,4,0.03125
ORIENTE GOLFO,2024-03-14,131,127,4,0.0305343511450382
ORIENTE GOLFO,2024-03-15,144,139,5,0.0347222222222222
ORIENTE GOLFO,2024-03-16,162,157,5,0.0308641975308642
ORIENTE GOLFO,2024-03-17,103,100,3,0.029126213592233
ORIENTE GOLFO,2024-03-18,149,143,6,0.0402684563758389
ORIENTE GOLFO,2024-03-19,170,167,3,0.0176470588235294
ORIENTE GOLFO,2024-03-20,167,162,5,0.029940119760479
ORIENTE GOLFO,2024-03-21,161,158,3,0.0186335403726708
ORIENTE GOLFO,2024-03-22,139,135,4,0.0287769784172662
ORIENTE GOLFO,2024-03-23,138,138,0,0
ORIENTE GOLFO,2024-03-24,98,94,4,0.0408163265306122
ORIENTE GOLFO,2024-03-25,136,133,3,0.0220588235294118
ORIENTE GOLFO,2024-03-26,146,143,3,0.0205479452054795
ORIENTE GOLFO,2024-03-27,126,123,3,0.0238095238095238
ORIENTE GOLFO,2024-03-28,165,160,5,0.0303030303030303
ORIENTE GOLFO,2024-03-29,150,144,6,0.04
ORIENTE GOLFO,2024-03-30,132,130,2,0.0151515151515152
ORIENTE GOLFO,2024-03-31,115,108,7,0.0608695652173913
ORIENTE GOLFO,2024-04-01,169,157,12,0.0710059171597633
ORIENTE GOLFO,2024-04-02,158,152,6,0.0379746835443038
ORIENTE GOLFO,2024-04-03,128,128,0,0
ORIENTE GOLFO,2024-04-04,163,163,0,0
ORIENTE GOLFO,2024-04-05,187,183,4,0.0213903743315508
ORIENTE GOLFO,2024-04-06,138,132,6,0.0434782608695652
ORIENTE GOLFO,2024-04-07,107,103,4,0.0373831775700935
ORIENTE GOLFO,2024-04-08,138,133,5,0.036231884057971
ORIENTE GOLFO,2024-04-09,160,157,3,0.01875
ORIENTE GOLFO,2024-04-10,139,132,7,0.0503597122302158
ORIENTE GOLFO,2024-04-11,125,123,2,0.016
ORIENTE GOLFO,2024-04-12,160,155,5,0.03125
ORIENTE GOLFO,2024-04-13,161,150,11,0.0683229813664596
ORIENTE GOLFO,2024-04-14,111,109,2,0.018018018018018
ORIENTE GOLFO,2024-04-15,185,181,4,0.0216216216216216
ORIENTE GOLFO,2024-04-16,213,200,13,0.0610328638497653
ORIENTE GOLFO,2024-04-17,140,130,10,0.0714285714285714
ORIENTE GOLFO,2024-04-18,136,126,10,0.0735294117647059
ORIENTE GOLFO,2024-04-19,137,132,5,0.0364963503649635
ORIENTE GOLFO,2024-04-20,120,116,4,0.0333333333333333
ORIENTE GOLFO,2024-04-21,104,98,6,0.0576923076923077
ORIENTE GOLFO,2024-04-22,95,92,3,0.0315789473684211
ORIENTE GOLFO,2024-04-23,214,199,15,0.0700934579439252
ORIENTE GOLFO,2024-04-24,133,128,5,0.037593984962406
ORIENTE GOLFO,2024-04-25,139,132,7,0.0503597122302158
ORIENTE GOLFO,2024-04-26,147,144,3,0.0204081632653061
ORIENTE GOLFO,2024-04-27,126,119,7,0.0555555555555556
ORIENTE GOLFO,2024-04-28,110,105,5,0.0454545454545455
ORIENTE GOLFO,2024-04-29,172,167,5,0.0290697674418605
ORIENTE GOLFO,2024-04-30,173,168,5,0.0289017341040462
ORIENTE GOLFO,2024-05-01,149,145,4,0.0268456375838926
ORIENTE GOLFO,2024-05-02,137,135,2,0.0145985401459854
ORIENTE GOLFO,2024-05-03,127,119,8,0.062992125984252
ORIENTE GOLFO,2024-05-04,141,137,4,0.0283687943262411
ORIENTE GOLFO,2024-05-05,104,101,3,0.0288461538461538
ORIENTE GOLFO,2024-05-06,155,155,0,0
ORIENTE GOLFO,2024-05-07,150,139,11,0.0733333333333333
ORIENTE GOLFO,2024-05-08,135,121,14,0.103703703703704
ORIENTE GOLFO,2024-05-09,129,125,4,0.0310077519379845
ORIENTE GOLFO,2024-05-10,114,103,11,0.0964912280701754
ORIENTE GOLFO,2024-05-11,140,129,11,0.0785714285714286
ORIENTE GOLFO,2024-05-12,91,81,10,0.10989010989011
ORIENTE GOLFO,2024-05-13,155,146,9,0.0580645161290323
ORIENTE GOLFO,2024-05-14,155,143,12,0.0774193548387097
ORIENTE GOLFO,2024-05-15,173,161,12,0.069364161849711
ORIENTE GOLFO,2024-05-16,178,143,35,0.196629213483146
ORIENTE GOLFO,2024-05-17,164,154,10,0.0609756097560976
ORIENTE GOLFO,2024-05-18,156,144,12,0.0769230769230769
ORIENTE GOLFO,2024-05-19,120,109,11,0.0916666666666667
ORIENTE GOLFO,2024-05-20,161,157,4,0.0248447204968944
ORIENTE GOLFO,2024-05-21,132,126,6,0.0454545454545455
ORIENTE GOLFO,2024-05-22,165,163,2,0.0121212121212121
ORIENTE GOLFO,2024-05-23,128,125,3,0.0234375
ORIENTE GOLFO,2024-05-24,158,150,8,0.0506329113924051
ORIENTE GOLFO,2024-05-25,159,155,4,0.0251572327044025
ORIENTE GOLFO,2024-05-26,110,106,4,0.0363636363636364
ORIENTE GOLFO,2024-05-27,137,133,4,0.0291970802919708
ORIENTE GOLFO,2024-05-28,127,126,1,0.0078740157480315
ORIENTE GOLFO,2024-05-29,142,138,4,0.028169014084507
ORIENTE GOLFO,2024-05-30,149,146,3,0.0201342281879195
ORIENTE GOLFO,2024-05-31,233,231,2,0.00858369098712446
ORIENTE GOLFO,2024-06-01,175,171,4,0.0228571428571429
ORIENTE GOLFO,2024-06-02,107,103,4,0.0373831775700935
ORIENTE GOLFO,2024-06-03,150,145,5,0.0333333333333333
ORIENTE GOLFO,2024-06-04,152,149,3,0.0197368421052632
ORIENTE GOLFO,2024-06-05,168,163,5,0.0297619047619048
ORIENTE GOLFO,2024-06-06,171,165,6,0.0350877192982456
ORIENTE GOLFO,2024-06-07,151,145,6,0.0397350993377483
ORIENTE GOLFO,2024-06-08,149,142,7,0.0469798657718121
ORIENTE GOLFO,2024-06-09,101,99,2,0.0198019801980198
ORIENTE GOLFO,2024-06-10,162,159,3,0.0185185185185185
ORIENTE GOLFO,2024-06-11,151,145,6,0.0397350993377483
ORIENTE GOLFO,2024-06-12,164,160,4,0.024390243902439
ORIENTE GOLFO,2024-06-13,153,149,4,0.0261437908496732
ORIENTE GOLFO,2024-06-14,147,140,7,0.0476190476190476
ORIENTE GOLFO,2024-06-15,157,152,5,0.0318471337579618
ORIENTE GOLFO,2024-06-16,98,95,3,0.0306122448979592
ORIENTE GOLFO,2024-06-17,162,157,5,0.0308641975308642
ORIENTE GOLFO,2024-06-18,177,171,6,0.0338983050847458
ORIENTE GOLFO,2024-06-19,155,147,8,0.0516129032258065
ORIENTE GOLFO,2024-06-20,137,129,8,0.0583941605839416
ORIENTE GOLFO,2024-06-21,151,146,5,0.033112582781457
ORIENTE GOLFO,2024-06-22,170,165,5,0.0294117647058824
ORIENTE GOLFO,2024-06-23,111,106,5,0.045045045045045
ORIENTE GOLFO,2024-06-24,168,161,7,0.0416666666666667
ORIENTE GOLFO,2024-06-25,178,175,3,0.0168539325842697
ORIENTE GOLFO,2024-06-26,129,120,9,0.0697674418604651
ORIENTE GOLFO,2024-06-27,108,101,7,0.0648148148148148
ORIENTE GOLFO,2024-06-28,162,158,4,0.0246913580246914
ORIENTE GOLFO,2024-06-29,185,180,5,0.027027027027027
ORIENTE GOLFO,2024-06-30,147,139,8,0.054421768707483
ORIENTE GOLFO,2024-07-01,173,165,8,0.046242774566474
ORIENTE GOLFO,2024-07-02,147,144,3,0.0204081632653061
ORIENTE PACIFICO,2023-07-03,195,193,2,0.0102564102564103
ORIENTE PACIFICO,2023-07-04,175,170,5,0.0285714285714286
ORIENTE PACIFICO,2023-07-05,203,194,9,0.0443349753694581
ORIENTE PACIFICO,2023-07-06,160,156,4,0.025
ORIENTE PACIFICO,2023-07-07,206,202,4,0.0194174757281553
ORIENTE PACIFICO,2023-07-08,230,226,4,0.0173913043478261
ORIENTE PACIFICO,2023-07-09,160,155,5,0.03125
ORIENTE PACIFICO,2023-07-10,166,161,5,0.0301204819277108
ORIENTE PACIFICO,2023-07-11,186,181,5,0.0268817204301075
ORIENTE PACIFICO,2023-07-12,194,189,5,0.0257731958762887
ORIENTE PACIFICO,2023-07-13,147,140,7,0.0476190476190476
ORIENTE PACIFICO,2023-07-14,183,179,4,0.0218579234972678
ORIENTE PACIFICO,2023-07-15,218,216,2,0.00917431192660551
ORIENTE PACIFICO,2023-07-16,176,172,4,0.0227272727272727
ORIENTE PACIFICO,2023-07-17,172,166,6,0.0348837209302326
ORIENTE PACIFICO,2023-07-18,149,146,3,0.0201342281879195
ORIENTE PACIFICO,2023-07-19,174,171,3,0.0172413793103448
ORIENTE PACIFICO,2023-07-20,205,198,7,0.0341463414634146
ORIENTE PACIFICO,2023-07-21,175,173,2,0.0114285714285714
ORIENTE PACIFICO,2023-07-22,192,187,5,0.0260416666666667
ORIENTE PACIFICO,2023-07-23,171,168,3,0.0175438596491228
ORIENTE PACIFICO,2023-07-24,192,188,4,0.0208333333333333
ORIENTE PACIFICO,2023-07-25,206,206,0,0
ORIENTE PACIFICO,2023-07-26,191,187,4,0.0209424083769634
ORIENTE PACIFICO,2023-07-27,209,203,6,0.0287081339712919
ORIENTE PACIFICO,2023-07-28,196,192,4,0.0204081632653061
ORIENTE PACIFICO,2023-07-29,244,240,4,0.0163934426229508
ORIENTE PACIFICO,2023-07-30,188,186,2,0.0106382978723404
ORIENTE PACIFICO,2023-07-31,237,236,1,0.00421940928270042
ORIENTE PACIFICO,2023-08-01,189,186,3,0.0158730158730159
ORIENTE PACIFICO,2023-08-02,199,196,3,0.0150753768844221
ORIENTE PACIFICO,2023-08-03,189,170,19,0.100529100529101
ORIENTE PACIFICO,2023-08-04,154,147,7,0.0454545454545455
ORIENTE PACIFICO,2023-08-05,199,195,4,0.0201005025125628
ORIENTE PACIFICO,2023-08-06,174,170,4,0.0229885057471264
ORIENTE PACIFICO,2023-08-07,192,186,6,0.03125
ORIENTE PACIFICO,2023-08-08,180,177,3,0.0166666666666667
ORIENTE PACIFICO,2023-08-09,222,214,8,0.036036036036036
ORIENTE PACIFICO,2023-08-10,225,222,3,0.0133333333333333
ORIENTE PACIFICO,2023-08-11,226,224,2,0.00884955752212389
ORIENTE PACIFICO,2023-08-12,202,199,3,0.0148514851485149
ORIENTE PACIFICO,2023-08-13,183,176,7,0.0382513661202186
ORIENTE PACIFICO,2023-08-14,203,197,6,0.0295566502463054
ORIENTE PACIFICO,2023-08-15,209,207,2,0.00956937799043062
ORIENTE PACIFICO,2023-08-16,204,200,4,0.0196078431372549
ORIENTE PACIFICO,2023-08-17,203,197,6,0.0295566502463054
ORIENTE PACIFICO,2023-08-18,208,204,4,0.0192307692307692
ORIENTE PACIFICO,2023-08-19,213,213,0,0
ORIENTE PACIFICO,2023-08-20,160,156,4,0.025
ORIENTE PACIFICO,2023-08-21,173,171,2,0.0115606936416185
ORIENTE PACIFICO,2023-08-22,165,165,0,0
ORIENTE PACIFICO,2023-08-23,163,163,0,0
ORIENTE PACIFICO,2023-08-24,189,189,0,0
ORIENTE PACIFICO,2023-08-25,216,216,0,0
ORIENTE PACIFICO,2023-08-26,219,218,1,0.0045662100456621
ORIENTE PACIFICO,2023-08-27,185,184,1,0.00540540540540541
ORIENTE PACIFICO,2023-08-28,201,201,0,0
ORIENTE PACIFICO,2023-08-29,208,207,1,0.00480769230769231
ORIENTE PACIFICO,2023-08-30,195,195,0,0
ORIENTE PACIFICO,2023-08-31,183,182,1,0.00546448087431694
ORIENTE PACIFICO,2023-09-01,150,150,0,0
ORIENTE PACIFICO,2023-09-02,169,169,0,0
ORIENTE PACIFICO,2023-09-03,138,138,0,0
ORIENTE PACIFICO,2023-09-04,172,172,0,0
ORIENTE PACIFICO,2023-09-05,181,181,0,0
ORIENTE PACIFICO,2023-09-06,178,178,0,0
ORIENTE PACIFICO,2023-09-07,167,167,0,0
ORIENTE PACIFICO,2023-09-08,160,159,1,0.00625
ORIENTE PACIFICO,2023-09-09,205,205,0,0
ORIENTE PACIFICO,2023-09-10,156,156,0,0
ORIENTE PACIFICO,2023-09-11,189,188,1,0.00529100529100529
ORIENTE PACIFICO,2023-09-12,186,185,1,0.00537634408602151
ORIENTE PACIFICO,2023-09-13,166,165,1,0.00602409638554217
ORIENTE PACIFICO,2023-09-14,208,208,0,0
ORIENTE PACIFICO,2023-09-15,227,227,0,0
ORIENTE PACIFICO,2023-09-16,156,156,0,0
ORIENTE PACIFICO,2023-09-17,136,136,0,0
ORIENTE PACIFICO,2023-09-18,173,173,0,0
ORIENTE PACIFICO,2023-09-19,184,184,0,0
ORIENTE PACIFICO,2023-09-20,162,161,1,0.00617283950617284
ORIENTE PACIFICO,2023-09-21,166,165,1,0.00602409638554217
ORIENTE PACIFICO,2023-09-22,168,168,0,0
ORIENTE PACIFICO,2023-09-23,229,228,1,0.00436681222707424
ORIENTE PACIFICO,2023-09-24,176,176,0,0
ORIENTE PACIFICO,2023-09-25,198,196,2,0.0101010101010101
ORIENTE PACIFICO,2023-09-26,216,216,0,0
ORIENTE PACIFICO,2023-09-27,177,177,0,0
ORIENTE PACIFICO,2023-09-28,173,172,1,0.00578034682080925
ORIENTE PACIFICO,2023-09-29,220,220,0,0
ORIENTE PACIFICO,2023-09-30,293,292,1,0.00341296928327645
ORIENTE PACIFICO,2023-10-01,177,177,0,0
ORIENTE PACIFICO,2023-10-02,150,150,0,0
ORIENTE PACIFICO,2023-10-03,150,148,2,0.0133333333333333
ORIENTE PACIFICO,2023-10-04,176,175,1,0.00568181818181818
ORIENTE PACIFICO,2023-10-05,154,152,2,0.012987012987013
ORIENTE PACIFICO,2023-10-06,201,198,3,0.0149253731343284
ORIENTE PACIFICO,2023-10-07,190,187,3,0.0157894736842105
ORIENTE PACIFICO,2023-10-08,114,110,4,0.0350877192982456
ORIENTE PACIFICO,2023-10-09,137,136,1,0.0072992700729927
ORIENTE PACIFICO,2023-10-10,144,143,1,0.00694444444444444
ORIENTE PACIFICO,2023-10-11,168,166,2,0.0119047619047619
ORIENTE PACIFICO,2023-10-12,135,134,1,0.00740740740740741
ORIENTE PACIFICO,2023-10-13,153,149,4,0.0261437908496732
ORIENTE PACIFICO,2023-10-14,192,190,2,0.0104166666666667
ORIENTE PACIFICO,2023-10-15,155,155,0,0
ORIENTE PACIFICO,2023-10-16,185,183,2,0.0108108108108108
ORIENTE PACIFICO,2023-10-17,167,163,4,0.0239520958083832
ORIENTE PACIFICO,2023-10-18,171,163,8,0.0467836257309941
ORIENTE PACIFICO,2023-10-19,174,170,4,0.0229885057471264
ORIENTE PACIFICO,2023-10-20,159,151,8,0.050314465408805
ORIENTE PACIFICO,2023-10-21,225,217,8,0.0355555555555556
ORIENTE PACIFICO,2023-10-22,165,163,2,0.0121212121212121
ORIENTE PACIFICO,2023-10-23,180,176,4,0.0222222222222222
ORIENTE PACIFICO,2023-10-24,190,185,5,0.0263157894736842
ORIENTE PACIFICO,2023-10-25,125,124,1,0.008
ORIENTE PACIFICO,2023-10-26,143,138,5,0.034965034965035
ORIENTE PACIFICO,2023-10-27,164,155,9,0.0548780487804878
ORIENTE PACIFICO,2023-10-28,189,183,6,0.0317460317460317
ORIENTE PACIFICO,2023-10-29,137,130,7,0.0510948905109489
ORIENTE PACIFICO,2023-10-30,134,133,1,0.00746268656716418
ORIENTE PACIFICO,2023-10-31,200,197,3,0.015
ORIENTE PACIFICO,2023-11-01,164,157,7,0.0426829268292683
ORIENTE PACIFICO,2023-11-02,131,127,4,0.0305343511450382
ORIENTE PACIFICO,2023-11-03,135,132,3,0.0222222222222222
ORIENTE PACIFICO,2023-11-04,167,164,3,0.0179640718562874
ORIENTE PACIFICO,2023-11-05,139,137,2,0.0143884892086331
ORIENTE PACIFICO,2023-11-06,177,175,2,0.0112994350282486
ORIENTE PACIFICO,2023-11-07,175,173,2,0.0114285714285714
ORIENTE PACIFICO,2023-11-08,160,158,2,0.0125
ORIENTE PACIFICO,2023-11-09,161,158,3,0.0186335403726708
ORIENTE PACIFICO,2023-11-10,159,156,3,0.0188679245283019
ORIENTE PACIFICO,2023-11-11,216,212,4,0.0185185185185185
ORIENTE PACIFICO,2023-11-12,148,143,5,0.0337837837837838
ORIENTE PACIFICO,2023-11-13,129,124,5,0.0387596899224806
ORIENTE PACIFICO,2023-11-14,187,185,2,0.0106951871657754
ORIENTE PACIFICO,2023-11-15,194,190,4,0.0206185567010309
ORIENTE PACIFICO,2023-11-16,171,167,4,0.0233918128654971
ORIENTE PACIFICO,2023-11-17,192,189,3,0.015625
ORIENTE PACIFICO,2023-11-18,192,188,4,0.0208333333333333
ORIENTE PACIFICO,2023-11-19,173,172,1,0.00578034682080925
ORIENTE PACIFICO,2023-11-20,169,167,2,0.0118343195266272
ORIENTE PACIFICO,2023-11-21,182,179,3,0.0164835164835165
ORIENTE PACIFICO,2023-11-22,152,150,2,0.0131578947368421
ORIENTE PACIFICO,2023-11-23,164,160,4,0.024390243902439
ORIENTE PACIFICO,2023-11-24,167,164,3,0.0179640718562874
ORIENTE PACIFICO,2023-11-25,211,210,1,0.004739336492891
ORIENTE PACIFICO,2023-11-26,124,122,2,0.0161290322580645
ORIENTE PACIFICO,2023-11-27,185,182,3,0.0162162162162162
ORIENTE PACIFICO,2023-11-28,157,151,6,0.0382165605095541
ORIENTE PACIFICO,2023-11-29,208,200,8,0.0384615384615385
ORIENTE PACIFICO,2023-11-30,241,237,4,0.016597510373444
ORIENTE PACIFICO,2023-12-01,167,161,6,0.0359281437125748
ORIENTE PACIFICO,2023-12-02,219,214,5,0.0228310502283105
ORIENTE PACIFICO,2023-12-03,146,140,6,0.0410958904109589
ORIENTE PACIFICO,2023-12-04,171,168,3,0.0175438596491228
ORIENTE PACIFICO,2023-12-05,197,192,5,0.0253807106598985
ORIENTE PACIFICO,2023-12-06,205,200,5,0.024390243902439
ORIENTE PACIFICO,2023-12-07,191,187,4,0.0209424083769634
ORIENTE PACIFICO,2023-12-08,195,187,8,0.041025641025641
ORIENTE PACIFICO,2023-12-09,213,210,3,0.0140845070422535
ORIENTE PACIFICO,2023-12-10,170,164,6,0.0352941176470588
ORIENTE PACIFICO,2023-12-11,177,173,4,0.0225988700564972
ORIENTE PACIFICO,2023-12-12,214,208,6,0.0280373831775701
ORIENTE PACIFICO,2023-12-13,169,167,2,0.0118343195266272
ORIENTE PACIFICO,2023-12-14,173,169,4,0.023121387283237
ORIENTE PACIFICO,2023-12-15,177,174,3,0.0169491525423729
ORIENTE PACIFICO,2023-12-16,225,222,3,0.0133333333333333
ORIENTE PACIFICO,2023-12-17,198,191,7,0.0353535353535354
ORIENTE PACIFICO,2023-12-18,208,205,3,0.0144230769230769
ORIENTE PACIFICO,2023-12-19,219,211,8,0.0365296803652968
ORIENTE PACIFICO,2023-12-20,199,195,4,0.0201005025125628
ORIENTE PACIFICO,2023-12-21,219,215,4,0.0182648401826484
ORIENTE PACIFICO,2023-12-22,187,185,2,0.0106951871657754
ORIENTE PACIFICO,2023-12-23,217,211,6,0.0276497695852535
ORIENTE PACIFICO,2023-12-24,132,129,3,0.0227272727272727
ORIENTE PACIFICO,2023-12-25,43,43,0,0
ORIENTE PACIFICO,2023-12-26,176,175,1,0.00568181818181818
ORIENTE PACIFICO,2023-12-27,225,219,6,0.0266666666666667
ORIENTE PACIFICO,2023-12-28,214,210,4,0.0186915887850467
ORIENTE PACIFICO,2023-12-29,232,225,7,0.0301724137931034
ORIENTE PACIFICO,2023-12-30,231,225,6,0.025974025974026
ORIENTE PACIFICO,2023-12-31,97,97,0,0
ORIENTE PACIFICO,2024-01-01,37,34,3,0.0810810810810811
ORIENTE PACIFICO,2024-01-02,131,130,1,0.00763358778625954
ORIENTE PACIFICO,2024-01-03,181,175,6,0.0331491712707182
ORIENTE PACIFICO,2024-01-04,218,215,3,0.0137614678899083
ORIENTE PACIFICO,2024-01-05,201,195,6,0.0298507462686567
ORIENTE PACIFICO,2024-01-06,223,222,1,0.00448430493273543
ORIENTE PACIFICO,2024-01-07,149,147,2,0.0134228187919463
ORIENTE PACIFICO,2024-01-08,195,195,0,0
ORIENTE PACIFICO,2024-01-09,230,223,7,0.0304347826086957
ORIENTE PACIFICO,2024-01-10,232,228,4,0.0172413793103448
ORIENTE PACIFICO,2024-01-11,215,207,8,0.0372093023255814
ORIENTE PACIFICO,2024-01-12,217,214,3,0.0138248847926267
ORIENTE PACIFICO,2024-01-13,287,282,5,0.0174216027874564
ORIENTE PACIFICO,2024-01-14,216,212,4,0.0185185185185185
ORIENTE PACIFICO,2024-01-15,219,209,10,0.045662100456621
ORIENTE PACIFICO,2024-01-16,282,274,8,0.0283687943262411
ORIENTE PACIFICO,2024-01-17,242,238,4,0.0165289256198347
ORIENTE PACIFICO,2024-01-18,216,210,6,0.0277777777777778
ORIENTE PACIFICO,2024-01-19,186,179,7,0.0376344086021505
ORIENTE PACIFICO,2024-01-20,226,222,4,0.0176991150442478
ORIENTE PACIFICO,2024-01-21,159,155,4,0.0251572327044025
ORIENTE PACIFICO,2024-01-22,168,163,5,0.0297619047619048
ORIENTE PACIFICO,2024-01-23,184,180,4,0.0217391304347826
ORIENTE PACIFICO,2024-01-24,193,188,5,0.0259067357512953
ORIENTE PACIFICO,2024-01-25,159,157,2,0.0125786163522013
ORIENTE PACIFICO,2024-01-26,177,172,5,0.0282485875706215
ORIENTE PACIFICO,2024-01-27,189,188,1,0.00529100529100529
ORIENTE PACIFICO,2024-01-28,152,148,4,0.0263157894736842
ORIENTE PACIFICO,2024-01-29,176,170,6,0.0340909090909091
ORIENTE PACIFICO,2024-01-30,176,172,4,0.0227272727272727
ORIENTE PACIFICO,2024-01-31,236,230,6,0.0254237288135593
ORIENTE PACIFICO,2024-02-01,178,177,1,0.00561797752808989
ORIENTE PACIFICO,2024-02-02,165,162,3,0.0181818181818182
ORIENTE PACIFICO,2024-02-03,218,212,6,0.0275229357798165
ORIENTE PACIFICO,2024-02-04,177,176,1,0.00564971751412429
ORIENTE PACIFICO,2024-02-05,191,186,5,0.0261780104712042
ORIENTE PACIFICO,2024-02-06,170,167,3,0.0176470588235294
ORIENTE PACIFICO,2024-02-07,183,176,7,0.0382513661202186
ORIENTE PACIFICO,2024-02-08,183,183,0,0
ORIENTE PACIFICO,2024-02-09,176,170,6,0.0340909090909091
ORIENTE PACIFICO,2024-02-10,206,199,7,0.0339805825242718
ORIENTE PACIFICO,2024-02-11,148,138,10,0.0675675675675676
ORIENTE PACIFICO,2024-02-12,151,144,7,0.0463576158940397
ORIENTE PACIFICO,2024-02-13,175,170,5,0.0285714285714286
ORIENTE PACIFICO,2024-02-14,143,140,3,0.020979020979021
ORIENTE PACIFICO,2024-02-15,168,165,3,0.0178571428571429
ORIENTE PACIFICO,2024-02-16,184,177,7,0.0380434782608696
ORIENTE PACIFICO,2024-02-17,181,177,4,0.0220994475138122
ORIENTE PACIFICO,2024-02-18,197,194,3,0.0152284263959391
ORIENTE PACIFICO,2024-02-19,194,189,5,0.0257731958762887
ORIENTE PACIFICO,2024-02-20,196,185,11,0.0561224489795918
ORIENTE PACIFICO,2024-02-21,213,202,11,0.0516431924882629
ORIENTE PACIFICO,2024-02-22,184,183,1,0.00543478260869565
ORIENTE PACIFICO,2024-02-23,120,108,12,0.1
ORIENTE PACIFICO,2024-02-24,259,250,9,0.0347490347490347
ORIENTE PACIFICO,2024-02-25,150,145,5,0.0333333333333333
ORIENTE PACIFICO,2024-02-26,174,164,10,0.0574712643678161
ORIENTE PACIFICO,2024-02-27,193,186,7,0.0362694300518135
ORIENTE PACIFICO,2024-02-28,198,194,4,0.0202020202020202
ORIENTE PACIFICO,2024-02-29,238,233,5,0.0210084033613445
ORIENTE PACIFICO,2024-03-01,204,201,3,0.0147058823529412
ORIENTE PACIFICO,2024-03-02,207,202,5,0.0241545893719807
ORIENTE PACIFICO,2024-03-03,186,181,5,0.0268817204301075
ORIENTE PACIFICO,2024-03-04,211,207,4,0.018957345971564
ORIENTE PACIFICO,2024-03-05,212,209,3,0.0141509433962264
ORIENTE PACIFICO,2024-03-06,191,187,4,0.0209424083769634
ORIENTE PACIFICO,2024-03-07,182,179,3,0.0164835164835165
ORIENTE PACIFICO,2024-03-08,198,193,5,0.0252525252525253
ORIENTE PACIFICO,2024-03-09,220,212,8,0.0363636363636364
ORIENTE PACIFICO,2024-03-10,152,151,1,0.00657894736842105
ORIENTE PACIFICO,2024-03-11,168,165,3,0.0178571428571429
ORIENTE PACIFICO,2024-03-12,199,190,9,0.0452261306532663
ORIENTE PACIFICO,2024-03-13,169,166,3,0.0177514792899408
ORIENTE PACIFICO,2024-03-14,148,143,5,0.0337837837837838
ORIENTE PACIFICO,2024-03-15,166,161,5,0.0301204819277108
ORIENTE PACIFICO,2024-03-16,196,193,3,0.0153061224489796
ORIENTE PACIFICO,2024-03-17,154,149,5,0.0324675324675325
ORIENTE PACIFICO,2024-03-18,178,174,4,0.0224719101123595
ORIENTE PACIFICO,2024-03-19,178,173,5,0.0280898876404494
ORIENTE PACIFICO,2024-03-20,137,134,3,0.0218978102189781
ORIENTE PACIFICO,2024-03-21,165,162,3,0.0181818181818182
ORIENTE PACIFICO,2024-03-22,180,172,8,0.0444444444444444
ORIENTE PACIFICO,2024-03-23,187,182,5,0.0267379679144385
ORIENTE PACIFICO,2024-03-24,124,119,5,0.0403225806451613
ORIENTE PACIFICO,2024-03-25,167,159,8,0.0479041916167665
ORIENTE PACIFICO,2024-03-26,195,187,8,0.041025641025641
ORIENTE PACIFICO,2024-03-27,185,175,10,0.0540540540540541
ORIENTE PACIFICO,2024-03-28,206,195,11,0.0533980582524272
ORIENTE PACIFICO,2024-03-29,179,173,6,0.0335195530726257
ORIENTE PACIFICO,2024-03-30,182,178,4,0.021978021978022
ORIENTE PACIFICO,2024-03-31,132,127,5,0.0378787878787879
ORIENTE PACIFICO,2024-04-01,173,169,4,0.023121387283237
ORIENTE PACIFICO,2024-04-02,184,177,7,0.0380434782608696
ORIENTE PACIFICO,2024-04-03,146,146,0,0
ORIENTE PACIFICO,2024-04-04,167,167,0,0
ORIENTE PACIFICO,2024-04-05,179,172,7,0.0391061452513966
ORIENTE PACIFICO,2024-04-06,204,196,8,0.0392156862745098
ORIENTE PACIFICO,2024-04-07,121,118,3,0.0247933884297521
ORIENTE PACIFICO,2024-04-08,166,157,9,0.0542168674698795
ORIENTE PACIFICO,2024-04-09,141,134,7,0.049645390070922
ORIENTE PACIFICO,2024-04-10,175,167,8,0.0457142857142857
ORIENTE PACIFICO,2024-04-11,149,145,4,0.0268456375838926
ORIENTE PACIFICO,2024-04-12,163,160,3,0.0184049079754601
ORIENTE PACIFICO,2024-04-13,168,159,9,0.0535714285714286
ORIENTE PACIFICO,2024-04-14,139,136,3,0.0215827338129496
ORIENTE PACIFICO,2024-04-15,175,170,5,0.0285714285714286
ORIENTE PACIFICO,2024-04-16,185,172,13,0.0702702702702703
ORIENTE PACIFICO,2024-04-17,151,144,7,0.0463576158940397
ORIENTE PACIFICO,2024-04-18,153,149,4,0.0261437908496732
ORIENTE PACIFICO,2024-04-19,182,175,7,0.0384615384615385
ORIENTE PACIFICO,2024-04-20,209,202,7,0.0334928229665072
ORIENTE PACIFICO,2024-04-21,125,119,6,0.048
ORIENTE PACIFICO,2024-04-22,121,109,12,0.0991735537190083
ORIENTE PACIFICO,2024-04-23,219,205,14,0.0639269406392694
ORIENTE PACIFICO,2024-04-24,154,149,5,0.0324675324675325
ORIENTE PACIFICO,2024-04-25,156,154,2,0.0128205128205128
ORIENTE PACIFICO,2024-04-26,163,157,6,0.0368098159509202
ORIENTE PACIFICO,2024-04-27,156,152,4,0.0256410256410256
ORIENTE PACIFICO,2024-04-28,140,138,2,0.0142857142857143
ORIENTE PACIFICO,2024-04-29,178,170,8,0.0449438202247191
ORIENTE PACIFICO,2024-04-30,211,201,10,0.0473933649289099
ORIENTE PACIFICO,2024-05-01,190,185,5,0.0263157894736842
ORIENTE PACIFICO,2024-05-02,146,139,7,0.0479452054794521
ORIENTE PACIFICO,2024-05-03,171,169,2,0.0116959064327485
ORIENTE PACIFICO,2024-05-04,184,179,5,0.0271739130434783
ORIENTE PACIFICO,2024-05-05,102,102,0,0
ORIENTE PACIFICO,2024-05-06,155,155,0,0
ORIENTE PACIFICO,2024-05-07,160,157,3,0.01875
ORIENTE PACIFICO,2024-05-08,148,142,6,0.0405405405405405
ORIENTE PACIFICO,2024-05-09,156,153,3,0.0192307692307692
ORIENTE PACIFICO,2024-05-10,141,135,6,0.0425531914893617
ORIENTE PACIFICO,2024-05-11,153,149,4,0.0261437908496732
ORIENTE PACIFICO,2024-05-12,112,108,4,0.0357142857142857
ORIENTE PACIFICO,2024-05-13,130,126,4,0.0307692307692308
ORIENTE PACIFICO,2024-05-14,202,195,7,0.0346534653465347
ORIENTE PACIFICO,2024-05-15,187,177,10,0.053475935828877
ORIENTE PACIFICO,2024-05-16,178,148,30,0.168539325842697
ORIENTE PACIFICO,2024-05-17,147,142,5,0.0340136054421769
ORIENTE PACIFICO,2024-05-18,180,177,3,0.0166666666666667
ORIENTE PACIFICO,2024-05-19,131,127,4,0.0305343511450382
ORIENTE PACIFICO,2024-05-20,178,172,6,0.0337078651685393
ORIENTE PACIFICO,2024-05-21,184,181,3,0.016304347826087
ORIENTE PACIFICO,2024-05-22,157,153,4,0.0254777070063694
ORIENTE PACIFICO,2024-05-23,164,158,6,0.0365853658536585
ORIENTE PACIFICO,2024-05-24,152,146,6,0.0394736842105263
ORIENTE PACIFICO,2024-05-25,179,175,4,0.0223463687150838
ORIENTE PACIFICO,2024-05-26,110,108,2,0.0181818181818182
ORIENTE PACIFICO,2024-05-27,166,163,3,0.0180722891566265
ORIENTE PACIFICO,2024-05-28,166,165,1,0.00602409638554217
ORIENTE PACIFICO,2024-05-29,151,148,3,0.0198675496688742
ORIENTE PACIFICO,2024-05-30,184,179,5,0.0271739130434783
ORIENTE PACIFICO,2024-05-31,231,228,3,0.012987012987013
ORIENTE PACIFICO,2024-06-01,194,190,4,0.0206185567010309
ORIENTE PACIFICO,2024-06-02,88,86,2,0.0227272727272727
ORIENTE PACIFICO,2024-06-03,145,141,4,0.0275862068965517
ORIENTE PACIFICO,2024-06-04,153,145,8,0.0522875816993464
ORIENTE PACIFICO,2024-06-05,153,142,11,0.0718954248366013
ORIENTE PACIFICO,2024-06-06,179,172,7,0.0391061452513966
ORIENTE PACIFICO,2024-06-07,171,166,5,0.0292397660818713
ORIENTE PACIFICO,2024-06-08,163,161,2,0.0122699386503067
ORIENTE PACIFICO,2024-06-09,113,109,4,0.0353982300884956
ORIENTE PACIFICO,2024-06-10,183,178,5,0.0273224043715847
ORIENTE PACIFICO,2024-06-11,168,162,6,0.0357142857142857
ORIENTE PACIFICO,2024-06-12,175,172,3,0.0171428571428571
ORIENTE PACIFICO,2024-06-13,185,176,9,0.0486486486486487
ORIENTE PACIFICO,2024-06-14,183,176,7,0.0382513661202186
ORIENTE PACIFICO,2024-06-15,195,193,2,0.0102564102564103
ORIENTE PACIFICO,2024-06-16,131,130,1,0.00763358778625954
ORIENTE PACIFICO,2024-06-17,171,166,5,0.0292397660818713
ORIENTE PACIFICO,2024-06-18,186,183,3,0.0161290322580645
ORIENTE PACIFICO,2024-06-19,176,172,4,0.0227272727272727
ORIENTE PACIFICO,2024-06-20,160,153,7,0.04375
ORIENTE PACIFICO,2024-06-21,181,178,3,0.0165745856353591
ORIENTE PACIFICO,2024-06-22,186,177,9,0.0483870967741935
ORIENTE PACIFICO,2024-06-23,143,142,1,0.00699300699300699
ORIENTE PACIFICO,2024-06-24,154,152,2,0.012987012987013
ORIENTE PACIFICO,2024-06-25,168,161,7,0.0416666666666667
ORIENTE PACIFICO,2024-06-26,171,163,8,0.0467836257309941
ORIENTE PACIFICO,2024-06-27,139,134,5,0.0359712230215827
ORIENTE PACIFICO,2024-06-28,197,194,3,0.0152284263959391
ORIENTE PACIFICO,2024-06-29,239,232,7,0.0292887029288703
ORIENTE PACIFICO,2024-06-30,175,173,2,0.0114285714285714
ORIENTE PACIFICO,2024-07-01,128,123,5,0.0390625
ORIENTE PACIFICO,2024-07-02,166,164,2,0.0120481927710843
PACIFICO,2023-07-03,102,100,2,0.0196078431372549
PACIFICO,2023-07-04,71,71,0,0
PACIFICO,2023-07-05,74,72,2,0.027027027027027
PACIFICO,2023-07-06,104,101,3,0.0288461538461538
PACIFICO,2023-07-07,101,100,1,0.0099009900990099
PACIFICO,2023-07-08,150,145,5,0.0333333333333333
PACIFICO,2023-07-09,142,138,4,0.028169014084507
PACIFICO,2023-07-10,138,136,2,0.0144927536231884
PACIFICO,2023-07-11,133,130,3,0.0225563909774436
PACIFICO,2023-07-12,135,131,4,0.0296296296296296
PACIFICO,2023-07-13,116,112,4,0.0344827586206897
PACIFICO,2023-07-14,105,97,8,0.0761904761904762
PACIFICO,2023-07-15,146,142,4,0.0273972602739726
PACIFICO,2023-07-16,103,99,4,0.0388349514563107
PACIFICO,2023-07-17,126,124,2,0.0158730158730159
PACIFICO,2023-07-18,113,108,5,0.0442477876106195
PACIFICO,2023-07-19,135,128,7,0.0518518518518519
PACIFICO,2023-07-20,134,128,6,0.0447761194029851
PACIFICO,2023-07-21,145,139,6,0.0413793103448276
PACIFICO,2023-07-22,137,133,4,0.0291970802919708
PACIFICO,2023-07-23,110,102,8,0.0727272727272727
PACIFICO,2023-07-24,115,112,3,0.0260869565217391
PACIFICO,2023-07-25,151,147,4,0.0264900662251656
PACIFICO,2023-07-26,130,124,6,0.0461538461538462
PACIFICO,2023-07-27,155,154,1,0.00645161290322581
PACIFICO,2023-07-28,148,144,4,0.027027027027027
PACIFICO,2023-07-29,166,164,2,0.0120481927710843
PACIFICO,2023-07-30,129,127,2,0.0155038759689922
PACIFICO,2023-07-31,144,135,9,0.0625
PACIFICO,2023-08-01,131,127,4,0.0305343511450382
PACIFICO,2023-08-02,143,135,8,0.0559440559440559
PACIFICO,2023-08-03,143,117,26,0.181818181818182
PACIFICO,2023-08-04,143,137,6,0.041958041958042
PACIFICO,2023-08-05,158,154,4,0.0253164556962025
PACIFICO,2023-08-06,120,115,5,0.0416666666666667
PACIFICO,2023-08-07,147,140,7,0.0476190476190476
PACIFICO,2023-08-08,150,146,4,0.0266666666666667
PACIFICO,2023-08-09,143,137,6,0.041958041958042
PACIFICO,2023-08-10,132,124,8,0.0606060606060606
PACIFICO,2023-08-11,160,155,5,0.03125
PACIFICO,2023-08-12,147,139,8,0.054421768707483
PACIFICO,2023-08-13,122,117,5,0.040983606557377
PACIFICO,2023-08-14,126,123,3,0.0238095238095238
PACIFICO,2023-08-15,144,134,10,0.0694444444444444
PACIFICO,2023-08-16,165,155,10,0.0606060606060606
PACIFICO,2023-08-17,142,138,4,0.028169014084507
PACIFICO,2023-08-18,167,157,10,0.0598802395209581
PACIFICO,2023-08-19,152,144,8,0.0526315789473684
PACIFICO,2023-08-20,127,121,6,0.047244094488189
PACIFICO,2023-08-21,140,138,2,0.0142857142857143
PACIFICO,2023-08-22,126,126,0,0
PACIFICO,2023-08-23,120,117,3,0.025
PACIFICO,2023-08-24,159,154,5,0.0314465408805031
PACIFICO,2023-08-25,136,133,3,0.0220588235294118
PACIFICO,2023-08-26,162,156,6,0.037037037037037
PACIFICO,2023-08-27,120,120,0,0
PACIFICO,2023-08-28,126,123,3,0.0238095238095238
PACIFICO,2023-08-29,110,109,1,0.00909090909090909
PACIFICO,2023-08-30,94,92,2,0.0212765957446809
PACIFICO,2023-08-31,150,148,2,0.0133333333333333
PACIFICO,2023-09-01,75,72,3,0.04
PACIFICO,2023-09-02,158,157,1,0.00632911392405063
PACIFICO,2023-09-03,113,112,1,0.00884955752212389
PACIFICO,2023-09-04,122,122,0,0
PACIFICO,2023-09-05,142,140,2,0.0140845070422535
PACIFICO,2023-09-06,159,158,1,0.00628930817610063
PACIFICO,2023-09-07,129,129,0,0
PACIFICO,2023-09-08,130,127,3,0.0230769230769231
PACIFICO,2023-09-09,157,156,1,0.00636942675159236
PACIFICO,2023-09-10,116,116,0,0
PACIFICO,2023-09-11,113,113,0,0
PACIFICO,2023-09-12,150,150,0,0
PACIFICO,2023-09-13,127,126,1,0.0078740157480315
PACIFICO,2023-09-14,129,126,3,0.0232558139534884
PACIFICO,2023-09-15,121,120,1,0.00826446280991736
PACIFICO,2023-09-16,127,125,2,0.015748031496063
PACIFICO,2023-09-17,99,98,1,0.0101010101010101
PACIFICO,2023-09-18,105,104,1,0.00952380952380952
PACIFICO,2023-09-19,112,111,1,0.00892857142857143
PACIFICO,2023-09-20,104,104,0,0
PACIFICO,2023-09-21,133,132,1,0.0075187969924812
PACIFICO,2023-09-22,127,126,1,0.0078740157480315
PACIFICO,2023-09-23,149,147,2,0.0134228187919463
PACIFICO,2023-09-24,111,109,2,0.018018018018018
PACIFICO,2023-09-25,122,118,4,0.0327868852459016
PACIFICO,2023-09-26,116,115,1,0.00862068965517241
PACIFICO,2023-09-27,124,123,1,0.00806451612903226
PACIFICO,2023-09-28,143,141,2,0.013986013986014
PACIFICO,2023-09-29,141,141,0,0
PACIFICO,2023-09-30,166,166,0,0
PACIFICO,2023-10-01,94,94,0,0
PACIFICO,2023-10-02,99,98,1,0.0101010101010101
PACIFICO,2023-10-03,129,126,3,0.0232558139534884
PACIFICO,2023-10-04,138,135,3,0.0217391304347826
PACIFICO,2023-10-05,124,122,2,0.0161290322580645
PACIFICO,2023-10-06,147,142,5,0.0340136054421769
PACIFICO,2023-10-07,159,152,7,0.0440251572327044
PACIFICO,2023-10-08,105,99,6,0.0571428571428571
PACIFICO,2023-10-09,119,119,0,0
PACIFICO,2023-10-10,104,101,3,0.0288461538461538
PACIFICO,2023-10-11,115,110,5,0.0434782608695652
PACIFICO,2023-10-12,104,100,4,0.0384615384615385
PACIFICO,2023-10-13,125,122,3,0.024
PACIFICO,2023-10-14,144,140,4,0.0277777777777778
PACIFICO,2023-10-15,105,104,1,0.00952380952380952
PACIFICO,2023-10-16,104,98,6,0.0576923076923077
PACIFICO,2023-10-17,115,112,3,0.0260869565217391
PACIFICO,2023-10-18,105,103,2,0.019047619047619
PACIFICO,2023-10-19,112,110,2,0.0178571428571429
PACIFICO,2023-10-20,99,96,3,0.0303030303030303
PACIFICO,2023-10-21,92,92,0,0
PACIFICO,2023-10-22,60,59,1,0.0166666666666667
PACIFICO,2023-10-23,57,54,3,0.0526315789473684
PACIFICO,2023-10-24,117,115,2,0.0170940170940171
PACIFICO,2023-10-25,104,98,6,0.0576923076923077
PACIFICO,2023-10-26,122,122,0,0
PACIFICO,2023-10-27,113,110,3,0.0265486725663717
PACIFICO,2023-10-28,123,121,2,0.016260162601626
PACIFICO,2023-10-29,78,75,3,0.0384615384615385
PACIFICO,2023-10-30,105,103,2,0.019047619047619
PACIFICO,2023-10-31,151,150,1,0.00662251655629139
PACIFICO,2023-11-01,139,139,0,0
PACIFICO,2023-11-02,132,128,4,0.0303030303030303
PACIFICO,2023-11-03,122,118,4,0.0327868852459016
PACIFICO,2023-11-04,141,140,1,0.00709219858156028
PACIFICO,2023-11-05,100,98,2,0.02
PACIFICO,2023-11-06,136,133,3,0.0220588235294118
PACIFICO,2023-11-07,159,156,3,0.0188679245283019
PACIFICO,2023-11-08,146,143,3,0.0205479452054795
PACIFICO,2023-11-09,143,138,5,0.034965034965035
PACIFICO,2023-11-10,134,131,3,0.0223880597014925
PACIFICO,2023-11-11,141,141,0,0
PACIFICO,2023-11-12,106,103,3,0.0283018867924528
PACIFICO,2023-11-13,138,133,5,0.036231884057971
PACIFICO,2023-11-14,137,135,2,0.0145985401459854
PACIFICO,2023-11-15,158,153,5,0.0316455696202532
PACIFICO,2023-11-16,165,161,4,0.0242424242424242
PACIFICO,2023-11-17,128,125,3,0.0234375
PACIFICO,2023-11-18,147,145,2,0.0136054421768707
PACIFICO,2023-11-19,98,97,1,0.0102040816326531
PACIFICO,2023-11-20,135,133,2,0.0148148148148148
PACIFICO,2023-11-21,121,117,4,0.0330578512396694
PACIFICO,2023-11-22,145,141,4,0.0275862068965517
PACIFICO,2023-11-23,151,149,2,0.0132450331125828
PACIFICO,2023-11-24,147,146,1,0.00680272108843537
PACIFICO,2023-11-25,152,148,4,0.0263157894736842
PACIFICO,2023-11-26,104,104,0,0
PACIFICO,2023-11-27,96,92,4,0.0416666666666667
PACIFICO,2023-11-28,128,123,5,0.0390625
PACIFICO,2023-11-29,155,154,1,0.00645161290322581
PACIFICO,2023-11-30,154,150,4,0.025974025974026
PACIFICO,2023-12-01,140,139,1,0.00714285714285714
PACIFICO,2023-12-02,158,155,3,0.0189873417721519
PACIFICO,2023-12-03,122,119,3,0.0245901639344262
PACIFICO,2023-12-04,120,116,4,0.0333333333333333
PACIFICO,2023-12-05,151,144,7,0.0463576158940397
PACIFICO,2023-12-06,149,143,6,0.0402684563758389
PACIFICO,2023-12-07,161,161,0,0
PACIFICO,2023-12-08,155,151,4,0.0258064516129032
PACIFICO,2023-12-09,149,148,1,0.00671140939597315
PACIFICO,2023-12-10,131,131,0,0
PACIFICO,2023-12-11,138,137,1,0.0072463768115942
PACIFICO,2023-12-12,136,133,3,0.0220588235294118
PACIFICO,2023-12-13,144,144,0,0
PACIFICO,2023-12-14,118,115,3,0.0254237288135593
PACIFICO,2023-12-15,137,134,3,0.0218978102189781
PACIFICO,2023-12-16,142,139,3,0.0211267605633803
PACIFICO,2023-12-17,108,106,2,0.0185185185185185
PACIFICO,2023-12-18,150,147,3,0.02
PACIFICO,2023-12-19,144,143,1,0.00694444444444444
PACIFICO,2023-12-20,144,142,2,0.0138888888888889
PACIFICO,2023-12-21,172,167,5,0.0290697674418605
PACIFICO,2023-12-22,121,119,2,0.0165289256198347
PACIFICO,2023-12-23,127,126,1,0.0078740157480315
PACIFICO,2023-12-24,94,94,0,0
PACIFICO,2023-12-25,18,18,0,0
PACIFICO,2023-12-26,115,114,1,0.00869565217391304
PACIFICO,2023-12-27,134,132,2,0.0149253731343284
PACIFICO,2023-12-28,130,128,2,0.0153846153846154
PACIFICO,2023-12-29,137,134,3,0.0218978102189781
PACIFICO,2023-12-30,136,134,2,0.0147058823529412
PACIFICO,2023-12-31,80,80,0,0
PACIFICO,2024-01-01,18,18,0,0
PACIFICO,2024-01-02,103,100,3,0.029126213592233
PACIFICO,2024-01-03,137,135,2,0.0145985401459854
PACIFICO,2024-01-04,145,144,1,0.00689655172413793
PACIFICO,2024-01-05,147,143,4,0.0272108843537415
PACIFICO,2024-01-06,169,163,6,0.0355029585798817
PACIFICO,2024-01-07,101,100,1,0.0099009900990099
PACIFICO,2024-01-08,146,142,4,0.0273972602739726
PACIFICO,2024-01-09,159,154,5,0.0314465408805031
PACIFICO,2024-01-10,138,136,2,0.0144927536231884
PACIFICO,2024-01-11,128,124,4,0.03125
PACIFICO,2024-01-12,151,149,2,0.0132450331125828
PACIFICO,2024-01-13,158,155,3,0.0189873417721519
PACIFICO,2024-01-14,112,108,4,0.0357142857142857
PACIFICO,2024-01-15,132,126,6,0.0454545454545455
PACIFICO,2024-01-16,168,164,4,0.0238095238095238
PACIFICO,2024-01-17,131,129,2,0.0152671755725191
PACIFICO,2024-01-18,151,146,5,0.033112582781457
PACIFICO,2024-01-19,147,141,6,0.0408163265306122
PACIFICO,2024-01-20,148,148,0,0
PACIFICO,2024-01-21,88,88,0,0
PACIFICO,2024-01-22,107,104,3,0.0280373831775701
PACIFICO,2024-01-23,141,139,2,0.0141843971631206
PACIFICO,2024-01-24,136,133,3,0.0220588235294118
PACIFICO,2024-01-25,139,137,2,0.0143884892086331
PACIFICO,2024-01-26,136,134,2,0.0147058823529412
PACIFICO,2024-01-27,127,124,3,0.0236220472440945
PACIFICO,2024-01-28,93,90,3,0.032258064516129
PACIFICO,2024-01-29,119,118,1,0.00840336134453781
PACIFICO,2024-01-30,127,125,2,0.015748031496063
PACIFICO,2024-01-31,130,127,3,0.0230769230769231
PACIFICO,2024-02-01,109,108,1,0.00917431192660551
PACIFICO,2024-02-02,132,130,2,0.0151515151515152
PACIFICO,2024-02-03,127,123,4,0.031496062992126
PACIFICO,2024-02-04,103,100,3,0.029126213592233
PACIFICO,2024-02-05,122,122,0,0
PACIFICO,2024-02-06,132,129,3,0.0227272727272727
PACIFICO,2024-02-07,144,142,2,0.0138888888888889
PACIFICO,2024-02-08,119,117,2,0.0168067226890756
PACIFICO,2024-02-09,110,107,3,0.0272727272727273
PACIFICO,2024-02-10,148,144,4,0.027027027027027
PACIFICO,2024-02-11,96,92,4,0.0416666666666667
PACIFICO,2024-02-12,111,111,0,0
PACIFICO,2024-02-13,118,114,4,0.0338983050847458
PACIFICO,2024-02-14,90,90,0,0
PACIFICO,2024-02-15,105,104,1,0.00952380952380952
PACIFICO,2024-02-16,114,110,4,0.0350877192982456
PACIFICO,2024-02-17,154,154,0,0
PACIFICO,2024-02-18,120,120,0,0
PACIFICO,2024-02-19,110,108,2,0.0181818181818182
PACIFICO,2024-02-20,151,146,5,0.033112582781457
PACIFICO,2024-02-21,119,115,4,0.0336134453781513
PACIFICO,2024-02-22,133,130,3,0.0225563909774436
PACIFICO,2024-02-23,82,71,11,0.134146341463415
PACIFICO,2024-02-24,166,163,3,0.0180722891566265
PACIFICO,2024-02-25,92,89,3,0.0326086956521739
PACIFICO,2024-02-26,123,120,3,0.024390243902439
PACIFICO,2024-02-27,128,126,2,0.015625
PACIFICO,2024-02-28,136,133,3,0.0220588235294118
PACIFICO,2024-02-29,149,147,2,0.0134228187919463
PACIFICO,2024-03-01,138,136,2,0.0144927536231884
PACIFICO,2024-03-02,145,144,1,0.00689655172413793
PACIFICO,2024-03-03,102,101,1,0.00980392156862745
PACIFICO,2024-03-04,130,129,1,0.00769230769230769
PACIFICO,2024-03-05,133,131,2,0.0150375939849624
PACIFICO,2024-03-06,153,152,1,0.0065359477124183
PACIFICO,2024-03-07,147,144,3,0.0204081632653061
PACIFICO,2024-03-08,161,158,3,0.0186335403726708
PACIFICO,2024-03-09,144,143,1,0.00694444444444444
PACIFICO,2024-03-10,98,96,2,0.0204081632653061
PACIFICO,2024-03-11,144,141,3,0.0208333333333333
PACIFICO,2024-03-12,167,165,2,0.0119760479041916
PACIFICO,2024-03-13,128,125,3,0.0234375
PACIFICO,2024-03-14,115,113,2,0.0173913043478261
PACIFICO,2024-03-15,114,112,2,0.0175438596491228
PACIFICO,2024-03-16,145,141,4,0.0275862068965517
PACIFICO,2024-03-17,103,102,1,0.00970873786407767
PACIFICO,2024-03-18,122,121,1,0.00819672131147541
PACIFICO,2024-03-19,139,135,4,0.0287769784172662
PACIFICO,2024-03-20,102,97,5,0.0490196078431373
PACIFICO,2024-03-21,120,120,0,0
PACIFICO,2024-03-22,108,106,2,0.0185185185185185
PACIFICO,2024-03-23,123,121,2,0.016260162601626
PACIFICO,2024-03-24,75,73,2,0.0266666666666667
PACIFICO,2024-03-25,108,106,2,0.0185185185185185
PACIFICO,2024-03-26,133,130,3,0.0225563909774436
PACIFICO,2024-03-27,135,134,1,0.00740740740740741
PACIFICO,2024-03-28,115,108,7,0.0608695652173913
PACIFICO,2024-03-29,94,90,4,0.0425531914893617
PACIFICO,2024-03-30,76,75,1,0.0131578947368421
PACIFICO,2024-03-31,59,57,2,0.0338983050847458
PACIFICO,2024-04-01,108,105,3,0.0277777777777778
PACIFICO,2024-04-02,118,114,4,0.0338983050847458
PACIFICO,2024-04-03,114,114,0,0
PACIFICO,2024-04-04,129,129,0,0
PACIFICO,2024-04-05,139,135,4,0.0287769784172662
PACIFICO,2024-04-06,156,154,2,0.0128205128205128
PACIFICO,2024-04-07,84,82,2,0.0238095238095238
PACIFICO,2024-04-08,131,128,3,0.0229007633587786
PACIFICO,2024-04-09,121,118,3,0.0247933884297521
PACIFICO,2024-04-10,143,140,3,0.020979020979021
PACIFICO,2024-04-11,145,141,4,0.0275862068965517
PACIFICO,2024-04-12,166,161,5,0.0301204819277108
PACIFICO,2024-04-13,143,137,6,0.041958041958042
PACIFICO,2024-04-14,92,91,1,0.0108695652173913
PACIFICO,2024-04-15,145,140,5,0.0344827586206897
PACIFICO,2024-04-16,133,126,7,0.0526315789473684
PACIFICO,2024-04-17,122,114,8,0.0655737704918033
PACIFICO,2024-04-18,106,103,3,0.0283018867924528
PACIFICO,2024-04-19,122,116,6,0.0491803278688525
PACIFICO,2024-04-20,133,129,4,0.0300751879699248
PACIFICO,2024-04-21,67,65,2,0.0298507462686567
PACIFICO,2024-04-22,48,47,1,0.0208333333333333
PACIFICO,2024-04-23,172,157,15,0.0872093023255814
PACIFICO,2024-04-24,110,108,2,0.0181818181818182
PACIFICO,2024-04-25,116,114,2,0.0172413793103448
PACIFICO,2024-04-26,116,110,6,0.0517241379310345
PACIFICO,2024-04-27,131,124,7,0.0534351145038168
PACIFICO,2024-04-28,76,74,2,0.0263157894736842
PACIFICO,2024-04-29,134,127,7,0.0522388059701493
PACIFICO,2024-04-30,137,131,6,0.0437956204379562
PACIFICO,2024-05-01,113,111,2,0.0176991150442478
PACIFICO,2024-05-02,90,90,0,0
PACIFICO,2024-05-03,110,107,3,0.0272727272727273
PACIFICO,2024-05-04,126,122,4,0.0317460317460317
PACIFICO,2024-05-05,79,74,5,0.0632911392405063
PACIFICO,2024-05-06,110,110,0,0
PACIFICO,2024-05-07,124,123,1,0.00806451612903226
PACIFICO,2024-05-08,141,140,1,0.00709219858156028
PACIFICO,2024-05-09,112,108,4,0.0357142857142857
PACIFICO,2024-05-10,89,87,2,0.0224719101123595
PACIFICO,2024-05-11,129,124,5,0.0387596899224806
PACIFICO,2024-05-12,76,73,3,0.0394736842105263
PACIFICO,2024-05-13,127,119,8,0.062992125984252
PACIFICO,2024-05-14,138,132,6,0.0434782608695652
PACIFICO,2024-05-15,153,148,5,0.0326797385620915
PACIFICO,2024-05-16,105,86,19,0.180952380952381
PACIFICO,2024-05-17,137,132,5,0.0364963503649635
PACIFICO,2024-05-18,119,114,5,0.0420168067226891
PACIFICO,2024-05-19,71,70,1,0.0140845070422535
PACIFICO,2024-05-20,111,107,4,0.036036036036036
PACIFICO,2024-05-21,149,146,3,0.0201342281879195
PACIFICO,2024-05-22,111,111,0,0
PACIFICO,2024-05-23,133,126,7,0.0526315789473684
PACIFICO,2024-05-24,111,109,2,0.018018018018018
PACIFICO,2024-05-25,107,106,1,0.00934579439252336
PACIFICO,2024-05-26,75,75,0,0
PACIFICO,2024-05-27,93,91,2,0.021505376344086
PACIFICO,2024-05-28,105,104,1,0.00952380952380952
PACIFICO,2024-05-29,116,111,5,0.0431034482758621
PACIFICO,2024-05-30,115,114,1,0.00869565217391304
PACIFICO,2024-05-31,146,139,7,0.0479452054794521
PACIFICO,2024-06-01,119,116,3,0.0252100840336134
PACIFICO,2024-06-02,76,74,2,0.0263157894736842
PACIFICO,2024-06-03,106,103,3,0.0283018867924528
PACIFICO,2024-06-04,122,115,7,0.0573770491803279
PACIFICO,2024-06-05,122,118,4,0.0327868852459016
PACIFICO,2024-06-06,151,144,7,0.0463576158940397
PACIFICO,2024-06-07,142,137,5,0.0352112676056338
PACIFICO,2024-06-08,142,136,6,0.0422535211267606
PACIFICO,2024-06-09,95,90,5,0.0526315789473684
PACIFICO,2024-06-10,106,104,2,0.0188679245283019
PACIFICO,2024-06-11,105,103,2,0.019047619047619
PACIFICO,2024-06-12,114,110,4,0.0350877192982456
PACIFICO,2024-06-13,109,106,3,0.0275229357798165
PACIFICO,2024-06-14,104,99,5,0.0480769230769231
PACIFICO,2024-06-15,134,129,5,0.0373134328358209
PACIFICO,2024-06-16,70,67,3,0.0428571428571429
PACIFICO,2024-06-17,113,111,2,0.0176991150442478
PACIFICO,2024-06-18,126,119,7,0.0555555555555556
PACIFICO,2024-06-19,131,128,3,0.0229007633587786
PACIFICO,2024-06-20,112,109,3,0.0267857142857143
PACIFICO,2024-06-21,125,118,7,0.056
PACIFICO,2024-06-22,134,129,5,0.0373134328358209
PACIFICO,2024-06-23,111,110,1,0.00900900900900901
PACIFICO,2024-06-24,119,112,7,0.0588235294117647
PACIFICO,2024-06-25,115,114,1,0.00869565217391304
PACIFICO,2024-06-26,104,100,4,0.0384615384615385
PACIFICO,2024-06-27,111,106,5,0.045045045045045
PACIFICO,2024-06-28,142,141,1,0.00704225352112676
PACIFICO,2024-06-29,163,160,3,0.0184049079754601
PACIFICO,2024-06-30,110,110,0,0
PACIFICO,2024-07-01,136,128,8,0.0588235294117647
PACIFICO,2024-07-02,116,111,5,0.0431034482758621
SURESTE,2023-07-03,206,199,7,0.0339805825242718
SURESTE,2023-07-04,187,183,4,0.0213903743315508
SURESTE,2023-07-05,174,169,5,0.028735632183908
SURESTE,2023-07-06,167,163,4,0.0239520958083832
SURESTE,2023-07-07,228,221,7,0.0307017543859649
SURESTE,2023-07-08,242,236,6,0.0247933884297521
SURESTE,2023-07-09,208,204,4,0.0192307692307692
SURESTE,2023-07-10,270,262,8,0.0296296296296296
SURESTE,2023-07-11,221,218,3,0.0135746606334842
SURESTE,2023-07-12,210,205,5,0.0238095238095238
SURESTE,2023-07-13,198,192,6,0.0303030303030303
SURESTE,2023-07-14,199,195,4,0.0201005025125628
SURESTE,2023-07-15,222,218,4,0.018018018018018
SURESTE,2023-07-16,207,205,2,0.00966183574879227
SURESTE,2023-07-17,222,217,5,0.0225225225225225
SURESTE,2023-07-18,196,192,4,0.0204081632653061
SURESTE,2023-07-19,172,167,5,0.0290697674418605
SURESTE,2023-07-20,235,229,6,0.025531914893617
SURESTE,2023-07-21,189,183,6,0.0317460317460317
SURESTE,2023-07-22,228,226,2,0.0087719298245614
SURESTE,2023-07-23,200,198,2,0.01
SURESTE,2023-07-24,207,206,1,0.00483091787439614
SURESTE,2023-07-25,216,208,8,0.037037037037037
SURESTE,2023-07-26,209,203,6,0.0287081339712919
SURESTE,2023-07-27,181,176,5,0.0276243093922652
SURESTE,2023-07-28,201,197,4,0.0199004975124378
SURESTE,2023-07-29,264,262,2,0.00757575757575758
SURESTE,2023-07-30,217,216,1,0.00460829493087558
SURESTE,2023-07-31,271,267,4,0.014760147601476
SURESTE,2023-08-01,213,206,7,0.0328638497652582
SURESTE,2023-08-02,214,211,3,0.014018691588785
SURESTE,2023-08-03,181,159,22,0.121546961325967
SURESTE,2023-08-04,191,186,5,0.0261780104712042
SURESTE,2023-08-05,201,190,11,0.054726368159204
SURESTE,2023-08-06,202,200,2,0.0099009900990099
SURESTE,2023-08-07,200,192,8,0.04
SURESTE,2023-08-08,181,175,6,0.0331491712707182
SURESTE,2023-08-09,205,202,3,0.0146341463414634
SURESTE,2023-08-10,198,194,4,0.0202020202020202
SURESTE,2023-08-11,178,165,13,0.0730337078651685
SURESTE,2023-08-12,201,193,8,0.0398009950248756
SURESTE,2023-08-13,217,210,7,0.032258064516129
SURESTE,2023-08-14,187,180,7,0.0374331550802139
SURESTE,2023-08-15,198,195,3,0.0151515151515152
SURESTE,2023-08-16,209,203,6,0.0287081339712919
SURESTE,2023-08-17,195,185,10,0.0512820512820513
SURESTE,2023-08-18,252,245,7,0.0277777777777778
SURESTE,2023-08-19,236,228,8,0.0338983050847458
SURESTE,2023-08-20,211,204,7,0.033175355450237
SURESTE,2023-08-21,199,199,0,0
SURESTE,2023-08-22,178,175,3,0.0168539325842697
SURESTE,2023-08-23,178,177,1,0.00561797752808989
SURESTE,2023-08-24,219,218,1,0.0045662100456621
SURESTE,2023-08-25,209,206,3,0.0143540669856459
SURESTE,2023-08-26,241,238,3,0.012448132780083
SURESTE,2023-08-27,199,199,0,0
SURESTE,2023-08-28,209,204,5,0.0239234449760766
SURESTE,2023-08-29,207,206,1,0.00483091787439614
SURESTE,2023-08-30,198,197,1,0.00505050505050505
SURESTE,2023-08-31,200,199,1,0.005
SURESTE,2023-09-01,191,191,0,0
SURESTE,2023-09-02,203,201,2,0.00985221674876847
SURESTE,2023-09-03,176,175,1,0.00568181818181818
SURESTE,2023-09-04,162,161,1,0.00617283950617284
SURESTE,2023-09-05,223,222,1,0.00448430493273543
SURESTE,2023-09-06,202,201,1,0.00495049504950495
SURESTE,2023-09-07,228,227,1,0.0043859649122807
SURESTE,2023-09-08,220,220,0,0
SURESTE,2023-09-09,225,224,1,0.00444444444444444
SURESTE,2023-09-10,180,180,0,0
SURESTE,2023-09-11,202,200,2,0.0099009900990099
SURESTE,2023-09-12,234,233,1,0.00427350427350427
SURESTE,2023-09-13,211,209,2,0.00947867298578199
SURESTE,2023-09-14,204,202,2,0.00980392156862745
SURESTE,2023-09-15,222,220,2,0.00900900900900901
SURESTE,2023-09-16,207,206,1,0.00483091787439614
SURESTE,2023-09-17,169,168,1,0.00591715976331361
SURESTE,2023-09-18,189,189,0,0
SURESTE,2023-09-19,189,188,1,0.00529100529100529
SURESTE,2023-09-20,182,179,3,0.0164835164835165
SURESTE,2023-09-21,187,186,1,0.0053475935828877
SURESTE,2023-09-22,196,195,1,0.00510204081632653
SURESTE,2023-09-23,224,222,2,0.00892857142857143
SURESTE,2023-09-24,180,178,2,0.0111111111111111
SURESTE,2023-09-25,192,190,2,0.0104166666666667
SURESTE,2023-09-26,205,204,1,0.0048780487804878
SURESTE,2023-09-27,212,212,0,0
SURESTE,2023-09-28,188,186,2,0.0106382978723404
SURESTE,2023-09-29,238,237,1,0.00420168067226891
SURESTE,2023-09-30,249,248,1,0.00401606425702811
SURESTE,2023-10-01,196,196,0,0
SURESTE,2023-10-02,198,198,0,0
SURESTE,2023-10-03,195,192,3,0.0153846153846154
SURESTE,2023-10-04,167,164,3,0.0179640718562874
SURESTE,2023-10-05,176,172,4,0.0227272727272727
SURESTE,2023-10-06,187,182,5,0.0267379679144385
SURESTE,2023-10-07,199,196,3,0.0150753768844221
SURESTE,2023-10-08,156,152,4,0.0256410256410256
SURESTE,2023-10-09,162,158,4,0.0246913580246914
SURESTE,2023-10-10,155,149,6,0.0387096774193548
SURESTE,2023-10-11,176,169,7,0.0397727272727273
SURESTE,2023-10-12,144,142,2,0.0138888888888889
SURESTE,2023-10-13,180,179,1,0.00555555555555556
SURESTE,2023-10-14,189,189,0,0
SURESTE,2023-10-15,174,170,4,0.0229885057471264
SURESTE,2023-10-16,179,177,2,0.0111731843575419
SURESTE,2023-10-17,189,182,7,0.037037037037037
SURESTE,2023-10-18,214,207,7,0.0327102803738318
SURESTE,2023-10-19,193,188,5,0.0259067357512953
SURESTE,2023-10-20,197,193,4,0.0203045685279188
SURESTE,2023-10-21,212,207,5,0.0235849056603774
SURESTE,2023-10-22,160,151,9,0.05625
SURESTE,2023-10-23,144,140,4,0.0277777777777778
SURESTE,2023-10-24,174,168,6,0.0344827586206897
SURESTE,2023-10-25,181,177,4,0.0220994475138122
SURESTE,2023-10-26,189,183,6,0.0317460317460317
SURESTE,2023-10-27,195,189,6,0.0307692307692308
SURESTE,2023-10-28,214,213,1,0.00467289719626168
SURESTE,2023-10-29,146,142,4,0.0273972602739726
SURESTE,2023-10-30,209,202,7,0.0334928229665072
SURESTE,2023-10-31,211,207,4,0.018957345971564
SURESTE,2023-11-01,202,199,3,0.0148514851485149
SURESTE,2023-11-02,184,181,3,0.016304347826087
SURESTE,2023-11-03,197,192,5,0.0253807106598985
SURESTE,2023-11-04,185,178,7,0.0378378378378378
SURESTE,2023-11-05,174,171,3,0.0172413793103448
SURESTE,2023-11-06,200,193,7,0.035
SURESTE,2023-11-07,211,209,2,0.00947867298578199
SURESTE,2023-11-08,229,220,9,0.0393013100436681
SURESTE,2023-11-09,217,214,3,0.0138248847926267
SURESTE,2023-11-10,190,187,3,0.0157894736842105
SURESTE,2023-11-11,223,220,3,0.0134529147982063
SURESTE,2023-11-12,218,215,3,0.0137614678899083
SURESTE,2023-11-13,203,195,8,0.0394088669950739
SURESTE,2023-11-14,229,223,6,0.0262008733624454
SURESTE,2023-11-15,275,260,15,0.0545454545454545
SURESTE,2023-11-16,240,233,7,0.0291666666666667
SURESTE,2023-11-17,232,224,8,0.0344827586206897
SURESTE,2023-11-18,285,279,6,0.0210526315789474
SURESTE,2023-11-19,246,238,8,0.032520325203252
SURESTE,2023-11-20,256,254,2,0.0078125
SURESTE,2023-11-21,234,229,5,0.0213675213675214
SURESTE,2023-11-22,212,206,6,0.0283018867924528
SURESTE,2023-11-23,228,225,3,0.0131578947368421
SURESTE,2023-11-24,201,196,5,0.0248756218905473
SURESTE,2023-11-25,237,230,7,0.029535864978903
SURESTE,2023-11-26,209,205,4,0.0191387559808612
SURESTE,2023-11-27,242,236,6,0.0247933884297521
SURESTE,2023-11-28,242,237,5,0.0206611570247934
SURESTE,2023-11-29,247,239,8,0.0323886639676113
SURESTE,2023-11-30,263,255,8,0.0304182509505703
SURESTE,2023-12-01,223,212,11,0.0493273542600897
SURESTE,2023-12-02,238,233,5,0.0210084033613445
SURESTE,2023-12-03,164,160,4,0.024390243902439
SURESTE,2023-12-04,180,179,1,0.00555555555555556
SURESTE,2023-12-05,199,192,7,0.0351758793969849
SURESTE,2023-12-06,209,204,5,0.0239234449760766
SURESTE,2023-12-07,227,222,5,0.0220264317180617
SURESTE,2023-12-08,232,224,8,0.0344827586206897
SURESTE,2023-12-09,248,242,6,0.0241935483870968
SURESTE,2023-12-10,195,188,7,0.0358974358974359
SURESTE,2023-12-11,196,191,5,0.0255102040816327
SURESTE,2023-12-12,198,191,7,0.0353535353535354
SURESTE,2023-12-13,197,194,3,0.0152284263959391
SURESTE,2023-12-14,213,205,8,0.0375586854460094
SURESTE,2023-12-15,177,174,3,0.0169491525423729
SURESTE,2023-12-16,212,210,2,0.00943396226415094
SURESTE,2023-12-17,199,197,2,0.0100502512562814
SURESTE,2023-12-18,210,202,8,0.0380952380952381
SURESTE,2023-12-19,240,238,2,0.00833333333333333
SURESTE,2023-12-20,210,203,7,0.0333333333333333
SURESTE,2023-12-21,224,218,6,0.0267857142857143
SURESTE,2023-12-22,202,200,2,0.0099009900990099
SURESTE,2023-12-23,246,240,6,0.024390243902439
SURESTE,2023-12-24,176,172,4,0.0227272727272727
SURESTE,2023-12-25,60,60,0,0
SURESTE,2023-12-26,203,200,3,0.0147783251231527
SURESTE,2023-12-27,250,244,6,0.024
SURESTE,2023-12-28,252,248,4,0.0158730158730159
SURESTE,2023-12-29,225,222,3,0.0133333333333333
SURESTE,2023-12-30,262,259,3,0.0114503816793893
SURESTE,2023-12-31,110,108,2,0.0181818181818182
SURESTE,2024-01-01,42,41,1,0.0238095238095238
SURESTE,2024-01-02,174,172,2,0.0114942528735632
SURESTE,2024-01-03,231,228,3,0.012987012987013
SURESTE,2024-01-04,219,214,5,0.0228310502283105
SURESTE,2024-01-05,214,210,4,0.0186915887850467
SURESTE,2024-01-06,242,237,5,0.0206611570247934
SURESTE,2024-01-07,170,166,4,0.0235294117647059
SURESTE,2024-01-08,220,214,6,0.0272727272727273
SURESTE,2024-01-09,208,205,3,0.0144230769230769
SURESTE,2024-01-10,209,208,1,0.00478468899521531
SURESTE,2024-01-11,229,224,5,0.0218340611353712
SURESTE,2024-01-12,217,213,4,0.0184331797235023
SURESTE,2024-01-13,241,236,5,0.020746887966805
SURESTE,2024-01-14,214,209,5,0.0233644859813084
SURESTE,2024-01-15,238,229,9,0.0378151260504202
SURESTE,2024-01-16,226,222,4,0.0176991150442478
SURESTE,2024-01-17,200,198,2,0.01
SURESTE,2024-01-18,192,190,2,0.0104166666666667
SURESTE,2024-01-19,235,230,5,0.0212765957446809
SURESTE,2024-01-20,219,216,3,0.0136986301369863
SURESTE,2024-01-21,176,171,5,0.0284090909090909
SURESTE,2024-01-22,184,183,1,0.00543478260869565
SURESTE,2024-01-23,226,218,8,0.0353982300884956
SURESTE,2024-01-24,268,256,12,0.0447761194029851
SURESTE,2024-01-25,215,210,5,0.0232558139534884
SURESTE,2024-01-26,235,230,5,0.0212765957446809
SURESTE,2024-01-27,233,226,7,0.0300429184549356
SURESTE,2024-01-28,193,188,5,0.0259067357512953
SURESTE,2024-01-29,186,180,6,0.032258064516129
SURESTE,2024-01-30,177,168,9,0.0508474576271186
SURESTE,2024-01-31,212,204,8,0.0377358490566038
SURESTE,2024-02-01,220,217,3,0.0136363636363636
SURESTE,2024-02-02,200,192,8,0.04
SURESTE,2024-02-03,242,232,10,0.0413223140495868
SURESTE,2024-02-04,186,182,4,0.021505376344086
SURESTE,2024-02-05,173,168,5,0.0289017341040462
SURESTE,2024-02-06,202,200,2,0.0099009900990099
SURESTE,2024-02-07,206,204,2,0.00970873786407767
SURESTE,2024-02-08,204,199,5,0.0245098039215686
SURESTE,2024-02-09,220,215,5,0.0227272727272727
SURESTE,2024-02-10,188,182,6,0.0319148936170213
SURESTE,2024-02-11,157,154,3,0.0191082802547771
SURESTE,2024-02-12,162,158,4,0.0246913580246914
SURESTE,2024-02-13,220,217,3,0.0136363636363636
SURESTE,2024-02-14,191,182,9,0.0471204188481675
SURESTE,2024-02-15,226,221,5,0.0221238938053097
SURESTE,2024-02-16,208,205,3,0.0144230769230769
SURESTE,2024-02-17,207,204,3,0.0144927536231884
SURESTE,2024-02-18,161,158,3,0.0186335403726708
SURESTE,2024-02-19,205,199,6,0.0292682926829268
SURESTE,2024-02-20,199,195,4,0.0201005025125628
SURESTE,2024-02-21,231,227,4,0.0173160173160173
SURESTE,2024-02-22,203,196,7,0.0344827586206897
SURESTE,2024-02-23,155,135,20,0.129032258064516
SURESTE,2024-02-24,258,248,10,0.0387596899224806
SURESTE,2024-02-25,185,183,2,0.0108108108108108
SURESTE,2024-02-26,220,211,9,0.0409090909090909
SURESTE,2024-02-27,223,216,7,0.031390134529148
SURESTE,2024-02-28,217,212,5,0.0230414746543779
SURESTE,2024-02-29,219,211,8,0.0365296803652968
SURESTE,2024-03-01,227,222,5,0.0220264317180617
SURESTE,2024-03-02,250,244,6,0.024
SURESTE,2024-03-03,176,169,7,0.0397727272727273
SURESTE,2024-03-04,201,197,4,0.0199004975124378
SURESTE,2024-03-05,188,182,6,0.0319148936170213
SURESTE,2024-03-06,182,175,7,0.0384615384615385
SURESTE,2024-03-07,189,182,7,0.037037037037037
SURESTE,2024-03-08,208,199,9,0.0432692307692308
SURESTE,2024-03-09,215,209,6,0.027906976744186
SURESTE,2024-03-10,166,165,1,0.00602409638554217
SURESTE,2024-03-11,194,185,9,0.0463917525773196
SURESTE,2024-03-12,199,193,6,0.0301507537688442
SURESTE,2024-03-13,178,165,13,0.0730337078651685
SURESTE,2024-03-14,178,169,9,0.050561797752809
SURESTE,2024-03-15,212,205,7,0.0330188679245283
SURESTE,2024-03-16,236,228,8,0.0338983050847458
SURESTE,2024-03-17,147,143,4,0.0272108843537415
SURESTE,2024-03-18,165,162,3,0.0181818181818182
SURESTE,2024-03-19,198,189,9,0.0454545454545455
SURESTE,2024-03-20,180,176,4,0.0222222222222222
SURESTE,2024-03-21,160,156,4,0.025
SURESTE,2024-03-22,167,163,4,0.0239520958083832
SURESTE,2024-03-23,222,210,12,0.0540540540540541
SURESTE,2024-03-24,154,151,3,0.0194805194805195
SURESTE,2024-03-25,171,162,9,0.0526315789473684
SURESTE,2024-03-26,213,205,8,0.0375586854460094
SURESTE,2024-03-27,169,166,3,0.0177514792899408
SURESTE,2024-03-28,227,223,4,0.0176211453744493
SURESTE,2024-03-29,196,187,9,0.0459183673469388
SURESTE,2024-03-30,179,175,4,0.0223463687150838
SURESTE,2024-03-31,132,130,2,0.0151515151515152
SURESTE,2024-04-01,168,165,3,0.0178571428571429
SURESTE,2024-04-02,213,211,2,0.00938967136150235
SURESTE,2024-04-03,187,187,0,0
SURESTE,2024-04-04,177,177,0,0
SURESTE,2024-04-05,194,190,4,0.0206185567010309
SURESTE,2024-04-06,192,184,8,0.0416666666666667
SURESTE,2024-04-07,137,136,1,0.0072992700729927
SURESTE,2024-04-08,170,166,4,0.0235294117647059
SURESTE,2024-04-09,174,167,7,0.0402298850574713
SURESTE,2024-04-10,181,170,11,0.0607734806629834
SURESTE,2024-04-11,164,157,7,0.0426829268292683
SURESTE,2024-04-12,185,181,4,0.0216216216216216
SURESTE,2024-04-13,226,222,4,0.0176991150442478
SURESTE,2024-04-14,143,139,4,0.027972027972028
SURESTE,2024-04-15,194,189,5,0.0257731958762887
SURESTE,2024-04-16,206,198,8,0.0388349514563107
SURESTE,2024-04-17,208,198,10,0.0480769230769231
SURESTE,2024-04-18,190,185,5,0.0263157894736842
SURESTE,2024-04-19,166,155,11,0.0662650602409639
SURESTE,2024-04-20,203,194,9,0.0443349753694581
SURESTE,2024-04-21,149,144,5,0.0335570469798658
SURESTE,2024-04-22,96,92,4,0.0416666666666667
SURESTE,2024-04-23,215,193,22,0.102325581395349
SURESTE,2024-04-24,191,188,3,0.0157068062827225
SURESTE,2024-04-25,195,191,4,0.0205128205128205
SURESTE,2024-04-26,176,169,7,0.0397727272727273
SURESTE,2024-04-27,180,178,2,0.0111111111111111
SURESTE,2024-04-28,130,127,3,0.0230769230769231
SURESTE,2024-04-29,185,177,8,0.0432432432432432
SURESTE,2024-04-30,174,172,2,0.0114942528735632
SURESTE,2024-05-01,166,162,4,0.0240963855421687
SURESTE,2024-05-02,178,175,3,0.0168539325842697
SURESTE,2024-05-03,186,181,5,0.0268817204301075
SURESTE,2024-05-04,197,191,6,0.0304568527918782
SURESTE,2024-05-05,136,133,3,0.0220588235294118
SURESTE,2024-05-06,179,179,0,0
SURESTE,2024-05-07,172,170,2,0.0116279069767442
SURESTE,2024-05-08,153,146,7,0.0457516339869281
SURESTE,2024-05-09,158,150,8,0.0506329113924051
SURESTE,2024-05-10,141,140,1,0.00709219858156028
SURESTE,2024-05-11,177,174,3,0.0169491525423729
SURESTE,2024-05-12,96,94,2,0.0208333333333333
SURESTE,2024-05-13,154,149,5,0.0324675324675325
SURESTE,2024-05-14,182,173,9,0.0494505494505494
SURESTE,2024-05-15,215,210,5,0.0232558139534884
SURESTE,2024-05-16,180,172,8,0.0444444444444444
SURESTE,2024-05-17,177,173,4,0.0225988700564972
SURESTE,2024-05-18,202,193,9,0.0445544554455446
SURESTE,2024-05-19,149,142,7,0.0469798657718121
SURESTE,2024-05-20,186,181,5,0.0268817204301075
SURESTE,2024-05-21,181,180,1,0.00552486187845304
SURESTE,2024-05-22,186,181,5,0.0268817204301075
SURESTE,2024-05-23,165,161,4,0.0242424242424242
SURESTE,2024-05-24,179,176,3,0.0167597765363128
SURESTE,2024-05-25,192,190,2,0.0104166666666667
SURESTE,2024-05-26,138,137,1,0.0072463768115942
SURESTE,2024-05-27,134,127,7,0.0522388059701493
SURESTE,2024-05-28,187,184,3,0.0160427807486631
SURESTE,2024-05-29,168,162,6,0.0357142857142857
SURESTE,2024-05-30,187,185,2,0.0106951871657754
SURESTE,2024-05-31,216,211,5,0.0231481481481481
SURESTE,2024-06-01,202,196,6,0.0297029702970297
SURESTE,2024-06-02,114,111,3,0.0263157894736842
SURESTE,2024-06-03,184,183,1,0.00543478260869565
SURESTE,2024-06-04,201,199,2,0.00995024875621891
SURESTE,2024-06-05,213,208,5,0.0234741784037559
SURESTE,2024-06-06,200,192,8,0.04
SURESTE,2024-06-07,179,172,7,0.0391061452513966
SURESTE,2024-06-08,205,194,11,0.0536585365853659
SURESTE,2024-06-09,148,147,1,0.00675675675675676
SURESTE,2024-06-10,156,154,2,0.0128205128205128
SURESTE,2024-06-11,160,154,6,0.0375
SURESTE,2024-06-12,182,180,2,0.010989010989011
SURESTE,2024-06-13,174,169,5,0.028735632183908
SURESTE,2024-06-14,188,184,4,0.0212765957446809
SURESTE,2024-06-15,199,196,3,0.0150753768844221
SURESTE,2024-06-16,157,151,6,0.0382165605095541
SURESTE,2024-06-17,171,165,6,0.0350877192982456
SURESTE,2024-06-18,204,200,4,0.0196078431372549
SURESTE,2024-06-19,194,189,5,0.0257731958762887
SURESTE,2024-06-20,188,186,2,0.0106382978723404
SURESTE,2024-06-21,170,167,3,0.0176470588235294
SURESTE,2024-06-22,184,182,2,0.0108695652173913
SURESTE,2024-06-23,176,172,4,0.0227272727272727
SURESTE,2024-06-24,189,184,5,0.0264550264550265
SURESTE,2024-06-25,192,186,6,0.03125
SURESTE,2024-06-26,195,192,3,0.0153846153846154
SURESTE,2024-06-27,198,194,4,0.0202020202020202
SURESTE,2024-06-28,209,203,6,0.0287081339712919
SURESTE,2024-06-29,201,198,3,0.0149253731343284
SURESTE,2024-06-30,198,193,5,0.0252525252525253
SURESTE,2024-07-01,175,172,3,0.0171428571428571
SURESTE,2024-07-02,192,189,3,0.015625