REGION,Fecha,Instalaciones,Activaciones_automaticas,Activaciones_manuales,PorcAM
BAJIO,2023-03-12,108,98,10,0.0925925925925926
BAJIO,2023-03-13,124,116,8,0.0645161290322581
BAJIO,2023-03-14,131,122,9,0.0687022900763359
BAJIO,2023-03-15,142,135,7,0.0492957746478873
BAJIO,2023-03-16,145,141,4,0.0275862068965517
BAJIO,2023-03-17,215,195,20,0.0930232558139535
BAJIO,2023-03-18,270,248,22,0.0814814814814815
BAJIO,2023-03-19,131,122,9,0.0687022900763359
BAJIO,2023-03-20,202,187,15,0.0742574257425743
BAJIO,2023-03-21,168,163,5,0.0297619047619048
BAJIO,2023-03-22,153,150,3,0.0196078431372549
BAJIO,2023-03-23,151,146,5,0.033112582781457
BAJIO,2023-03-24,148,143,5,0.0337837837837838
BAJIO,2023-03-25,202,197,5,0.0247524752475248
BAJIO,2023-03-26,111,109,2,0.018018018018018
BAJIO,2023-03-27,131,128,3,0.0229007633587786
BAJIO,2023-03-28,144,142,2,0.0138888888888889
BAJIO,2023-03-29,166,164,2,0.0120481927710843
BAJIO,2023-03-30,178,171,7,0.0393258426966292
BAJIO,2023-03-31,266,254,12,0.0451127819548872
BAJIO,2023-04-01,198,192,6,0.0303030303030303
BAJIO,2023-04-02,114,111,3,0.0263157894736842
BAJIO,2023-04-03,152,148,4,0.0263157894736842
BAJIO,2023-04-04,169,158,11,0.0650887573964497
BAJIO,2023-04-05,149,131,18,0.120805369127517
BAJIO,2023-04-06,146,136,10,0.0684931506849315
BAJIO,2023-04-07,114,108,6,0.0526315789473684
BAJIO,2023-04-08,96,96,0,0
BAJIO,2023-04-09,66,62,4,0.0606060606060606
BAJIO,2023-04-10,144,140,4,0.0277777777777778
BAJIO,2023-04-11,150,143,7,0.0466666666666667
BAJIO,2023-04-12,138,131,7,0.0507246376811594
BAJIO,2023-04-13,122,119,3,0.0245901639344262
BAJIO,2023-04-14,141,138,3,0.0212765957446809
BAJIO,2023-04-15,259,244,15,0.0579150579150579
BAJIO,2023-04-16,159,154,5,0.0314465408805031
BAJIO,2023-04-17,159,154,5,0.0314465408805031
BAJIO,2023-04-18,164,149,15,0.0914634146341463
BAJIO,2023-04-19,150,139,11,0.0733333333333333
BAJIO,2023-04-20,141,130,11,0.0780141843971631
BAJIO,2023-04-21,141,133,8,0.0567375886524823
BAJIO,2023-04-22,177,169,8,0.0451977401129944
BAJIO,2023-04-23,124,117,7,0.0564516129032258
BAJIO,2023-04-24,150,143,7,0.0466666666666667
BAJIO,2023-04-25,211,200,11,0.0521327014218009
BAJIO,2023-04-26,174,164,10,0.0574712643678161
BAJIO,2023-04-27,124,115,9,0.0725806451612903
BAJIO,2023-04-28,181,171,10,0.0552486187845304
BAJIO,2023-04-29,261,245,16,0.0613026819923372
BAJIO,2023-04-30,147,136,11,0.0748299319727891
BAJIO,2023-05-01,149,136,13,0.087248322147651
BAJIO,2023-05-02,145,138,7,0.0482758620689655
BAJIO,2023-05-03,128,119,9,0.0703125
BAJIO,2023-05-04,136,124,12,0.0882352941176471
BAJIO,2023-05-05,151,136,15,0.0993377483443709
BAJIO,2023-05-06,182,172,10,0.0549450549450549
BAJIO,2023-05-07,95,84,11,0.115789473684211
BAJIO,2023-05-08,129,123,6,0.0465116279069767
BAJIO,2023-05-09,136,130,6,0.0441176470588235
BAJIO,2023-05-10,105,96,9,0.0857142857142857
BAJIO,2023-05-11,123,115,8,0.0650406504065041
BAJIO,2023-05-12,115,106,9,0.0782608695652174
BAJIO,2023-05-13,191,177,14,0.0732984293193717
BAJIO,2023-05-14,184,178,6,0.0326086956521739
BAJIO,2023-05-15,236,228,8,0.0338983050847458
BAJIO,2023-05-16,221,215,6,0.0271493212669683
BAJIO,2023-05-17,160,152,8,0.05
BAJIO,2023-05-18,160,152,8,0.05
BAJIO,2023-05-19,125,114,11,0.088
BAJIO,2023-05-20,202,191,11,0.0544554455445545
BAJIO,2023-05-21,136,125,11,0.0808823529411765
BAJIO,2023-05-22,141,131,10,0.0709219858156028
BAJIO,2023-05-23,139,132,7,0.0503597122302158
BAJIO,2023-05-24,155,138,17,0.109677419354839
BAJIO,2023-05-25,149,137,12,0.0805369127516778
BAJIO,2023-05-26,171,162,9,0.0526315789473684
BAJIO,2023-05-27,219,213,6,0.0273972602739726
BAJIO,2023-05-28,150,144,6,0.04
BAJIO,2023-05-29,156,146,10,0.0641025641025641
BAJIO,2023-05-30,171,161,10,0.0584795321637427
BAJIO,2023-05-31,226,215,11,0.0486725663716814
BAJIO,2023-06-01,156,151,5,0.032051282051282
BAJIO,2023-06-02,156,147,9,0.0576923076923077
BAJIO,2023-06-03,195,182,13,0.0666666666666667
BAJIO,2023-06-04,134,120,14,0.104477611940299
BAJIO,2023-06-05,127,119,8,0.062992125984252
BAJIO,2023-06-06,143,135,8,0.0559440559440559
BAJIO,2023-06-07,141,133,8,0.0567375886524823
BAJIO,2023-06-08,148,144,4,0.027027027027027
BAJIO,2023-06-09,157,153,4,0.0254777070063694
BAJIO,2023-06-10,196,191,5,0.0255102040816327
BAJIO,2023-06-11,148,140,8,0.0540540540540541
BAJIO,2023-06-12,145,137,8,0.0551724137931034
BAJIO,2023-06-13,156,150,6,0.0384615384615385
BAJIO,2023-06-14,135,127,8,0.0592592592592593
BAJIO,2023-06-15,161,153,8,0.0496894409937888
BAJIO,2023-06-16,168,162,6,0.0357142857142857
BAJIO,2023-06-17,182,172,10,0.0549450549450549
BAJIO,2023-06-18,128,124,4,0.03125
BAJIO,2023-06-19,148,142,6,0.0405405405405405
BAJIO,2023-06-20,139,130,9,0.0647482014388489
BAJIO,2023-06-21,174,168,6,0.0344827586206897
BAJIO,2023-06-22,139,135,4,0.0287769784172662
BAJIO,2023-06-23,122,113,9,0.0737704918032787
BAJIO,2023-06-24,169,158,11,0.0650887573964497
BAJIO,2023-06-25,105,100,5,0.0476190476190476
BAJIO,2023-06-26,118,108,10,0.0847457627118644
BAJIO,2023-06-27,161,157,4,0.0248447204968944
BAJIO,2023-06-28,138,129,9,0.0652173913043478
BAJIO,2023-06-29,165,156,9,0.0545454545454545
BAJIO,2023-06-30,123,93,30,0.24390243902439
BAJIO,2023-07-01,169,155,14,0.0828402366863905
BAJIO,2023-07-02,133,127,6,0.0451127819548872
BAJIO,2023-07-03,127,125,2,0.015748031496063
BAJIO,2023-07-04,138,133,5,0.036231884057971
BAJIO,2023-07-05,122,117,5,0.040983606557377
BAJIO,2023-07-06,96,92,4,0.0416666666666667
BAJIO,2023-07-07,163,163,0,0
BAJIO,2023-07-08,204,202,2,0.00980392156862745
BAJIO,2023-07-09,133,127,6,0.0451127819548872
BAJIO,2023-07-10,155,150,5,0.032258064516129
BAJIO,2023-07-11,139,133,6,0.0431654676258993
BAJIO,2023-07-12,128,126,2,0.015625
BAJIO,2023-07-13,118,113,5,0.0423728813559322
BAJIO,2023-07-14,130,128,2,0.0153846153846154
BAJIO,2023-07-15,254,248,6,0.0236220472440945
BAJIO,2023-07-16,108,102,6,0.0555555555555556
BAJIO,2023-07-17,136,133,3,0.0220588235294118
BAJIO,2023-07-18,147,143,4,0.0272108843537415
BAJIO,2023-07-19,188,184,4,0.0212765957446809
BAJIO,2023-07-20,183,176,7,0.0382513661202186
BAJIO,2023-07-21,183,181,2,0.0109289617486339
BAJIO,2023-07-22,198,192,6,0.0303030303030303
BAJIO,2023-07-23,128,126,2,0.015625
BAJIO,2023-07-24,153,149,4,0.0261437908496732
BAJIO,2023-07-25,179,173,6,0.0335195530726257
BAJIO,2023-07-26,150,147,3,0.02
BAJIO,2023-07-27,160,158,2,0.0125
BAJIO,2023-07-28,170,165,5,0.0294117647058824
BAJIO,2023-07-29,248,244,4,0.0161290322580645
BAJIO,2023-07-30,122,118,4,0.0327868852459016
BAJIO,2023-07-31,186,180,6,0.032258064516129
BAJIO,2023-08-01,174,171,3,0.0172413793103448
BAJIO,2023-08-02,151,150,1,0.00662251655629139
BAJIO,2023-08-03,173,154,19,0.109826589595376
BAJIO,2023-08-04,134,132,2,0.0149253731343284
BAJIO,2023-08-05,174,171,3,0.0172413793103448
BAJIO,2023-08-06,126,123,3,0.0238095238095238
BAJIO,2023-08-07,130,128,2,0.0153846153846154
BAJIO,2023-08-08,149,148,1,0.00671140939597315
BAJIO,2023-08-09,163,160,3,0.0184049079754601
BAJIO,2023-08-10,183,177,6,0.0327868852459016
BAJIO,2023-08-11,184,182,2,0.0108695652173913
BAJIO,2023-08-12,199,194,5,0.0251256281407035
BAJIO,2023-08-13,121,116,5,0.0413223140495868
BAJIO,2023-08-14,134,130,4,0.0298507462686567
BAJIO,2023-08-15,206,199,7,0.0339805825242718
BAJIO,2023-08-16,190,186,4,0.0210526315789474
BAJIO,2023-08-17,161,157,4,0.0248447204968944
BAJIO,2023-08-18,180,174,6,0.0333333333333333
BAJIO,2023-08-19,192,189,3,0.015625
BAJIO,2023-08-20,129,124,5,0.0387596899224806
BAJIO,2023-08-21,139,135,4,0.0287769784172662
BAJIO,2023-08-22,162,157,5,0.0308641975308642
BAJIO,2023-08-23,162,158,4,0.0246913580246914
BAJIO,2023-08-24,152,152,0,0
BAJIO,2023-08-25,197,196,1,0.0050761421319797
BAJIO,2023-08-26,226,222,4,0.0176991150442478
BAJIO,2023-08-27,146,146,0,0
BAJIO,2023-08-28,151,151,0,0
BAJIO,2023-08-29,203,201,2,0.00985221674876847
BAJIO,2023-08-30,166,163,3,0.0180722891566265
BAJIO,2023-08-31,172,168,4,0.0232558139534884
BAJIO,2023-09-01,167,164,3,0.0179640718562874
BAJIO,2023-09-02,158,158,0,0
BAJIO,2023-09-03,115,114,1,0.00869565217391304
BAJIO,2023-09-04,123,123,0,0
BAJIO,2023-09-05,163,161,2,0.0122699386503067
BAJIO,2023-09-06,139,136,3,0.0215827338129496
BAJIO,2023-09-07,155,154,1,0.00645161290322581
BAJIO,2023-09-08,160,158,2,0.0125
BAJIO,2023-09-09,187,187,0,0
BAJIO,2023-09-10,129,126,3,0.0232558139534884
BAJIO,2023-09-11,150,148,2,0.0133333333333333
BAJIO,2023-09-12,176,174,2,0.0113636363636364
BAJIO,2023-09-13,164,164,0,0
BAJIO,2023-09-14,149,146,3,0.0201342281879195
BAJIO,2023-09-15,181,178,3,0.0165745856353591
BAJIO,2023-09-16,147,144,3,0.0204081632653061
BAJIO,2023-09-17,120,118,2,0.0166666666666667
BAJIO,2023-09-18,133,133,0,0
BAJIO,2023-09-19,138,131,7,0.0507246376811594
BAJIO,2023-09-20,116,115,1,0.00862068965517241
BAJIO,2023-09-21,137,135,2,0.0145985401459854
BAJIO,2023-09-22,134,130,4,0.0298507462686567
BAJIO,2023-09-23,201,197,4,0.0199004975124378
BAJIO,2023-09-24,101,99,2,0.0198019801980198
BAJIO,2023-09-25,161,160,1,0.0062111801242236
BAJIO,2023-09-26,137,135,2,0.0145985401459854
BAJIO,2023-09-27,150,149,1,0.00666666666666667
BAJIO,2023-09-28,169,169,0,0
BAJIO,2023-09-29,145,143,2,0.0137931034482759
BAJIO,2023-09-30,228,223,5,0.0219298245614035
BAJIO,2023-10-01,114,113,1,0.0087719298245614
BAJIO,2023-10-02,132,132,0,0
BAJIO,2023-10-03,132,126,6,0.0454545454545455
BAJIO,2023-10-04,126,123,3,0.0238095238095238
BAJIO,2023-10-05,126,123,3,0.0238095238095238
BAJIO,2023-10-06,167,163,4,0.0239520958083832
BAJIO,2023-10-07,209,204,5,0.0239234449760766
BAJIO,2023-10-08,115,107,8,0.0695652173913043
BAJIO,2023-10-09,142,135,7,0.0492957746478873
BAJIO,2023-10-10,124,117,7,0.0564516129032258
BAJIO,2023-10-11,109,104,5,0.0458715596330275
BAJIO,2023-10-12,137,134,3,0.0218978102189781
BAJIO,2023-10-13,114,108,6,0.0526315789473684
BAJIO,2023-10-14,146,140,6,0.0410958904109589
BAJIO,2023-10-15,121,115,6,0.0495867768595041
BAJIO,2023-10-16,156,149,7,0.0448717948717949
BAJIO,2023-10-17,135,134,1,0.00740740740740741
BAJIO,2023-10-18,134,128,6,0.0447761194029851
BAJIO,2023-10-19,139,134,5,0.0359712230215827
BAJIO,2023-10-20,153,147,6,0.0392156862745098
BAJIO,2023-10-21,224,216,8,0.0357142857142857
BAJIO,2023-10-22,137,134,3,0.0218978102189781
BAJIO,2023-10-23,154,148,6,0.038961038961039
BAJIO,2023-10-24,154,150,4,0.025974025974026
BAJIO,2023-10-25,153,149,4,0.0261437908496732
BAJIO,2023-10-26,154,151,3,0.0194805194805195
BAJIO,2023-10-27,151,147,4,0.0264900662251656
BAJIO,2023-10-28,175,167,8,0.0457142857142857
BAJIO,2023-10-29,120,117,3,0.025
BAJIO,2023-10-30,172,165,7,0.0406976744186047
BAJIO,2023-10-31,198,191,7,0.0353535353535354
BAJIO,2023-11-01,158,155,3,0.0189873417721519
BAJIO,2023-11-02,143,141,2,0.013986013986014
BAJIO,2023-11-03,142,138,4,0.028169014084507
BAJIO,2023-11-04,173,169,4,0.023121387283237
BAJIO,2023-11-05,115,112,3,0.0260869565217391
BAJIO,2023-11-06,155,150,5,0.032258064516129
BAJIO,2023-11-07,200,199,1,0.005
BAJIO,2023-11-08,149,141,8,0.0536912751677852
BAJIO,2023-11-09,124,118,6,0.0483870967741935
BAJIO,2023-11-10,137,134,3,0.0218978102189781
BAJIO,2023-11-11,189,183,6,0.0317460317460317
BAJIO,2023-11-12,135,132,3,0.0222222222222222
BAJIO,2023-11-13,182,173,9,0.0494505494505494
BAJIO,2023-11-14,194,188,6,0.0309278350515464
BAJIO,2023-11-15,189,185,4,0.0211640211640212
BAJIO,2023-11-16,185,182,3,0.0162162162162162
BAJIO,2023-11-17,184,182,2,0.0108695652173913
BAJIO,2023-11-18,264,259,5,0.0189393939393939
BAJIO,2023-11-19,135,132,3,0.0222222222222222
BAJIO,2023-11-20,173,167,6,0.0346820809248555
BAJIO,2023-11-21,189,182,7,0.037037037037037
BAJIO,2023-11-22,181,178,3,0.0165745856353591
BAJIO,2023-11-23,173,168,5,0.0289017341040462
BAJIO,2023-11-24,170,166,4,0.0235294117647059
BAJIO,2023-11-25,219,213,6,0.0273972602739726
BAJIO,2023-11-26,159,152,7,0.0440251572327044
BAJIO,2023-11-27,156,150,6,0.0384615384615385
BAJIO,2023-11-28,181,176,5,0.0276243093922652
BAJIO,2023-11-29,187,182,5,0.0267379679144385
BAJIO,2023-11-30,220,213,7,0.0318181818181818
BAJIO,2023-12-01,174,170,4,0.0229885057471264
BAJIO,2023-12-02,180,174,6,0.0333333333333333
BAJIO,2023-12-03,148,140,8,0.0540540540540541
BAJIO,2023-12-04,166,162,4,0.0240963855421687
BAJIO,2023-12-05,198,193,5,0.0252525252525253
BAJIO,2023-12-06,193,186,7,0.0362694300518135
BAJIO,2023-12-07,122,119,3,0.0245901639344262
BAJIO,2023-12-08,189,185,4,0.0211640211640212
BAJIO,2023-12-09,188,180,8,0.0425531914893617
BAJIO,2023-12-10,158,153,5,0.0316455696202532
BAJIO,2023-12-11,144,139,5,0.0347222222222222
BAJIO,2023-12-12,173,168,5,0.0289017341040462
BAJIO,2023-12-13,147,139,8,0.054421768707483
BAJIO,2023-12-14,172,167,5,0.0290697674418605
BAJIO,2023-12-15,127,125,2,0.015748031496063
BAJIO,2023-12-16,250,241,9,0.036
BAJIO,2023-12-17,156,154,2,0.0128205128205128
BAJIO,2023-12-18,196,189,7,0.0357142857142857
BAJIO,2023-12-19,168,163,5,0.0297619047619048
BAJIO,2023-12-20,204,193,11,0.053921568627451
BAJIO,2023-12-21,182,178,4,0.021978021978022
BAJIO,2023-12-22,177,170,7,0.0395480225988701
BAJIO,2023-12-23,196,191,5,0.0255102040816327
BAJIO,2023-12-24,109,107,2,0.018348623853211
BAJIO,2023-12-25,43,40,3,0.0697674418604651
BAJIO,2023-12-26,154,152,2,0.012987012987013
BAJIO,2023-12-27,204,197,7,0.0343137254901961
BAJIO,2023-12-28,199,193,6,0.0301507537688442
BAJIO,2023-12-29,208,203,5,0.0240384615384615
BAJIO,2023-12-30,198,197,1,0.00505050505050505
BAJIO,2023-12-31,94,93,1,0.0106382978723404
BAJIO,2024-01-01,43,42,1,0.0232558139534884
BAJIO,2024-01-02,138,134,4,0.0289855072463768
BAJIO,2024-01-03,211,204,7,0.033175355450237
BAJIO,2024-01-04,202,197,5,0.0247524752475248
BAJIO,2024-01-05,187,178,9,0.0481283422459893
BAJIO,2024-01-06,193,190,3,0.0155440414507772
BAJIO,2024-01-07,132,126,6,0.0454545454545455
BAJIO,2024-01-08,179,166,13,0.0726256983240224
BAJIO,2024-01-09,209,200,9,0.0430622009569378
BAJIO,2024-01-10,175,168,7,0.04
BAJIO,2024-01-11,192,183,9,0.046875
BAJIO,2024-01-12,167,164,3,0.0179640718562874
BAJIO,2024-01-13,233,224,9,0.0386266094420601
BAJIO,2024-01-14,182,178,4,0.021978021978022
BAJIO,2024-01-15,163,159,4,0.0245398773006135
BAJIO,2024-01-16,196,192,4,0.0204081632653061
BAJIO,2024-01-17,193,187,6,0.0310880829015544
BAJIO,2024-01-18,165,159,6,0.0363636363636364
BAJIO,2024-01-19,191,180,11,0.0575916230366492
BAJIO,2024-01-20,206,202,4,0.0194174757281553
BAJIO,2024-01-21,127,124,3,0.0236220472440945
BAJIO,2024-01-22,128,125,3,0.0234375
BAJIO,2024-01-23,171,170,1,0.00584795321637427
BAJIO,2024-01-24,169,161,8,0.0473372781065089
BAJIO,2024-01-25,173,167,6,0.0346820809248555
BAJIO,2024-01-26,187,184,3,0.0160427807486631
BAJIO,2024-01-27,228,221,7,0.0307017543859649
BAJIO,2024-01-28,126,124,2,0.0158730158730159
BAJIO,2024-01-29,169,168,1,0.00591715976331361
BAJIO,2024-01-30,185,178,7,0.0378378378378378
BAJIO,2024-01-31,196,189,7,0.0357142857142857
BAJIO,2024-02-01,148,142,6,0.0405405405405405
BAJIO,2024-02-02,175,171,4,0.0228571428571429
BAJIO,2024-02-03,188,180,8,0.0425531914893617
BAJIO,2024-02-04,124,123,1,0.00806451612903226
BAJIO,2024-02-05,160,154,6,0.0375
BAJIO,2024-02-06,164,162,2,0.0121951219512195
BAJIO,2024-02-07,197,192,5,0.0253807106598985
BAJIO,2024-02-08,164,162,2,0.0121951219512195
BAJIO,2024-02-09,190,188,2,0.0105263157894737
BAJIO,2024-02-10,209,203,6,0.0287081339712919
BAJIO,2024-02-11,119,115,4,0.0336134453781513
BAJIO,2024-02-12,121,116,5,0.0413223140495868
BAJIO,2024-02-13,201,190,11,0.054726368159204
BAJIO,2024-02-14,164,158,6,0.0365853658536585
BAJIO,2024-02-15,166,164,2,0.0120481927710843
BAJIO,2024-02-16,146,144,2,0.0136986301369863
BAJIO,2024-02-17,198,189,9,0.0454545454545455
BAJIO,2024-02-18,168,166,2,0.0119047619047619
BAJIO,2024-02-19,167,162,5,0.029940119760479
BAJIO,2024-02-20,173,166,7,0.0404624277456647
BAJIO,2024-02-21,191,182,9,0.0471204188481675
BAJIO,2024-02-22,152,147,5,0.0328947368421053
BAJIO,2024-02-23,137,108,29,0.211678832116788
BAJIO,2024-02-24,258,249,9,0.0348837209302326
BAJIO,2024-02-25,123,118,5,0.040650406504065
BAJIO,2024-02-26,164,161,3,0.0182926829268293
BAJIO,2024-02-27,217,210,7,0.032258064516129
BAJIO,2024-02-28,177,170,7,0.0395480225988701
BAJIO,2024-02-29,193,184,9,0.0466321243523316
BAJIO,2024-03-01,154,152,2,0.012987012987013
BAJIO,2024-03-02,193,186,7,0.0362694300518135
BAJIO,2024-03-03,151,146,5,0.033112582781457
BAJIO,2024-03-04,174,170,4,0.0229885057471264
BAJIO,2024-03-05,190,184,6,0.0315789473684211
BAJIO,2024-03-06,205,197,8,0.0390243902439024
BAJIO,2024-03-07,165,162,3,0.0181818181818182
BAJIO,2024-03-08,189,188,1,0.00529100529100529
BAJIO,2024-03-09,182,176,6,0.032967032967033
BAJIO,2024-03-10,139,137,2,0.0143884892086331
BAJIO,2024-03-11,184,181,3,0.016304347826087
CDMX FORANEAS,2023-03-12,181,145,36,0.198895027624309
CDMX FORANEAS,2023-03-13,272,222,50,0.183823529411765
CDMX FORANEAS,2023-03-14,237,200,37,0.156118143459916
CDMX FORANEAS,2023-03-15,188,175,13,0.0691489361702128
CDMX FORANEAS,2023-03-16,253,248,5,0.0197628458498024
CDMX FORANEAS,2023-03-17,347,335,12,0.0345821325648415
CDMX FORANEAS,2023-03-18,360,338,22,0.0611111111111111
CDMX FORANEAS,2023-03-19,318,296,22,0.0691823899371069
CDMX FORANEAS,2023-03-20,392,375,17,0.0433673469387755
CDMX FORANEAS,2023-03-21,309,304,5,0.0161812297734628
CDMX FORANEAS,2023-03-22,278,276,2,0.00719424460431655
CDMX FORANEAS,2023-03-23,242,236,6,0.0247933884297521
CDMX FORANEAS,2023-03-24,272,271,1,0.00367647058823529
CDMX FORANEAS,2023-03-25,309,306,3,0.00970873786407767
CDMX FORANEAS,2023-03-26,315,309,6,0.019047619047619
CDMX FORANEAS,2023-03-27,249,245,4,0.0160642570281124
CDMX FORANEAS,2023-03-28,203,202,1,0.00492610837438424
CDMX FORANEAS,2023-03-29,229,228,1,0.00436681222707424
CDMX FORANEAS,2023-03-30,278,273,5,0.0179856115107914
CDMX FORANEAS,2023-03-31,353,348,5,0.0141643059490085
CDMX FORANEAS,2023-04-01,322,314,8,0.0248447204968944
CDMX FORANEAS,2023-04-02,273,272,1,0.00366300366300366
CDMX FORANEAS,2023-04-03,319,316,3,0.00940438871473354
CDMX FORANEAS,2023-04-04,209,205,4,0.0191387559808612
CDMX FORANEAS,2023-04-05,246,241,5,0.0203252032520325
CDMX FORANEAS,2023-04-06,247,245,2,0.00809716599190283
CDMX FORANEAS,2023-04-07,191,187,4,0.0209424083769634
CDMX FORANEAS,2023-04-08,167,165,2,0.0119760479041916
CDMX FORANEAS,2023-04-09,122,122,0,0
CDMX FORANEAS,2023-04-10,167,164,3,0.0179640718562874
CDMX FORANEAS,2023-04-11,228,226,2,0.0087719298245614
CDMX FORANEAS,2023-04-12,261,260,1,0.00383141762452107
CDMX FORANEAS,2023-04-13,224,220,4,0.0178571428571429
CDMX FORANEAS,2023-04-14,277,277,0,0
CDMX FORANEAS,2023-04-15,322,318,4,0.0124223602484472
CDMX FORANEAS,2023-04-16,326,326,0,0
CDMX FORANEAS,2023-04-17,270,266,4,0.0148148148148148
CDMX FORANEAS,2023-04-18,237,237,0,0
CDMX FORANEAS,2023-04-19,268,267,1,0.00373134328358209
CDMX FORANEAS,2023-04-20,228,227,1,0.0043859649122807
CDMX FORANEAS,2023-04-21,212,211,1,0.00471698113207547
CDMX FORANEAS,2023-04-22,253,253,0,0
CDMX FORANEAS,2023-04-23,228,227,1,0.0043859649122807
CDMX FORANEAS,2023-04-24,284,279,5,0.0176056338028169
CDMX FORANEAS,2023-04-25,290,289,1,0.00344827586206897
CDMX FORANEAS,2023-04-26,259,255,4,0.0154440154440154
CDMX FORANEAS,2023-04-27,219,218,1,0.0045662100456621
CDMX FORANEAS,2023-04-28,259,256,3,0.0115830115830116
CDMX FORANEAS,2023-04-29,297,295,2,0.00673400673400673
CDMX FORANEAS,2023-04-30,251,248,3,0.0119521912350598
CDMX FORANEAS,2023-05-01,264,262,2,0.00757575757575758
CDMX FORANEAS,2023-05-02,219,213,6,0.0273972602739726
CDMX FORANEAS,2023-05-03,233,230,3,0.0128755364806867
CDMX FORANEAS,2023-05-04,178,175,3,0.0168539325842697
CDMX FORANEAS,2023-05-05,218,216,2,0.00917431192660551
CDMX FORANEAS,2023-05-06,210,209,1,0.00476190476190476
CDMX FORANEAS,2023-05-07,187,185,2,0.0106951871657754
CDMX FORANEAS,2023-05-08,191,188,3,0.0157068062827225
CDMX FORANEAS,2023-05-09,233,229,4,0.0171673819742489
CDMX FORANEAS,2023-05-10,215,208,7,0.0325581395348837
CDMX FORANEAS,2023-05-11,192,189,3,0.015625
CDMX FORANEAS,2023-05-12,201,200,1,0.00497512437810945
CDMX FORANEAS,2023-05-13,313,307,6,0.0191693290734824
CDMX FORANEAS,2023-05-14,327,323,4,0.0122324159021407
CDMX FORANEAS,2023-05-15,349,345,4,0.0114613180515759
CDMX FORANEAS,2023-05-16,374,372,2,0.0053475935828877
CDMX FORANEAS,2023-05-17,291,290,1,0.00343642611683849
CDMX FORANEAS,2023-05-18,227,225,2,0.00881057268722467
CDMX FORANEAS,2023-05-19,252,247,5,0.0198412698412698
CDMX FORANEAS,2023-05-20,310,299,11,0.0354838709677419
CDMX FORANEAS,2023-05-21,251,248,3,0.0119521912350598
CDMX FORANEAS,2023-05-22,235,230,5,0.0212765957446809
CDMX FORANEAS,2023-05-23,226,222,4,0.0176991150442478
CDMX FORANEAS,2023-05-24,226,223,3,0.0132743362831858
CDMX FORANEAS,2023-05-25,220,218,2,0.00909090909090909
CDMX FORANEAS,2023-05-26,271,269,2,0.00738007380073801
CDMX FORANEAS,2023-05-27,260,250,10,0.0384615384615385
CDMX FORANEAS,2023-05-28,230,228,2,0.00869565217391304
CDMX FORANEAS,2023-05-29,246,244,2,0.00813008130081301
CDMX FORANEAS,2023-05-30,271,267,4,0.014760147601476
CDMX FORANEAS,2023-05-31,288,281,7,0.0243055555555556
CDMX FORANEAS,2023-06-01,219,216,3,0.0136986301369863
CDMX FORANEAS,2023-06-02,197,194,3,0.0152284263959391
CDMX FORANEAS,2023-06-03,225,224,1,0.00444444444444444
CDMX FORANEAS,2023-06-04,281,274,7,0.0249110320284698
CDMX FORANEAS,2023-06-05,290,279,11,0.0379310344827586
CDMX FORANEAS,2023-06-06,237,235,2,0.00843881856540084
CDMX FORANEAS,2023-06-07,212,207,5,0.0235849056603774
CDMX FORANEAS,2023-06-08,180,177,3,0.0166666666666667
CDMX FORANEAS,2023-06-09,244,242,2,0.00819672131147541
CDMX FORANEAS,2023-06-10,293,283,10,0.0341296928327645
CDMX FORANEAS,2023-06-11,237,230,7,0.029535864978903
CDMX FORANEAS,2023-06-12,250,246,4,0.016
CDMX FORANEAS,2023-06-13,254,248,6,0.0236220472440945
CDMX FORANEAS,2023-06-14,240,237,3,0.0125
CDMX FORANEAS,2023-06-15,254,249,5,0.0196850393700787
CDMX FORANEAS,2023-06-16,273,268,5,0.0183150183150183
CDMX FORANEAS,2023-06-17,317,310,7,0.0220820189274448
CDMX FORANEAS,2023-06-18,209,207,2,0.00956937799043062
CDMX FORANEAS,2023-06-19,250,247,3,0.012
CDMX FORANEAS,2023-06-20,278,275,3,0.0107913669064748
CDMX FORANEAS,2023-06-21,226,219,7,0.0309734513274336
CDMX FORANEAS,2023-06-22,227,222,5,0.0220264317180617
CDMX FORANEAS,2023-06-23,310,301,9,0.0290322580645161
CDMX FORANEAS,2023-06-24,292,285,7,0.023972602739726
CDMX FORANEAS,2023-06-25,238,235,3,0.0126050420168067
CDMX FORANEAS,2023-06-26,263,256,7,0.026615969581749
CDMX FORANEAS,2023-06-27,237,233,4,0.0168776371308017
CDMX FORANEAS,2023-06-28,251,244,7,0.0278884462151394
CDMX FORANEAS,2023-06-29,258,255,3,0.0116279069767442
CDMX FORANEAS,2023-06-30,170,162,8,0.0470588235294118
CDMX FORANEAS,2023-07-01,291,283,8,0.0274914089347079
CDMX FORANEAS,2023-07-02,243,239,4,0.0164609053497942
CDMX FORANEAS,2023-07-03,252,247,5,0.0198412698412698
CDMX FORANEAS,2023-07-04,211,206,5,0.023696682464455
CDMX FORANEAS,2023-07-05,236,230,6,0.0254237288135593
CDMX FORANEAS,2023-07-06,188,184,4,0.0212765957446809
CDMX FORANEAS,2023-07-07,300,291,9,0.03
CDMX FORANEAS,2023-07-08,246,242,4,0.016260162601626
CDMX FORANEAS,2023-07-09,245,235,10,0.0408163265306122
CDMX FORANEAS,2023-07-10,224,220,4,0.0178571428571429
CDMX FORANEAS,2023-07-11,217,209,8,0.0368663594470046
CDMX FORANEAS,2023-07-12,273,262,11,0.0402930402930403
CDMX FORANEAS,2023-07-13,210,203,7,0.0333333333333333
CDMX FORANEAS,2023-07-14,246,240,6,0.024390243902439
CDMX FORANEAS,2023-07-15,267,259,8,0.0299625468164794
CDMX FORANEAS,2023-07-16,201,196,5,0.0248756218905473
CDMX FORANEAS,2023-07-17,229,223,6,0.0262008733624454
CDMX FORANEAS,2023-07-18,249,244,5,0.0200803212851406
CDMX FORANEAS,2023-07-19,256,248,8,0.03125
CDMX FORANEAS,2023-07-20,266,257,9,0.0338345864661654
CDMX FORANEAS,2023-07-21,221,216,5,0.0226244343891403
CDMX FORANEAS,2023-07-22,266,262,4,0.0150375939849624
CDMX FORANEAS,2023-07-23,251,243,8,0.0318725099601594
CDMX FORANEAS,2023-07-24,217,214,3,0.0138248847926267
CDMX FORANEAS,2023-07-25,266,255,11,0.0413533834586466
CDMX FORANEAS,2023-07-26,306,296,10,0.0326797385620915
CDMX FORANEAS,2023-07-27,306,300,6,0.0196078431372549
CDMX FORANEAS,2023-07-28,301,296,5,0.0166112956810631
CDMX FORANEAS,2023-07-29,299,296,3,0.0100334448160535
CDMX FORANEAS,2023-07-30,268,263,5,0.0186567164179104
CDMX FORANEAS,2023-07-31,279,274,5,0.017921146953405
CDMX FORANEAS,2023-08-01,270,262,8,0.0296296296296296
CDMX FORANEAS,2023-08-02,264,259,5,0.0189393939393939
CDMX FORANEAS,2023-08-03,227,216,11,0.0484581497797357
CDMX FORANEAS,2023-08-04,266,261,5,0.018796992481203
CDMX FORANEAS,2023-08-05,259,252,7,0.027027027027027
CDMX FORANEAS,2023-08-06,263,258,5,0.0190114068441065
CDMX FORANEAS,2023-08-07,237,234,3,0.0126582278481013
CDMX FORANEAS,2023-08-08,249,244,5,0.0200803212851406
CDMX FORANEAS,2023-08-09,290,280,10,0.0344827586206897
CDMX FORANEAS,2023-08-10,266,255,11,0.0413533834586466
CDMX FORANEAS,2023-08-11,279,275,4,0.014336917562724
CDMX FORANEAS,2023-08-12,291,283,8,0.0274914089347079
CDMX FORANEAS,2023-08-13,274,263,11,0.0401459854014599
CDMX FORANEAS,2023-08-14,270,262,8,0.0296296296296296
CDMX FORANEAS,2023-08-15,312,306,6,0.0192307692307692
CDMX FORANEAS,2023-08-16,258,254,4,0.0155038759689922
CDMX FORANEAS,2023-08-17,236,229,7,0.0296610169491525
CDMX FORANEAS,2023-08-18,248,245,3,0.0120967741935484
CDMX FORANEAS,2023-08-19,284,277,7,0.0246478873239437
CDMX FORANEAS,2023-08-20,253,245,8,0.0316205533596838
CDMX FORANEAS,2023-08-21,229,228,1,0.00436681222707424
CDMX FORANEAS,2023-08-22,249,248,1,0.00401606425702811
CDMX FORANEAS,2023-08-23,272,270,2,0.00735294117647059
CDMX FORANEAS,2023-08-24,266,266,0,0
CDMX FORANEAS,2023-08-25,251,251,0,0
CDMX FORANEAS,2023-08-26,311,311,0,0
CDMX FORANEAS,2023-08-27,271,271,0,0
CDMX FORANEAS,2023-08-28,271,271,0,0
CDMX FORANEAS,2023-08-29,308,306,2,0.00649350649350649
CDMX FORANEAS,2023-08-30,260,260,0,0
CDMX FORANEAS,2023-08-31,259,258,1,0.00386100386100386
CDMX FORANEAS,2023-09-01,229,229,0,0
CDMX FORANEAS,2023-09-02,227,226,1,0.00440528634361234
CDMX FORANEAS,2023-09-03,245,244,1,0.00408163265306122
CDMX FORANEAS,2023-09-04,263,263,0,0
CDMX FORANEAS,2023-09-05,228,227,1,0.0043859649122807
CDMX FORANEAS,2023-09-06,254,253,1,0.00393700787401575
CDMX FORANEAS,2023-09-07,273,271,2,0.00732600732600733
CDMX FORANEAS,2023-09-08,234,234,0,0
CDMX FORANEAS,2023-09-09,251,251,0,0
CDMX FORANEAS,2023-09-10,230,229,1,0.00434782608695652
CDMX FORANEAS,2023-09-11,243,243,0,0
CDMX FORANEAS,2023-09-12,263,263,0,0
CDMX FORANEAS,2023-09-13,225,224,1,0.00444444444444444
CDMX FORANEAS,2023-09-14,228,228,0,0
CDMX FORANEAS,2023-09-15,207,206,1,0.00483091787439614
CDMX FORANEAS,2023-09-16,166,166,0,0
CDMX FORANEAS,2023-09-17,201,201,0,0
CDMX FORANEAS,2023-09-18,249,249,0,0
CDMX FORANEAS,2023-09-19,210,209,1,0.00476190476190476
CDMX FORANEAS,2023-09-20,218,218,0,0
CDMX FORANEAS,2023-09-21,215,215,0,0
CDMX FORANEAS,2023-09-22,278,277,1,0.00359712230215827
CDMX FORANEAS,2023-09-23,285,284,1,0.00350877192982456
CDMX FORANEAS,2023-09-24,247,247,0,0
CDMX FORANEAS,2023-09-25,233,233,0,0
CDMX FORANEAS,2023-09-26,260,258,2,0.00769230769230769
CDMX FORANEAS,2023-09-27,215,213,2,0.00930232558139535
CDMX FORANEAS,2023-09-28,283,282,1,0.00353356890459364
CDMX FORANEAS,2023-09-29,253,253,0,0
CDMX FORANEAS,2023-09-30,337,335,2,0.00593471810089021
CDMX FORANEAS,2023-10-01,222,221,1,0.0045045045045045
CDMX FORANEAS,2023-10-02,257,256,1,0.00389105058365759
CDMX FORANEAS,2023-10-03,216,211,5,0.0231481481481481
CDMX FORANEAS,2023-10-04,231,227,4,0.0173160173160173
CDMX FORANEAS,2023-10-05,210,202,8,0.0380952380952381
CDMX FORANEAS,2023-10-06,234,224,10,0.0427350427350427
CDMX FORANEAS,2023-10-07,263,254,9,0.0342205323193916
CDMX FORANEAS,2023-10-08,228,221,7,0.0307017543859649
CDMX FORANEAS,2023-10-09,247,238,9,0.0364372469635627
CDMX FORANEAS,2023-10-10,215,207,8,0.0372093023255814
CDMX FORANEAS,2023-10-11,211,206,5,0.023696682464455
CDMX FORANEAS,2023-10-12,211,202,9,0.042654028436019
CDMX FORANEAS,2023-10-13,222,216,6,0.027027027027027
CDMX FORANEAS,2023-10-14,302,293,9,0.0298013245033113
CDMX FORANEAS,2023-10-15,287,280,7,0.024390243902439
CDMX FORANEAS,2023-10-16,259,253,6,0.0231660231660232
CDMX FORANEAS,2023-10-17,247,240,7,0.0283400809716599
CDMX FORANEAS,2023-10-18,221,211,10,0.0452488687782805
CDMX FORANEAS,2023-10-19,255,249,6,0.0235294117647059
CDMX FORANEAS,2023-10-20,244,240,4,0.0163934426229508
CDMX FORANEAS,2023-10-21,306,298,8,0.0261437908496732
CDMX FORANEAS,2023-10-22,229,222,7,0.0305676855895196
CDMX FORANEAS,2023-10-23,235,229,6,0.025531914893617
CDMX FORANEAS,2023-10-24,261,250,11,0.0421455938697318
CDMX FORANEAS,2023-10-25,199,192,7,0.0351758793969849
CDMX FORANEAS,2023-10-26,229,222,7,0.0305676855895196
CDMX FORANEAS,2023-10-27,221,213,8,0.0361990950226244
CDMX FORANEAS,2023-10-28,258,249,9,0.0348837209302326
CDMX FORANEAS,2023-10-29,239,231,8,0.0334728033472803
CDMX FORANEAS,2023-10-30,223,205,18,0.0807174887892377
CDMX FORANEAS,2023-10-31,294,286,8,0.0272108843537415
CDMX FORANEAS,2023-11-01,263,255,8,0.0304182509505703
CDMX FORANEAS,2023-11-02,210,206,4,0.019047619047619
CDMX FORANEAS,2023-11-03,210,200,10,0.0476190476190476
CDMX FORANEAS,2023-11-04,268,263,5,0.0186567164179104
CDMX FORANEAS,2023-11-05,291,278,13,0.0446735395189003
CDMX FORANEAS,2023-11-06,302,292,10,0.033112582781457
CDMX FORANEAS,2023-11-07,303,291,12,0.0396039603960396
CDMX FORANEAS,2023-11-08,266,260,6,0.0225563909774436
CDMX FORANEAS,2023-11-09,245,233,12,0.0489795918367347
CDMX FORANEAS,2023-11-10,248,246,2,0.00806451612903226
CDMX FORANEAS,2023-11-11,306,303,3,0.00980392156862745
CDMX FORANEAS,2023-11-12,285,281,4,0.0140350877192982
CDMX FORANEAS,2023-11-13,298,284,14,0.0469798657718121
CDMX FORANEAS,2023-11-14,317,304,13,0.0410094637223975
CDMX FORANEAS,2023-11-15,319,310,9,0.0282131661442006
CDMX FORANEAS,2023-11-16,371,361,10,0.0269541778975741
CDMX FORANEAS,2023-11-17,371,363,8,0.0215633423180593
CDMX FORANEAS,2023-11-18,402,389,13,0.0323383084577114
CDMX FORANEAS,2023-11-19,396,381,15,0.0378787878787879
CDMX FORANEAS,2023-11-20,379,371,8,0.0211081794195251
CDMX FORANEAS,2023-11-21,369,360,9,0.024390243902439
CDMX FORANEAS,2023-11-22,299,291,8,0.0267558528428094
CDMX FORANEAS,2023-11-23,295,287,8,0.0271186440677966
CDMX FORANEAS,2023-11-24,315,302,13,0.0412698412698413
CDMX FORANEAS,2023-11-25,327,320,7,0.0214067278287462
CDMX FORANEAS,2023-11-26,293,278,15,0.0511945392491468
CDMX FORANEAS,2023-11-27,322,311,11,0.0341614906832298
CDMX FORANEAS,2023-11-28,314,307,7,0.0222929936305732
CDMX FORANEAS,2023-11-29,323,318,5,0.0154798761609907
CDMX FORANEAS,2023-11-30,408,381,27,0.0661764705882353
CDMX FORANEAS,2023-12-01,296,280,16,0.0540540540540541
CDMX FORANEAS,2023-12-02,320,305,15,0.046875
CDMX FORANEAS,2023-12-03,326,315,11,0.0337423312883436
CDMX FORANEAS,2023-12-04,341,325,16,0.0469208211143695
CDMX FORANEAS,2023-12-05,321,307,14,0.043613707165109
CDMX FORANEAS,2023-12-06,266,256,10,0.037593984962406
CDMX FORANEAS,2023-12-07,295,289,6,0.0203389830508475
CDMX FORANEAS,2023-12-08,272,268,4,0.0147058823529412
CDMX FORANEAS,2023-12-09,321,308,13,0.0404984423676012
CDMX FORANEAS,2023-12-10,303,292,11,0.0363036303630363
CDMX FORANEAS,2023-12-11,280,277,3,0.0107142857142857
CDMX FORANEAS,2023-12-12,321,315,6,0.0186915887850467
CDMX FORANEAS,2023-12-13,291,279,12,0.0412371134020619
CDMX FORANEAS,2023-12-14,259,251,8,0.0308880308880309
CDMX FORANEAS,2023-12-15,280,270,10,0.0357142857142857
CDMX FORANEAS,2023-12-16,343,327,16,0.0466472303206997
CDMX FORANEAS,2023-12-17,290,277,13,0.0448275862068966
CDMX FORANEAS,2023-12-18,305,295,10,0.0327868852459016
CDMX FORANEAS,2023-12-19,302,290,12,0.0397350993377483
CDMX FORANEAS,2023-12-20,316,302,14,0.0443037974683544
CDMX FORANEAS,2023-12-21,311,303,8,0.0257234726688103
CDMX FORANEAS,2023-12-22,261,253,8,0.0306513409961686
CDMX FORANEAS,2023-12-23,263,256,7,0.026615969581749
CDMX FORANEAS,2023-12-24,204,194,10,0.0490196078431373
CDMX FORANEAS,2023-12-25,96,91,5,0.0520833333333333
CDMX FORANEAS,2023-12-26,229,223,6,0.0262008733624454
CDMX FORANEAS,2023-12-27,304,297,7,0.0230263157894737
CDMX FORANEAS,2023-12-28,303,296,7,0.0231023102310231
CDMX FORANEAS,2023-12-29,306,298,8,0.0261437908496732
CDMX FORANEAS,2023-12-30,286,277,9,0.0314685314685315
CDMX FORANEAS,2023-12-31,166,163,3,0.0180722891566265
CDMX FORANEAS,2024-01-01,45,44,1,0.0222222222222222
CDMX FORANEAS,2024-01-02,226,219,7,0.0309734513274336
CDMX FORANEAS,2024-01-03,320,315,5,0.015625
CDMX FORANEAS,2024-01-04,355,345,10,0.028169014084507
CDMX FORANEAS,2024-01-05,259,255,4,0.0154440154440154
CDMX FORANEAS,2024-01-06,275,266,9,0.0327272727272727
CDMX FORANEAS,2024-01-07,261,255,6,0.0229885057471264
CDMX FORANEAS,2024-01-08,274,264,10,0.0364963503649635
CDMX FORANEAS,2024-01-09,313,303,10,0.0319488817891374
CDMX FORANEAS,2024-01-10,292,282,10,0.0342465753424658
CDMX FORANEAS,2024-01-11,307,296,11,0.0358306188925081
CDMX FORANEAS,2024-01-12,287,278,9,0.0313588850174216
CDMX FORANEAS,2024-01-13,341,337,4,0.0117302052785924
CDMX FORANEAS,2024-01-14,332,326,6,0.0180722891566265
CDMX FORANEAS,2024-01-15,282,277,5,0.0177304964539007
CDMX FORANEAS,2024-01-16,317,311,6,0.0189274447949527
CDMX FORANEAS,2024-01-17,277,266,11,0.0397111913357401
CDMX FORANEAS,2024-01-18,312,304,8,0.0256410256410256
CDMX FORANEAS,2024-01-19,294,285,9,0.0306122448979592
CDMX FORANEAS,2024-01-20,316,306,10,0.0316455696202532
CDMX FORANEAS,2024-01-21,257,251,6,0.0233463035019455
CDMX FORANEAS,2024-01-22,271,262,9,0.033210332103321
CDMX FORANEAS,2024-01-23,300,294,6,0.02
CDMX FORANEAS,2024-01-24,343,331,12,0.0349854227405248
CDMX FORANEAS,2024-01-25,291,278,13,0.0446735395189003
CDMX FORANEAS,2024-01-26,243,232,11,0.0452674897119342
CDMX FORANEAS,2024-01-27,327,318,9,0.0275229357798165
CDMX FORANEAS,2024-01-28,259,252,7,0.027027027027027
CDMX FORANEAS,2024-01-29,259,250,9,0.0347490347490347
CDMX FORANEAS,2024-01-30,274,262,12,0.0437956204379562
CDMX FORANEAS,2024-01-31,297,289,8,0.0269360269360269
CDMX FORANEAS,2024-02-01,312,301,11,0.0352564102564103
CDMX FORANEAS,2024-02-02,258,253,5,0.0193798449612403
CDMX FORANEAS,2024-02-03,324,320,4,0.0123456790123457
CDMX FORANEAS,2024-02-04,304,296,8,0.0263157894736842
CDMX FORANEAS,2024-02-05,300,293,7,0.0233333333333333
CDMX FORANEAS,2024-02-06,304,297,7,0.0230263157894737
CDMX FORANEAS,2024-02-07,264,256,8,0.0303030303030303
CDMX FORANEAS,2024-02-08,257,250,7,0.0272373540856031
CDMX FORANEAS,2024-02-09,268,258,10,0.0373134328358209
CDMX FORANEAS,2024-02-10,317,308,9,0.028391167192429
CDMX FORANEAS,2024-02-11,272,258,14,0.0514705882352941
CDMX FORANEAS,2024-02-12,224,216,8,0.0357142857142857
CDMX FORANEAS,2024-02-13,274,266,8,0.0291970802919708
CDMX FORANEAS,2024-02-14,224,216,8,0.0357142857142857
CDMX FORANEAS,2024-02-15,268,265,3,0.0111940298507463
CDMX FORANEAS,2024-02-16,269,264,5,0.0185873605947955
CDMX FORANEAS,2024-02-17,290,283,7,0.0241379310344828
CDMX FORANEAS,2024-02-18,307,301,6,0.0195439739413681
CDMX FORANEAS,2024-02-19,277,270,7,0.0252707581227437
CDMX FORANEAS,2024-02-20,286,280,6,0.020979020979021
CDMX FORANEAS,2024-02-21,273,266,7,0.0256410256410256
CDMX FORANEAS,2024-02-22,284,279,5,0.0176056338028169
CDMX FORANEAS,2024-02-23,204,193,11,0.053921568627451
CDMX FORANEAS,2024-02-24,336,330,6,0.0178571428571429
CDMX FORANEAS,2024-02-25,257,250,7,0.0272373540856031
CDMX FORANEAS,2024-02-26,327,313,14,0.0428134556574924
CDMX FORANEAS,2024-02-27,299,292,7,0.0234113712374582
CDMX FORANEAS,2024-02-28,283,272,11,0.03886925795053
CDMX FORANEAS,2024-02-29,279,275,4,0.014336917562724
CDMX FORANEAS,2024-03-01,313,311,2,0.00638977635782748
CDMX FORANEAS,2024-03-02,331,318,13,0.0392749244712991
CDMX FORANEAS,2024-03-03,294,288,6,0.0204081632653061
CDMX FORANEAS,2024-03-04,283,278,5,0.0176678445229682
CDMX FORANEAS,2024-03-05,291,284,7,0.0240549828178694
CDMX FORANEAS,2024-03-06,281,271,10,0.0355871886120996
CDMX FORANEAS,2024-03-07,292,283,9,0.0308219178082192
CDMX FORANEAS,2024-03-08,273,266,7,0.0256410256410256
CDMX FORANEAS,2024-03-09,308,303,5,0.0162337662337662
CDMX FORANEAS,2024-03-10,239,229,10,0.0418410041841004
CDMX FORANEAS,2024-03-11,315,307,8,0.0253968253968254
CDMX NORORIENTE,2023-03-12,202,186,16,0.0792079207920792
CDMX NORORIENTE,2023-03-13,180,165,15,0.0833333333333333
CDMX NORORIENTE,2023-03-14,206,193,13,0.0631067961165049
CDMX NORORIENTE,2023-03-15,241,237,4,0.016597510373444
CDMX NORORIENTE,2023-03-16,240,237,3,0.0125
CDMX NORORIENTE,2023-03-17,343,339,4,0.0116618075801749
CDMX NORORIENTE,2023-03-18,399,396,3,0.0075187969924812
CDMX NORORIENTE,2023-03-19,360,353,7,0.0194444444444444
CDMX NORORIENTE,2023-03-20,375,373,2,0.00533333333333333
CDMX NORORIENTE,2023-03-21,296,291,5,0.0168918918918919
CDMX NORORIENTE,2023-03-22,266,264,2,0.0075187969924812
CDMX NORORIENTE,2023-03-23,228,227,1,0.0043859649122807
CDMX NORORIENTE,2023-03-24,276,273,3,0.0108695652173913
CDMX NORORIENTE,2023-03-25,309,309,0,0
CDMX NORORIENTE,2023-03-26,263,263,0,0
CDMX NORORIENTE,2023-03-27,205,204,1,0.0048780487804878
CDMX NORORIENTE,2023-03-28,186,185,1,0.00537634408602151
CDMX NORORIENTE,2023-03-29,207,204,3,0.0144927536231884
CDMX NORORIENTE,2023-03-30,258,257,1,0.00387596899224806
CDMX NORORIENTE,2023-03-31,358,356,2,0.00558659217877095
CDMX NORORIENTE,2023-04-01,319,318,1,0.00313479623824451
CDMX NORORIENTE,2023-04-02,275,273,2,0.00727272727272727
CDMX NORORIENTE,2023-04-03,306,302,4,0.0130718954248366
CDMX NORORIENTE,2023-04-04,205,204,1,0.0048780487804878
CDMX NORORIENTE,2023-04-05,239,237,2,0.00836820083682008
CDMX NORORIENTE,2023-04-06,241,236,5,0.020746887966805
CDMX NORORIENTE,2023-04-07,190,190,0,0
CDMX NORORIENTE,2023-04-08,198,196,2,0.0101010101010101
CDMX NORORIENTE,2023-04-09,170,170,0,0
CDMX NORORIENTE,2023-04-10,194,193,1,0.00515463917525773
CDMX NORORIENTE,2023-04-11,179,174,5,0.0279329608938547
CDMX NORORIENTE,2023-04-12,211,206,5,0.023696682464455
CDMX NORORIENTE,2023-04-13,194,188,6,0.0309278350515464
CDMX NORORIENTE,2023-04-14,260,259,1,0.00384615384615385
CDMX NORORIENTE,2023-04-15,346,346,0,0
CDMX NORORIENTE,2023-04-16,329,328,1,0.00303951367781155
CDMX NORORIENTE,2023-04-17,287,285,2,0.00696864111498258
CDMX NORORIENTE,2023-04-18,226,224,2,0.00884955752212389
CDMX NORORIENTE,2023-04-19,200,200,0,0
CDMX NORORIENTE,2023-04-20,184,183,1,0.00543478260869565
CDMX NORORIENTE,2023-04-21,249,248,1,0.00401606425702811
CDMX NORORIENTE,2023-04-22,279,278,1,0.003584229390681
CDMX NORORIENTE,2023-04-23,240,240,0,0
CDMX NORORIENTE,2023-04-24,266,266,0,0
CDMX NORORIENTE,2023-04-25,292,289,3,0.0102739726027397
CDMX NORORIENTE,2023-04-26,248,248,0,0
CDMX NORORIENTE,2023-04-27,196,194,2,0.0102040816326531
CDMX NORORIENTE,2023-04-28,262,259,3,0.0114503816793893
CDMX NORORIENTE,2023-04-29,330,325,5,0.0151515151515152
CDMX NORORIENTE,2023-04-30,273,269,4,0.0146520146520147
CDMX NORORIENTE,2023-05-01,257,253,4,0.0155642023346304
CDMX NORORIENTE,2023-05-02,231,230,1,0.00432900432900433
CDMX NORORIENTE,2023-05-03,172,171,1,0.00581395348837209
CDMX NORORIENTE,2023-05-04,188,186,2,0.0106382978723404
CDMX NORORIENTE,2023-05-05,231,229,2,0.00865800865800866
CDMX NORORIENTE,2023-05-06,239,233,6,0.0251046025104603
CDMX NORORIENTE,2023-05-07,184,182,2,0.0108695652173913
CDMX NORORIENTE,2023-05-08,206,204,2,0.00970873786407767
CDMX NORORIENTE,2023-05-09,204,196,8,0.0392156862745098
CDMX NORORIENTE,2023-05-10,175,172,3,0.0171428571428571
CDMX NORORIENTE,2023-05-11,198,197,1,0.00505050505050505
CDMX NORORIENTE,2023-05-12,186,185,1,0.00537634408602151
CDMX NORORIENTE,2023-05-13,288,283,5,0.0173611111111111
CDMX NORORIENTE,2023-05-14,356,355,1,0.00280898876404494
CDMX NORORIENTE,2023-05-15,385,377,8,0.0207792207792208
CDMX NORORIENTE,2023-05-16,378,369,9,0.0238095238095238
CDMX NORORIENTE,2023-05-17,280,272,8,0.0285714285714286
CDMX NORORIENTE,2023-05-18,226,223,3,0.0132743362831858
CDMX NORORIENTE,2023-05-19,211,208,3,0.014218009478673
CDMX NORORIENTE,2023-05-20,298,292,6,0.0201342281879195
CDMX NORORIENTE,2023-05-21,284,284,0,0
CDMX NORORIENTE,2023-05-22,258,254,4,0.0155038759689922
CDMX NORORIENTE,2023-05-23,235,227,8,0.0340425531914894
CDMX NORORIENTE,2023-05-24,209,204,5,0.0239234449760766
CDMX NORORIENTE,2023-05-25,240,234,6,0.025
CDMX NORORIENTE,2023-05-26,281,272,9,0.0320284697508897
CDMX NORORIENTE,2023-05-27,304,299,5,0.0164473684210526
CDMX NORORIENTE,2023-05-28,248,245,3,0.0120967741935484
CDMX NORORIENTE,2023-05-29,216,214,2,0.00925925925925926
CDMX NORORIENTE,2023-05-30,303,299,4,0.0132013201320132
CDMX NORORIENTE,2023-05-31,312,306,6,0.0192307692307692
CDMX NORORIENTE,2023-06-01,201,196,5,0.0248756218905473
CDMX NORORIENTE,2023-06-02,196,191,5,0.0255102040816327
CDMX NORORIENTE,2023-06-03,305,299,6,0.019672131147541
CDMX NORORIENTE,2023-06-04,267,265,2,0.00749063670411985
CDMX NORORIENTE,2023-06-05,296,291,5,0.0168918918918919
CDMX NORORIENTE,2023-06-06,217,214,3,0.0138248847926267
CDMX NORORIENTE,2023-06-07,208,203,5,0.0240384615384615
CDMX NORORIENTE,2023-06-08,200,194,6,0.03
CDMX NORORIENTE,2023-06-09,246,239,7,0.0284552845528455
CDMX NORORIENTE,2023-06-10,284,278,6,0.0211267605633803
CDMX NORORIENTE,2023-06-11,255,250,5,0.0196078431372549
CDMX NORORIENTE,2023-06-12,251,244,7,0.0278884462151394
CDMX NORORIENTE,2023-06-13,245,244,1,0.00408163265306122
CDMX NORORIENTE,2023-06-14,252,248,4,0.0158730158730159
CDMX NORORIENTE,2023-06-15,256,248,8,0.03125
CDMX NORORIENTE,2023-06-16,247,242,5,0.0202429149797571
CDMX NORORIENTE,2023-06-17,299,294,5,0.0167224080267559
CDMX NORORIENTE,2023-06-18,209,207,2,0.00956937799043062
CDMX NORORIENTE,2023-06-19,254,252,2,0.0078740157480315
CDMX NORORIENTE,2023-06-20,252,249,3,0.0119047619047619
CDMX NORORIENTE,2023-06-21,220,215,5,0.0227272727272727
CDMX NORORIENTE,2023-06-22,221,217,4,0.0180995475113122
CDMX NORORIENTE,2023-06-23,206,200,6,0.029126213592233
CDMX NORORIENTE,2023-06-24,272,267,5,0.0183823529411765
CDMX NORORIENTE,2023-06-25,227,221,6,0.026431718061674
CDMX NORORIENTE,2023-06-26,250,247,3,0.012
CDMX NORORIENTE,2023-06-27,200,195,5,0.025
CDMX NORORIENTE,2023-06-28,239,239,0,0
CDMX NORORIENTE,2023-06-29,245,241,4,0.0163265306122449
CDMX NORORIENTE,2023-06-30,208,180,28,0.134615384615385
CDMX NORORIENTE,2023-07-01,286,283,3,0.0104895104895105
CDMX NORORIENTE,2023-07-02,235,229,6,0.025531914893617
CDMX NORORIENTE,2023-07-03,243,239,4,0.0164609053497942
CDMX NORORIENTE,2023-07-04,224,219,5,0.0223214285714286
CDMX NORORIENTE,2023-07-05,241,239,2,0.00829875518672199
CDMX NORORIENTE,2023-07-06,176,168,8,0.0454545454545455
CDMX NORORIENTE,2023-07-07,205,204,1,0.0048780487804878
CDMX NORORIENTE,2023-07-08,236,227,9,0.038135593220339
CDMX NORORIENTE,2023-07-09,207,205,2,0.00966183574879227
CDMX NORORIENTE,2023-07-10,196,193,3,0.0153061224489796
CDMX NORORIENTE,2023-07-11,239,236,3,0.0125523012552301
CDMX NORORIENTE,2023-07-12,205,202,3,0.0146341463414634
CDMX NORORIENTE,2023-07-13,202,197,5,0.0247524752475248
CDMX NORORIENTE,2023-07-14,235,226,9,0.0382978723404255
CDMX NORORIENTE,2023-07-15,280,278,2,0.00714285714285714
CDMX NORORIENTE,2023-07-16,238,232,6,0.0252100840336134
CDMX NORORIENTE,2023-07-17,213,204,9,0.0422535211267606
CDMX NORORIENTE,2023-07-18,253,248,5,0.0197628458498024
CDMX NORORIENTE,2023-07-19,180,172,8,0.0444444444444444
CDMX NORORIENTE,2023-07-20,254,251,3,0.0118110236220472
CDMX NORORIENTE,2023-07-21,205,203,2,0.00975609756097561
CDMX NORORIENTE,2023-07-22,261,256,5,0.0191570881226054
CDMX NORORIENTE,2023-07-23,254,248,6,0.0236220472440945
CDMX NORORIENTE,2023-07-24,244,238,6,0.0245901639344262
CDMX NORORIENTE,2023-07-25,242,236,6,0.0247933884297521
CDMX NORORIENTE,2023-07-26,286,281,5,0.0174825174825175
CDMX NORORIENTE,2023-07-27,237,233,4,0.0168776371308017
CDMX NORORIENTE,2023-07-28,237,234,3,0.0126582278481013
CDMX NORORIENTE,2023-07-29,270,267,3,0.0111111111111111
CDMX NORORIENTE,2023-07-30,293,285,8,0.0273037542662116
CDMX NORORIENTE,2023-07-31,313,308,5,0.0159744408945687
CDMX NORORIENTE,2023-08-01,229,222,7,0.0305676855895196
CDMX NORORIENTE,2023-08-02,235,231,4,0.0170212765957447
CDMX NORORIENTE,2023-08-03,234,203,31,0.132478632478632
CDMX NORORIENTE,2023-08-04,277,265,12,0.0433212996389892
CDMX NORORIENTE,2023-08-05,284,279,5,0.0176056338028169
CDMX NORORIENTE,2023-08-06,222,215,7,0.0315315315315315
CDMX NORORIENTE,2023-08-07,250,246,4,0.016
CDMX NORORIENTE,2023-08-08,246,238,8,0.032520325203252
CDMX NORORIENTE,2023-08-09,214,204,10,0.0467289719626168
CDMX NORORIENTE,2023-08-10,212,208,4,0.0188679245283019
CDMX NORORIENTE,2023-08-11,254,247,7,0.0275590551181102
CDMX NORORIENTE,2023-08-12,251,242,9,0.0358565737051793
CDMX NORORIENTE,2023-08-13,276,259,17,0.0615942028985507
CDMX NORORIENTE,2023-08-14,235,229,6,0.025531914893617
CDMX NORORIENTE,2023-08-15,309,301,8,0.0258899676375405
CDMX NORORIENTE,2023-08-16,255,252,3,0.0117647058823529
CDMX NORORIENTE,2023-08-17,235,231,4,0.0170212765957447
CDMX NORORIENTE,2023-08-18,269,263,6,0.0223048327137546
CDMX NORORIENTE,2023-08-19,247,242,5,0.0202429149797571
CDMX NORORIENTE,2023-08-20,249,244,5,0.0200803212851406
CDMX NORORIENTE,2023-08-21,241,241,0,0
CDMX NORORIENTE,2023-08-22,252,252,0,0
CDMX NORORIENTE,2023-08-23,215,215,0,0
CDMX NORORIENTE,2023-08-24,249,247,2,0.00803212851405622
CDMX NORORIENTE,2023-08-25,263,263,0,0
CDMX NORORIENTE,2023-08-26,318,318,0,0
CDMX NORORIENTE,2023-08-27,312,311,1,0.00320512820512821
CDMX NORORIENTE,2023-08-28,314,312,2,0.00636942675159236
CDMX NORORIENTE,2023-08-29,273,273,0,0
CDMX NORORIENTE,2023-08-30,272,271,1,0.00367647058823529
CDMX NORORIENTE,2023-08-31,214,210,4,0.0186915887850467
CDMX NORORIENTE,2023-09-01,229,228,1,0.00436681222707424
CDMX NORORIENTE,2023-09-02,277,275,2,0.0072202166064982
CDMX NORORIENTE,2023-09-03,261,259,2,0.00766283524904215
CDMX NORORIENTE,2023-09-04,216,216,0,0
CDMX NORORIENTE,2023-09-05,220,220,0,0
CDMX NORORIENTE,2023-09-06,206,206,0,0
CDMX NORORIENTE,2023-09-07,231,230,1,0.00432900432900433
CDMX NORORIENTE,2023-09-08,191,191,0,0
CDMX NORORIENTE,2023-09-09,260,260,0,0
CDMX NORORIENTE,2023-09-10,258,257,1,0.00387596899224806
CDMX NORORIENTE,2023-09-11,209,208,1,0.00478468899521531
CDMX NORORIENTE,2023-09-12,197,195,2,0.0101522842639594
CDMX NORORIENTE,2023-09-13,223,223,0,0
CDMX NORORIENTE,2023-09-14,226,226,0,0
CDMX NORORIENTE,2023-09-15,201,197,4,0.0199004975124378
CDMX NORORIENTE,2023-09-16,213,212,1,0.00469483568075117
CDMX NORORIENTE,2023-09-17,200,199,1,0.005
CDMX NORORIENTE,2023-09-18,199,198,1,0.0050251256281407
CDMX NORORIENTE,2023-09-19,196,193,3,0.0153061224489796
CDMX NORORIENTE,2023-09-20,134,133,1,0.00746268656716418
CDMX NORORIENTE,2023-09-21,222,219,3,0.0135135135135135
CDMX NORORIENTE,2023-09-22,288,288,0,0
CDMX NORORIENTE,2023-09-23,266,266,0,0
CDMX NORORIENTE,2023-09-24,307,305,2,0.00651465798045603
CDMX NORORIENTE,2023-09-25,222,220,2,0.00900900900900901
CDMX NORORIENTE,2023-09-26,217,216,1,0.00460829493087558
CDMX NORORIENTE,2023-09-27,229,229,0,0
CDMX NORORIENTE,2023-09-28,241,236,5,0.020746887966805
CDMX NORORIENTE,2023-09-29,276,273,3,0.0108695652173913
CDMX NORORIENTE,2023-09-30,366,364,2,0.00546448087431694
CDMX NORORIENTE,2023-10-01,246,243,3,0.0121951219512195
CDMX NORORIENTE,2023-10-02,211,210,1,0.004739336492891
CDMX NORORIENTE,2023-10-03,205,198,7,0.0341463414634146
CDMX NORORIENTE,2023-10-04,188,182,6,0.0319148936170213
CDMX NORORIENTE,2023-10-05,202,195,7,0.0346534653465347
CDMX NORORIENTE,2023-10-06,239,225,14,0.0585774058577406
CDMX NORORIENTE,2023-10-07,291,280,11,0.0378006872852234
CDMX NORORIENTE,2023-10-08,243,238,5,0.0205761316872428
CDMX NORORIENTE,2023-10-09,221,214,7,0.0316742081447964
CDMX NORORIENTE,2023-10-10,182,178,4,0.021978021978022
CDMX NORORIENTE,2023-10-11,185,179,6,0.0324324324324324
CDMX NORORIENTE,2023-10-12,167,163,4,0.0239520958083832
CDMX NORORIENTE,2023-10-13,205,196,9,0.0439024390243902
CDMX NORORIENTE,2023-10-14,260,254,6,0.0230769230769231
CDMX NORORIENTE,2023-10-15,274,267,7,0.0255474452554745
CDMX NORORIENTE,2023-10-16,252,245,7,0.0277777777777778
CDMX NORORIENTE,2023-10-17,224,218,6,0.0267857142857143
CDMX NORORIENTE,2023-10-18,214,206,8,0.0373831775700935
CDMX NORORIENTE,2023-10-19,195,189,6,0.0307692307692308
CDMX NORORIENTE,2023-10-20,225,219,6,0.0266666666666667
CDMX NORORIENTE,2023-10-21,283,278,5,0.0176678445229682
CDMX NORORIENTE,2023-10-22,249,240,9,0.036144578313253
CDMX NORORIENTE,2023-10-23,255,248,7,0.0274509803921569
CDMX NORORIENTE,2023-10-24,218,214,4,0.018348623853211
CDMX NORORIENTE,2023-10-25,189,182,7,0.037037037037037
CDMX NORORIENTE,2023-10-26,157,154,3,0.0191082802547771
CDMX NORORIENTE,2023-10-27,201,194,7,0.0348258706467662
CDMX NORORIENTE,2023-10-28,237,232,5,0.0210970464135021
CDMX NORORIENTE,2023-10-29,237,231,6,0.0253164556962025
CDMX NORORIENTE,2023-10-30,249,238,11,0.0441767068273092
CDMX NORORIENTE,2023-10-31,304,295,9,0.0296052631578947
CDMX NORORIENTE,2023-11-01,222,212,10,0.045045045045045
CDMX NORORIENTE,2023-11-02,214,206,8,0.0373831775700935
CDMX NORORIENTE,2023-11-03,219,212,7,0.0319634703196347
CDMX NORORIENTE,2023-11-04,303,296,7,0.0231023102310231
CDMX NORORIENTE,2023-11-05,309,301,8,0.0258899676375405
CDMX NORORIENTE,2023-11-06,296,291,5,0.0168918918918919
CDMX NORORIENTE,2023-11-07,309,303,6,0.0194174757281553
CDMX NORORIENTE,2023-11-08,303,295,8,0.0264026402640264
CDMX NORORIENTE,2023-11-09,241,233,8,0.033195020746888
CDMX NORORIENTE,2023-11-10,265,261,4,0.0150943396226415
CDMX NORORIENTE,2023-11-11,324,317,7,0.0216049382716049
CDMX NORORIENTE,2023-11-12,276,266,10,0.036231884057971
CDMX NORORIENTE,2023-11-13,290,277,13,0.0448275862068966
CDMX NORORIENTE,2023-11-14,270,264,6,0.0222222222222222
CDMX NORORIENTE,2023-11-15,307,301,6,0.0195439739413681
CDMX NORORIENTE,2023-11-16,318,310,8,0.0251572327044025
CDMX NORORIENTE,2023-11-17,341,336,5,0.0146627565982405
CDMX NORORIENTE,2023-11-18,406,397,9,0.0221674876847291
CDMX NORORIENTE,2023-11-19,396,387,9,0.0227272727272727
CDMX NORORIENTE,2023-11-20,411,403,8,0.0194647201946472
CDMX NORORIENTE,2023-11-21,325,320,5,0.0153846153846154
CDMX NORORIENTE,2023-11-22,286,277,9,0.0314685314685315
CDMX NORORIENTE,2023-11-23,271,264,7,0.025830258302583
CDMX NORORIENTE,2023-11-24,275,265,10,0.0363636363636364
CDMX NORORIENTE,2023-11-25,346,341,5,0.0144508670520231
CDMX NORORIENTE,2023-11-26,293,288,5,0.0170648464163823
CDMX NORORIENTE,2023-11-27,290,282,8,0.0275862068965517
CDMX NORORIENTE,2023-11-28,305,299,6,0.019672131147541
CDMX NORORIENTE,2023-11-29,303,292,11,0.0363036303630363
CDMX NORORIENTE,2023-11-30,354,347,7,0.019774011299435
CDMX NORORIENTE,2023-12-01,279,265,14,0.0501792114695341
CDMX NORORIENTE,2023-12-02,320,307,13,0.040625
CDMX NORORIENTE,2023-12-03,343,329,14,0.0408163265306122
CDMX NORORIENTE,2023-12-04,263,253,10,0.0380228136882129
CDMX NORORIENTE,2023-12-05,263,255,8,0.0304182509505703
CDMX NORORIENTE,2023-12-06,253,247,6,0.0237154150197628
CDMX NORORIENTE,2023-12-07,256,247,9,0.03515625
CDMX NORORIENTE,2023-12-08,285,280,5,0.0175438596491228
CDMX NORORIENTE,2023-12-09,299,290,9,0.0301003344481605
CDMX NORORIENTE,2023-12-10,301,289,12,0.0398671096345515
CDMX NORORIENTE,2023-12-11,262,253,9,0.0343511450381679
CDMX NORORIENTE,2023-12-12,257,254,3,0.0116731517509728
CDMX NORORIENTE,2023-12-13,246,235,11,0.0447154471544715
CDMX NORORIENTE,2023-12-14,250,240,10,0.04
CDMX NORORIENTE,2023-12-15,246,241,5,0.0203252032520325
CDMX NORORIENTE,2023-12-16,298,292,6,0.0201342281879195
CDMX NORORIENTE,2023-12-17,294,283,11,0.0374149659863946
CDMX NORORIENTE,2023-12-18,283,274,9,0.0318021201413428
CDMX NORORIENTE,2023-12-19,282,268,14,0.049645390070922
CDMX NORORIENTE,2023-12-20,313,304,9,0.0287539936102236
CDMX NORORIENTE,2023-12-21,305,295,10,0.0327868852459016
CDMX NORORIENTE,2023-12-22,263,253,10,0.0380228136882129
CDMX NORORIENTE,2023-12-23,304,296,8,0.0263157894736842
CDMX NORORIENTE,2023-12-24,210,202,8,0.0380952380952381
CDMX NORORIENTE,2023-12-25,71,69,2,0.028169014084507
CDMX NORORIENTE,2023-12-26,245,239,6,0.0244897959183673
CDMX NORORIENTE,2023-12-27,308,300,8,0.025974025974026
CDMX NORORIENTE,2023-12-28,286,279,7,0.0244755244755245
CDMX NORORIENTE,2023-12-29,264,253,11,0.0416666666666667
CDMX NORORIENTE,2023-12-30,306,302,4,0.0130718954248366
CDMX NORORIENTE,2023-12-31,184,181,3,0.016304347826087
CDMX NORORIENTE,2024-01-01,62,60,2,0.032258064516129
CDMX NORORIENTE,2024-01-02,223,214,9,0.0403587443946188
CDMX NORORIENTE,2024-01-03,280,274,6,0.0214285714285714
CDMX NORORIENTE,2024-01-04,261,255,6,0.0229885057471264
CDMX NORORIENTE,2024-01-05,286,283,3,0.0104895104895105
CDMX NORORIENTE,2024-01-06,253,247,6,0.0237154150197628
CDMX NORORIENTE,2024-01-07,275,271,4,0.0145454545454545
CDMX NORORIENTE,2024-01-08,288,276,12,0.0416666666666667
CDMX NORORIENTE,2024-01-09,288,285,3,0.0104166666666667
CDMX NORORIENTE,2024-01-10,273,262,11,0.0402930402930403
CDMX NORORIENTE,2024-01-11,305,299,6,0.019672131147541
CDMX NORORIENTE,2024-01-12,309,305,4,0.0129449838187702
CDMX NORORIENTE,2024-01-13,324,315,9,0.0277777777777778
CDMX NORORIENTE,2024-01-14,344,338,6,0.0174418604651163
CDMX NORORIENTE,2024-01-15,313,300,13,0.0415335463258786
CDMX NORORIENTE,2024-01-16,304,295,9,0.0296052631578947
CDMX NORORIENTE,2024-01-17,277,270,7,0.0252707581227437
CDMX NORORIENTE,2024-01-18,281,278,3,0.0106761565836299
CDMX NORORIENTE,2024-01-19,260,252,8,0.0307692307692308
CDMX NORORIENTE,2024-01-20,315,305,10,0.0317460317460317
CDMX NORORIENTE,2024-01-21,278,275,3,0.0107913669064748
CDMX NORORIENTE,2024-01-22,253,248,5,0.0197628458498024
CDMX NORORIENTE,2024-01-23,290,277,13,0.0448275862068966
CDMX NORORIENTE,2024-01-24,265,255,10,0.0377358490566038
CDMX NORORIENTE,2024-01-25,235,229,6,0.025531914893617
CDMX NORORIENTE,2024-01-26,257,252,5,0.0194552529182879
CDMX NORORIENTE,2024-01-27,303,295,8,0.0264026402640264
CDMX NORORIENTE,2024-01-28,290,282,8,0.0275862068965517
CDMX NORORIENTE,2024-01-29,273,268,5,0.0183150183150183
CDMX NORORIENTE,2024-01-30,261,248,13,0.0498084291187739
CDMX NORORIENTE,2024-01-31,325,317,8,0.0246153846153846
CDMX NORORIENTE,2024-02-01,253,240,13,0.0513833992094862
CDMX NORORIENTE,2024-02-02,254,247,7,0.0275590551181102
CDMX NORORIENTE,2024-02-03,273,264,9,0.032967032967033
CDMX NORORIENTE,2024-02-04,257,251,6,0.0233463035019455
CDMX NORORIENTE,2024-02-05,278,275,3,0.0107913669064748
CDMX NORORIENTE,2024-02-06,274,268,6,0.0218978102189781
CDMX NORORIENTE,2024-02-07,292,283,9,0.0308219178082192
CDMX NORORIENTE,2024-02-08,244,237,7,0.0286885245901639
CDMX NORORIENTE,2024-02-09,255,246,9,0.0352941176470588
CDMX NORORIENTE,2024-02-10,296,289,7,0.0236486486486486
CDMX NORORIENTE,2024-02-11,224,219,5,0.0223214285714286
CDMX NORORIENTE,2024-02-12,208,203,5,0.0240384615384615
CDMX NORORIENTE,2024-02-13,237,233,4,0.0168776371308017
CDMX NORORIENTE,2024-02-14,209,204,5,0.0239234449760766
CDMX NORORIENTE,2024-02-15,254,243,11,0.0433070866141732
CDMX NORORIENTE,2024-02-16,298,289,9,0.0302013422818792
CDMX NORORIENTE,2024-02-17,323,316,7,0.021671826625387
CDMX NORORIENTE,2024-02-18,334,327,7,0.0209580838323353
CDMX NORORIENTE,2024-02-19,302,292,10,0.033112582781457
CDMX NORORIENTE,2024-02-20,288,282,6,0.0208333333333333
CDMX NORORIENTE,2024-02-21,251,244,7,0.0278884462151394
CDMX NORORIENTE,2024-02-22,275,266,9,0.0327272727272727
CDMX NORORIENTE,2024-02-23,188,168,20,0.106382978723404
CDMX NORORIENTE,2024-02-24,359,351,8,0.0222841225626741
CDMX NORORIENTE,2024-02-25,324,321,3,0.00925925925925926
CDMX NORORIENTE,2024-02-26,295,289,6,0.0203389830508475
CDMX NORORIENTE,2024-02-27,290,284,6,0.0206896551724138
CDMX NORORIENTE,2024-02-28,293,283,10,0.0341296928327645
CDMX NORORIENTE,2024-02-29,324,313,11,0.0339506172839506
CDMX NORORIENTE,2024-03-01,274,267,7,0.0255474452554745
CDMX NORORIENTE,2024-03-02,336,332,4,0.0119047619047619
CDMX NORORIENTE,2024-03-03,285,280,5,0.0175438596491228
CDMX NORORIENTE,2024-03-04,291,284,7,0.0240549828178694
CDMX NORORIENTE,2024-03-05,240,231,9,0.0375
CDMX NORORIENTE,2024-03-06,266,257,9,0.0338345864661654
CDMX NORORIENTE,2024-03-07,299,296,3,0.0100334448160535
CDMX NORORIENTE,2024-03-08,295,290,5,0.0169491525423729
CDMX NORORIENTE,2024-03-09,349,343,6,0.0171919770773639
CDMX NORORIENTE,2024-03-10,328,325,3,0.00914634146341463
CDMX NORORIENTE,2024-03-11,306,299,7,0.0228758169934641
CDMX NORPONIENTE,2023-03-12,317,234,83,0.261829652996845
CDMX NORPONIENTE,2023-03-13,289,228,61,0.211072664359862
CDMX NORPONIENTE,2023-03-14,344,274,70,0.203488372093023
CDMX NORPONIENTE,2023-03-15,372,315,57,0.153225806451613
CDMX NORPONIENTE,2023-03-16,380,327,53,0.139473684210526
CDMX NORPONIENTE,2023-03-17,477,399,78,0.163522012578616
CDMX NORPONIENTE,2023-03-18,530,447,83,0.156603773584906
CDMX NORPONIENTE,2023-03-19,441,383,58,0.131519274376417
CDMX NORPONIENTE,2023-03-20,501,436,65,0.129740518962076
CDMX NORPONIENTE,2023-03-21,403,379,24,0.0595533498759305
CDMX NORPONIENTE,2023-03-22,344,320,24,0.0697674418604651
CDMX NORPONIENTE,2023-03-23,360,333,27,0.075
CDMX NORPONIENTE,2023-03-24,375,354,21,0.056
CDMX NORPONIENTE,2023-03-25,432,411,21,0.0486111111111111
CDMX NORPONIENTE,2023-03-26,357,334,23,0.0644257703081232
CDMX NORPONIENTE,2023-03-27,281,269,12,0.0427046263345196
CDMX NORPONIENTE,2023-03-28,274,258,16,0.0583941605839416
CDMX NORPONIENTE,2023-03-29,308,293,15,0.0487012987012987
CDMX NORPONIENTE,2023-03-30,352,328,24,0.0681818181818182
CDMX NORPONIENTE,2023-03-31,557,526,31,0.0556552962298025
CDMX NORPONIENTE,2023-04-01,414,400,14,0.0338164251207729
CDMX NORPONIENTE,2023-04-02,295,274,21,0.0711864406779661
CDMX NORPONIENTE,2023-04-03,407,396,11,0.027027027027027
CDMX NORPONIENTE,2023-04-04,375,351,24,0.064
CDMX NORPONIENTE,2023-04-05,327,297,30,0.0917431192660551
CDMX NORPONIENTE,2023-04-06,358,346,12,0.0335195530726257
CDMX NORPONIENTE,2023-04-07,243,233,10,0.0411522633744856
CDMX NORPONIENTE,2023-04-08,183,177,6,0.0327868852459016
CDMX NORPONIENTE,2023-04-09,171,165,6,0.0350877192982456
CDMX NORPONIENTE,2023-04-10,268,258,10,0.0373134328358209
CDMX NORPONIENTE,2023-04-11,298,286,12,0.0402684563758389
CDMX NORPONIENTE,2023-04-12,328,312,16,0.0487804878048781
CDMX NORPONIENTE,2023-04-13,303,294,9,0.0297029702970297
CDMX NORPONIENTE,2023-04-14,364,337,27,0.0741758241758242
CDMX NORPONIENTE,2023-04-15,528,494,34,0.0643939393939394
CDMX NORPONIENTE,2023-04-16,441,424,17,0.0385487528344671
CDMX NORPONIENTE,2023-04-17,401,382,19,0.0473815461346633
CDMX NORPONIENTE,2023-04-18,374,347,27,0.072192513368984
CDMX NORPONIENTE,2023-04-19,317,294,23,0.0725552050473186
CDMX NORPONIENTE,2023-04-20,320,300,20,0.0625
CDMX NORPONIENTE,2023-04-21,330,317,13,0.0393939393939394
CDMX NORPONIENTE,2023-04-22,439,416,23,0.0523917995444191
CDMX NORPONIENTE,2023-04-23,370,356,14,0.0378378378378378
CDMX NORPONIENTE,2023-04-24,383,367,16,0.0417754569190601
CDMX NORPONIENTE,2023-04-25,432,403,29,0.0671296296296296
CDMX NORPONIENTE,2023-04-26,363,346,17,0.046831955922865
CDMX NORPONIENTE,2023-04-27,314,300,14,0.0445859872611465
CDMX NORPONIENTE,2023-04-28,377,355,22,0.0583554376657825
CDMX NORPONIENTE,2023-04-29,525,484,41,0.0780952380952381
CDMX NORPONIENTE,2023-04-30,415,396,19,0.0457831325301205
CDMX NORPONIENTE,2023-05-01,299,277,22,0.0735785953177258
CDMX NORPONIENTE,2023-05-02,381,353,28,0.073490813648294
CDMX NORPONIENTE,2023-05-03,352,333,19,0.0539772727272727
CDMX NORPONIENTE,2023-05-04,335,314,21,0.0626865671641791
CDMX NORPONIENTE,2023-05-05,309,294,15,0.0485436893203883
CDMX NORPONIENTE,2023-05-06,385,354,31,0.0805194805194805
CDMX NORPONIENTE,2023-05-07,284,269,15,0.0528169014084507
CDMX NORPONIENTE,2023-05-08,341,317,24,0.0703812316715543
CDMX NORPONIENTE,2023-05-09,315,297,18,0.0571428571428571
CDMX NORPONIENTE,2023-05-10,319,292,27,0.0846394984326019
CDMX NORPONIENTE,2023-05-11,290,272,18,0.0620689655172414
CDMX NORPONIENTE,2023-05-12,331,311,20,0.0604229607250755
CDMX NORPONIENTE,2023-05-13,499,474,25,0.0501002004008016
CDMX NORPONIENTE,2023-05-14,461,434,27,0.0585683297180043
CDMX NORPONIENTE,2023-05-15,576,529,47,0.0815972222222222
CDMX NORPONIENTE,2023-05-16,552,510,42,0.0760869565217391
CDMX NORPONIENTE,2023-05-17,485,449,36,0.0742268041237113
CDMX NORPONIENTE,2023-05-18,365,344,21,0.0575342465753425
CDMX NORPONIENTE,2023-05-19,313,286,27,0.0862619808306709
CDMX NORPONIENTE,2023-05-20,451,421,30,0.0665188470066519
CDMX NORPONIENTE,2023-05-21,385,364,21,0.0545454545454545
CDMX NORPONIENTE,2023-05-22,394,374,20,0.050761421319797
CDMX NORPONIENTE,2023-05-23,347,330,17,0.0489913544668588
CDMX NORPONIENTE,2023-05-24,352,328,24,0.0681818181818182
CDMX NORPONIENTE,2023-05-25,377,349,28,0.0742705570291777
CDMX NORPONIENTE,2023-05-26,404,377,27,0.0668316831683168
CDMX NORPONIENTE,2023-05-27,448,414,34,0.0758928571428571
CDMX NORPONIENTE,2023-05-28,346,321,25,0.0722543352601156
CDMX NORPONIENTE,2023-05-29,386,356,30,0.077720207253886
CDMX NORPONIENTE,2023-05-30,445,408,37,0.0831460674157303
CDMX NORPONIENTE,2023-05-31,496,470,26,0.0524193548387097
CDMX NORPONIENTE,2023-06-01,398,360,38,0.0954773869346734
CDMX NORPONIENTE,2023-06-02,320,290,30,0.09375
CDMX NORPONIENTE,2023-06-03,402,371,31,0.0771144278606965
CDMX NORPONIENTE,2023-06-04,333,306,27,0.0810810810810811
CDMX NORPONIENTE,2023-06-05,378,344,34,0.0899470899470899
CDMX NORPONIENTE,2023-06-06,328,307,21,0.0640243902439024
CDMX NORPONIENTE,2023-06-07,346,328,18,0.0520231213872832
CDMX NORPONIENTE,2023-06-08,349,331,18,0.0515759312320917
CDMX NORPONIENTE,2023-06-09,339,310,29,0.0855457227138643
CDMX NORPONIENTE,2023-06-10,373,354,19,0.0509383378016086
CDMX NORPONIENTE,2023-06-11,332,310,22,0.0662650602409639
CDMX NORPONIENTE,2023-06-12,306,285,21,0.0686274509803922
CDMX NORPONIENTE,2023-06-13,313,291,22,0.0702875399361022
CDMX NORPONIENTE,2023-06-14,413,386,27,0.0653753026634383
CDMX NORPONIENTE,2023-06-15,383,354,29,0.0757180156657963
CDMX NORPONIENTE,2023-06-16,411,387,24,0.0583941605839416
CDMX NORPONIENTE,2023-06-17,451,421,30,0.0665188470066519
CDMX NORPONIENTE,2023-06-18,308,293,15,0.0487012987012987
CDMX NORPONIENTE,2023-06-19,345,322,23,0.0666666666666667
CDMX NORPONIENTE,2023-06-20,363,345,18,0.0495867768595041
CDMX NORPONIENTE,2023-06-21,390,368,22,0.0564102564102564
CDMX NORPONIENTE,2023-06-22,321,300,21,0.0654205607476635
CDMX NORPONIENTE,2023-06-23,374,347,27,0.072192513368984
CDMX NORPONIENTE,2023-06-24,445,412,33,0.0741573033707865
CDMX NORPONIENTE,2023-06-25,320,299,21,0.065625
CDMX NORPONIENTE,2023-06-26,363,342,21,0.0578512396694215
CDMX NORPONIENTE,2023-06-27,333,324,9,0.027027027027027
CDMX NORPONIENTE,2023-06-28,373,360,13,0.0348525469168901
CDMX NORPONIENTE,2023-06-29,397,367,30,0.0755667506297229
CDMX NORPONIENTE,2023-06-30,236,198,38,0.161016949152542
CDMX NORPONIENTE,2023-07-01,415,395,20,0.0481927710843374
CDMX NORPONIENTE,2023-07-02,272,263,9,0.0330882352941176
CDMX NORPONIENTE,2023-07-03,393,382,11,0.0279898218829517
CDMX NORPONIENTE,2023-07-04,320,309,11,0.034375
CDMX NORPONIENTE,2023-07-05,249,242,7,0.0281124497991968
CDMX NORPONIENTE,2023-07-06,213,200,13,0.0610328638497653
CDMX NORPONIENTE,2023-07-07,354,345,9,0.0254237288135593
CDMX NORPONIENTE,2023-07-08,430,421,9,0.0209302325581395
CDMX NORPONIENTE,2023-07-09,305,291,14,0.0459016393442623
CDMX NORPONIENTE,2023-07-10,333,318,15,0.045045045045045
CDMX NORPONIENTE,2023-07-11,342,327,15,0.043859649122807
CDMX NORPONIENTE,2023-07-12,300,288,12,0.04
CDMX NORPONIENTE,2023-07-13,302,288,14,0.0463576158940397
CDMX NORPONIENTE,2023-07-14,327,312,15,0.0458715596330275
CDMX NORPONIENTE,2023-07-15,414,401,13,0.0314009661835749
CDMX NORPONIENTE,2023-07-16,311,298,13,0.0418006430868167
CDMX NORPONIENTE,2023-07-17,324,316,8,0.0246913580246914
CDMX NORPONIENTE,2023-07-18,350,340,10,0.0285714285714286
CDMX NORPONIENTE,2023-07-19,341,328,13,0.0381231671554252
CDMX NORPONIENTE,2023-07-20,403,388,15,0.0372208436724566
CDMX NORPONIENTE,2023-07-21,374,363,11,0.0294117647058824
CDMX NORPONIENTE,2023-07-22,417,403,14,0.0335731414868106
CDMX NORPONIENTE,2023-07-23,265,256,9,0.0339622641509434
CDMX NORPONIENTE,2023-07-24,321,311,10,0.0311526479750779
CDMX NORPONIENTE,2023-07-25,361,348,13,0.03601108033241
CDMX NORPONIENTE,2023-07-26,387,374,13,0.0335917312661499
CDMX NORPONIENTE,2023-07-27,361,349,12,0.0332409972299169
CDMX NORPONIENTE,2023-07-28,410,396,14,0.0341463414634146
CDMX NORPONIENTE,2023-07-29,456,446,10,0.0219298245614035
CDMX NORPONIENTE,2023-07-30,387,380,7,0.0180878552971576
CDMX NORPONIENTE,2023-07-31,426,417,9,0.0211267605633803
CDMX NORPONIENTE,2023-08-01,391,377,14,0.0358056265984655
CDMX NORPONIENTE,2023-08-02,371,355,16,0.0431266846361186
CDMX NORPONIENTE,2023-08-03,387,315,72,0.186046511627907
CDMX NORPONIENTE,2023-08-04,365,353,12,0.0328767123287671
CDMX NORPONIENTE,2023-08-05,474,456,18,0.0379746835443038
CDMX NORPONIENTE,2023-08-06,371,361,10,0.0269541778975741
CDMX NORPONIENTE,2023-08-07,374,364,10,0.0267379679144385
CDMX NORPONIENTE,2023-08-08,374,363,11,0.0294117647058824
CDMX NORPONIENTE,2023-08-09,348,334,14,0.0402298850574713
CDMX NORPONIENTE,2023-08-10,348,336,12,0.0344827586206897
CDMX NORPONIENTE,2023-08-11,380,361,19,0.05
CDMX NORPONIENTE,2023-08-12,448,437,11,0.0245535714285714
CDMX NORPONIENTE,2023-08-13,371,359,12,0.032345013477089
CDMX NORPONIENTE,2023-08-14,318,302,16,0.050314465408805
CDMX NORPONIENTE,2023-08-15,430,418,12,0.027906976744186
CDMX NORPONIENTE,2023-08-16,347,335,12,0.0345821325648415
CDMX NORPONIENTE,2023-08-17,335,320,15,0.0447761194029851
CDMX NORPONIENTE,2023-08-18,386,375,11,0.0284974093264249
CDMX NORPONIENTE,2023-08-19,476,464,12,0.0252100840336134
CDMX NORPONIENTE,2023-08-20,314,303,11,0.035031847133758
CDMX NORPONIENTE,2023-08-21,361,358,3,0.00831024930747922
CDMX NORPONIENTE,2023-08-22,338,338,0,0
CDMX NORPONIENTE,2023-08-23,343,338,5,0.0145772594752187
CDMX NORPONIENTE,2023-08-24,345,339,6,0.0173913043478261
CDMX NORPONIENTE,2023-08-25,413,409,4,0.00968523002421308
CDMX NORPONIENTE,2023-08-26,467,465,2,0.00428265524625268
CDMX NORPONIENTE,2023-08-27,380,379,1,0.00263157894736842
CDMX NORPONIENTE,2023-08-28,411,408,3,0.0072992700729927
CDMX NORPONIENTE,2023-08-29,368,361,7,0.0190217391304348
CDMX NORPONIENTE,2023-08-30,403,401,2,0.00496277915632754
CDMX NORPONIENTE,2023-08-31,331,326,5,0.0151057401812689
CDMX NORPONIENTE,2023-09-01,355,353,2,0.00563380281690141
CDMX NORPONIENTE,2023-09-02,412,409,3,0.00728155339805825
CDMX NORPONIENTE,2023-09-03,319,319,0,0
CDMX NORPONIENTE,2023-09-04,331,329,2,0.00604229607250755
CDMX NORPONIENTE,2023-09-05,366,366,0,0
CDMX NORPONIENTE,2023-09-06,329,325,4,0.0121580547112462
CDMX NORPONIENTE,2023-09-07,319,319,0,0
CDMX NORPONIENTE,2023-09-08,300,296,4,0.0133333333333333
CDMX NORPONIENTE,2023-09-09,404,404,0,0
CDMX NORPONIENTE,2023-09-10,331,331,0,0
CDMX NORPONIENTE,2023-09-11,315,312,3,0.00952380952380952
CDMX NORPONIENTE,2023-09-12,318,314,4,0.0125786163522013
CDMX NORPONIENTE,2023-09-13,243,236,7,0.0288065843621399
CDMX NORPONIENTE,2023-09-14,279,276,3,0.010752688172043
CDMX NORPONIENTE,2023-09-15,406,401,5,0.0123152709359606
CDMX NORPONIENTE,2023-09-16,263,262,1,0.00380228136882129
CDMX NORPONIENTE,2023-09-17,339,335,4,0.0117994100294985
CDMX NORPONIENTE,2023-09-18,365,364,1,0.00273972602739726
CDMX NORPONIENTE,2023-09-19,321,317,4,0.0124610591900312
CDMX NORPONIENTE,2023-09-20,319,316,3,0.00940438871473354
CDMX NORPONIENTE,2023-09-21,367,361,6,0.0163487738419619
CDMX NORPONIENTE,2023-09-22,370,365,5,0.0135135135135135
CDMX NORPONIENTE,2023-09-23,460,454,6,0.0130434782608696
CDMX NORPONIENTE,2023-09-24,340,337,3,0.00882352941176471
CDMX NORPONIENTE,2023-09-25,344,336,8,0.0232558139534884
CDMX NORPONIENTE,2023-09-26,351,347,4,0.0113960113960114
CDMX NORPONIENTE,2023-09-27,312,310,2,0.00641025641025641
CDMX NORPONIENTE,2023-09-28,387,381,6,0.0155038759689922
CDMX NORPONIENTE,2023-09-29,391,384,7,0.0179028132992327
CDMX NORPONIENTE,2023-09-30,517,505,12,0.02321083172147
CDMX NORPONIENTE,2023-10-01,300,295,5,0.0166666666666667
CDMX NORPONIENTE,2023-10-02,313,309,4,0.012779552715655
CDMX NORPONIENTE,2023-10-03,317,312,5,0.0157728706624606
CDMX NORPONIENTE,2023-10-04,302,290,12,0.0397350993377483
CDMX NORPONIENTE,2023-10-05,295,283,12,0.0406779661016949
CDMX NORPONIENTE,2023-10-06,334,323,11,0.0329341317365269
CDMX NORPONIENTE,2023-10-07,377,369,8,0.0212201591511936
CDMX NORPONIENTE,2023-10-08,313,299,14,0.0447284345047923
CDMX NORPONIENTE,2023-10-09,299,290,9,0.0301003344481605
CDMX NORPONIENTE,2023-10-10,276,271,5,0.0181159420289855
CDMX NORPONIENTE,2023-10-11,281,268,13,0.0462633451957295
CDMX NORPONIENTE,2023-10-12,260,250,10,0.0384615384615385
CDMX NORPONIENTE,2023-10-13,244,234,10,0.040983606557377
CDMX NORPONIENTE,2023-10-14,445,428,17,0.0382022471910112
CDMX NORPONIENTE,2023-10-15,345,334,11,0.0318840579710145
CDMX NORPONIENTE,2023-10-16,351,341,10,0.0284900284900285
CDMX NORPONIENTE,2023-10-17,347,340,7,0.0201729106628242
CDMX NORPONIENTE,2023-10-18,334,323,11,0.0329341317365269
CDMX NORPONIENTE,2023-10-19,296,288,8,0.027027027027027
CDMX NORPONIENTE,2023-10-20,296,292,4,0.0135135135135135
CDMX NORPONIENTE,2023-10-21,396,384,12,0.0303030303030303
CDMX NORPONIENTE,2023-10-22,290,281,9,0.0310344827586207
CDMX NORPONIENTE,2023-10-23,306,296,10,0.0326797385620915
CDMX NORPONIENTE,2023-10-24,304,299,5,0.0164473684210526
CDMX NORPONIENTE,2023-10-25,300,293,7,0.0233333333333333
CDMX NORPONIENTE,2023-10-26,327,318,9,0.0275229357798165
CDMX NORPONIENTE,2023-10-27,331,324,7,0.0211480362537764
CDMX NORPONIENTE,2023-10-28,390,377,13,0.0333333333333333
CDMX NORPONIENTE,2023-10-29,315,307,8,0.0253968253968254
CDMX NORPONIENTE,2023-10-30,311,299,12,0.0385852090032154
CDMX NORPONIENTE,2023-10-31,362,351,11,0.0303867403314917
CDMX NORPONIENTE,2023-11-01,358,346,12,0.0335195530726257
CDMX NORPONIENTE,2023-11-02,317,308,9,0.028391167192429
CDMX NORPONIENTE,2023-11-03,327,318,9,0.0275229357798165
CDMX NORPONIENTE,2023-11-04,369,361,8,0.021680216802168
CDMX NORPONIENTE,2023-11-05,343,333,10,0.0291545189504373
CDMX NORPONIENTE,2023-11-06,343,334,9,0.0262390670553936
CDMX NORPONIENTE,2023-11-07,365,350,15,0.0410958904109589
CDMX NORPONIENTE,2023-11-08,357,349,8,0.0224089635854342
CDMX NORPONIENTE,2023-11-09,356,349,7,0.0196629213483146
CDMX NORPONIENTE,2023-11-10,339,325,14,0.0412979351032448
CDMX NORPONIENTE,2023-11-11,395,385,10,0.0253164556962025
CDMX NORPONIENTE,2023-11-12,346,336,10,0.0289017341040462
CDMX NORPONIENTE,2023-11-13,348,337,11,0.0316091954022989
CDMX NORPONIENTE,2023-11-14,354,340,14,0.0395480225988701
CDMX NORPONIENTE,2023-11-15,365,359,6,0.0164383561643836
CDMX NORPONIENTE,2023-11-16,372,361,11,0.0295698924731183
CDMX NORPONIENTE,2023-11-17,430,413,17,0.0395348837209302
CDMX NORPONIENTE,2023-11-18,502,486,16,0.0318725099601594
CDMX NORPONIENTE,2023-11-19,361,353,8,0.0221606648199446
CDMX NORPONIENTE,2023-11-20,425,415,10,0.0235294117647059
CDMX NORPONIENTE,2023-11-21,386,376,10,0.0259067357512953
CDMX NORPONIENTE,2023-11-22,398,381,17,0.042713567839196
CDMX NORPONIENTE,2023-11-23,376,367,9,0.023936170212766
CDMX NORPONIENTE,2023-11-24,356,351,5,0.0140449438202247
CDMX NORPONIENTE,2023-11-25,452,438,14,0.0309734513274336
CDMX NORPONIENTE,2023-11-26,381,369,12,0.031496062992126
CDMX NORPONIENTE,2023-11-27,377,367,10,0.026525198938992
CDMX NORPONIENTE,2023-11-28,414,402,12,0.0289855072463768
CDMX NORPONIENTE,2023-11-29,349,321,28,0.0802292263610315
CDMX NORPONIENTE,2023-11-30,472,452,20,0.0423728813559322
CDMX NORPONIENTE,2023-12-01,386,370,16,0.0414507772020725
CDMX NORPONIENTE,2023-12-02,437,418,19,0.0434782608695652
CDMX NORPONIENTE,2023-12-03,366,346,20,0.0546448087431694
CDMX NORPONIENTE,2023-12-04,319,312,7,0.0219435736677116
CDMX NORPONIENTE,2023-12-05,339,315,24,0.0707964601769911
CDMX NORPONIENTE,2023-12-06,343,336,7,0.0204081632653061
CDMX NORPONIENTE,2023-12-07,299,289,10,0.0334448160535117
CDMX NORPONIENTE,2023-12-08,371,356,15,0.0404312668463612
CDMX NORPONIENTE,2023-12-09,430,413,17,0.0395348837209302
CDMX NORPONIENTE,2023-12-10,321,315,6,0.0186915887850467
CDMX NORPONIENTE,2023-12-11,331,320,11,0.0332326283987915
CDMX NORPONIENTE,2023-12-12,401,383,18,0.0448877805486284
CDMX NORPONIENTE,2023-12-13,304,295,9,0.0296052631578947
CDMX NORPONIENTE,2023-12-14,322,305,17,0.0527950310559006
CDMX NORPONIENTE,2023-12-15,342,330,12,0.0350877192982456
CDMX NORPONIENTE,2023-12-16,389,379,10,0.025706940874036
CDMX NORPONIENTE,2023-12-17,327,320,7,0.0214067278287462
CDMX NORPONIENTE,2023-12-18,361,351,10,0.0277008310249307
CDMX NORPONIENTE,2023-12-19,416,408,8,0.0192307692307692
CDMX NORPONIENTE,2023-12-20,418,404,14,0.0334928229665072
CDMX NORPONIENTE,2023-12-21,398,387,11,0.0276381909547739
CDMX NORPONIENTE,2023-12-22,390,379,11,0.0282051282051282
CDMX NORPONIENTE,2023-12-23,438,422,16,0.0365296803652968
CDMX NORPONIENTE,2023-12-24,226,221,5,0.0221238938053097
CDMX NORPONIENTE,2023-12-25,106,99,7,0.0660377358490566
CDMX NORPONIENTE,2023-12-26,308,303,5,0.0162337662337662
CDMX NORPONIENTE,2023-12-27,437,425,12,0.0274599542334096
CDMX NORPONIENTE,2023-12-28,476,465,11,0.023109243697479
CDMX NORPONIENTE,2023-12-29,419,412,7,0.0167064439140811
CDMX NORPONIENTE,2023-12-30,383,374,9,0.0234986945169713
CDMX NORPONIENTE,2023-12-31,197,195,2,0.0101522842639594
CDMX NORPONIENTE,2024-01-01,65,64,1,0.0153846153846154
CDMX NORPONIENTE,2024-01-02,322,316,6,0.0186335403726708
CDMX NORPONIENTE,2024-01-03,445,434,11,0.0247191011235955
CDMX NORPONIENTE,2024-01-04,411,395,16,0.0389294403892944
CDMX NORPONIENTE,2024-01-05,371,358,13,0.0350404312668464
CDMX NORPONIENTE,2024-01-06,390,384,6,0.0153846153846154
CDMX NORPONIENTE,2024-01-07,312,308,4,0.0128205128205128
CDMX NORPONIENTE,2024-01-08,365,357,8,0.0219178082191781
CDMX NORPONIENTE,2024-01-09,345,336,9,0.0260869565217391
CDMX NORPONIENTE,2024-01-10,410,400,10,0.024390243902439
CDMX NORPONIENTE,2024-01-11,369,361,8,0.021680216802168
CDMX NORPONIENTE,2024-01-12,350,338,12,0.0342857142857143
CDMX NORPONIENTE,2024-01-13,469,458,11,0.023454157782516
CDMX NORPONIENTE,2024-01-14,369,364,5,0.013550135501355
CDMX NORPONIENTE,2024-01-15,427,417,10,0.0234192037470726
CDMX NORPONIENTE,2024-01-16,453,436,17,0.0375275938189845
CDMX NORPONIENTE,2024-01-17,390,379,11,0.0282051282051282
CDMX NORPONIENTE,2024-01-18,429,421,8,0.0186480186480186
CDMX NORPONIENTE,2024-01-19,367,359,8,0.0217983651226158
CDMX NORPONIENTE,2024-01-20,439,423,16,0.0364464692482916
CDMX NORPONIENTE,2024-01-21,388,379,9,0.0231958762886598
CDMX NORPONIENTE,2024-01-22,374,364,10,0.0267379679144385
CDMX NORPONIENTE,2024-01-23,367,362,5,0.0136239782016349
CDMX NORPONIENTE,2024-01-24,347,338,9,0.0259365994236311
CDMX NORPONIENTE,2024-01-25,367,357,10,0.0272479564032698
CDMX NORPONIENTE,2024-01-26,377,369,8,0.0212201591511936
CDMX NORPONIENTE,2024-01-27,443,436,7,0.0158013544018059
CDMX NORPONIENTE,2024-01-28,349,340,9,0.0257879656160458
CDMX NORPONIENTE,2024-01-29,371,357,14,0.0377358490566038
CDMX NORPONIENTE,2024-01-30,370,359,11,0.0297297297297297
CDMX NORPONIENTE,2024-01-31,405,392,13,0.0320987654320988
CDMX NORPONIENTE,2024-02-01,364,356,8,0.021978021978022
CDMX NORPONIENTE,2024-02-02,354,346,8,0.0225988700564972
CDMX NORPONIENTE,2024-02-03,421,403,18,0.0427553444180523
CDMX NORPONIENTE,2024-02-04,305,298,7,0.0229508196721311
CDMX NORPONIENTE,2024-02-05,400,396,4,0.01
CDMX NORPONIENTE,2024-02-06,373,359,14,0.0375335120643432
CDMX NORPONIENTE,2024-02-07,366,357,9,0.0245901639344262
CDMX NORPONIENTE,2024-02-08,352,340,12,0.0340909090909091
CDMX NORPONIENTE,2024-02-09,328,318,10,0.0304878048780488
CDMX NORPONIENTE,2024-02-10,447,441,6,0.0134228187919463
CDMX NORPONIENTE,2024-02-11,300,291,9,0.03
CDMX NORPONIENTE,2024-02-12,281,270,11,0.0391459074733096
CDMX NORPONIENTE,2024-02-13,361,353,8,0.0221606648199446
CDMX NORPONIENTE,2024-02-14,295,289,6,0.0203389830508475
CDMX NORPONIENTE,2024-02-15,354,346,8,0.0225988700564972
CDMX NORPONIENTE,2024-02-16,350,334,16,0.0457142857142857
CDMX NORPONIENTE,2024-02-17,437,427,10,0.022883295194508
CDMX NORPONIENTE,2024-02-18,339,331,8,0.023598820058997
CDMX NORPONIENTE,2024-02-19,365,354,11,0.0301369863013699
CDMX NORPONIENTE,2024-02-20,317,312,5,0.0157728706624606
CDMX NORPONIENTE,2024-02-21,343,338,5,0.0145772594752187
CDMX NORPONIENTE,2024-02-22,402,397,5,0.0124378109452736
CDMX NORPONIENTE,2024-02-23,294,261,33,0.112244897959184
CDMX NORPONIENTE,2024-02-24,496,485,11,0.0221774193548387
CDMX NORPONIENTE,2024-02-25,331,326,5,0.0151057401812689
CDMX NORPONIENTE,2024-02-26,395,388,7,0.0177215189873418
CDMX NORPONIENTE,2024-02-27,396,389,7,0.0176767676767677
CDMX NORPONIENTE,2024-02-28,420,406,14,0.0333333333333333
CDMX NORPONIENTE,2024-02-29,422,411,11,0.0260663507109005
CDMX NORPONIENTE,2024-03-01,369,366,3,0.00813008130081301
CDMX NORPONIENTE,2024-03-02,482,477,5,0.0103734439834025
CDMX NORPONIENTE,2024-03-03,391,385,6,0.0153452685421995
CDMX NORPONIENTE,2024-03-04,398,392,6,0.0150753768844221
CDMX NORPONIENTE,2024-03-05,371,357,14,0.0377358490566038
CDMX NORPONIENTE,2024-03-06,377,367,10,0.026525198938992
CDMX NORPONIENTE,2024-03-07,349,340,9,0.0257879656160458
CDMX NORPONIENTE,2024-03-08,363,350,13,0.0358126721763085
CDMX NORPONIENTE,2024-03-09,421,415,6,0.0142517814726841
CDMX NORPONIENTE,2024-03-10,333,328,5,0.015015015015015
CDMX NORPONIENTE,2024-03-11,375,371,4,0.0106666666666667
CDMX PONIENTE CONDESA,2023-03-12,91,75,16,0.175824175824176
CDMX PONIENTE CONDESA,2023-03-13,138,92,46,0.333333333333333
CDMX PONIENTE CONDESA,2023-03-14,140,104,36,0.257142857142857
CDMX PONIENTE CONDESA,2023-03-15,140,114,26,0.185714285714286
CDMX PONIENTE CONDESA,2023-03-16,143,122,21,0.146853146853147
CDMX PONIENTE CONDESA,2023-03-17,178,157,21,0.117977528089888
CDMX PONIENTE CONDESA,2023-03-18,165,148,17,0.103030303030303
CDMX PONIENTE CONDESA,2023-03-19,106,94,12,0.113207547169811
CDMX PONIENTE CONDESA,2023-03-20,140,129,11,0.0785714285714286
CDMX PONIENTE CONDESA,2023-03-21,143,136,7,0.048951048951049
CDMX PONIENTE CONDESA,2023-03-22,157,146,11,0.0700636942675159
CDMX PONIENTE CONDESA,2023-03-23,144,141,3,0.0208333333333333
CDMX PONIENTE CONDESA,2023-03-24,134,123,11,0.082089552238806
CDMX PONIENTE CONDESA,2023-03-25,161,153,8,0.0496894409937888
CDMX PONIENTE CONDESA,2023-03-26,102,97,5,0.0490196078431373
CDMX PONIENTE CONDESA,2023-03-27,129,123,6,0.0465116279069767
CDMX PONIENTE CONDESA,2023-03-28,134,129,5,0.0373134328358209
CDMX PONIENTE CONDESA,2023-03-29,126,122,4,0.0317460317460317
CDMX PONIENTE CONDESA,2023-03-30,138,134,4,0.0289855072463768
CDMX PONIENTE CONDESA,2023-03-31,209,198,11,0.0526315789473684
CDMX PONIENTE CONDESA,2023-04-01,184,175,9,0.0489130434782609
CDMX PONIENTE CONDESA,2023-04-02,91,88,3,0.032967032967033
CDMX PONIENTE CONDESA,2023-04-03,154,152,2,0.012987012987013
CDMX PONIENTE CONDESA,2023-04-04,167,166,1,0.00598802395209581
CDMX PONIENTE CONDESA,2023-04-05,134,124,10,0.0746268656716418
CDMX PONIENTE CONDESA,2023-04-06,143,140,3,0.020979020979021
CDMX PONIENTE CONDESA,2023-04-07,111,109,2,0.018018018018018
CDMX PONIENTE CONDESA,2023-04-08,81,81,0,0
CDMX PONIENTE CONDESA,2023-04-09,60,57,3,0.05
CDMX PONIENTE CONDESA,2023-04-10,125,122,3,0.024
CDMX PONIENTE CONDESA,2023-04-11,125,116,9,0.072
CDMX PONIENTE CONDESA,2023-04-12,133,123,10,0.075187969924812
CDMX PONIENTE CONDESA,2023-04-13,129,121,8,0.062015503875969
CDMX PONIENTE CONDESA,2023-04-14,143,139,4,0.027972027972028
CDMX PONIENTE CONDESA,2023-04-15,187,177,10,0.053475935828877
CDMX PONIENTE CONDESA,2023-04-16,126,121,5,0.0396825396825397
CDMX PONIENTE CONDESA,2023-04-17,151,142,9,0.0596026490066225
CDMX PONIENTE CONDESA,2023-04-18,131,122,9,0.0687022900763359
CDMX PONIENTE CONDESA,2023-04-19,144,136,8,0.0555555555555556
CDMX PONIENTE CONDESA,2023-04-20,126,119,7,0.0555555555555556
CDMX PONIENTE CONDESA,2023-04-21,160,152,8,0.05
CDMX PONIENTE CONDESA,2023-04-22,141,134,7,0.049645390070922
CDMX PONIENTE CONDESA,2023-04-23,130,125,5,0.0384615384615385
CDMX PONIENTE CONDESA,2023-04-24,133,120,13,0.0977443609022556
CDMX PONIENTE CONDESA,2023-04-25,170,159,11,0.0647058823529412
CDMX PONIENTE CONDESA,2023-04-26,145,137,8,0.0551724137931034
CDMX PONIENTE CONDESA,2023-04-27,147,135,12,0.0816326530612245
CDMX PONIENTE CONDESA,2023-04-28,153,140,13,0.0849673202614379
CDMX PONIENTE CONDESA,2023-04-29,204,195,9,0.0441176470588235
CDMX PONIENTE CONDESA,2023-04-30,140,126,14,0.1
CDMX PONIENTE CONDESA,2023-05-01,127,115,12,0.094488188976378
CDMX PONIENTE CONDESA,2023-05-02,172,162,10,0.0581395348837209
CDMX PONIENTE CONDESA,2023-05-03,126,116,10,0.0793650793650794
CDMX PONIENTE CONDESA,2023-05-04,161,152,9,0.0559006211180124
CDMX PONIENTE CONDESA,2023-05-05,183,173,10,0.0546448087431694
CDMX PONIENTE CONDESA,2023-05-06,154,143,11,0.0714285714285714
CDMX PONIENTE CONDESA,2023-05-07,117,116,1,0.00854700854700855
CDMX PONIENTE CONDESA,2023-05-08,146,137,9,0.0616438356164384
CDMX PONIENTE CONDESA,2023-05-09,142,130,12,0.0845070422535211
CDMX PONIENTE CONDESA,2023-05-10,154,141,13,0.0844155844155844
CDMX PONIENTE CONDESA,2023-05-11,148,135,13,0.0878378378378378
CDMX PONIENTE CONDESA,2023-05-12,164,148,16,0.0975609756097561
CDMX PONIENTE CONDESA,2023-05-13,201,189,12,0.0597014925373134
CDMX PONIENTE CONDESA,2023-05-14,137,128,9,0.0656934306569343
CDMX PONIENTE CONDESA,2023-05-15,195,181,14,0.0717948717948718
CDMX PONIENTE CONDESA,2023-05-16,206,189,17,0.0825242718446602
CDMX PONIENTE CONDESA,2023-05-17,207,196,11,0.0531400966183575
CDMX PONIENTE CONDESA,2023-05-18,148,138,10,0.0675675675675676
CDMX PONIENTE CONDESA,2023-05-19,146,136,10,0.0684931506849315
CDMX PONIENTE CONDESA,2023-05-20,165,155,10,0.0606060606060606
CDMX PONIENTE CONDESA,2023-05-21,120,115,5,0.0416666666666667
CDMX PONIENTE CONDESA,2023-05-22,184,172,12,0.0652173913043478
CDMX PONIENTE CONDESA,2023-05-23,142,134,8,0.0563380281690141
CDMX PONIENTE CONDESA,2023-05-24,135,126,9,0.0666666666666667
CDMX PONIENTE CONDESA,2023-05-25,166,154,12,0.072289156626506
CDMX PONIENTE CONDESA,2023-05-26,155,144,11,0.0709677419354839
CDMX PONIENTE CONDESA,2023-05-27,157,147,10,0.0636942675159236
CDMX PONIENTE CONDESA,2023-05-28,101,96,5,0.0495049504950495
CDMX PONIENTE CONDESA,2023-05-29,164,151,13,0.0792682926829268
CDMX PONIENTE CONDESA,2023-05-30,178,160,18,0.101123595505618
CDMX PONIENTE CONDESA,2023-05-31,159,142,17,0.106918238993711
CDMX PONIENTE CONDESA,2023-06-01,157,147,10,0.0636942675159236
CDMX PONIENTE CONDESA,2023-06-02,135,120,15,0.111111111111111
CDMX PONIENTE CONDESA,2023-06-03,165,155,10,0.0606060606060606
CDMX PONIENTE CONDESA,2023-06-04,132,130,2,0.0151515151515152
CDMX PONIENTE CONDESA,2023-06-05,135,116,19,0.140740740740741
CDMX PONIENTE CONDESA,2023-06-06,123,114,9,0.0731707317073171
CDMX PONIENTE CONDESA,2023-06-07,139,120,19,0.136690647482014
CDMX PONIENTE CONDESA,2023-06-08,152,140,12,0.0789473684210526
CDMX PONIENTE CONDESA,2023-06-09,157,142,15,0.0955414012738854
CDMX PONIENTE CONDESA,2023-06-10,160,144,16,0.1
CDMX PONIENTE CONDESA,2023-06-11,97,93,4,0.0412371134020619
CDMX PONIENTE CONDESA,2023-06-12,156,135,21,0.134615384615385
CDMX PONIENTE CONDESA,2023-06-13,134,119,15,0.111940298507463
CDMX PONIENTE CONDESA,2023-06-14,146,133,13,0.089041095890411
CDMX PONIENTE CONDESA,2023-06-15,161,147,14,0.0869565217391304
CDMX PONIENTE CONDESA,2023-06-16,150,138,12,0.08
CDMX PONIENTE CONDESA,2023-06-17,119,110,9,0.0756302521008403
CDMX PONIENTE CONDESA,2023-06-18,128,116,12,0.09375
CDMX PONIENTE CONDESA,2023-06-19,150,138,12,0.08
CDMX PONIENTE CONDESA,2023-06-20,144,131,13,0.0902777777777778
CDMX PONIENTE CONDESA,2023-06-21,132,118,14,0.106060606060606
CDMX PONIENTE CONDESA,2023-06-22,134,129,5,0.0373134328358209
CDMX PONIENTE CONDESA,2023-06-23,117,110,7,0.0598290598290598
CDMX PONIENTE CONDESA,2023-06-24,150,141,9,0.06
CDMX PONIENTE CONDESA,2023-06-25,103,97,6,0.058252427184466
CDMX PONIENTE CONDESA,2023-06-26,122,117,5,0.040983606557377
CDMX PONIENTE CONDESA,2023-06-27,142,138,4,0.028169014084507
CDMX PONIENTE CONDESA,2023-06-28,111,106,5,0.045045045045045
CDMX PONIENTE CONDESA,2023-06-29,125,111,14,0.112
CDMX PONIENTE CONDESA,2023-06-30,105,94,11,0.104761904761905
CDMX PONIENTE CONDESA,2023-07-01,153,144,9,0.0588235294117647
CDMX PONIENTE CONDESA,2023-07-02,80,77,3,0.0375
CDMX PONIENTE CONDESA,2023-07-03,152,143,9,0.0592105263157895
CDMX PONIENTE CONDESA,2023-07-04,103,98,5,0.0485436893203883
CDMX PONIENTE CONDESA,2023-07-05,99,91,8,0.0808080808080808
CDMX PONIENTE CONDESA,2023-07-06,108,106,2,0.0185185185185185
CDMX PONIENTE CONDESA,2023-07-07,145,143,2,0.0137931034482759
CDMX PONIENTE CONDESA,2023-07-08,142,137,5,0.0352112676056338
CDMX PONIENTE CONDESA,2023-07-09,110,110,0,0
CDMX PONIENTE CONDESA,2023-07-10,145,138,7,0.0482758620689655
CDMX PONIENTE CONDESA,2023-07-11,138,128,10,0.072463768115942
CDMX PONIENTE CONDESA,2023-07-12,135,122,13,0.0962962962962963
CDMX PONIENTE CONDESA,2023-07-13,110,98,12,0.109090909090909
CDMX PONIENTE CONDESA,2023-07-14,119,113,6,0.0504201680672269
CDMX PONIENTE CONDESA,2023-07-15,149,142,7,0.0469798657718121
CDMX PONIENTE CONDESA,2023-07-16,125,123,2,0.016
CDMX PONIENTE CONDESA,2023-07-17,144,136,8,0.0555555555555556
CDMX PONIENTE CONDESA,2023-07-18,125,119,6,0.048
CDMX PONIENTE CONDESA,2023-07-19,138,136,2,0.0144927536231884
CDMX PONIENTE CONDESA,2023-07-20,146,136,10,0.0684931506849315
CDMX PONIENTE CONDESA,2023-07-21,105,94,11,0.104761904761905
CDMX PONIENTE CONDESA,2023-07-22,138,134,4,0.0289855072463768
CDMX PONIENTE CONDESA,2023-07-23,102,98,4,0.0392156862745098
CDMX PONIENTE CONDESA,2023-07-24,146,137,9,0.0616438356164384
CDMX PONIENTE CONDESA,2023-07-25,151,145,6,0.0397350993377483
CDMX PONIENTE CONDESA,2023-07-26,112,105,7,0.0625
CDMX PONIENTE CONDESA,2023-07-27,164,155,9,0.0548780487804878
CDMX PONIENTE CONDESA,2023-07-28,183,177,6,0.0327868852459016
CDMX PONIENTE CONDESA,2023-07-29,155,145,10,0.0645161290322581
CDMX PONIENTE CONDESA,2023-07-30,117,109,8,0.0683760683760684
CDMX PONIENTE CONDESA,2023-07-31,143,133,10,0.0699300699300699
CDMX PONIENTE CONDESA,2023-08-01,174,165,9,0.0517241379310345
CDMX PONIENTE CONDESA,2023-08-02,173,168,5,0.0289017341040462
CDMX PONIENTE CONDESA,2023-08-03,152,123,29,0.190789473684211
CDMX PONIENTE CONDESA,2023-08-04,133,126,7,0.0526315789473684
CDMX PONIENTE CONDESA,2023-08-05,156,145,11,0.0705128205128205
CDMX PONIENTE CONDESA,2023-08-06,121,118,3,0.0247933884297521
CDMX PONIENTE CONDESA,2023-08-07,139,134,5,0.0359712230215827
CDMX PONIENTE CONDESA,2023-08-08,154,144,10,0.0649350649350649
CDMX PONIENTE CONDESA,2023-08-09,176,163,13,0.0738636363636364
CDMX PONIENTE CONDESA,2023-08-10,141,135,6,0.0425531914893617
CDMX PONIENTE CONDESA,2023-08-11,156,146,10,0.0641025641025641
CDMX PONIENTE CONDESA,2023-08-12,153,151,2,0.0130718954248366
CDMX PONIENTE CONDESA,2023-08-13,117,111,6,0.0512820512820513
CDMX PONIENTE CONDESA,2023-08-14,144,135,9,0.0625
CDMX PONIENTE CONDESA,2023-08-15,187,179,8,0.0427807486631016
CDMX PONIENTE CONDESA,2023-08-16,155,149,6,0.0387096774193548
CDMX PONIENTE CONDESA,2023-08-17,183,172,11,0.0601092896174863
CDMX PONIENTE CONDESA,2023-08-18,154,145,9,0.0584415584415584
CDMX PONIENTE CONDESA,2023-08-19,147,140,7,0.0476190476190476
CDMX PONIENTE CONDESA,2023-08-20,122,117,5,0.040983606557377
CDMX PONIENTE CONDESA,2023-08-21,143,142,1,0.00699300699300699
CDMX PONIENTE CONDESA,2023-08-22,139,139,0,0
CDMX PONIENTE CONDESA,2023-08-23,150,148,2,0.0133333333333333
CDMX PONIENTE CONDESA,2023-08-24,165,160,5,0.0303030303030303
CDMX PONIENTE CONDESA,2023-08-25,153,148,5,0.0326797385620915
CDMX PONIENTE CONDESA,2023-08-26,170,168,2,0.0117647058823529
CDMX PONIENTE CONDESA,2023-08-27,126,124,2,0.0158730158730159
CDMX PONIENTE CONDESA,2023-08-28,153,150,3,0.0196078431372549
CDMX PONIENTE CONDESA,2023-08-29,153,151,2,0.0130718954248366
CDMX PONIENTE CONDESA,2023-08-30,138,135,3,0.0217391304347826
CDMX PONIENTE CONDESA,2023-08-31,157,155,2,0.0127388535031847
CDMX PONIENTE CONDESA,2023-09-01,141,140,1,0.00709219858156028
CDMX PONIENTE CONDESA,2023-09-02,187,186,1,0.0053475935828877
CDMX PONIENTE CONDESA,2023-09-03,143,143,0,0
CDMX PONIENTE CONDESA,2023-09-04,142,141,1,0.00704225352112676
CDMX PONIENTE CONDESA,2023-09-05,160,160,0,0
CDMX PONIENTE CONDESA,2023-09-06,136,134,2,0.0147058823529412
CDMX PONIENTE CONDESA,2023-09-07,103,102,1,0.00970873786407767
CDMX PONIENTE CONDESA,2023-09-08,113,113,0,0
CDMX PONIENTE CONDESA,2023-09-09,171,171,0,0
CDMX PONIENTE CONDESA,2023-09-10,129,128,1,0.00775193798449612
CDMX PONIENTE CONDESA,2023-09-11,128,125,3,0.0234375
CDMX PONIENTE CONDESA,2023-09-12,158,158,0,0
CDMX PONIENTE CONDESA,2023-09-13,135,131,4,0.0296296296296296
CDMX PONIENTE CONDESA,2023-09-14,116,109,7,0.0603448275862069
CDMX PONIENTE CONDESA,2023-09-15,84,80,4,0.0476190476190476
CDMX PONIENTE CONDESA,2023-09-16,123,120,3,0.024390243902439
CDMX PONIENTE CONDESA,2023-09-17,107,106,1,0.00934579439252336
CDMX PONIENTE CONDESA,2023-09-18,119,118,1,0.00840336134453781
CDMX PONIENTE CONDESA,2023-09-19,147,144,3,0.0204081632653061
CDMX PONIENTE CONDESA,2023-09-20,141,136,5,0.0354609929078014
CDMX PONIENTE CONDESA,2023-09-21,146,140,6,0.0410958904109589
CDMX PONIENTE CONDESA,2023-09-22,169,163,6,0.0355029585798817
CDMX PONIENTE CONDESA,2023-09-23,164,164,0,0
CDMX PONIENTE CONDESA,2023-09-24,116,113,3,0.0258620689655172
CDMX PONIENTE CONDESA,2023-09-25,136,135,1,0.00735294117647059
CDMX PONIENTE CONDESA,2023-09-26,147,146,1,0.00680272108843537
CDMX PONIENTE CONDESA,2023-09-27,139,138,1,0.00719424460431655
CDMX PONIENTE CONDESA,2023-09-28,142,141,1,0.00704225352112676
CDMX PONIENTE CONDESA,2023-09-29,179,178,1,0.00558659217877095
CDMX PONIENTE CONDESA,2023-09-30,196,192,4,0.0204081632653061
CDMX PONIENTE CONDESA,2023-10-01,122,119,3,0.0245901639344262
CDMX PONIENTE CONDESA,2023-10-02,145,141,4,0.0275862068965517
CDMX PONIENTE CONDESA,2023-10-03,157,147,10,0.0636942675159236
CDMX PONIENTE CONDESA,2023-10-04,131,124,7,0.0534351145038168
CDMX PONIENTE CONDESA,2023-10-05,119,111,8,0.0672268907563025
CDMX PONIENTE CONDESA,2023-10-06,134,125,9,0.0671641791044776
CDMX PONIENTE CONDESA,2023-10-07,115,112,3,0.0260869565217391
CDMX PONIENTE CONDESA,2023-10-08,89,85,4,0.0449438202247191
CDMX PONIENTE CONDESA,2023-10-09,131,121,10,0.0763358778625954
CDMX PONIENTE CONDESA,2023-10-10,133,128,5,0.037593984962406
CDMX PONIENTE CONDESA,2023-10-11,136,121,15,0.110294117647059
CDMX PONIENTE CONDESA,2023-10-12,119,114,5,0.0420168067226891
CDMX PONIENTE CONDESA,2023-10-13,114,106,8,0.0701754385964912
CDMX PONIENTE CONDESA,2023-10-14,134,129,5,0.0373134328358209
CDMX PONIENTE CONDESA,2023-10-15,91,91,0,0
CDMX PONIENTE CONDESA,2023-10-16,148,142,6,0.0405405405405405
CDMX PONIENTE CONDESA,2023-10-17,121,117,4,0.0330578512396694
CDMX PONIENTE CONDESA,2023-10-18,133,126,7,0.0526315789473684
CDMX PONIENTE CONDESA,2023-10-19,132,124,8,0.0606060606060606
CDMX PONIENTE CONDESA,2023-10-20,130,123,7,0.0538461538461538
CDMX PONIENTE CONDESA,2023-10-21,124,120,4,0.032258064516129
CDMX PONIENTE CONDESA,2023-10-22,93,91,2,0.021505376344086
CDMX PONIENTE CONDESA,2023-10-23,132,121,11,0.0833333333333333
CDMX PONIENTE CONDESA,2023-10-24,132,127,5,0.0378787878787879
CDMX PONIENTE CONDESA,2023-10-25,112,108,4,0.0357142857142857
CDMX PONIENTE CONDESA,2023-10-26,131,129,2,0.0152671755725191
CDMX PONIENTE CONDESA,2023-10-27,120,118,2,0.0166666666666667
CDMX PONIENTE CONDESA,2023-10-28,131,128,3,0.0229007633587786
CDMX PONIENTE CONDESA,2023-10-29,101,97,4,0.0396039603960396
CDMX PONIENTE CONDESA,2023-10-30,131,125,6,0.0458015267175573
CDMX PONIENTE CONDESA,2023-10-31,157,149,8,0.0509554140127389
CDMX PONIENTE CONDESA,2023-11-01,121,119,2,0.0165289256198347
CDMX PONIENTE CONDESA,2023-11-02,122,116,6,0.0491803278688525
CDMX PONIENTE CONDESA,2023-11-03,128,126,2,0.015625
CDMX PONIENTE CONDESA,2023-11-04,133,126,7,0.0526315789473684
CDMX PONIENTE CONDESA,2023-11-05,109,106,3,0.0275229357798165
CDMX PONIENTE CONDESA,2023-11-06,133,128,5,0.037593984962406
CDMX PONIENTE CONDESA,2023-11-07,132,121,11,0.0833333333333333
CDMX PONIENTE CONDESA,2023-11-08,149,143,6,0.0402684563758389
CDMX PONIENTE CONDESA,2023-11-09,118,114,4,0.0338983050847458
CDMX PONIENTE CONDESA,2023-11-10,131,124,7,0.0534351145038168
CDMX PONIENTE CONDESA,2023-11-11,148,142,6,0.0405405405405405
CDMX PONIENTE CONDESA,2023-11-12,95,92,3,0.0315789473684211
CDMX PONIENTE CONDESA,2023-11-13,145,136,9,0.0620689655172414
CDMX PONIENTE CONDESA,2023-11-14,148,144,4,0.027027027027027
CDMX PONIENTE CONDESA,2023-11-15,165,157,8,0.0484848484848485
CDMX PONIENTE CONDESA,2023-11-16,156,148,8,0.0512820512820513
CDMX PONIENTE CONDESA,2023-11-17,164,160,4,0.024390243902439
CDMX PONIENTE CONDESA,2023-11-18,192,185,7,0.0364583333333333
CDMX PONIENTE CONDESA,2023-11-19,119,117,2,0.0168067226890756
CDMX PONIENTE CONDESA,2023-11-20,184,180,4,0.0217391304347826
CDMX PONIENTE CONDESA,2023-11-21,189,179,10,0.0529100529100529
CDMX PONIENTE CONDESA,2023-11-22,161,160,1,0.0062111801242236
CDMX PONIENTE CONDESA,2023-11-23,156,152,4,0.0256410256410256
CDMX PONIENTE CONDESA,2023-11-24,141,130,11,0.0780141843971631
CDMX PONIENTE CONDESA,2023-11-25,157,156,1,0.00636942675159236
CDMX PONIENTE CONDESA,2023-11-26,94,91,3,0.0319148936170213
CDMX PONIENTE CONDESA,2023-11-27,149,144,5,0.0335570469798658
CDMX PONIENTE CONDESA,2023-11-28,149,142,7,0.0469798657718121
CDMX PONIENTE CONDESA,2023-11-29,154,142,12,0.0779220779220779
CDMX PONIENTE CONDESA,2023-11-30,180,166,14,0.0777777777777778
CDMX PONIENTE CONDESA,2023-12-01,183,178,5,0.0273224043715847
CDMX PONIENTE CONDESA,2023-12-02,123,116,7,0.0569105691056911
CDMX PONIENTE CONDESA,2023-12-03,128,125,3,0.0234375
CDMX PONIENTE CONDESA,2023-12-04,169,158,11,0.0650887573964497
CDMX PONIENTE CONDESA,2023-12-05,174,169,5,0.028735632183908
CDMX PONIENTE CONDESA,2023-12-06,135,124,11,0.0814814814814815
CDMX PONIENTE CONDESA,2023-12-07,137,133,4,0.0291970802919708
CDMX PONIENTE CONDESA,2023-12-08,138,129,9,0.0652173913043478
CDMX PONIENTE CONDESA,2023-12-09,141,137,4,0.0283687943262411
CDMX PONIENTE CONDESA,2023-12-10,97,96,1,0.0103092783505155
CDMX PONIENTE CONDESA,2023-12-11,140,134,6,0.0428571428571429
CDMX PONIENTE CONDESA,2023-12-12,166,154,12,0.072289156626506
CDMX PONIENTE CONDESA,2023-12-13,107,101,6,0.0560747663551402
CDMX PONIENTE CONDESA,2023-12-14,123,117,6,0.0487804878048781
CDMX PONIENTE CONDESA,2023-12-15,143,141,2,0.013986013986014
CDMX PONIENTE CONDESA,2023-12-16,154,151,3,0.0194805194805195
CDMX PONIENTE CONDESA,2023-12-17,108,107,1,0.00925925925925926
CDMX PONIENTE CONDESA,2023-12-18,134,131,3,0.0223880597014925
CDMX PONIENTE CONDESA,2023-12-19,147,140,7,0.0476190476190476
CDMX PONIENTE CONDESA,2023-12-20,156,151,5,0.032051282051282
CDMX PONIENTE CONDESA,2023-12-21,136,132,4,0.0294117647058824
CDMX PONIENTE CONDESA,2023-12-22,133,131,2,0.0150375939849624
CDMX PONIENTE CONDESA,2023-12-23,139,133,6,0.0431654676258993
CDMX PONIENTE CONDESA,2023-12-24,63,61,2,0.0317460317460317
CDMX PONIENTE CONDESA,2023-12-25,29,29,0,0
CDMX PONIENTE CONDESA,2023-12-26,126,119,7,0.0555555555555556
CDMX PONIENTE CONDESA,2023-12-27,158,151,7,0.0443037974683544
CDMX PONIENTE CONDESA,2023-12-28,137,132,5,0.0364963503649635
CDMX PONIENTE CONDESA,2023-12-29,130,123,7,0.0538461538461538
CDMX PONIENTE CONDESA,2023-12-30,139,137,2,0.0143884892086331
CDMX PONIENTE CONDESA,2023-12-31,44,44,0,0
CDMX PONIENTE CONDESA,2024-01-01,35,34,1,0.0285714285714286
CDMX PONIENTE CONDESA,2024-01-02,126,118,8,0.0634920634920635
CDMX PONIENTE CONDESA,2024-01-03,179,176,3,0.0167597765363128
CDMX PONIENTE CONDESA,2024-01-04,151,151,0,0
CDMX PONIENTE CONDESA,2024-01-05,145,140,5,0.0344827586206897
CDMX PONIENTE CONDESA,2024-01-06,156,149,7,0.0448717948717949
CDMX PONIENTE CONDESA,2024-01-07,85,82,3,0.0352941176470588
CDMX PONIENTE CONDESA,2024-01-08,147,140,7,0.0476190476190476
CDMX PONIENTE CONDESA,2024-01-09,151,142,9,0.0596026490066225
CDMX PONIENTE CONDESA,2024-01-10,143,141,2,0.013986013986014
CDMX PONIENTE CONDESA,2024-01-11,135,131,4,0.0296296296296296
CDMX PONIENTE CONDESA,2024-01-12,164,157,7,0.0426829268292683
CDMX PONIENTE CONDESA,2024-01-13,164,158,6,0.0365853658536585
CDMX PONIENTE CONDESA,2024-01-14,137,132,5,0.0364963503649635
CDMX PONIENTE CONDESA,2024-01-15,168,161,7,0.0416666666666667
CDMX PONIENTE CONDESA,2024-01-16,139,132,7,0.0503597122302158
CDMX PONIENTE CONDESA,2024-01-17,172,167,5,0.0290697674418605
CDMX PONIENTE CONDESA,2024-01-18,122,117,5,0.040983606557377
CDMX PONIENTE CONDESA,2024-01-19,132,122,10,0.0757575757575758
CDMX PONIENTE CONDESA,2024-01-20,135,132,3,0.0222222222222222
CDMX PONIENTE CONDESA,2024-01-21,85,82,3,0.0352941176470588
CDMX PONIENTE CONDESA,2024-01-22,145,140,5,0.0344827586206897
CDMX PONIENTE CONDESA,2024-01-23,138,133,5,0.036231884057971
CDMX PONIENTE CONDESA,2024-01-24,154,147,7,0.0454545454545455
CDMX PONIENTE CONDESA,2024-01-25,141,133,8,0.0567375886524823
CDMX PONIENTE CONDESA,2024-01-26,143,133,10,0.0699300699300699
CDMX PONIENTE CONDESA,2024-01-27,180,176,4,0.0222222222222222
CDMX PONIENTE CONDESA,2024-01-28,126,123,3,0.0238095238095238
CDMX PONIENTE CONDESA,2024-01-29,163,156,7,0.0429447852760736
CDMX PONIENTE CONDESA,2024-01-30,152,143,9,0.0592105263157895
CDMX PONIENTE CONDESA,2024-01-31,173,169,4,0.023121387283237
CDMX PONIENTE CONDESA,2024-02-01,147,136,11,0.0748299319727891
CDMX PONIENTE CONDESA,2024-02-02,154,154,0,0
CDMX PONIENTE CONDESA,2024-02-03,168,166,2,0.0119047619047619
CDMX PONIENTE CONDESA,2024-02-04,139,136,3,0.0215827338129496
CDMX PONIENTE CONDESA,2024-02-05,101,98,3,0.0297029702970297
CDMX PONIENTE CONDESA,2024-02-06,145,135,10,0.0689655172413793
CDMX PONIENTE CONDESA,2024-02-07,164,155,9,0.0548780487804878
CDMX PONIENTE CONDESA,2024-02-08,162,154,8,0.0493827160493827
CDMX PONIENTE CONDESA,2024-02-09,171,163,8,0.0467836257309941
CDMX PONIENTE CONDESA,2024-02-10,171,171,0,0
CDMX PONIENTE CONDESA,2024-02-11,87,85,2,0.0229885057471264
CDMX PONIENTE CONDESA,2024-02-12,105,93,12,0.114285714285714
CDMX PONIENTE CONDESA,2024-02-13,130,126,4,0.0307692307692308
CDMX PONIENTE CONDESA,2024-02-14,125,121,4,0.032
CDMX PONIENTE CONDESA,2024-02-15,121,116,5,0.0413223140495868
CDMX PONIENTE CONDESA,2024-02-16,146,140,6,0.0410958904109589
CDMX PONIENTE CONDESA,2024-02-17,159,154,5,0.0314465408805031
CDMX PONIENTE CONDESA,2024-02-18,121,118,3,0.0247933884297521
CDMX PONIENTE CONDESA,2024-02-19,129,123,6,0.0465116279069767
CDMX PONIENTE CONDESA,2024-02-20,178,174,4,0.0224719101123595
CDMX PONIENTE CONDESA,2024-02-21,130,124,6,0.0461538461538462
CDMX PONIENTE CONDESA,2024-02-22,150,148,2,0.0133333333333333
CDMX PONIENTE CONDESA,2024-02-23,85,74,11,0.129411764705882
CDMX PONIENTE CONDESA,2024-02-24,158,156,2,0.0126582278481013
CDMX PONIENTE CONDESA,2024-02-25,104,100,4,0.0384615384615385
CDMX PONIENTE CONDESA,2024-02-26,149,142,7,0.0469798657718121
CDMX PONIENTE CONDESA,2024-02-27,161,154,7,0.0434782608695652
CDMX PONIENTE CONDESA,2024-02-28,157,148,9,0.0573248407643312
CDMX PONIENTE CONDESA,2024-02-29,173,168,5,0.0289017341040462
CDMX PONIENTE CONDESA,2024-03-01,151,143,8,0.0529801324503311
CDMX PONIENTE CONDESA,2024-03-02,160,158,2,0.0125
CDMX PONIENTE CONDESA,2024-03-03,126,125,1,0.00793650793650794
CDMX PONIENTE CONDESA,2024-03-04,149,146,3,0.0201342281879195
CDMX PONIENTE CONDESA,2024-03-05,202,197,5,0.0247524752475248
CDMX PONIENTE CONDESA,2024-03-06,145,139,6,0.0413793103448276
CDMX PONIENTE CONDESA,2024-03-07,159,153,6,0.0377358490566038
CDMX PONIENTE CONDESA,2024-03-08,145,141,4,0.0275862068965517
CDMX PONIENTE CONDESA,2024-03-09,171,168,3,0.0175438596491228
CDMX PONIENTE CONDESA,2024-03-10,141,138,3,0.0212765957446809
CDMX PONIENTE CONDESA,2024-03-11,121,118,3,0.0247933884297521
CDMX PONIENTE PEDREGAL,2023-03-12,98,66,32,0.326530612244898
CDMX PONIENTE PEDREGAL,2023-03-13,120,82,38,0.316666666666667
CDMX PONIENTE PEDREGAL,2023-03-14,100,67,33,0.33
CDMX PONIENTE PEDREGAL,2023-03-15,104,85,19,0.182692307692308
CDMX PONIENTE PEDREGAL,2023-03-16,139,106,33,0.237410071942446
CDMX PONIENTE PEDREGAL,2023-03-17,158,116,42,0.265822784810127
CDMX PONIENTE PEDREGAL,2023-03-18,224,172,52,0.232142857142857
CDMX PONIENTE PEDREGAL,2023-03-19,155,132,23,0.148387096774194
CDMX PONIENTE PEDREGAL,2023-03-20,184,141,43,0.233695652173913
CDMX PONIENTE PEDREGAL,2023-03-21,139,115,24,0.172661870503597
CDMX PONIENTE PEDREGAL,2023-03-22,123,106,17,0.138211382113821
CDMX PONIENTE PEDREGAL,2023-03-23,128,111,17,0.1328125
CDMX PONIENTE PEDREGAL,2023-03-24,108,94,14,0.12962962962963
CDMX PONIENTE PEDREGAL,2023-03-25,151,130,21,0.139072847682119
CDMX PONIENTE PEDREGAL,2023-03-26,134,120,14,0.104477611940299
CDMX PONIENTE PEDREGAL,2023-03-27,114,103,11,0.0964912280701754
CDMX PONIENTE PEDREGAL,2023-03-28,102,95,7,0.0686274509803922
CDMX PONIENTE PEDREGAL,2023-03-29,108,102,6,0.0555555555555556
CDMX PONIENTE PEDREGAL,2023-03-30,157,141,16,0.101910828025478
CDMX PONIENTE PEDREGAL,2023-03-31,183,165,18,0.0983606557377049
CDMX PONIENTE PEDREGAL,2023-04-01,156,152,4,0.0256410256410256
CDMX PONIENTE PEDREGAL,2023-04-02,104,95,9,0.0865384615384615
CDMX PONIENTE PEDREGAL,2023-04-03,131,119,12,0.0916030534351145
CDMX PONIENTE PEDREGAL,2023-04-04,146,135,11,0.0753424657534247
CDMX PONIENTE PEDREGAL,2023-04-05,115,90,25,0.217391304347826
CDMX PONIENTE PEDREGAL,2023-04-06,136,125,11,0.0808823529411765
CDMX PONIENTE PEDREGAL,2023-04-07,101,98,3,0.0297029702970297
CDMX PONIENTE PEDREGAL,2023-04-08,79,72,7,0.0886075949367089
CDMX PONIENTE PEDREGAL,2023-04-09,86,81,5,0.0581395348837209
CDMX PONIENTE PEDREGAL,2023-04-10,91,83,8,0.0879120879120879
CDMX PONIENTE PEDREGAL,2023-04-11,106,91,15,0.141509433962264
CDMX PONIENTE PEDREGAL,2023-04-12,107,96,11,0.102803738317757
CDMX PONIENTE PEDREGAL,2023-04-13,118,108,10,0.0847457627118644
CDMX PONIENTE PEDREGAL,2023-04-14,137,123,14,0.102189781021898
CDMX PONIENTE PEDREGAL,2023-04-15,183,151,32,0.174863387978142
CDMX PONIENTE PEDREGAL,2023-04-16,162,153,9,0.0555555555555556
CDMX PONIENTE PEDREGAL,2023-04-17,131,122,9,0.0687022900763359
CDMX PONIENTE PEDREGAL,2023-04-18,135,114,21,0.155555555555556
CDMX PONIENTE PEDREGAL,2023-04-19,117,108,9,0.0769230769230769
CDMX PONIENTE PEDREGAL,2023-04-20,98,87,11,0.112244897959184
CDMX PONIENTE PEDREGAL,2023-04-21,133,120,13,0.0977443609022556
CDMX PONIENTE PEDREGAL,2023-04-22,137,130,7,0.0510948905109489
CDMX PONIENTE PEDREGAL,2023-04-23,124,112,12,0.0967741935483871
CDMX PONIENTE PEDREGAL,2023-04-24,146,130,16,0.10958904109589
CDMX PONIENTE PEDREGAL,2023-04-25,151,136,15,0.0993377483443709
CDMX PONIENTE PEDREGAL,2023-04-26,134,122,12,0.0895522388059701
CDMX PONIENTE PEDREGAL,2023-04-27,126,110,16,0.126984126984127
CDMX PONIENTE PEDREGAL,2023-04-28,159,143,16,0.10062893081761
CDMX PONIENTE PEDREGAL,2023-04-29,181,164,17,0.0939226519337017
CDMX PONIENTE PEDREGAL,2023-04-30,126,107,19,0.150793650793651
CDMX PONIENTE PEDREGAL,2023-05-01,110,87,23,0.209090909090909
CDMX PONIENTE PEDREGAL,2023-05-02,141,124,17,0.120567375886525
CDMX PONIENTE PEDREGAL,2023-05-03,103,89,14,0.135922330097087
CDMX PONIENTE PEDREGAL,2023-05-04,126,116,10,0.0793650793650794
CDMX PONIENTE PEDREGAL,2023-05-05,152,137,15,0.0986842105263158
CDMX PONIENTE PEDREGAL,2023-05-06,118,109,9,0.076271186440678
CDMX PONIENTE PEDREGAL,2023-05-07,109,100,9,0.0825688073394495
CDMX PONIENTE PEDREGAL,2023-05-08,95,89,6,0.0631578947368421
CDMX PONIENTE PEDREGAL,2023-05-09,109,99,10,0.0917431192660551
CDMX PONIENTE PEDREGAL,2023-05-10,111,101,10,0.0900900900900901
CDMX PONIENTE PEDREGAL,2023-05-11,107,97,10,0.0934579439252336
CDMX PONIENTE PEDREGAL,2023-05-12,135,116,19,0.140740740740741
CDMX PONIENTE PEDREGAL,2023-05-13,148,140,8,0.0540540540540541
CDMX PONIENTE PEDREGAL,2023-05-14,152,141,11,0.0723684210526316
CDMX PONIENTE PEDREGAL,2023-05-15,184,170,14,0.0760869565217391
CDMX PONIENTE PEDREGAL,2023-05-16,183,168,15,0.0819672131147541
CDMX PONIENTE PEDREGAL,2023-05-17,183,159,24,0.131147540983607
CDMX PONIENTE PEDREGAL,2023-05-18,141,132,9,0.0638297872340425
CDMX PONIENTE PEDREGAL,2023-05-19,96,87,9,0.09375
CDMX PONIENTE PEDREGAL,2023-05-20,154,142,12,0.0779220779220779
CDMX PONIENTE PEDREGAL,2023-05-21,120,104,16,0.133333333333333
CDMX PONIENTE PEDREGAL,2023-05-22,159,148,11,0.0691823899371069
CDMX PONIENTE PEDREGAL,2023-05-23,120,111,9,0.075
CDMX PONIENTE PEDREGAL,2023-05-24,120,115,5,0.0416666666666667
CDMX PONIENTE PEDREGAL,2023-05-25,109,97,12,0.110091743119266
CDMX PONIENTE PEDREGAL,2023-05-26,115,103,12,0.104347826086957
CDMX PONIENTE PEDREGAL,2023-05-27,147,138,9,0.0612244897959184
CDMX PONIENTE PEDREGAL,2023-05-28,115,108,7,0.0608695652173913
CDMX PONIENTE PEDREGAL,2023-05-29,149,132,17,0.114093959731544
CDMX PONIENTE PEDREGAL,2023-05-30,157,131,26,0.165605095541401
CDMX PONIENTE PEDREGAL,2023-05-31,168,141,27,0.160714285714286
CDMX PONIENTE PEDREGAL,2023-06-01,118,108,10,0.0847457627118644
CDMX PONIENTE PEDREGAL,2023-06-02,144,131,13,0.0902777777777778
CDMX PONIENTE PEDREGAL,2023-06-03,103,85,18,0.174757281553398
CDMX PONIENTE PEDREGAL,2023-06-04,131,116,15,0.114503816793893
CDMX PONIENTE PEDREGAL,2023-06-05,127,109,18,0.141732283464567
CDMX PONIENTE PEDREGAL,2023-06-06,130,121,9,0.0692307692307692
CDMX PONIENTE PEDREGAL,2023-06-07,112,99,13,0.116071428571429
CDMX PONIENTE PEDREGAL,2023-06-08,128,109,19,0.1484375
CDMX PONIENTE PEDREGAL,2023-06-09,117,102,15,0.128205128205128
CDMX PONIENTE PEDREGAL,2023-06-10,137,118,19,0.138686131386861
CDMX PONIENTE PEDREGAL,2023-06-11,123,112,11,0.0894308943089431
CDMX PONIENTE PEDREGAL,2023-06-12,159,144,15,0.0943396226415094
CDMX PONIENTE PEDREGAL,2023-06-13,120,103,17,0.141666666666667
CDMX PONIENTE PEDREGAL,2023-06-14,156,140,16,0.102564102564103
CDMX PONIENTE PEDREGAL,2023-06-15,144,138,6,0.0416666666666667
CDMX PONIENTE PEDREGAL,2023-06-16,129,113,16,0.124031007751938
CDMX PONIENTE PEDREGAL,2023-06-17,163,144,19,0.116564417177914
CDMX PONIENTE PEDREGAL,2023-06-18,104,97,7,0.0673076923076923
CDMX PONIENTE PEDREGAL,2023-06-19,137,123,14,0.102189781021898
CDMX PONIENTE PEDREGAL,2023-06-20,119,105,14,0.117647058823529
CDMX PONIENTE PEDREGAL,2023-06-21,110,98,12,0.109090909090909
CDMX PONIENTE PEDREGAL,2023-06-22,122,110,12,0.0983606557377049
CDMX PONIENTE PEDREGAL,2023-06-23,141,123,18,0.127659574468085
CDMX PONIENTE PEDREGAL,2023-06-24,136,130,6,0.0441176470588235
CDMX PONIENTE PEDREGAL,2023-06-25,98,94,4,0.0408163265306122
CDMX PONIENTE PEDREGAL,2023-06-26,114,106,8,0.0701754385964912
CDMX PONIENTE PEDREGAL,2023-06-27,104,96,8,0.0769230769230769
CDMX PONIENTE PEDREGAL,2023-06-28,104,100,4,0.0384615384615385
CDMX PONIENTE PEDREGAL,2023-06-29,113,109,4,0.0353982300884956
CDMX PONIENTE PEDREGAL,2023-06-30,123,104,19,0.154471544715447
CDMX PONIENTE PEDREGAL,2023-07-01,140,132,8,0.0571428571428571
CDMX PONIENTE PEDREGAL,2023-07-02,92,92,0,0
CDMX PONIENTE PEDREGAL,2023-07-03,92,86,6,0.0652173913043478
CDMX PONIENTE PEDREGAL,2023-07-04,117,109,8,0.0683760683760684
CDMX PONIENTE PEDREGAL,2023-07-05,94,87,7,0.074468085106383
CDMX PONIENTE PEDREGAL,2023-07-06,126,120,6,0.0476190476190476
CDMX PONIENTE PEDREGAL,2023-07-07,143,135,8,0.0559440559440559
CDMX PONIENTE PEDREGAL,2023-07-08,169,158,11,0.0650887573964497
CDMX PONIENTE PEDREGAL,2023-07-09,132,124,8,0.0606060606060606
CDMX PONIENTE PEDREGAL,2023-07-10,121,117,4,0.0330578512396694
CDMX PONIENTE PEDREGAL,2023-07-11,143,139,4,0.027972027972028
CDMX PONIENTE PEDREGAL,2023-07-12,120,115,5,0.0416666666666667
CDMX PONIENTE PEDREGAL,2023-07-13,141,136,5,0.0354609929078014
CDMX PONIENTE PEDREGAL,2023-07-14,105,101,4,0.0380952380952381
CDMX PONIENTE PEDREGAL,2023-07-15,133,128,5,0.037593984962406
CDMX PONIENTE PEDREGAL,2023-07-16,125,123,2,0.016
CDMX PONIENTE PEDREGAL,2023-07-17,148,142,6,0.0405405405405405
CDMX PONIENTE PEDREGAL,2023-07-18,129,125,4,0.0310077519379845
CDMX PONIENTE PEDREGAL,2023-07-19,141,133,8,0.0567375886524823
CDMX PONIENTE PEDREGAL,2023-07-20,145,138,7,0.0482758620689655
CDMX PONIENTE PEDREGAL,2023-07-21,141,139,2,0.0141843971631206
CDMX PONIENTE PEDREGAL,2023-07-22,151,147,4,0.0264900662251656
CDMX PONIENTE PEDREGAL,2023-07-23,138,134,4,0.0289855072463768
CDMX PONIENTE PEDREGAL,2023-07-24,143,136,7,0.048951048951049
CDMX PONIENTE PEDREGAL,2023-07-25,132,127,5,0.0378787878787879
CDMX PONIENTE PEDREGAL,2023-07-26,122,118,4,0.0327868852459016
CDMX PONIENTE PEDREGAL,2023-07-27,137,136,1,0.0072992700729927
CDMX PONIENTE PEDREGAL,2023-07-28,168,163,5,0.0297619047619048
CDMX PONIENTE PEDREGAL,2023-07-29,153,148,5,0.0326797385620915
CDMX PONIENTE PEDREGAL,2023-07-30,127,126,1,0.0078740157480315
CDMX PONIENTE PEDREGAL,2023-07-31,153,148,5,0.0326797385620915
CDMX PONIENTE PEDREGAL,2023-08-01,170,165,5,0.0294117647058824
CDMX PONIENTE PEDREGAL,2023-08-02,169,159,10,0.0591715976331361
CDMX PONIENTE PEDREGAL,2023-08-03,180,161,19,0.105555555555556
CDMX PONIENTE PEDREGAL,2023-08-04,159,151,8,0.050314465408805
CDMX PONIENTE PEDREGAL,2023-08-05,156,149,7,0.0448717948717949
CDMX PONIENTE PEDREGAL,2023-08-06,137,134,3,0.0218978102189781
CDMX PONIENTE PEDREGAL,2023-08-07,143,136,7,0.048951048951049
CDMX PONIENTE PEDREGAL,2023-08-08,142,140,2,0.0140845070422535
CDMX PONIENTE PEDREGAL,2023-08-09,152,147,5,0.0328947368421053
CDMX PONIENTE PEDREGAL,2023-08-10,135,128,7,0.0518518518518519
CDMX PONIENTE PEDREGAL,2023-08-11,161,157,4,0.0248447204968944
CDMX PONIENTE PEDREGAL,2023-08-12,148,143,5,0.0337837837837838
CDMX PONIENTE PEDREGAL,2023-08-13,130,128,2,0.0153846153846154
CDMX PONIENTE PEDREGAL,2023-08-14,122,118,4,0.0327868852459016
CDMX PONIENTE PEDREGAL,2023-08-15,186,180,6,0.032258064516129
CDMX PONIENTE PEDREGAL,2023-08-16,151,147,4,0.0264900662251656
CDMX PONIENTE PEDREGAL,2023-08-17,131,125,6,0.0458015267175573
CDMX PONIENTE PEDREGAL,2023-08-18,180,169,11,0.0611111111111111
CDMX PONIENTE PEDREGAL,2023-08-19,150,142,8,0.0533333333333333
CDMX PONIENTE PEDREGAL,2023-08-20,142,136,6,0.0422535211267606
CDMX PONIENTE PEDREGAL,2023-08-21,122,121,1,0.00819672131147541
CDMX PONIENTE PEDREGAL,2023-08-22,131,129,2,0.0152671755725191
CDMX PONIENTE PEDREGAL,2023-08-23,135,132,3,0.0222222222222222
CDMX PONIENTE PEDREGAL,2023-08-24,159,157,2,0.0125786163522013
CDMX PONIENTE PEDREGAL,2023-08-25,138,137,1,0.0072463768115942
CDMX PONIENTE PEDREGAL,2023-08-26,161,159,2,0.0124223602484472
CDMX PONIENTE PEDREGAL,2023-08-27,180,179,1,0.00555555555555556
CDMX PONIENTE PEDREGAL,2023-08-28,123,121,2,0.016260162601626
CDMX PONIENTE PEDREGAL,2023-08-29,138,137,1,0.0072463768115942
CDMX PONIENTE PEDREGAL,2023-08-30,153,151,2,0.0130718954248366
CDMX PONIENTE PEDREGAL,2023-08-31,147,145,2,0.0136054421768707
CDMX PONIENTE PEDREGAL,2023-09-01,153,151,2,0.0130718954248366
CDMX PONIENTE PEDREGAL,2023-09-02,155,153,2,0.0129032258064516
CDMX PONIENTE PEDREGAL,2023-09-03,128,126,2,0.015625
CDMX PONIENTE PEDREGAL,2023-09-04,121,121,0,0
CDMX PONIENTE PEDREGAL,2023-09-05,137,135,2,0.0145985401459854
CDMX PONIENTE PEDREGAL,2023-09-06,120,119,1,0.00833333333333333
CDMX PONIENTE PEDREGAL,2023-09-07,121,120,1,0.00826446280991736
CDMX PONIENTE PEDREGAL,2023-09-08,108,107,1,0.00925925925925926
CDMX PONIENTE PEDREGAL,2023-09-09,147,145,2,0.0136054421768707
CDMX PONIENTE PEDREGAL,2023-09-10,107,107,0,0
CDMX PONIENTE PEDREGAL,2023-09-11,138,135,3,0.0217391304347826
CDMX PONIENTE PEDREGAL,2023-09-12,138,136,2,0.0144927536231884
CDMX PONIENTE PEDREGAL,2023-09-13,107,106,1,0.00934579439252336
CDMX PONIENTE PEDREGAL,2023-09-14,124,122,2,0.0161290322580645
CDMX PONIENTE PEDREGAL,2023-09-15,153,151,2,0.0130718954248366
CDMX PONIENTE PEDREGAL,2023-09-16,98,96,2,0.0204081632653061
CDMX PONIENTE PEDREGAL,2023-09-17,106,103,3,0.0283018867924528
CDMX PONIENTE PEDREGAL,2023-09-18,138,136,2,0.0144927536231884
CDMX PONIENTE PEDREGAL,2023-09-19,136,135,1,0.00735294117647059
CDMX PONIENTE PEDREGAL,2023-09-20,124,123,1,0.00806451612903226
CDMX PONIENTE PEDREGAL,2023-09-21,144,141,3,0.0208333333333333
CDMX PONIENTE PEDREGAL,2023-09-22,128,124,4,0.03125
CDMX PONIENTE PEDREGAL,2023-09-23,148,145,3,0.0202702702702703
CDMX PONIENTE PEDREGAL,2023-09-24,117,115,2,0.0170940170940171
CDMX PONIENTE PEDREGAL,2023-09-25,129,126,3,0.0232558139534884
CDMX PONIENTE PEDREGAL,2023-09-26,138,137,1,0.0072463768115942
CDMX PONIENTE PEDREGAL,2023-09-27,129,128,1,0.00775193798449612
CDMX PONIENTE PEDREGAL,2023-09-28,131,129,2,0.0152671755725191
CDMX PONIENTE PEDREGAL,2023-09-29,147,139,8,0.054421768707483
CDMX PONIENTE PEDREGAL,2023-09-30,168,161,7,0.0416666666666667
CDMX PONIENTE PEDREGAL,2023-10-01,119,117,2,0.0168067226890756
CDMX PONIENTE PEDREGAL,2023-10-02,125,125,0,0
CDMX PONIENTE PEDREGAL,2023-10-03,126,122,4,0.0317460317460317
CDMX PONIENTE PEDREGAL,2023-10-04,112,110,2,0.0178571428571429
CDMX PONIENTE PEDREGAL,2023-10-05,112,110,2,0.0178571428571429
CDMX PONIENTE PEDREGAL,2023-10-06,122,119,3,0.0245901639344262
CDMX PONIENTE PEDREGAL,2023-10-07,143,142,1,0.00699300699300699
CDMX PONIENTE PEDREGAL,2023-10-08,95,88,7,0.0736842105263158
CDMX PONIENTE PEDREGAL,2023-10-09,111,109,2,0.018018018018018
CDMX PONIENTE PEDREGAL,2023-10-10,129,125,4,0.0310077519379845
CDMX PONIENTE PEDREGAL,2023-10-11,115,111,4,0.0347826086956522
CDMX PONIENTE PEDREGAL,2023-10-12,93,89,4,0.043010752688172
CDMX PONIENTE PEDREGAL,2023-10-13,109,105,4,0.036697247706422
CDMX PONIENTE PEDREGAL,2023-10-14,119,115,4,0.0336134453781513
CDMX PONIENTE PEDREGAL,2023-10-15,126,124,2,0.0158730158730159
CDMX PONIENTE PEDREGAL,2023-10-16,141,138,3,0.0212765957446809
CDMX PONIENTE PEDREGAL,2023-10-17,124,122,2,0.0161290322580645
CDMX PONIENTE PEDREGAL,2023-10-18,111,107,4,0.036036036036036
CDMX PONIENTE PEDREGAL,2023-10-19,142,136,6,0.0422535211267606
CDMX PONIENTE PEDREGAL,2023-10-20,126,122,4,0.0317460317460317
CDMX PONIENTE PEDREGAL,2023-10-21,115,112,3,0.0260869565217391
CDMX PONIENTE PEDREGAL,2023-10-22,122,120,2,0.0163934426229508
CDMX PONIENTE PEDREGAL,2023-10-23,93,90,3,0.032258064516129
CDMX PONIENTE PEDREGAL,2023-10-24,106,101,5,0.0471698113207547
CDMX PONIENTE PEDREGAL,2023-10-25,119,115,4,0.0336134453781513
CDMX PONIENTE PEDREGAL,2023-10-26,111,108,3,0.027027027027027
CDMX PONIENTE PEDREGAL,2023-10-27,116,114,2,0.0172413793103448
CDMX PONIENTE PEDREGAL,2023-10-28,149,146,3,0.0201342281879195
CDMX PONIENTE PEDREGAL,2023-10-29,120,118,2,0.0166666666666667
CDMX PONIENTE PEDREGAL,2023-10-30,126,125,1,0.00793650793650794
CDMX PONIENTE PEDREGAL,2023-10-31,157,153,4,0.0254777070063694
CDMX PONIENTE PEDREGAL,2023-11-01,138,136,2,0.0144927536231884
CDMX PONIENTE PEDREGAL,2023-11-02,107,107,0,0
CDMX PONIENTE PEDREGAL,2023-11-03,114,111,3,0.0263157894736842
CDMX PONIENTE PEDREGAL,2023-11-04,142,142,0,0
CDMX PONIENTE PEDREGAL,2023-11-05,123,122,1,0.00813008130081301
CDMX PONIENTE PEDREGAL,2023-11-06,130,130,0,0
CDMX PONIENTE PEDREGAL,2023-11-07,132,131,1,0.00757575757575758
CDMX PONIENTE PEDREGAL,2023-11-08,133,130,3,0.0225563909774436
CDMX PONIENTE PEDREGAL,2023-11-09,119,116,3,0.0252100840336134
CDMX PONIENTE PEDREGAL,2023-11-10,133,131,2,0.0150375939849624
CDMX PONIENTE PEDREGAL,2023-11-11,170,166,4,0.0235294117647059
CDMX PONIENTE PEDREGAL,2023-11-12,130,128,2,0.0153846153846154
CDMX PONIENTE PEDREGAL,2023-11-13,140,136,4,0.0285714285714286
CDMX PONIENTE PEDREGAL,2023-11-14,160,156,4,0.025
CDMX PONIENTE PEDREGAL,2023-11-15,152,150,2,0.0131578947368421
CDMX PONIENTE PEDREGAL,2023-11-16,142,139,3,0.0211267605633803
CDMX PONIENTE PEDREGAL,2023-11-17,174,168,6,0.0344827586206897
CDMX PONIENTE PEDREGAL,2023-11-18,221,218,3,0.0135746606334842
CDMX PONIENTE PEDREGAL,2023-11-19,163,158,5,0.0306748466257669
CDMX PONIENTE PEDREGAL,2023-11-20,162,156,6,0.037037037037037
CDMX PONIENTE PEDREGAL,2023-11-21,162,159,3,0.0185185185185185
CDMX PONIENTE PEDREGAL,2023-11-22,147,144,3,0.0204081632653061
CDMX PONIENTE PEDREGAL,2023-11-23,163,158,5,0.0306748466257669
CDMX PONIENTE PEDREGAL,2023-11-24,156,153,3,0.0192307692307692
CDMX PONIENTE PEDREGAL,2023-11-25,166,165,1,0.00602409638554217
CDMX PONIENTE PEDREGAL,2023-11-26,156,152,4,0.0256410256410256
CDMX PONIENTE PEDREGAL,2023-11-27,170,166,4,0.0235294117647059
CDMX PONIENTE PEDREGAL,2023-11-28,164,161,3,0.0182926829268293
CDMX PONIENTE PEDREGAL,2023-11-29,165,155,10,0.0606060606060606
CDMX PONIENTE PEDREGAL,2023-11-30,186,172,14,0.0752688172043011
CDMX PONIENTE PEDREGAL,2023-12-01,151,144,7,0.0463576158940397
CDMX PONIENTE PEDREGAL,2023-12-02,161,154,7,0.0434782608695652
CDMX PONIENTE PEDREGAL,2023-12-03,164,156,8,0.0487804878048781
CDMX PONIENTE PEDREGAL,2023-12-04,147,143,4,0.0272108843537415
CDMX PONIENTE PEDREGAL,2023-12-05,141,131,10,0.0709219858156028
CDMX PONIENTE PEDREGAL,2023-12-06,136,130,6,0.0441176470588235
CDMX PONIENTE PEDREGAL,2023-12-07,127,120,7,0.0551181102362205
CDMX PONIENTE PEDREGAL,2023-12-08,123,118,5,0.040650406504065
CDMX PONIENTE PEDREGAL,2023-12-09,146,143,3,0.0205479452054795
CDMX PONIENTE PEDREGAL,2023-12-10,120,118,2,0.0166666666666667
CDMX PONIENTE PEDREGAL,2023-12-11,138,134,4,0.0289855072463768
CDMX PONIENTE PEDREGAL,2023-12-12,140,136,4,0.0285714285714286
CDMX PONIENTE PEDREGAL,2023-12-13,136,135,1,0.00735294117647059
CDMX PONIENTE PEDREGAL,2023-12-14,122,119,3,0.0245901639344262
CDMX PONIENTE PEDREGAL,2023-12-15,130,130,0,0
CDMX PONIENTE PEDREGAL,2023-12-16,150,149,1,0.00666666666666667
CDMX PONIENTE PEDREGAL,2023-12-17,109,106,3,0.0275229357798165
CDMX PONIENTE PEDREGAL,2023-12-18,175,172,3,0.0171428571428571
CDMX PONIENTE PEDREGAL,2023-12-19,154,150,4,0.025974025974026
CDMX PONIENTE PEDREGAL,2023-12-20,150,143,7,0.0466666666666667
CDMX PONIENTE PEDREGAL,2023-12-21,148,145,3,0.0202702702702703
CDMX PONIENTE PEDREGAL,2023-12-22,125,122,3,0.024
CDMX PONIENTE PEDREGAL,2023-12-23,128,125,3,0.0234375
CDMX PONIENTE PEDREGAL,2023-12-24,91,89,2,0.021978021978022
CDMX PONIENTE PEDREGAL,2023-12-25,39,39,0,0
CDMX PONIENTE PEDREGAL,2023-12-26,133,126,7,0.0526315789473684
CDMX PONIENTE PEDREGAL,2023-12-27,158,157,1,0.00632911392405063
CDMX PONIENTE PEDREGAL,2023-12-28,137,132,5,0.0364963503649635
CDMX PONIENTE PEDREGAL,2023-12-29,154,151,3,0.0194805194805195
CDMX PONIENTE PEDREGAL,2023-12-30,177,172,5,0.0282485875706215
CDMX PONIENTE PEDREGAL,2023-12-31,93,88,5,0.0537634408602151
CDMX PONIENTE PEDREGAL,2024-01-01,34,34,0,0
CDMX PONIENTE PEDREGAL,2024-01-02,139,138,1,0.00719424460431655
CDMX PONIENTE PEDREGAL,2024-01-03,149,147,2,0.0134228187919463
CDMX PONIENTE PEDREGAL,2024-01-04,145,143,2,0.0137931034482759
CDMX PONIENTE PEDREGAL,2024-01-05,133,129,4,0.0300751879699248
CDMX PONIENTE PEDREGAL,2024-01-06,143,140,3,0.020979020979021
CDMX PONIENTE PEDREGAL,2024-01-07,128,125,3,0.0234375
CDMX PONIENTE PEDREGAL,2024-01-08,153,149,4,0.0261437908496732
CDMX PONIENTE PEDREGAL,2024-01-09,149,148,1,0.00671140939597315
CDMX PONIENTE PEDREGAL,2024-01-10,120,116,4,0.0333333333333333
CDMX PONIENTE PEDREGAL,2024-01-11,138,133,5,0.036231884057971
CDMX PONIENTE PEDREGAL,2024-01-12,157,154,3,0.0191082802547771
CDMX PONIENTE PEDREGAL,2024-01-13,166,159,7,0.0421686746987952
CDMX PONIENTE PEDREGAL,2024-01-14,153,148,5,0.0326797385620915
CDMX PONIENTE PEDREGAL,2024-01-15,166,158,8,0.0481927710843374
CDMX PONIENTE PEDREGAL,2024-01-16,163,160,3,0.0184049079754601
CDMX PONIENTE PEDREGAL,2024-01-17,143,137,6,0.041958041958042
CDMX PONIENTE PEDREGAL,2024-01-18,151,147,4,0.0264900662251656
CDMX PONIENTE PEDREGAL,2024-01-19,141,137,4,0.0283687943262411
CDMX PONIENTE PEDREGAL,2024-01-20,142,135,7,0.0492957746478873
CDMX PONIENTE PEDREGAL,2024-01-21,114,113,1,0.0087719298245614
CDMX PONIENTE PEDREGAL,2024-01-22,160,152,8,0.05
CDMX PONIENTE PEDREGAL,2024-01-23,138,138,0,0
CDMX PONIENTE PEDREGAL,2024-01-24,149,144,5,0.0335570469798658
CDMX PONIENTE PEDREGAL,2024-01-25,143,139,4,0.027972027972028
CDMX PONIENTE PEDREGAL,2024-01-26,157,154,3,0.0191082802547771
CDMX PONIENTE PEDREGAL,2024-01-27,162,158,4,0.0246913580246914
CDMX PONIENTE PEDREGAL,2024-01-28,130,127,3,0.0230769230769231
CDMX PONIENTE PEDREGAL,2024-01-29,172,168,4,0.0232558139534884
CDMX PONIENTE PEDREGAL,2024-01-30,139,134,5,0.0359712230215827
CDMX PONIENTE PEDREGAL,2024-01-31,159,156,3,0.0188679245283019
CDMX PONIENTE PEDREGAL,2024-02-01,134,132,2,0.0149253731343284
CDMX PONIENTE PEDREGAL,2024-02-02,153,150,3,0.0196078431372549
CDMX PONIENTE PEDREGAL,2024-02-03,163,161,2,0.0122699386503067
CDMX PONIENTE PEDREGAL,2024-02-04,143,140,3,0.020979020979021
CDMX PONIENTE PEDREGAL,2024-02-05,138,133,5,0.036231884057971
CDMX PONIENTE PEDREGAL,2024-02-06,151,146,5,0.033112582781457
CDMX PONIENTE PEDREGAL,2024-02-07,149,143,6,0.0402684563758389
CDMX PONIENTE PEDREGAL,2024-02-08,119,117,2,0.0168067226890756
CDMX PONIENTE PEDREGAL,2024-02-09,142,139,3,0.0211267605633803
CDMX PONIENTE PEDREGAL,2024-02-10,170,166,4,0.0235294117647059
CDMX PONIENTE PEDREGAL,2024-02-11,128,125,3,0.0234375
CDMX PONIENTE PEDREGAL,2024-02-12,126,116,10,0.0793650793650794
CDMX PONIENTE PEDREGAL,2024-02-13,145,144,1,0.00689655172413793
CDMX PONIENTE PEDREGAL,2024-02-14,153,148,5,0.0326797385620915
CDMX PONIENTE PEDREGAL,2024-02-15,130,126,4,0.0307692307692308
CDMX PONIENTE PEDREGAL,2024-02-16,155,154,1,0.00645161290322581
CDMX PONIENTE PEDREGAL,2024-02-17,165,165,0,0
CDMX PONIENTE PEDREGAL,2024-02-18,162,158,4,0.0246913580246914
CDMX PONIENTE PEDREGAL,2024-02-19,142,134,8,0.0563380281690141
CDMX PONIENTE PEDREGAL,2024-02-20,139,136,3,0.0215827338129496
CDMX PONIENTE PEDREGAL,2024-02-21,144,138,6,0.0416666666666667
CDMX PONIENTE PEDREGAL,2024-02-22,114,110,4,0.0350877192982456
CDMX PONIENTE PEDREGAL,2024-02-23,103,96,7,0.0679611650485437
CDMX PONIENTE PEDREGAL,2024-02-24,132,132,0,0
CDMX PONIENTE PEDREGAL,2024-02-25,130,130,0,0
CDMX PONIENTE PEDREGAL,2024-02-26,150,146,4,0.0266666666666667
CDMX PONIENTE PEDREGAL,2024-02-27,150,148,2,0.0133333333333333
CDMX PONIENTE PEDREGAL,2024-02-28,156,154,2,0.0128205128205128
CDMX PONIENTE PEDREGAL,2024-02-29,167,164,3,0.0179640718562874
CDMX PONIENTE PEDREGAL,2024-03-01,140,134,6,0.0428571428571429
CDMX PONIENTE PEDREGAL,2024-03-02,164,160,4,0.024390243902439
CDMX PONIENTE PEDREGAL,2024-03-03,132,130,2,0.0151515151515152
CDMX PONIENTE PEDREGAL,2024-03-04,143,136,7,0.048951048951049
CDMX PONIENTE PEDREGAL,2024-03-05,148,145,3,0.0202702702702703
CDMX PONIENTE PEDREGAL,2024-03-06,156,154,2,0.0128205128205128
CDMX PONIENTE PEDREGAL,2024-03-07,137,135,2,0.0145985401459854
CDMX PONIENTE PEDREGAL,2024-03-08,149,146,3,0.0201342281879195
CDMX PONIENTE PEDREGAL,2024-03-09,174,169,5,0.028735632183908
CDMX PONIENTE PEDREGAL,2024-03-10,120,119,1,0.00833333333333333
CDMX PONIENTE PEDREGAL,2024-03-11,152,149,3,0.0197368421052632
CDMX SUR ORIENTE,2023-03-12,242,220,22,0.0909090909090909
CDMX SUR ORIENTE,2023-03-13,222,202,20,0.0900900900900901
CDMX SUR ORIENTE,2023-03-14,271,250,21,0.0774907749077491
CDMX SUR ORIENTE,2023-03-15,252,243,9,0.0357142857142857
CDMX SUR ORIENTE,2023-03-16,320,312,8,0.025
CDMX SUR ORIENTE,2023-03-17,366,363,3,0.00819672131147541
CDMX SUR ORIENTE,2023-03-18,395,383,12,0.030379746835443
CDMX SUR ORIENTE,2023-03-19,416,401,15,0.0360576923076923
CDMX SUR ORIENTE,2023-03-20,447,442,5,0.0111856823266219
CDMX SUR ORIENTE,2023-03-21,302,298,4,0.0132450331125828
CDMX SUR ORIENTE,2023-03-22,270,263,7,0.0259259259259259
CDMX SUR ORIENTE,2023-03-23,283,279,4,0.0141342756183746
CDMX SUR ORIENTE,2023-03-24,263,263,0,0
CDMX SUR ORIENTE,2023-03-25,307,306,1,0.00325732899022801
CDMX SUR ORIENTE,2023-03-26,313,313,0,0
CDMX SUR ORIENTE,2023-03-27,232,231,1,0.00431034482758621
CDMX SUR ORIENTE,2023-03-28,197,197,0,0
CDMX SUR ORIENTE,2023-03-29,227,225,2,0.00881057268722467
CDMX SUR ORIENTE,2023-03-30,335,331,4,0.0119402985074627
CDMX SUR ORIENTE,2023-03-31,382,376,6,0.0157068062827225
CDMX SUR ORIENTE,2023-04-01,330,327,3,0.00909090909090909
CDMX SUR ORIENTE,2023-04-02,302,300,2,0.00662251655629139
CDMX SUR ORIENTE,2023-04-03,336,330,6,0.0178571428571429
CDMX SUR ORIENTE,2023-04-04,183,179,4,0.0218579234972678
CDMX SUR ORIENTE,2023-04-05,231,229,2,0.00865800865800866
CDMX SUR ORIENTE,2023-04-06,254,251,3,0.0118110236220472
CDMX SUR ORIENTE,2023-04-07,222,222,0,0
CDMX SUR ORIENTE,2023-04-08,184,184,0,0
CDMX SUR ORIENTE,2023-04-09,188,186,2,0.0106382978723404
CDMX SUR ORIENTE,2023-04-10,201,201,0,0
CDMX SUR ORIENTE,2023-04-11,231,229,2,0.00865800865800866
CDMX SUR ORIENTE,2023-04-12,236,236,0,0
CDMX SUR ORIENTE,2023-04-13,221,218,3,0.0135746606334842
CDMX SUR ORIENTE,2023-04-14,269,269,0,0
CDMX SUR ORIENTE,2023-04-15,350,350,0,0
CDMX SUR ORIENTE,2023-04-16,387,386,1,0.00258397932816537
CDMX SUR ORIENTE,2023-04-17,350,348,2,0.00571428571428571
CDMX SUR ORIENTE,2023-04-18,279,277,2,0.00716845878136201
CDMX SUR ORIENTE,2023-04-19,234,233,1,0.00427350427350427
CDMX SUR ORIENTE,2023-04-20,229,228,1,0.00436681222707424
CDMX SUR ORIENTE,2023-04-21,278,277,1,0.00359712230215827
CDMX SUR ORIENTE,2023-04-22,308,308,0,0
CDMX SUR ORIENTE,2023-04-23,270,270,0,0
CDMX SUR ORIENTE,2023-04-24,280,280,0,0
CDMX SUR ORIENTE,2023-04-25,339,337,2,0.00589970501474926
CDMX SUR ORIENTE,2023-04-26,297,297,0,0
CDMX SUR ORIENTE,2023-04-27,212,209,3,0.0141509433962264
CDMX SUR ORIENTE,2023-04-28,316,312,4,0.0126582278481013
CDMX SUR ORIENTE,2023-04-29,365,361,4,0.010958904109589
CDMX SUR ORIENTE,2023-04-30,341,331,10,0.0293255131964809
CDMX SUR ORIENTE,2023-05-01,325,318,7,0.0215384615384615
CDMX SUR ORIENTE,2023-05-02,305,302,3,0.00983606557377049
CDMX SUR ORIENTE,2023-05-03,249,243,6,0.0240963855421687
CDMX SUR ORIENTE,2023-05-04,230,227,3,0.0130434782608696
CDMX SUR ORIENTE,2023-05-05,255,251,4,0.0156862745098039
CDMX SUR ORIENTE,2023-05-06,299,296,3,0.0100334448160535
CDMX SUR ORIENTE,2023-05-07,210,205,5,0.0238095238095238
CDMX SUR ORIENTE,2023-05-08,249,246,3,0.0120481927710843
CDMX SUR ORIENTE,2023-05-09,215,208,7,0.0325581395348837
CDMX SUR ORIENTE,2023-05-10,219,213,6,0.0273972602739726
CDMX SUR ORIENTE,2023-05-11,216,214,2,0.00925925925925926
CDMX SUR ORIENTE,2023-05-12,235,231,4,0.0170212765957447
CDMX SUR ORIENTE,2023-05-13,346,341,5,0.0144508670520231
CDMX SUR ORIENTE,2023-05-14,368,362,6,0.016304347826087
CDMX SUR ORIENTE,2023-05-15,416,410,6,0.0144230769230769
CDMX SUR ORIENTE,2023-05-16,461,457,4,0.00867678958785249
CDMX SUR ORIENTE,2023-05-17,360,352,8,0.0222222222222222
CDMX SUR ORIENTE,2023-05-18,259,252,7,0.027027027027027
CDMX SUR ORIENTE,2023-05-19,290,285,5,0.0172413793103448
CDMX SUR ORIENTE,2023-05-20,317,313,4,0.0126182965299685
CDMX SUR ORIENTE,2023-05-21,304,299,5,0.0164473684210526
CDMX SUR ORIENTE,2023-05-22,307,306,1,0.00325732899022801
CDMX SUR ORIENTE,2023-05-23,290,286,4,0.0137931034482759
CDMX SUR ORIENTE,2023-05-24,268,259,9,0.0335820895522388
CDMX SUR ORIENTE,2023-05-25,253,248,5,0.0197628458498024
CDMX SUR ORIENTE,2023-05-26,329,324,5,0.0151975683890578
CDMX SUR ORIENTE,2023-05-27,311,301,10,0.0321543408360129
CDMX SUR ORIENTE,2023-05-28,312,309,3,0.00961538461538462
CDMX SUR ORIENTE,2023-05-29,263,259,4,0.0152091254752852
CDMX SUR ORIENTE,2023-05-30,288,279,9,0.03125
CDMX SUR ORIENTE,2023-05-31,361,359,2,0.00554016620498615
CDMX SUR ORIENTE,2023-06-01,255,250,5,0.0196078431372549
CDMX SUR ORIENTE,2023-06-02,241,237,4,0.016597510373444
CDMX SUR ORIENTE,2023-06-03,328,326,2,0.00609756097560976
CDMX SUR ORIENTE,2023-06-04,325,319,6,0.0184615384615385
CDMX SUR ORIENTE,2023-06-05,269,265,4,0.0148698884758364
CDMX SUR ORIENTE,2023-06-06,236,232,4,0.0169491525423729
CDMX SUR ORIENTE,2023-06-07,226,220,6,0.0265486725663717
CDMX SUR ORIENTE,2023-06-08,225,222,3,0.0133333333333333
CDMX SUR ORIENTE,2023-06-09,217,214,3,0.0138248847926267
CDMX SUR ORIENTE,2023-06-10,308,304,4,0.012987012987013
CDMX SUR ORIENTE,2023-06-11,294,290,4,0.0136054421768707
CDMX SUR ORIENTE,2023-06-12,259,253,6,0.0231660231660232
CDMX SUR ORIENTE,2023-06-13,260,256,4,0.0153846153846154
CDMX SUR ORIENTE,2023-06-14,287,281,6,0.0209059233449477
CDMX SUR ORIENTE,2023-06-15,270,264,6,0.0222222222222222
CDMX SUR ORIENTE,2023-06-16,284,279,5,0.0176056338028169
CDMX SUR ORIENTE,2023-06-17,326,318,8,0.0245398773006135
CDMX SUR ORIENTE,2023-06-18,273,267,6,0.021978021978022
CDMX SUR ORIENTE,2023-06-19,279,276,3,0.010752688172043
CDMX SUR ORIENTE,2023-06-20,278,273,5,0.0179856115107914
CDMX SUR ORIENTE,2023-06-21,266,261,5,0.018796992481203
CDMX SUR ORIENTE,2023-06-22,230,225,5,0.0217391304347826
CDMX SUR ORIENTE,2023-06-23,230,223,7,0.0304347826086957
CDMX SUR ORIENTE,2023-06-24,292,284,8,0.0273972602739726
CDMX SUR ORIENTE,2023-06-25,233,224,9,0.0386266094420601
CDMX SUR ORIENTE,2023-06-26,243,239,4,0.0164609053497942
CDMX SUR ORIENTE,2023-06-27,225,223,2,0.00888888888888889
CDMX SUR ORIENTE,2023-06-28,224,216,8,0.0357142857142857
CDMX SUR ORIENTE,2023-06-29,263,253,10,0.0380228136882129
CDMX SUR ORIENTE,2023-06-30,203,196,7,0.0344827586206897
CDMX SUR ORIENTE,2023-07-01,340,336,4,0.0117647058823529
CDMX SUR ORIENTE,2023-07-02,249,246,3,0.0120481927710843
CDMX SUR ORIENTE,2023-07-03,245,240,5,0.0204081632653061
CDMX SUR ORIENTE,2023-07-04,237,231,6,0.0253164556962025
CDMX SUR ORIENTE,2023-07-05,254,251,3,0.0118110236220472
CDMX SUR ORIENTE,2023-07-06,237,232,5,0.0210970464135021
CDMX SUR ORIENTE,2023-07-07,258,251,7,0.0271317829457364
CDMX SUR ORIENTE,2023-07-08,315,307,8,0.0253968253968254
CDMX SUR ORIENTE,2023-07-09,245,244,1,0.00408163265306122
CDMX SUR ORIENTE,2023-07-10,295,287,8,0.0271186440677966
CDMX SUR ORIENTE,2023-07-11,256,249,7,0.02734375
CDMX SUR ORIENTE,2023-07-12,254,248,6,0.0236220472440945
CDMX SUR ORIENTE,2023-07-13,243,233,10,0.0411522633744856
CDMX SUR ORIENTE,2023-07-14,252,246,6,0.0238095238095238
CDMX SUR ORIENTE,2023-07-15,326,321,5,0.0153374233128834
CDMX SUR ORIENTE,2023-07-16,294,287,7,0.0238095238095238
CDMX SUR ORIENTE,2023-07-17,312,308,4,0.0128205128205128
CDMX SUR ORIENTE,2023-07-18,285,281,4,0.0140350877192982
CDMX SUR ORIENTE,2023-07-19,250,242,8,0.032
CDMX SUR ORIENTE,2023-07-20,271,270,1,0.003690036900369
CDMX SUR ORIENTE,2023-07-21,268,264,4,0.0149253731343284
CDMX SUR ORIENTE,2023-07-22,309,302,7,0.0226537216828479
CDMX SUR ORIENTE,2023-07-23,252,249,3,0.0119047619047619
CDMX SUR ORIENTE,2023-07-24,240,236,4,0.0166666666666667
CDMX SUR ORIENTE,2023-07-25,281,276,5,0.0177935943060498
CDMX SUR ORIENTE,2023-07-26,309,308,1,0.00323624595469256
CDMX SUR ORIENTE,2023-07-27,284,280,4,0.0140845070422535
CDMX SUR ORIENTE,2023-07-28,294,288,6,0.0204081632653061
CDMX SUR ORIENTE,2023-07-29,325,323,2,0.00615384615384615
CDMX SUR ORIENTE,2023-07-30,366,360,6,0.0163934426229508
CDMX SUR ORIENTE,2023-07-31,399,393,6,0.0150375939849624
CDMX SUR ORIENTE,2023-08-01,308,299,9,0.0292207792207792
CDMX SUR ORIENTE,2023-08-02,238,229,9,0.0378151260504202
CDMX SUR ORIENTE,2023-08-03,248,241,7,0.0282258064516129
CDMX SUR ORIENTE,2023-08-04,275,270,5,0.0181818181818182
CDMX SUR ORIENTE,2023-08-05,336,324,12,0.0357142857142857
CDMX SUR ORIENTE,2023-08-06,284,273,11,0.0387323943661972
CDMX SUR ORIENTE,2023-08-07,275,267,8,0.0290909090909091
CDMX SUR ORIENTE,2023-08-08,247,239,8,0.0323886639676113
CDMX SUR ORIENTE,2023-08-09,278,270,8,0.0287769784172662
CDMX SUR ORIENTE,2023-08-10,254,247,7,0.0275590551181102
CDMX SUR ORIENTE,2023-08-11,269,266,3,0.0111524163568773
CDMX SUR ORIENTE,2023-08-12,277,271,6,0.0216606498194946
CDMX SUR ORIENTE,2023-08-13,324,310,14,0.0432098765432099
CDMX SUR ORIENTE,2023-08-14,286,277,9,0.0314685314685315
CDMX SUR ORIENTE,2023-08-15,313,307,6,0.0191693290734824
CDMX SUR ORIENTE,2023-08-16,326,313,13,0.0398773006134969
CDMX SUR ORIENTE,2023-08-17,268,262,6,0.0223880597014925
CDMX SUR ORIENTE,2023-08-18,276,271,5,0.0181159420289855
CDMX SUR ORIENTE,2023-08-19,298,292,6,0.0201342281879195
CDMX SUR ORIENTE,2023-08-20,264,258,6,0.0227272727272727
CDMX SUR ORIENTE,2023-08-21,240,240,0,0
CDMX SUR ORIENTE,2023-08-22,245,245,0,0
CDMX SUR ORIENTE,2023-08-23,264,264,0,0
CDMX SUR ORIENTE,2023-08-24,247,247,0,0
CDMX SUR ORIENTE,2023-08-25,315,315,0,0
CDMX SUR ORIENTE,2023-08-26,380,378,2,0.00526315789473684
CDMX SUR ORIENTE,2023-08-27,369,369,0,0
CDMX SUR ORIENTE,2023-08-28,309,309,0,0
CDMX SUR ORIENTE,2023-08-29,332,332,0,0
CDMX SUR ORIENTE,2023-08-30,330,329,1,0.00303030303030303
CDMX SUR ORIENTE,2023-08-31,302,300,2,0.00662251655629139
CDMX SUR ORIENTE,2023-09-01,278,277,1,0.00359712230215827
CDMX SUR ORIENTE,2023-09-02,291,291,0,0
CDMX SUR ORIENTE,2023-09-03,237,237,0,0
CDMX SUR ORIENTE,2023-09-04,247,246,1,0.00404858299595142
CDMX SUR ORIENTE,2023-09-05,256,255,1,0.00390625
CDMX SUR ORIENTE,2023-09-06,256,256,0,0
CDMX SUR ORIENTE,2023-09-07,289,288,1,0.00346020761245675
CDMX SUR ORIENTE,2023-09-08,225,224,1,0.00444444444444444
CDMX SUR ORIENTE,2023-09-09,293,293,0,0
CDMX SUR ORIENTE,2023-09-10,280,280,0,0
CDMX SUR ORIENTE,2023-09-11,218,218,0,0
CDMX SUR ORIENTE,2023-09-12,159,158,1,0.00628930817610063
CDMX SUR ORIENTE,2023-09-13,177,177,0,0
CDMX SUR ORIENTE,2023-09-14,193,191,2,0.0103626943005181
CDMX SUR ORIENTE,2023-09-15,167,166,1,0.00598802395209581
CDMX SUR ORIENTE,2023-09-16,243,240,3,0.0123456790123457
CDMX SUR ORIENTE,2023-09-17,294,293,1,0.00340136054421769
CDMX SUR ORIENTE,2023-09-18,238,238,0,0
CDMX SUR ORIENTE,2023-09-19,241,241,0,0
CDMX SUR ORIENTE,2023-09-20,166,165,1,0.00602409638554217
CDMX SUR ORIENTE,2023-09-21,265,264,1,0.00377358490566038
CDMX SUR ORIENTE,2023-09-22,300,299,1,0.00333333333333333
CDMX SUR ORIENTE,2023-09-23,300,300,0,0
CDMX SUR ORIENTE,2023-09-24,321,321,0,0
CDMX SUR ORIENTE,2023-09-25,288,288,0,0
CDMX SUR ORIENTE,2023-09-26,254,254,0,0
CDMX SUR ORIENTE,2023-09-27,250,249,1,0.004
CDMX SUR ORIENTE,2023-09-28,293,293,0,0
CDMX SUR ORIENTE,2023-09-29,367,367,0,0
CDMX SUR ORIENTE,2023-09-30,385,382,3,0.00779220779220779
CDMX SUR ORIENTE,2023-10-01,277,277,0,0
CDMX SUR ORIENTE,2023-10-02,250,250,0,0
CDMX SUR ORIENTE,2023-10-03,242,234,8,0.0330578512396694
CDMX SUR ORIENTE,2023-10-04,241,236,5,0.020746887966805
CDMX SUR ORIENTE,2023-10-05,244,237,7,0.0286885245901639
CDMX SUR ORIENTE,2023-10-06,258,253,5,0.0193798449612403
CDMX SUR ORIENTE,2023-10-07,294,289,5,0.0170068027210884
CDMX SUR ORIENTE,2023-10-08,293,283,10,0.0341296928327645
CDMX SUR ORIENTE,2023-10-09,259,252,7,0.027027027027027
CDMX SUR ORIENTE,2023-10-10,206,201,5,0.0242718446601942
CDMX SUR ORIENTE,2023-10-11,223,219,4,0.0179372197309417
CDMX SUR ORIENTE,2023-10-12,205,203,2,0.00975609756097561
CDMX SUR ORIENTE,2023-10-13,248,245,3,0.0120967741935484
CDMX SUR ORIENTE,2023-10-14,302,298,4,0.0132450331125828
CDMX SUR ORIENTE,2023-10-15,301,289,12,0.0398671096345515
CDMX SUR ORIENTE,2023-10-16,309,304,5,0.0161812297734628
CDMX SUR ORIENTE,2023-10-17,291,279,12,0.0412371134020619
CDMX SUR ORIENTE,2023-10-18,243,238,5,0.0205761316872428
CDMX SUR ORIENTE,2023-10-19,259,252,7,0.027027027027027
CDMX SUR ORIENTE,2023-10-20,265,259,6,0.0226415094339623
CDMX SUR ORIENTE,2023-10-21,327,317,10,0.0305810397553517
CDMX SUR ORIENTE,2023-10-22,328,315,13,0.0396341463414634
CDMX SUR ORIENTE,2023-10-23,295,287,8,0.0271186440677966
CDMX SUR ORIENTE,2023-10-24,247,238,9,0.0364372469635627
CDMX SUR ORIENTE,2023-10-25,238,231,7,0.0294117647058824
CDMX SUR ORIENTE,2023-10-26,213,206,7,0.0328638497652582
CDMX SUR ORIENTE,2023-10-27,228,223,5,0.0219298245614035
CDMX SUR ORIENTE,2023-10-28,301,296,5,0.0166112956810631
CDMX SUR ORIENTE,2023-10-29,280,275,5,0.0178571428571429
CDMX SUR ORIENTE,2023-10-30,257,249,8,0.0311284046692607
CDMX SUR ORIENTE,2023-10-31,360,350,10,0.0277777777777778
CDMX SUR ORIENTE,2023-11-01,240,233,7,0.0291666666666667
CDMX SUR ORIENTE,2023-11-02,252,247,5,0.0198412698412698
CDMX SUR ORIENTE,2023-11-03,221,217,4,0.0180995475113122
CDMX SUR ORIENTE,2023-11-04,327,317,10,0.0305810397553517
CDMX SUR ORIENTE,2023-11-05,337,326,11,0.0326409495548961
CDMX SUR ORIENTE,2023-11-06,299,292,7,0.0234113712374582
CDMX SUR ORIENTE,2023-11-07,317,307,10,0.0315457413249211
CDMX SUR ORIENTE,2023-11-08,306,297,9,0.0294117647058824
CDMX SUR ORIENTE,2023-11-09,300,294,6,0.02
CDMX SUR ORIENTE,2023-11-10,294,286,8,0.0272108843537415
CDMX SUR ORIENTE,2023-11-11,373,361,12,0.032171581769437
CDMX SUR ORIENTE,2023-11-12,332,328,4,0.0120481927710843
CDMX SUR ORIENTE,2023-11-13,314,298,16,0.0509554140127389
CDMX SUR ORIENTE,2023-11-14,348,338,10,0.028735632183908
CDMX SUR ORIENTE,2023-11-15,359,350,9,0.0250696378830084
CDMX SUR ORIENTE,2023-11-16,396,384,12,0.0303030303030303
CDMX SUR ORIENTE,2023-11-17,427,422,5,0.0117096018735363
CDMX SUR ORIENTE,2023-11-18,479,466,13,0.0271398747390397
CDMX SUR ORIENTE,2023-11-19,509,499,10,0.0196463654223969
CDMX SUR ORIENTE,2023-11-20,500,489,11,0.022
CDMX SUR ORIENTE,2023-11-21,384,370,14,0.0364583333333333
CDMX SUR ORIENTE,2023-11-22,334,325,9,0.0269461077844311
CDMX SUR ORIENTE,2023-11-23,317,308,9,0.028391167192429
CDMX SUR ORIENTE,2023-11-24,326,319,7,0.0214723926380368
CDMX SUR ORIENTE,2023-11-25,373,366,7,0.0187667560321716
CDMX SUR ORIENTE,2023-11-26,357,351,6,0.0168067226890756
CDMX SUR ORIENTE,2023-11-27,366,349,17,0.046448087431694
CDMX SUR ORIENTE,2023-11-28,388,376,12,0.0309278350515464
CDMX SUR ORIENTE,2023-11-29,372,354,18,0.0483870967741935
CDMX SUR ORIENTE,2023-11-30,439,423,16,0.0364464692482916
CDMX SUR ORIENTE,2023-12-01,332,322,10,0.0301204819277108
CDMX SUR ORIENTE,2023-12-02,404,385,19,0.047029702970297
CDMX SUR ORIENTE,2023-12-03,370,358,12,0.0324324324324324
CDMX SUR ORIENTE,2023-12-04,343,335,8,0.0233236151603499
CDMX SUR ORIENTE,2023-12-05,269,254,15,0.0557620817843866
CDMX SUR ORIENTE,2023-12-06,337,322,15,0.0445103857566766
CDMX SUR ORIENTE,2023-12-07,350,336,14,0.04
CDMX SUR ORIENTE,2023-12-08,233,225,8,0.0343347639484979
CDMX SUR ORIENTE,2023-12-09,376,366,10,0.0265957446808511
CDMX SUR ORIENTE,2023-12-10,376,364,12,0.0319148936170213
CDMX SUR ORIENTE,2023-12-11,299,290,9,0.0301003344481605
CDMX SUR ORIENTE,2023-12-12,318,304,14,0.0440251572327044
CDMX SUR ORIENTE,2023-12-13,267,259,8,0.0299625468164794
CDMX SUR ORIENTE,2023-12-14,200,194,6,0.03
CDMX SUR ORIENTE,2023-12-15,419,405,14,0.0334128878281623
CDMX SUR ORIENTE,2023-12-16,434,425,9,0.0207373271889401
CDMX SUR ORIENTE,2023-12-17,340,328,12,0.0352941176470588
CDMX SUR ORIENTE,2023-12-18,366,356,10,0.0273224043715847
CDMX SUR ORIENTE,2023-12-19,347,341,6,0.0172910662824208
CDMX SUR ORIENTE,2023-12-20,322,312,10,0.031055900621118
CDMX SUR ORIENTE,2023-12-21,335,327,8,0.0238805970149254
CDMX SUR ORIENTE,2023-12-22,312,302,10,0.032051282051282
CDMX SUR ORIENTE,2023-12-23,344,330,14,0.0406976744186047
CDMX SUR ORIENTE,2023-12-24,253,245,8,0.0316205533596838
CDMX SUR ORIENTE,2023-12-25,93,89,4,0.043010752688172
CDMX SUR ORIENTE,2023-12-26,286,272,14,0.048951048951049
CDMX SUR ORIENTE,2023-12-27,352,345,7,0.0198863636363636
CDMX SUR ORIENTE,2023-12-28,366,358,8,0.0218579234972678
CDMX SUR ORIENTE,2023-12-29,367,352,15,0.0408719346049046
CDMX SUR ORIENTE,2023-12-30,347,336,11,0.031700288184438
CDMX SUR ORIENTE,2023-12-31,236,228,8,0.0338983050847458
CDMX SUR ORIENTE,2024-01-01,67,62,5,0.0746268656716418
CDMX SUR ORIENTE,2024-01-02,263,257,6,0.0228136882129278
CDMX SUR ORIENTE,2024-01-03,311,307,4,0.0128617363344051
CDMX SUR ORIENTE,2024-01-04,255,244,11,0.0431372549019608
CDMX SUR ORIENTE,2024-01-05,340,331,9,0.0264705882352941
CDMX SUR ORIENTE,2024-01-06,301,290,11,0.0365448504983389
CDMX SUR ORIENTE,2024-01-07,332,326,6,0.0180722891566265
CDMX SUR ORIENTE,2024-01-08,325,314,11,0.0338461538461538
CDMX SUR ORIENTE,2024-01-09,342,332,10,0.0292397660818713
CDMX SUR ORIENTE,2024-01-10,324,317,7,0.0216049382716049
CDMX SUR ORIENTE,2024-01-11,335,331,4,0.0119402985074627
CDMX SUR ORIENTE,2024-01-12,345,335,10,0.0289855072463768
CDMX SUR ORIENTE,2024-01-13,393,379,14,0.0356234096692112
CDMX SUR ORIENTE,2024-01-14,363,348,15,0.0413223140495868
CDMX SUR ORIENTE,2024-01-15,382,374,8,0.0209424083769634
CDMX SUR ORIENTE,2024-01-16,377,367,10,0.026525198938992
CDMX SUR ORIENTE,2024-01-17,305,294,11,0.0360655737704918
CDMX SUR ORIENTE,2024-01-18,355,349,6,0.0169014084507042
CDMX SUR ORIENTE,2024-01-19,301,298,3,0.00996677740863787
CDMX SUR ORIENTE,2024-01-20,340,332,8,0.0235294117647059
CDMX SUR ORIENTE,2024-01-21,333,324,9,0.027027027027027
CDMX SUR ORIENTE,2024-01-22,322,313,9,0.0279503105590062
CDMX SUR ORIENTE,2024-01-23,296,285,11,0.0371621621621622
CDMX SUR ORIENTE,2024-01-24,297,285,12,0.0404040404040404
CDMX SUR ORIENTE,2024-01-25,287,282,5,0.0174216027874564
CDMX SUR ORIENTE,2024-01-26,288,276,12,0.0416666666666667
CDMX SUR ORIENTE,2024-01-27,364,359,5,0.0137362637362637
CDMX SUR ORIENTE,2024-01-28,301,289,12,0.0398671096345515
CDMX SUR ORIENTE,2024-01-29,321,313,8,0.0249221183800623
CDMX SUR ORIENTE,2024-01-30,323,309,14,0.043343653250774
CDMX SUR ORIENTE,2024-01-31,396,386,10,0.0252525252525253
CDMX SUR ORIENTE,2024-02-01,319,309,10,0.0313479623824451
CDMX SUR ORIENTE,2024-02-02,287,284,3,0.0104529616724739
CDMX SUR ORIENTE,2024-02-03,340,332,8,0.0235294117647059
CDMX SUR ORIENTE,2024-02-04,313,307,6,0.0191693290734824
CDMX SUR ORIENTE,2024-02-05,315,304,11,0.0349206349206349
CDMX SUR ORIENTE,2024-02-06,334,321,13,0.0389221556886228
CDMX SUR ORIENTE,2024-02-07,262,252,10,0.0381679389312977
CDMX SUR ORIENTE,2024-02-08,290,280,10,0.0344827586206897
CDMX SUR ORIENTE,2024-02-09,269,264,5,0.0185873605947955
CDMX SUR ORIENTE,2024-02-10,333,325,8,0.024024024024024
CDMX SUR ORIENTE,2024-02-11,278,268,10,0.0359712230215827
CDMX SUR ORIENTE,2024-02-12,265,256,9,0.0339622641509434
CDMX SUR ORIENTE,2024-02-13,298,290,8,0.0268456375838926
CDMX SUR ORIENTE,2024-02-14,257,248,9,0.0350194552529183
CDMX SUR ORIENTE,2024-02-15,259,254,5,0.0193050193050193
CDMX SUR ORIENTE,2024-02-16,330,323,7,0.0212121212121212
CDMX SUR ORIENTE,2024-02-17,383,376,7,0.0182767624020888
CDMX SUR ORIENTE,2024-02-18,382,375,7,0.0183246073298429
CDMX SUR ORIENTE,2024-02-19,341,336,5,0.0146627565982405
CDMX SUR ORIENTE,2024-02-20,288,282,6,0.0208333333333333
CDMX SUR ORIENTE,2024-02-21,358,350,8,0.0223463687150838
CDMX SUR ORIENTE,2024-02-22,298,293,5,0.0167785234899329
CDMX SUR ORIENTE,2024-02-23,241,218,23,0.0954356846473029
CDMX SUR ORIENTE,2024-02-24,394,383,11,0.0279187817258883
CDMX SUR ORIENTE,2024-02-25,337,330,7,0.0207715133531157
CDMX SUR ORIENTE,2024-02-26,308,299,9,0.0292207792207792
CDMX SUR ORIENTE,2024-02-27,351,342,9,0.0256410256410256
CDMX SUR ORIENTE,2024-02-28,316,310,6,0.0189873417721519
CDMX SUR ORIENTE,2024-02-29,382,378,4,0.0104712041884817
CDMX SUR ORIENTE,2024-03-01,295,288,7,0.023728813559322
CDMX SUR ORIENTE,2024-03-02,360,356,4,0.0111111111111111
CDMX SUR ORIENTE,2024-03-03,335,329,6,0.017910447761194
CDMX SUR ORIENTE,2024-03-04,289,282,7,0.0242214532871972
CDMX SUR ORIENTE,2024-03-05,306,298,8,0.0261437908496732
CDMX SUR ORIENTE,2024-03-06,298,292,6,0.0201342281879195
CDMX SUR ORIENTE,2024-03-07,239,237,2,0.00836820083682008
CDMX SUR ORIENTE,2024-03-08,273,263,10,0.0366300366300366
CDMX SUR ORIENTE,2024-03-09,339,335,4,0.0117994100294985
CDMX SUR ORIENTE,2024-03-10,325,320,5,0.0153846153846154
CDMX SUR ORIENTE,2024-03-11,298,292,6,0.0201342281879195
FRONTERA,2023-03-12,236,231,5,0.0211864406779661
FRONTERA,2023-03-13,273,273,0,0
FRONTERA,2023-03-14,314,303,11,0.035031847133758
FRONTERA,2023-03-15,279,279,0,0
FRONTERA,2023-03-16,312,311,1,0.00320512820512821
FRONTERA,2023-03-17,380,379,1,0.00263157894736842
FRONTERA,2023-03-18,456,456,0,0
FRONTERA,2023-03-19,324,324,0,0
FRONTERA,2023-03-20,359,358,1,0.00278551532033426
FRONTERA,2023-03-21,329,328,1,0.00303951367781155
FRONTERA,2023-03-22,321,321,0,0
FRONTERA,2023-03-23,311,310,1,0.00321543408360129
FRONTERA,2023-03-24,309,309,0,0
FRONTERA,2023-03-25,378,377,1,0.00264550264550265
FRONTERA,2023-03-26,257,254,3,0.0116731517509728
FRONTERA,2023-03-27,274,274,0,0
FRONTERA,2023-03-28,236,235,1,0.00423728813559322
FRONTERA,2023-03-29,272,271,1,0.00367647058823529
FRONTERA,2023-03-30,324,321,3,0.00925925925925926
FRONTERA,2023-03-31,431,431,0,0
FRONTERA,2023-04-01,378,378,0,0
FRONTERA,2023-04-02,217,215,2,0.00921658986175115
FRONTERA,2023-04-03,368,366,2,0.00543478260869565
FRONTERA,2023-04-04,312,308,4,0.0128205128205128
FRONTERA,2023-04-05,253,253,0,0
FRONTERA,2023-04-06,278,275,3,0.0107913669064748
FRONTERA,2023-04-07,249,249,0,0
FRONTERA,2023-04-08,235,235,0,0
FRONTERA,2023-04-09,145,145,0,0
FRONTERA,2023-04-10,231,228,3,0.012987012987013
FRONTERA,2023-04-11,260,260,0,0
FRONTERA,2023-04-12,254,251,3,0.0118110236220472
FRONTERA,2023-04-13,275,272,3,0.0109090909090909
FRONTERA,2023-04-14,299,296,3,0.0100334448160535
FRONTERA,2023-04-15,364,356,8,0.021978021978022
FRONTERA,2023-04-16,242,241,1,0.00413223140495868
FRONTERA,2023-04-17,297,294,3,0.0101010101010101
FRONTERA,2023-04-18,291,284,7,0.0240549828178694
FRONTERA,2023-04-19,257,253,4,0.0155642023346304
FRONTERA,2023-04-20,257,249,8,0.0311284046692607
FRONTERA,2023-04-21,299,293,6,0.020066889632107
FRONTERA,2023-04-22,312,306,6,0.0192307692307692
FRONTERA,2023-04-23,239,235,4,0.0167364016736402
FRONTERA,2023-04-24,270,263,7,0.0259259259259259
FRONTERA,2023-04-25,326,320,6,0.0184049079754601
FRONTERA,2023-04-26,306,299,7,0.0228758169934641
FRONTERA,2023-04-27,280,272,8,0.0285714285714286
FRONTERA,2023-04-28,326,315,11,0.0337423312883436
FRONTERA,2023-04-29,313,303,10,0.0319488817891374
FRONTERA,2023-04-30,243,237,6,0.0246913580246914
FRONTERA,2023-05-01,230,224,6,0.0260869565217391
FRONTERA,2023-05-02,249,243,6,0.0240963855421687
FRONTERA,2023-05-03,225,217,8,0.0355555555555556
FRONTERA,2023-05-04,252,246,6,0.0238095238095238
FRONTERA,2023-05-05,298,292,6,0.0201342281879195
FRONTERA,2023-05-06,271,262,9,0.033210332103321
FRONTERA,2023-05-07,286,280,6,0.020979020979021
FRONTERA,2023-05-08,292,280,12,0.0410958904109589
FRONTERA,2023-05-09,292,279,13,0.0445205479452055
FRONTERA,2023-05-10,252,239,13,0.0515873015873016
FRONTERA,2023-05-11,299,284,15,0.0501672240802676
FRONTERA,2023-05-12,297,280,17,0.0572390572390572
FRONTERA,2023-05-13,325,310,15,0.0461538461538462
FRONTERA,2023-05-14,344,335,9,0.0261627906976744
FRONTERA,2023-05-15,352,338,14,0.0397727272727273
FRONTERA,2023-05-16,416,400,16,0.0384615384615385
FRONTERA,2023-05-17,427,405,22,0.0515222482435597
FRONTERA,2023-05-18,247,243,4,0.0161943319838057
FRONTERA,2023-05-19,376,357,19,0.050531914893617
FRONTERA,2023-05-20,401,386,15,0.0374064837905237
FRONTERA,2023-05-21,320,302,18,0.05625
FRONTERA,2023-05-22,333,313,20,0.0600600600600601
FRONTERA,2023-05-23,315,308,7,0.0222222222222222
FRONTERA,2023-05-24,279,265,14,0.0501792114695341
FRONTERA,2023-05-25,312,291,21,0.0673076923076923
FRONTERA,2023-05-26,281,268,13,0.0462633451957295
FRONTERA,2023-05-27,330,310,20,0.0606060606060606
FRONTERA,2023-05-28,250,228,22,0.088
FRONTERA,2023-05-29,307,291,16,0.0521172638436482
FRONTERA,2023-05-30,306,284,22,0.0718954248366013
FRONTERA,2023-05-31,294,277,17,0.0578231292517007
FRONTERA,2023-06-01,276,257,19,0.0688405797101449
FRONTERA,2023-06-02,261,245,16,0.0613026819923372
FRONTERA,2023-06-03,303,290,13,0.0429042904290429
FRONTERA,2023-06-04,245,235,10,0.0408163265306122
FRONTERA,2023-06-05,259,246,13,0.0501930501930502
FRONTERA,2023-06-06,241,230,11,0.045643153526971
FRONTERA,2023-06-07,270,261,9,0.0333333333333333
FRONTERA,2023-06-08,267,256,11,0.0411985018726592
FRONTERA,2023-06-09,287,275,12,0.0418118466898955
FRONTERA,2023-06-10,354,339,15,0.0423728813559322
FRONTERA,2023-06-11,265,252,13,0.0490566037735849
FRONTERA,2023-06-12,291,277,14,0.0481099656357388
FRONTERA,2023-06-13,297,286,11,0.037037037037037
FRONTERA,2023-06-14,290,278,12,0.0413793103448276
FRONTERA,2023-06-15,288,273,15,0.0520833333333333
FRONTERA,2023-06-16,275,262,13,0.0472727272727273
FRONTERA,2023-06-17,282,279,3,0.0106382978723404
FRONTERA,2023-06-18,188,177,11,0.0585106382978723
FRONTERA,2023-06-19,261,250,11,0.0421455938697318
FRONTERA,2023-06-20,239,230,9,0.0376569037656904
FRONTERA,2023-06-21,269,253,16,0.0594795539033457
FRONTERA,2023-06-22,261,251,10,0.0383141762452107
FRONTERA,2023-06-23,269,253,16,0.0594795539033457
FRONTERA,2023-06-24,295,280,15,0.0508474576271186
FRONTERA,2023-06-25,232,225,7,0.0301724137931034
FRONTERA,2023-06-26,292,283,9,0.0308219178082192
FRONTERA,2023-06-27,308,289,19,0.0616883116883117
FRONTERA,2023-06-28,267,260,7,0.0262172284644195
FRONTERA,2023-06-29,280,274,6,0.0214285714285714
FRONTERA,2023-06-30,172,165,7,0.0406976744186047
FRONTERA,2023-07-01,283,282,1,0.00353356890459364
FRONTERA,2023-07-02,203,197,6,0.0295566502463054
FRONTERA,2023-07-03,254,248,6,0.0236220472440945
FRONTERA,2023-07-04,314,305,9,0.0286624203821656
FRONTERA,2023-07-05,249,242,7,0.0281124497991968
FRONTERA,2023-07-06,236,232,4,0.0169491525423729
FRONTERA,2023-07-07,292,288,4,0.0136986301369863
FRONTERA,2023-07-08,247,240,7,0.0283400809716599
FRONTERA,2023-07-09,211,210,1,0.004739336492891
FRONTERA,2023-07-10,249,242,7,0.0281124497991968
FRONTERA,2023-07-11,264,258,6,0.0227272727272727
FRONTERA,2023-07-12,267,261,6,0.0224719101123595
FRONTERA,2023-07-13,262,258,4,0.0152671755725191
FRONTERA,2023-07-14,260,257,3,0.0115384615384615
FRONTERA,2023-07-15,288,280,8,0.0277777777777778
FRONTERA,2023-07-16,192,192,0,0
FRONTERA,2023-07-17,274,269,5,0.0182481751824818
FRONTERA,2023-07-18,259,257,2,0.00772200772200772
FRONTERA,2023-07-19,263,259,4,0.0152091254752852
FRONTERA,2023-07-20,260,257,3,0.0115384615384615
FRONTERA,2023-07-21,291,288,3,0.0103092783505155
FRONTERA,2023-07-22,287,284,3,0.0104529616724739
FRONTERA,2023-07-23,189,189,0,0
FRONTERA,2023-07-24,244,240,4,0.0163934426229508
FRONTERA,2023-07-25,259,254,5,0.0193050193050193
FRONTERA,2023-07-26,270,264,6,0.0222222222222222
FRONTERA,2023-07-27,257,253,4,0.0155642023346304
FRONTERA,2023-07-28,282,279,3,0.0106382978723404
FRONTERA,2023-07-29,286,283,3,0.0104895104895105
FRONTERA,2023-07-30,219,217,2,0.0091324200913242
FRONTERA,2023-07-31,241,237,4,0.016597510373444
FRONTERA,2023-08-01,239,234,5,0.0209205020920502
FRONTERA,2023-08-02,307,302,5,0.0162866449511401
FRONTERA,2023-08-03,221,185,36,0.16289592760181
FRONTERA,2023-08-04,248,242,6,0.0241935483870968
FRONTERA,2023-08-05,212,210,2,0.00943396226415094
FRONTERA,2023-08-06,186,182,4,0.021505376344086
FRONTERA,2023-08-07,262,255,7,0.0267175572519084
FRONTERA,2023-08-08,258,254,4,0.0155038759689922
FRONTERA,2023-08-09,240,237,3,0.0125
FRONTERA,2023-08-10,216,211,5,0.0231481481481481
FRONTERA,2023-08-11,250,249,1,0.004
FRONTERA,2023-08-12,257,250,7,0.0272373540856031
FRONTERA,2023-08-13,186,185,1,0.00537634408602151
FRONTERA,2023-08-14,220,219,1,0.00454545454545455
FRONTERA,2023-08-15,224,220,4,0.0178571428571429
FRONTERA,2023-08-16,249,246,3,0.0120481927710843
FRONTERA,2023-08-17,248,239,9,0.0362903225806452
FRONTERA,2023-08-18,255,253,2,0.00784313725490196
FRONTERA,2023-08-19,311,286,25,0.0803858520900322
FRONTERA,2023-08-20,240,225,15,0.0625
FRONTERA,2023-08-21,233,220,13,0.055793991416309
FRONTERA,2023-08-22,192,179,13,0.0677083333333333
FRONTERA,2023-08-23,255,226,29,0.113725490196078
FRONTERA,2023-08-24,249,228,21,0.0843373493975904
FRONTERA,2023-08-25,304,271,33,0.108552631578947
FRONTERA,2023-08-26,329,307,22,0.0668693009118541
FRONTERA,2023-08-27,276,256,20,0.072463768115942
FRONTERA,2023-08-28,241,227,14,0.0580912863070539
FRONTERA,2023-08-29,238,229,9,0.0378151260504202
FRONTERA,2023-08-30,224,219,5,0.0223214285714286
FRONTERA,2023-08-31,224,221,3,0.0133928571428571
FRONTERA,2023-09-01,221,217,4,0.0180995475113122
FRONTERA,2023-09-02,229,226,3,0.0131004366812227
FRONTERA,2023-09-03,236,231,5,0.0211864406779661
FRONTERA,2023-09-04,242,241,1,0.00413223140495868
FRONTERA,2023-09-05,257,256,1,0.00389105058365759
FRONTERA,2023-09-06,271,269,2,0.00738007380073801
FRONTERA,2023-09-07,221,221,0,0
FRONTERA,2023-09-08,226,224,2,0.00884955752212389
FRONTERA,2023-09-09,248,242,6,0.0241935483870968
FRONTERA,2023-09-10,219,218,1,0.0045662100456621
FRONTERA,2023-09-11,222,221,1,0.0045045045045045
FRONTERA,2023-09-12,243,240,3,0.0123456790123457
FRONTERA,2023-09-13,263,261,2,0.00760456273764259
FRONTERA,2023-09-14,240,237,3,0.0125
FRONTERA,2023-09-15,244,242,2,0.00819672131147541
FRONTERA,2023-09-16,178,177,1,0.00561797752808989
FRONTERA,2023-09-17,200,197,3,0.015
FRONTERA,2023-09-18,234,233,1,0.00427350427350427
FRONTERA,2023-09-19,190,188,2,0.0105263157894737
FRONTERA,2023-09-20,155,155,0,0
FRONTERA,2023-09-21,175,169,6,0.0342857142857143
FRONTERA,2023-09-22,177,174,3,0.0169491525423729
FRONTERA,2023-09-23,226,223,3,0.0132743362831858
FRONTERA,2023-09-24,203,200,3,0.0147783251231527
FRONTERA,2023-09-25,198,195,3,0.0151515151515152
FRONTERA,2023-09-26,194,191,3,0.0154639175257732
FRONTERA,2023-09-27,232,227,5,0.021551724137931
FRONTERA,2023-09-28,258,255,3,0.0116279069767442
FRONTERA,2023-09-29,237,235,2,0.00843881856540084
FRONTERA,2023-09-30,241,240,1,0.004149377593361
FRONTERA,2023-10-01,169,168,1,0.00591715976331361
FRONTERA,2023-10-02,202,201,1,0.00495049504950495
FRONTERA,2023-10-03,209,208,1,0.00478468899521531
FRONTERA,2023-10-04,209,204,5,0.0239234449760766
FRONTERA,2023-10-05,168,166,2,0.0119047619047619
FRONTERA,2023-10-06,194,192,2,0.0103092783505155
FRONTERA,2023-10-07,247,241,6,0.0242914979757085
FRONTERA,2023-10-08,193,189,4,0.0207253886010363
FRONTERA,2023-10-09,186,185,1,0.00537634408602151
FRONTERA,2023-10-10,209,209,0,0
FRONTERA,2023-10-11,243,236,7,0.0288065843621399
FRONTERA,2023-10-12,198,192,6,0.0303030303030303
FRONTERA,2023-10-13,174,170,4,0.0229885057471264
FRONTERA,2023-10-14,255,250,5,0.0196078431372549
FRONTERA,2023-10-15,197,191,6,0.0304568527918782
FRONTERA,2023-10-16,205,202,3,0.0146341463414634
FRONTERA,2023-10-17,231,227,4,0.0173160173160173
FRONTERA,2023-10-18,215,211,4,0.0186046511627907
FRONTERA,2023-10-19,227,224,3,0.013215859030837
FRONTERA,2023-10-20,208,204,4,0.0192307692307692
FRONTERA,2023-10-21,236,234,2,0.00847457627118644
FRONTERA,2023-10-22,188,186,2,0.0106382978723404
FRONTERA,2023-10-23,189,184,5,0.0264550264550265
FRONTERA,2023-10-24,221,217,4,0.0180995475113122
FRONTERA,2023-10-25,225,219,6,0.0266666666666667
FRONTERA,2023-10-26,225,219,6,0.0266666666666667
FRONTERA,2023-10-27,208,203,5,0.0240384615384615
FRONTERA,2023-10-28,233,230,3,0.0128755364806867
FRONTERA,2023-10-29,155,152,3,0.0193548387096774
FRONTERA,2023-10-30,187,184,3,0.0160427807486631
FRONTERA,2023-10-31,190,189,1,0.00526315789473684
FRONTERA,2023-11-01,247,244,3,0.0121457489878543
FRONTERA,2023-11-02,207,205,2,0.00966183574879227
FRONTERA,2023-11-03,248,245,3,0.0120967741935484
FRONTERA,2023-11-04,259,255,4,0.0154440154440154
FRONTERA,2023-11-05,190,188,2,0.0105263157894737
FRONTERA,2023-11-06,258,256,2,0.00775193798449612
FRONTERA,2023-11-07,270,268,2,0.00740740740740741
FRONTERA,2023-11-08,223,221,2,0.00896860986547085
FRONTERA,2023-11-09,244,241,3,0.0122950819672131
FRONTERA,2023-11-10,245,242,3,0.0122448979591837
FRONTERA,2023-11-11,247,242,5,0.0202429149797571
FRONTERA,2023-11-12,175,172,3,0.0171428571428571
FRONTERA,2023-11-13,249,245,4,0.0160642570281124
FRONTERA,2023-11-14,306,301,5,0.0163398692810458
FRONTERA,2023-11-15,250,245,5,0.02
FRONTERA,2023-11-16,231,223,8,0.0346320346320346
FRONTERA,2023-11-17,287,284,3,0.0104529616724739
FRONTERA,2023-11-18,330,326,4,0.0121212121212121
FRONTERA,2023-11-19,278,273,5,0.0179856115107914
FRONTERA,2023-11-20,242,237,5,0.0206611570247934
FRONTERA,2023-11-21,297,293,4,0.0134680134680135
FRONTERA,2023-11-22,285,282,3,0.0105263157894737
FRONTERA,2023-11-23,298,295,3,0.0100671140939597
FRONTERA,2023-11-24,286,286,0,0
FRONTERA,2023-11-25,296,291,5,0.0168918918918919
FRONTERA,2023-11-26,264,262,2,0.00757575757575758
FRONTERA,2023-11-27,289,288,1,0.00346020761245675
FRONTERA,2023-11-28,320,319,1,0.003125
FRONTERA,2023-11-29,315,307,8,0.0253968253968254
FRONTERA,2023-11-30,320,318,2,0.00625
FRONTERA,2023-12-01,286,283,3,0.0104895104895105
FRONTERA,2023-12-02,309,304,5,0.0161812297734628
FRONTERA,2023-12-03,257,253,4,0.0155642023346304
FRONTERA,2023-12-04,300,295,5,0.0166666666666667
FRONTERA,2023-12-05,292,287,5,0.0171232876712329
FRONTERA,2023-12-06,311,305,6,0.0192926045016077
FRONTERA,2023-12-07,299,295,4,0.0133779264214047
FRONTERA,2023-12-08,361,354,7,0.0193905817174515
FRONTERA,2023-12-09,314,311,3,0.00955414012738853
FRONTERA,2023-12-10,267,260,7,0.0262172284644195
FRONTERA,2023-12-11,248,247,1,0.00403225806451613
FRONTERA,2023-12-12,259,250,9,0.0347490347490347
FRONTERA,2023-12-13,260,260,0,0
FRONTERA,2023-12-14,241,239,2,0.00829875518672199
FRONTERA,2023-12-15,225,220,5,0.0222222222222222
FRONTERA,2023-12-16,282,279,3,0.0106382978723404
FRONTERA,2023-12-17,230,226,4,0.0173913043478261
FRONTERA,2023-12-18,287,283,4,0.0139372822299652
FRONTERA,2023-12-19,317,311,6,0.0189274447949527
FRONTERA,2023-12-20,347,338,9,0.0259365994236311
FRONTERA,2023-12-21,296,289,7,0.0236486486486486
FRONTERA,2023-12-22,324,317,7,0.0216049382716049
FRONTERA,2023-12-23,299,295,4,0.0133779264214047
FRONTERA,2023-12-24,182,182,0,0
FRONTERA,2023-12-25,70,70,0,0
FRONTERA,2023-12-26,267,265,2,0.00749063670411985
FRONTERA,2023-12-27,324,318,6,0.0185185185185185
FRONTERA,2023-12-28,317,313,4,0.0126182965299685
FRONTERA,2023-12-29,328,323,5,0.0152439024390244
FRONTERA,2023-12-30,323,318,5,0.0154798761609907
FRONTERA,2023-12-31,156,152,4,0.0256410256410256
FRONTERA,2024-01-01,32,32,0,0
FRONTERA,2024-01-02,226,222,4,0.0176991150442478
FRONTERA,2024-01-03,338,333,5,0.014792899408284
FRONTERA,2024-01-04,295,292,3,0.0101694915254237
FRONTERA,2024-01-05,310,307,3,0.00967741935483871
FRONTERA,2024-01-06,325,317,8,0.0246153846153846
FRONTERA,2024-01-07,251,246,5,0.0199203187250996
FRONTERA,2024-01-08,273,268,5,0.0183150183150183
FRONTERA,2024-01-09,276,272,4,0.0144927536231884
FRONTERA,2024-01-10,263,259,4,0.0152091254752852
FRONTERA,2024-01-11,229,227,2,0.00873362445414847
FRONTERA,2024-01-12,281,276,5,0.0177935943060498
FRONTERA,2024-01-13,277,275,2,0.0072202166064982
FRONTERA,2024-01-14,223,222,1,0.00448430493273543
FRONTERA,2024-01-15,269,260,9,0.033457249070632
FRONTERA,2024-01-16,278,275,3,0.0107913669064748
FRONTERA,2024-01-17,305,298,7,0.0229508196721311
FRONTERA,2024-01-18,295,291,4,0.0135593220338983
FRONTERA,2024-01-19,281,277,4,0.0142348754448399
FRONTERA,2024-01-20,275,272,3,0.0109090909090909
FRONTERA,2024-01-21,239,237,2,0.00836820083682008
FRONTERA,2024-01-22,300,294,6,0.02
FRONTERA,2024-01-23,279,274,5,0.017921146953405
FRONTERA,2024-01-24,273,269,4,0.0146520146520147
FRONTERA,2024-01-25,282,280,2,0.00709219858156028
FRONTERA,2024-01-26,315,310,5,0.0158730158730159
FRONTERA,2024-01-27,314,308,6,0.0191082802547771
FRONTERA,2024-01-28,238,236,2,0.00840336134453781
FRONTERA,2024-01-29,274,271,3,0.0109489051094891
FRONTERA,2024-01-30,226,221,5,0.0221238938053097
FRONTERA,2024-01-31,306,297,9,0.0294117647058824
FRONTERA,2024-02-01,284,280,4,0.0140845070422535
FRONTERA,2024-02-02,270,264,6,0.0222222222222222
FRONTERA,2024-02-03,299,294,5,0.0167224080267559
FRONTERA,2024-02-04,243,242,1,0.00411522633744856
FRONTERA,2024-02-05,237,232,5,0.0210970464135021
FRONTERA,2024-02-06,285,280,5,0.0175438596491228
FRONTERA,2024-02-07,314,311,3,0.00955414012738853
FRONTERA,2024-02-08,299,298,1,0.00334448160535117
FRONTERA,2024-02-09,278,277,1,0.00359712230215827
FRONTERA,2024-02-10,306,304,2,0.0065359477124183
FRONTERA,2024-02-11,205,204,1,0.0048780487804878
FRONTERA,2024-02-12,243,237,6,0.0246913580246914
FRONTERA,2024-02-13,243,239,4,0.0164609053497942
FRONTERA,2024-02-14,249,247,2,0.00803212851405622
FRONTERA,2024-02-15,243,241,2,0.00823045267489712
FRONTERA,2024-02-16,286,285,1,0.0034965034965035
FRONTERA,2024-02-17,248,242,6,0.0241935483870968
FRONTERA,2024-02-18,259,256,3,0.0115830115830116
FRONTERA,2024-02-19,255,250,5,0.0196078431372549
FRONTERA,2024-02-20,297,294,3,0.0101010101010101
FRONTERA,2024-02-21,298,297,1,0.00335570469798658
FRONTERA,2024-02-22,301,298,3,0.00996677740863787
FRONTERA,2024-02-23,220,206,14,0.0636363636363636
FRONTERA,2024-02-24,311,309,2,0.00643086816720257
FRONTERA,2024-02-25,230,227,3,0.0130434782608696
FRONTERA,2024-02-26,319,316,3,0.00940438871473354
FRONTERA,2024-02-27,278,277,1,0.00359712230215827
FRONTERA,2024-02-28,286,284,2,0.00699300699300699
FRONTERA,2024-02-29,283,276,7,0.0247349823321555
FRONTERA,2024-03-01,269,266,3,0.0111524163568773
FRONTERA,2024-03-02,290,287,3,0.0103448275862069
FRONTERA,2024-03-03,211,209,2,0.00947867298578199
FRONTERA,2024-03-04,269,263,6,0.0223048327137546
FRONTERA,2024-03-05,254,250,4,0.015748031496063
FRONTERA,2024-03-06,304,300,4,0.0131578947368421
FRONTERA,2024-03-07,285,284,1,0.00350877192982456
FRONTERA,2024-03-08,260,257,3,0.0115384615384615
FRONTERA,2024-03-09,270,267,3,0.0111111111111111
FRONTERA,2024-03-10,242,240,2,0.00826446280991736
FRONTERA,2024-03-11,254,252,2,0.0078740157480315
NORESTE 1,2023-03-12,84,60,24,0.285714285714286
NORESTE 1,2023-03-13,125,89,36,0.288
NORESTE 1,2023-03-14,145,100,45,0.310344827586207
NORESTE 1,2023-03-15,136,120,16,0.117647058823529
NORESTE 1,2023-03-16,179,165,14,0.0782122905027933
NORESTE 1,2023-03-17,195,160,35,0.179487179487179
NORESTE 1,2023-03-18,241,213,28,0.116182572614108
NORESTE 1,2023-03-19,114,93,21,0.184210526315789
NORESTE 1,2023-03-20,133,113,20,0.150375939849624
NORESTE 1,2023-03-21,190,176,14,0.0736842105263158
NORESTE 1,2023-03-22,158,151,7,0.0443037974683544
NORESTE 1,2023-03-23,191,185,6,0.031413612565445
NORESTE 1,2023-03-24,167,155,12,0.0718562874251497
NORESTE 1,2023-03-25,224,207,17,0.0758928571428571
NORESTE 1,2023-03-26,133,124,9,0.0676691729323308
NORESTE 1,2023-03-27,163,154,9,0.0552147239263804
NORESTE 1,2023-03-28,122,115,7,0.0573770491803279
NORESTE 1,2023-03-29,134,126,8,0.0597014925373134
NORESTE 1,2023-03-30,155,145,10,0.0645161290322581
NORESTE 1,2023-03-31,224,218,6,0.0267857142857143
NORESTE 1,2023-04-01,210,202,8,0.0380952380952381
NORESTE 1,2023-04-02,106,102,4,0.0377358490566038
NORESTE 1,2023-04-03,162,157,5,0.0308641975308642
NORESTE 1,2023-04-04,152,147,5,0.0328947368421053
NORESTE 1,2023-04-05,125,111,14,0.112
NORESTE 1,2023-04-06,164,162,2,0.0121951219512195
NORESTE 1,2023-04-07,144,140,4,0.0277777777777778
NORESTE 1,2023-04-08,123,118,5,0.040650406504065
NORESTE 1,2023-04-09,83,80,3,0.036144578313253
NORESTE 1,2023-04-10,125,120,5,0.04
NORESTE 1,2023-04-11,154,146,8,0.051948051948052
NORESTE 1,2023-04-12,133,127,6,0.0451127819548872
NORESTE 1,2023-04-13,111,109,2,0.018018018018018
NORESTE 1,2023-04-14,182,174,8,0.043956043956044
NORESTE 1,2023-04-15,259,247,12,0.0463320463320463
NORESTE 1,2023-04-16,161,153,8,0.0496894409937888
NORESTE 1,2023-04-17,162,149,13,0.0802469135802469
NORESTE 1,2023-04-18,178,170,8,0.0449438202247191
NORESTE 1,2023-04-19,167,157,10,0.0598802395209581
NORESTE 1,2023-04-20,161,146,15,0.093167701863354
NORESTE 1,2023-04-21,199,190,9,0.0452261306532663
NORESTE 1,2023-04-22,208,193,15,0.0721153846153846
NORESTE 1,2023-04-23,137,133,4,0.0291970802919708
NORESTE 1,2023-04-24,187,181,6,0.0320855614973262
NORESTE 1,2023-04-25,199,187,12,0.0603015075376884
NORESTE 1,2023-04-26,164,153,11,0.0670731707317073
NORESTE 1,2023-04-27,158,148,10,0.0632911392405063
NORESTE 1,2023-04-28,199,188,11,0.0552763819095477
NORESTE 1,2023-04-29,261,247,14,0.053639846743295
NORESTE 1,2023-04-30,192,177,15,0.078125
NORESTE 1,2023-05-01,142,133,9,0.0633802816901408
NORESTE 1,2023-05-02,201,193,8,0.0398009950248756
NORESTE 1,2023-05-03,158,154,4,0.0253164556962025
NORESTE 1,2023-05-04,173,163,10,0.0578034682080925
NORESTE 1,2023-05-05,188,172,16,0.0851063829787234
NORESTE 1,2023-05-06,214,207,7,0.0327102803738318
NORESTE 1,2023-05-07,128,121,7,0.0546875
NORESTE 1,2023-05-08,150,141,9,0.06
NORESTE 1,2023-05-09,184,173,11,0.0597826086956522
NORESTE 1,2023-05-10,153,140,13,0.0849673202614379
NORESTE 1,2023-05-11,133,119,14,0.105263157894737
NORESTE 1,2023-05-12,174,165,9,0.0517241379310345
NORESTE 1,2023-05-13,250,231,19,0.076
NORESTE 1,2023-05-14,210,194,16,0.0761904761904762
NORESTE 1,2023-05-15,268,251,17,0.0634328358208955
NORESTE 1,2023-05-16,224,214,10,0.0446428571428571
NORESTE 1,2023-05-17,212,197,15,0.0707547169811321
NORESTE 1,2023-05-18,156,147,9,0.0576923076923077
NORESTE 1,2023-05-19,158,148,10,0.0632911392405063
NORESTE 1,2023-05-20,168,159,9,0.0535714285714286
NORESTE 1,2023-05-21,188,174,14,0.074468085106383
NORESTE 1,2023-05-22,168,164,4,0.0238095238095238
NORESTE 1,2023-05-23,165,154,11,0.0666666666666667
NORESTE 1,2023-05-24,175,164,11,0.0628571428571429
NORESTE 1,2023-05-25,166,148,18,0.108433734939759
NORESTE 1,2023-05-26,134,118,16,0.119402985074627
NORESTE 1,2023-05-27,159,143,16,0.10062893081761
NORESTE 1,2023-05-28,119,111,8,0.0672268907563025
NORESTE 1,2023-05-29,157,143,14,0.089171974522293
NORESTE 1,2023-05-30,152,137,15,0.0986842105263158
NORESTE 1,2023-05-31,189,167,22,0.116402116402116
NORESTE 1,2023-06-01,118,103,15,0.127118644067797
NORESTE 1,2023-06-02,121,108,13,0.107438016528926
NORESTE 1,2023-06-03,147,136,11,0.0748299319727891
NORESTE 1,2023-06-04,142,131,11,0.0774647887323944
NORESTE 1,2023-06-05,143,133,10,0.0699300699300699
NORESTE 1,2023-06-06,147,133,14,0.0952380952380952
NORESTE 1,2023-06-07,176,159,17,0.0965909090909091
NORESTE 1,2023-06-08,135,123,12,0.0888888888888889
NORESTE 1,2023-06-09,182,173,9,0.0494505494505494
NORESTE 1,2023-06-10,165,152,13,0.0787878787878788
NORESTE 1,2023-06-11,135,128,7,0.0518518518518519
NORESTE 1,2023-06-12,149,143,6,0.0402684563758389
NORESTE 1,2023-06-13,178,164,14,0.0786516853932584
NORESTE 1,2023-06-14,150,136,14,0.0933333333333333
NORESTE 1,2023-06-15,161,149,12,0.0745341614906832
NORESTE 1,2023-06-16,187,163,24,0.128342245989305
NORESTE 1,2023-06-17,187,166,21,0.112299465240642
NORESTE 1,2023-06-18,137,129,8,0.0583941605839416
NORESTE 1,2023-06-19,186,168,18,0.0967741935483871
NORESTE 1,2023-06-20,150,135,15,0.1
NORESTE 1,2023-06-21,160,145,15,0.09375
NORESTE 1,2023-06-22,181,174,7,0.0386740331491713
NORESTE 1,2023-06-23,180,164,16,0.0888888888888889
NORESTE 1,2023-06-24,229,209,20,0.0873362445414847
NORESTE 1,2023-06-25,159,150,9,0.0566037735849057
NORESTE 1,2023-06-26,171,156,15,0.087719298245614
NORESTE 1,2023-06-27,167,156,11,0.0658682634730539
NORESTE 1,2023-06-28,137,128,9,0.0656934306569343
NORESTE 1,2023-06-29,150,145,5,0.0333333333333333
NORESTE 1,2023-06-30,68,67,1,0.0147058823529412
NORESTE 1,2023-07-01,188,183,5,0.0265957446808511
NORESTE 1,2023-07-02,88,86,2,0.0227272727272727
NORESTE 1,2023-07-03,144,140,4,0.0277777777777778
NORESTE 1,2023-07-04,133,129,4,0.0300751879699248
NORESTE 1,2023-07-05,82,81,1,0.0121951219512195
NORESTE 1,2023-07-06,115,109,6,0.0521739130434783
NORESTE 1,2023-07-07,143,142,1,0.00699300699300699
NORESTE 1,2023-07-08,202,201,1,0.00495049504950495
NORESTE 1,2023-07-09,159,157,2,0.0125786163522013
NORESTE 1,2023-07-10,136,135,1,0.00735294117647059
NORESTE 1,2023-07-11,114,113,1,0.0087719298245614
NORESTE 1,2023-07-12,142,141,1,0.00704225352112676
NORESTE 1,2023-07-13,149,141,8,0.0536912751677852
NORESTE 1,2023-07-14,153,151,2,0.0130718954248366
NORESTE 1,2023-07-15,201,192,9,0.0447761194029851
NORESTE 1,2023-07-16,119,119,0,0
NORESTE 1,2023-07-17,148,144,4,0.027027027027027
NORESTE 1,2023-07-18,173,171,2,0.0115606936416185
NORESTE 1,2023-07-19,141,139,2,0.0141843971631206
NORESTE 1,2023-07-20,185,179,6,0.0324324324324324
NORESTE 1,2023-07-21,217,213,4,0.0184331797235023
NORESTE 1,2023-07-22,201,198,3,0.0149253731343284
NORESTE 1,2023-07-23,112,112,0,0
NORESTE 1,2023-07-24,138,134,4,0.0289855072463768
NORESTE 1,2023-07-25,169,167,2,0.0118343195266272
NORESTE 1,2023-07-26,154,152,2,0.012987012987013
NORESTE 1,2023-07-27,201,198,3,0.0149253731343284
NORESTE 1,2023-07-28,235,231,4,0.0170212765957447
NORESTE 1,2023-07-29,244,241,3,0.0122950819672131
NORESTE 1,2023-07-30,89,86,3,0.0337078651685393
NORESTE 1,2023-07-31,173,171,2,0.0115606936416185
NORESTE 1,2023-08-01,158,151,7,0.0443037974683544
NORESTE 1,2023-08-02,173,165,8,0.046242774566474
NORESTE 1,2023-08-03,191,165,26,0.136125654450262
NORESTE 1,2023-08-04,203,193,10,0.0492610837438424
NORESTE 1,2023-08-05,241,235,6,0.024896265560166
NORESTE 1,2023-08-06,163,156,7,0.0429447852760736
NORESTE 1,2023-08-07,143,133,10,0.0699300699300699
NORESTE 1,2023-08-08,173,166,7,0.0404624277456647
NORESTE 1,2023-08-09,140,134,6,0.0428571428571429
NORESTE 1,2023-08-10,171,158,13,0.0760233918128655
NORESTE 1,2023-08-11,198,184,14,0.0707070707070707
NORESTE 1,2023-08-12,187,176,11,0.0588235294117647
NORESTE 1,2023-08-13,101,94,7,0.0693069306930693
NORESTE 1,2023-08-14,148,140,8,0.0540540540540541
NORESTE 1,2023-08-15,212,205,7,0.0330188679245283
NORESTE 1,2023-08-16,193,182,11,0.0569948186528497
NORESTE 1,2023-08-17,209,201,8,0.0382775119617225
NORESTE 1,2023-08-18,237,231,6,0.0253164556962025
NORESTE 1,2023-08-19,244,233,11,0.0450819672131148
NORESTE 1,2023-08-20,144,140,4,0.0277777777777778
NORESTE 1,2023-08-21,156,155,1,0.00641025641025641
NORESTE 1,2023-08-22,172,169,3,0.0174418604651163
NORESTE 1,2023-08-23,206,205,1,0.00485436893203883
NORESTE 1,2023-08-24,198,197,1,0.00505050505050505
NORESTE 1,2023-08-25,220,216,4,0.0181818181818182
NORESTE 1,2023-08-26,266,262,4,0.0150375939849624
NORESTE 1,2023-08-27,145,142,3,0.0206896551724138
NORESTE 1,2023-08-28,170,167,3,0.0176470588235294
NORESTE 1,2023-08-29,176,175,1,0.00568181818181818
NORESTE 1,2023-08-30,176,176,0,0
NORESTE 1,2023-08-31,186,182,4,0.021505376344086
NORESTE 1,2023-09-01,172,172,0,0
NORESTE 1,2023-09-02,189,189,0,0
NORESTE 1,2023-09-03,152,151,1,0.00657894736842105
NORESTE 1,2023-09-04,150,149,1,0.00666666666666667
NORESTE 1,2023-09-05,193,191,2,0.0103626943005181
NORESTE 1,2023-09-06,192,190,2,0.0104166666666667
NORESTE 1,2023-09-07,165,165,0,0
NORESTE 1,2023-09-08,153,153,0,0
NORESTE 1,2023-09-09,212,211,1,0.00471698113207547
NORESTE 1,2023-09-10,137,136,1,0.0072992700729927
NORESTE 1,2023-09-11,159,157,2,0.0125786163522013
NORESTE 1,2023-09-12,184,183,1,0.00543478260869565
NORESTE 1,2023-09-13,172,172,0,0
NORESTE 1,2023-09-14,146,146,0,0
NORESTE 1,2023-09-15,199,195,4,0.0201005025125628
NORESTE 1,2023-09-16,165,162,3,0.0181818181818182
NORESTE 1,2023-09-17,152,151,1,0.00657894736842105
NORESTE 1,2023-09-18,165,164,1,0.00606060606060606
NORESTE 1,2023-09-19,151,151,0,0
NORESTE 1,2023-09-20,124,123,1,0.00806451612903226
NORESTE 1,2023-09-21,140,135,5,0.0357142857142857
NORESTE 1,2023-09-22,194,187,7,0.0360824742268041
NORESTE 1,2023-09-23,212,211,1,0.00471698113207547
NORESTE 1,2023-09-24,133,133,0,0
NORESTE 1,2023-09-25,177,174,3,0.0169491525423729
NORESTE 1,2023-09-26,164,158,6,0.0365853658536585
NORESTE 1,2023-09-27,173,170,3,0.0173410404624277
NORESTE 1,2023-09-28,170,166,4,0.0235294117647059
NORESTE 1,2023-09-29,195,187,8,0.041025641025641
NORESTE 1,2023-09-30,221,216,5,0.0226244343891403
NORESTE 1,2023-10-01,146,144,2,0.0136986301369863
NORESTE 1,2023-10-02,146,143,3,0.0205479452054795
NORESTE 1,2023-10-03,126,120,6,0.0476190476190476
NORESTE 1,2023-10-04,197,187,10,0.050761421319797
NORESTE 1,2023-10-05,151,142,9,0.0596026490066225
NORESTE 1,2023-10-06,184,176,8,0.0434782608695652
NORESTE 1,2023-10-07,187,182,5,0.0267379679144385
NORESTE 1,2023-10-08,124,120,4,0.032258064516129
NORESTE 1,2023-10-09,177,168,9,0.0508474576271186
NORESTE 1,2023-10-10,127,125,2,0.015748031496063
NORESTE 1,2023-10-11,148,144,4,0.027027027027027
NORESTE 1,2023-10-12,115,111,4,0.0347826086956522
NORESTE 1,2023-10-13,121,116,5,0.0413223140495868
NORESTE 1,2023-10-14,144,136,8,0.0555555555555556
NORESTE 1,2023-10-15,122,122,0,0
NORESTE 1,2023-10-16,167,161,6,0.0359281437125748
NORESTE 1,2023-10-17,158,156,2,0.0126582278481013
NORESTE 1,2023-10-18,190,184,6,0.0315789473684211
NORESTE 1,2023-10-19,146,144,2,0.0136986301369863
NORESTE 1,2023-10-20,180,172,8,0.0444444444444444
NORESTE 1,2023-10-21,177,174,3,0.0169491525423729
NORESTE 1,2023-10-22,130,127,3,0.0230769230769231
NORESTE 1,2023-10-23,141,133,8,0.0567375886524823
NORESTE 1,2023-10-24,150,143,7,0.0466666666666667
NORESTE 1,2023-10-25,144,138,6,0.0416666666666667
NORESTE 1,2023-10-26,174,167,7,0.0402298850574713
NORESTE 1,2023-10-27,154,149,5,0.0324675324675325
NORESTE 1,2023-10-28,191,186,5,0.0261780104712042
NORESTE 1,2023-10-29,112,110,2,0.0178571428571429
NORESTE 1,2023-10-30,115,113,2,0.0173913043478261
NORESTE 1,2023-10-31,110,107,3,0.0272727272727273
NORESTE 1,2023-11-01,153,145,8,0.0522875816993464
NORESTE 1,2023-11-02,179,172,7,0.0391061452513966
NORESTE 1,2023-11-03,200,192,8,0.04
NORESTE 1,2023-11-04,171,161,10,0.0584795321637427
NORESTE 1,2023-11-05,148,145,3,0.0202702702702703
NORESTE 1,2023-11-06,166,162,4,0.0240963855421687
NORESTE 1,2023-11-07,176,174,2,0.0113636363636364
NORESTE 1,2023-11-08,196,194,2,0.0102040816326531
NORESTE 1,2023-11-09,192,187,5,0.0260416666666667
NORESTE 1,2023-11-10,169,168,1,0.00591715976331361
NORESTE 1,2023-11-11,226,221,5,0.0221238938053097
NORESTE 1,2023-11-12,138,136,2,0.0144927536231884
NORESTE 1,2023-11-13,172,167,5,0.0290697674418605
NORESTE 1,2023-11-14,183,176,7,0.0382513661202186
NORESTE 1,2023-11-15,169,166,3,0.0177514792899408
NORESTE 1,2023-11-16,174,167,7,0.0402298850574713
NORESTE 1,2023-11-17,228,223,5,0.0219298245614035
NORESTE 1,2023-11-18,236,231,5,0.0211864406779661
NORESTE 1,2023-11-19,155,153,2,0.0129032258064516
NORESTE 1,2023-11-20,163,156,7,0.0429447852760736
NORESTE 1,2023-11-21,164,160,4,0.024390243902439
NORESTE 1,2023-11-22,149,145,4,0.0268456375838926
NORESTE 1,2023-11-23,194,187,7,0.0360824742268041
NORESTE 1,2023-11-24,196,189,7,0.0357142857142857
NORESTE 1,2023-11-25,231,226,5,0.0216450216450216
NORESTE 1,2023-11-26,227,220,7,0.0308370044052863
NORESTE 1,2023-11-27,145,141,4,0.0275862068965517
NORESTE 1,2023-11-28,163,162,1,0.00613496932515337
NORESTE 1,2023-11-29,212,196,16,0.0754716981132075
NORESTE 1,2023-11-30,208,193,15,0.0721153846153846
NORESTE 1,2023-12-01,159,150,9,0.0566037735849057
NORESTE 1,2023-12-02,229,213,16,0.0698689956331878
NORESTE 1,2023-12-03,240,230,10,0.0416666666666667
NORESTE 1,2023-12-04,172,165,7,0.0406976744186047
NORESTE 1,2023-12-05,205,195,10,0.0487804878048781
NORESTE 1,2023-12-06,190,178,12,0.0631578947368421
NORESTE 1,2023-12-07,206,196,10,0.0485436893203883
NORESTE 1,2023-12-08,232,224,8,0.0344827586206897
NORESTE 1,2023-12-09,236,225,11,0.0466101694915254
NORESTE 1,2023-12-10,184,176,8,0.0434782608695652
NORESTE 1,2023-12-11,162,152,10,0.0617283950617284
NORESTE 1,2023-12-12,193,184,9,0.0466321243523316
NORESTE 1,2023-12-13,184,176,8,0.0434782608695652
NORESTE 1,2023-12-14,165,157,8,0.0484848484848485
NORESTE 1,2023-12-15,176,166,10,0.0568181818181818
NORESTE 1,2023-12-16,214,204,10,0.0467289719626168
NORESTE 1,2023-12-17,164,159,5,0.0304878048780488
NORESTE 1,2023-12-18,166,159,7,0.0421686746987952
NORESTE 1,2023-12-19,191,185,6,0.031413612565445
NORESTE 1,2023-12-20,189,181,8,0.0423280423280423
NORESTE 1,2023-12-21,199,189,10,0.050251256281407
NORESTE 1,2023-12-22,205,201,4,0.0195121951219512
NORESTE 1,2023-12-23,240,234,6,0.025
NORESTE 1,2023-12-24,146,144,2,0.0136986301369863
NORESTE 1,2023-12-25,52,52,0,0
NORESTE 1,2023-12-26,153,149,4,0.0261437908496732
NORESTE 1,2023-12-27,218,213,5,0.0229357798165138
NORESTE 1,2023-12-28,213,205,8,0.0375586854460094
NORESTE 1,2023-12-29,232,226,6,0.0258620689655172
NORESTE 1,2023-12-30,199,196,3,0.0150753768844221
NORESTE 1,2023-12-31,116,116,0,0
NORESTE 1,2024-01-01,21,21,0,0
NORESTE 1,2024-01-02,130,128,2,0.0153846153846154
NORESTE 1,2024-01-03,215,211,4,0.0186046511627907
NORESTE 1,2024-01-04,208,202,6,0.0288461538461538
NORESTE 1,2024-01-05,232,227,5,0.021551724137931
NORESTE 1,2024-01-06,268,263,5,0.0186567164179104
NORESTE 1,2024-01-07,168,166,2,0.0119047619047619
NORESTE 1,2024-01-08,162,161,1,0.00617283950617284
NORESTE 1,2024-01-09,174,168,6,0.0344827586206897
NORESTE 1,2024-01-10,219,216,3,0.0136986301369863
NORESTE 1,2024-01-11,210,207,3,0.0142857142857143
NORESTE 1,2024-01-12,235,230,5,0.0212765957446809
NORESTE 1,2024-01-13,254,247,7,0.0275590551181102
NORESTE 1,2024-01-14,188,183,5,0.0265957446808511
NORESTE 1,2024-01-15,213,206,7,0.0328638497652582
NORESTE 1,2024-01-16,200,191,9,0.045
NORESTE 1,2024-01-17,205,195,10,0.0487804878048781
NORESTE 1,2024-01-18,200,196,4,0.02
NORESTE 1,2024-01-19,193,184,9,0.0466321243523316
NORESTE 1,2024-01-20,236,231,5,0.0211864406779661
NORESTE 1,2024-01-21,166,158,8,0.0481927710843374
NORESTE 1,2024-01-22,174,167,7,0.0402298850574713
NORESTE 1,2024-01-23,198,189,9,0.0454545454545455
NORESTE 1,2024-01-24,173,171,2,0.0115606936416185
NORESTE 1,2024-01-25,197,191,6,0.0304568527918782
NORESTE 1,2024-01-26,175,164,11,0.0628571428571429
NORESTE 1,2024-01-27,231,223,8,0.0346320346320346
NORESTE 1,2024-01-28,142,137,5,0.0352112676056338
NORESTE 1,2024-01-29,183,179,4,0.0218579234972678
NORESTE 1,2024-01-30,160,154,6,0.0375
NORESTE 1,2024-01-31,176,172,4,0.0227272727272727
NORESTE 1,2024-02-01,166,162,4,0.0240963855421687
NORESTE 1,2024-02-02,166,162,4,0.0240963855421687
NORESTE 1,2024-02-03,190,186,4,0.0210526315789474
NORESTE 1,2024-02-04,147,144,3,0.0204081632653061
NORESTE 1,2024-02-05,133,132,1,0.0075187969924812
NORESTE 1,2024-02-06,170,165,5,0.0294117647058824
NORESTE 1,2024-02-07,173,167,6,0.0346820809248555
NORESTE 1,2024-02-08,199,197,2,0.0100502512562814
NORESTE 1,2024-02-09,177,173,4,0.0225988700564972
NORESTE 1,2024-02-10,236,231,5,0.0211864406779661
NORESTE 1,2024-02-11,159,157,2,0.0125786163522013
NORESTE 1,2024-02-12,143,140,3,0.020979020979021
NORESTE 1,2024-02-13,209,207,2,0.00956937799043062
NORESTE 1,2024-02-14,195,189,6,0.0307692307692308
NORESTE 1,2024-02-15,176,174,2,0.0113636363636364
NORESTE 1,2024-02-16,165,160,5,0.0303030303030303
NORESTE 1,2024-02-17,185,183,2,0.0108108108108108
NORESTE 1,2024-02-18,186,185,1,0.00537634408602151
NORESTE 1,2024-02-19,159,156,3,0.0188679245283019
NORESTE 1,2024-02-20,190,186,4,0.0210526315789474
NORESTE 1,2024-02-21,160,152,8,0.05
NORESTE 1,2024-02-22,229,226,3,0.0131004366812227
NORESTE 1,2024-02-23,131,113,18,0.137404580152672
NORESTE 1,2024-02-24,246,243,3,0.0121951219512195
NORESTE 1,2024-02-25,191,190,1,0.00523560209424084
NORESTE 1,2024-02-26,169,167,2,0.0118343195266272
NORESTE 1,2024-02-27,179,175,4,0.0223463687150838
NORESTE 1,2024-02-28,156,154,2,0.0128205128205128
NORESTE 1,2024-02-29,217,216,1,0.00460829493087558
NORESTE 1,2024-03-01,177,168,9,0.0508474576271186
NORESTE 1,2024-03-02,201,199,2,0.00995024875621891
NORESTE 1,2024-03-03,177,176,1,0.00564971751412429
NORESTE 1,2024-03-04,147,145,2,0.0136054421768707
NORESTE 1,2024-03-05,146,140,6,0.0410958904109589
NORESTE 1,2024-03-06,180,176,4,0.0222222222222222
NORESTE 1,2024-03-07,198,194,4,0.0202020202020202
NORESTE 1,2024-03-08,209,203,6,0.0287081339712919
NORESTE 1,2024-03-09,248,243,5,0.0201612903225806
NORESTE 1,2024-03-10,153,148,5,0.0326797385620915
NORESTE 1,2024-03-11,134,133,1,0.00746268656716418
NORESTE 2,2023-03-12,187,131,56,0.299465240641711
NORESTE 2,2023-03-13,152,106,46,0.302631578947368
NORESTE 2,2023-03-14,178,128,50,0.280898876404494
NORESTE 2,2023-03-15,169,142,27,0.159763313609467
NORESTE 2,2023-03-16,185,162,23,0.124324324324324
NORESTE 2,2023-03-17,198,175,23,0.116161616161616
NORESTE 2,2023-03-18,279,245,34,0.121863799283154
NORESTE 2,2023-03-19,143,123,20,0.13986013986014
NORESTE 2,2023-03-20,168,141,27,0.160714285714286
NORESTE 2,2023-03-21,218,198,20,0.0917431192660551
NORESTE 2,2023-03-22,209,191,18,0.0861244019138756
NORESTE 2,2023-03-23,212,193,19,0.089622641509434
NORESTE 2,2023-03-24,254,229,25,0.0984251968503937
NORESTE 2,2023-03-25,220,198,22,0.1
NORESTE 2,2023-03-26,138,118,20,0.144927536231884
NORESTE 2,2023-03-27,205,189,16,0.0780487804878049
NORESTE 2,2023-03-28,153,145,8,0.0522875816993464
NORESTE 2,2023-03-29,208,182,26,0.125
NORESTE 2,2023-03-30,225,201,24,0.106666666666667
NORESTE 2,2023-03-31,321,292,29,0.0903426791277259
NORESTE 2,2023-04-01,192,176,16,0.0833333333333333
NORESTE 2,2023-04-02,131,118,13,0.099236641221374
NORESTE 2,2023-04-03,173,162,11,0.0635838150289017
NORESTE 2,2023-04-04,168,166,2,0.0119047619047619
NORESTE 2,2023-04-05,174,164,10,0.0574712643678161
NORESTE 2,2023-04-06,197,194,3,0.0152284263959391
NORESTE 2,2023-04-07,214,213,1,0.00467289719626168
NORESTE 2,2023-04-08,204,203,1,0.00490196078431373
NORESTE 2,2023-04-09,114,114,0,0
NORESTE 2,2023-04-10,134,133,1,0.00746268656716418
NORESTE 2,2023-04-11,176,170,6,0.0340909090909091
NORESTE 2,2023-04-12,159,157,2,0.0125786163522013
NORESTE 2,2023-04-13,146,139,7,0.0479452054794521
NORESTE 2,2023-04-14,236,236,0,0
NORESTE 2,2023-04-15,252,249,3,0.0119047619047619
NORESTE 2,2023-04-16,161,158,3,0.0186335403726708
NORESTE 2,2023-04-17,219,213,6,0.0273972602739726
NORESTE 2,2023-04-18,200,197,3,0.015
NORESTE 2,2023-04-19,173,171,2,0.0115606936416185
NORESTE 2,2023-04-20,179,175,4,0.0223463687150838
NORESTE 2,2023-04-21,236,230,6,0.0254237288135593
NORESTE 2,2023-04-22,247,245,2,0.00809716599190283
NORESTE 2,2023-04-23,189,187,2,0.0105820105820106
NORESTE 2,2023-04-24,188,186,2,0.0106382978723404
NORESTE 2,2023-04-25,244,233,11,0.0450819672131148
NORESTE 2,2023-04-26,223,223,0,0
NORESTE 2,2023-04-27,171,170,1,0.00584795321637427
NORESTE 2,2023-04-28,202,199,3,0.0148514851485149
NORESTE 2,2023-04-29,276,269,7,0.0253623188405797
NORESTE 2,2023-04-30,214,210,4,0.0186915887850467
NORESTE 2,2023-05-01,166,165,1,0.00602409638554217
NORESTE 2,2023-05-02,170,165,5,0.0294117647058824
NORESTE 2,2023-05-03,205,201,4,0.0195121951219512
NORESTE 2,2023-05-04,203,196,7,0.0344827586206897
NORESTE 2,2023-05-05,225,218,7,0.0311111111111111
NORESTE 2,2023-05-06,251,244,7,0.0278884462151394
NORESTE 2,2023-05-07,153,151,2,0.0130718954248366
NORESTE 2,2023-05-08,139,133,6,0.0431654676258993
NORESTE 2,2023-05-09,177,176,1,0.00564971751412429
NORESTE 2,2023-05-10,182,176,6,0.032967032967033
NORESTE 2,2023-05-11,178,176,2,0.0112359550561798
NORESTE 2,2023-05-12,181,179,2,0.0110497237569061
NORESTE 2,2023-05-13,276,274,2,0.0072463768115942
NORESTE 2,2023-05-14,240,235,5,0.0208333333333333
NORESTE 2,2023-05-15,254,251,3,0.0118110236220472
NORESTE 2,2023-05-16,285,280,5,0.0175438596491228
NORESTE 2,2023-05-17,211,208,3,0.014218009478673
NORESTE 2,2023-05-18,179,174,5,0.0279329608938547
NORESTE 2,2023-05-19,193,190,3,0.0155440414507772
NORESTE 2,2023-05-20,173,170,3,0.0173410404624277
NORESTE 2,2023-05-21,188,185,3,0.0159574468085106
NORESTE 2,2023-05-22,206,202,4,0.0194174757281553
NORESTE 2,2023-05-23,183,181,2,0.0109289617486339
NORESTE 2,2023-05-24,185,179,6,0.0324324324324324
NORESTE 2,2023-05-25,167,164,3,0.0179640718562874
NORESTE 2,2023-05-26,112,109,3,0.0267857142857143
NORESTE 2,2023-05-27,158,147,11,0.069620253164557
NORESTE 2,2023-05-28,179,174,5,0.0279329608938547
NORESTE 2,2023-05-29,144,141,3,0.0208333333333333
NORESTE 2,2023-05-30,126,124,2,0.0158730158730159
NORESTE 2,2023-05-31,151,148,3,0.0198675496688742
NORESTE 2,2023-06-01,90,87,3,0.0333333333333333
NORESTE 2,2023-06-02,169,164,5,0.029585798816568
NORESTE 2,2023-06-03,155,153,2,0.0129032258064516
NORESTE 2,2023-06-04,143,142,1,0.00699300699300699
NORESTE 2,2023-06-05,152,146,6,0.0394736842105263
NORESTE 2,2023-06-06,196,194,2,0.0102040816326531
NORESTE 2,2023-06-07,186,181,5,0.0268817204301075
NORESTE 2,2023-06-08,167,160,7,0.0419161676646707
NORESTE 2,2023-06-09,144,141,3,0.0208333333333333
NORESTE 2,2023-06-10,168,164,4,0.0238095238095238
NORESTE 2,2023-06-11,140,139,1,0.00714285714285714
NORESTE 2,2023-06-12,174,169,5,0.028735632183908
NORESTE 2,2023-06-13,155,150,5,0.032258064516129
NORESTE 2,2023-06-14,172,168,4,0.0232558139534884
NORESTE 2,2023-06-15,154,150,4,0.025974025974026
NORESTE 2,2023-06-16,136,135,1,0.00735294117647059
NORESTE 2,2023-06-17,223,218,5,0.0224215246636771
NORESTE 2,2023-06-18,112,110,2,0.0178571428571429
NORESTE 2,2023-06-19,145,143,2,0.0137931034482759
NORESTE 2,2023-06-20,153,148,5,0.0326797385620915
NORESTE 2,2023-06-21,149,147,2,0.0134228187919463
NORESTE 2,2023-06-22,182,178,4,0.021978021978022
NORESTE 2,2023-06-23,194,187,7,0.0360824742268041
NORESTE 2,2023-06-24,176,175,1,0.00568181818181818
NORESTE 2,2023-06-25,144,138,6,0.0416666666666667
NORESTE 2,2023-06-26,139,135,4,0.0287769784172662
NORESTE 2,2023-06-27,186,181,5,0.0268817204301075
NORESTE 2,2023-06-28,138,130,8,0.0579710144927536
NORESTE 2,2023-06-29,171,164,7,0.0409356725146199
NORESTE 2,2023-06-30,101,92,9,0.0891089108910891
NORESTE 2,2023-07-01,149,142,7,0.0469798657718121
NORESTE 2,2023-07-02,126,123,3,0.0238095238095238
NORESTE 2,2023-07-03,157,153,4,0.0254777070063694
NORESTE 2,2023-07-04,174,168,6,0.0344827586206897
NORESTE 2,2023-07-05,66,64,2,0.0303030303030303
NORESTE 2,2023-07-06,140,136,4,0.0285714285714286
NORESTE 2,2023-07-07,158,152,6,0.0379746835443038
NORESTE 2,2023-07-08,196,190,6,0.0306122448979592
NORESTE 2,2023-07-09,171,171,0,0
NORESTE 2,2023-07-10,152,146,6,0.0394736842105263
NORESTE 2,2023-07-11,216,208,8,0.037037037037037
NORESTE 2,2023-07-12,203,196,7,0.0344827586206897
NORESTE 2,2023-07-13,224,219,5,0.0223214285714286
NORESTE 2,2023-07-14,204,195,9,0.0441176470588235
NORESTE 2,2023-07-15,244,237,7,0.0286885245901639
NORESTE 2,2023-07-16,155,153,2,0.0129032258064516
NORESTE 2,2023-07-17,196,191,5,0.0255102040816327
NORESTE 2,2023-07-18,209,206,3,0.0143540669856459
NORESTE 2,2023-07-19,175,172,3,0.0171428571428571
NORESTE 2,2023-07-20,192,188,4,0.0208333333333333
NORESTE 2,2023-07-21,220,211,9,0.0409090909090909
NORESTE 2,2023-07-22,276,268,8,0.0289855072463768
NORESTE 2,2023-07-23,203,200,3,0.0147783251231527
NORESTE 2,2023-07-24,187,178,9,0.0481283422459893
NORESTE 2,2023-07-25,214,208,6,0.0280373831775701
NORESTE 2,2023-07-26,227,221,6,0.026431718061674
NORESTE 2,2023-07-27,222,219,3,0.0135135135135135
NORESTE 2,2023-07-28,220,212,8,0.0363636363636364
NORESTE 2,2023-07-29,214,206,8,0.0373831775700935
NORESTE 2,2023-07-30,199,196,3,0.0150753768844221
NORESTE 2,2023-07-31,179,168,11,0.0614525139664804
NORESTE 2,2023-08-01,199,188,11,0.0552763819095477
NORESTE 2,2023-08-02,239,230,9,0.0376569037656904
NORESTE 2,2023-08-03,228,194,34,0.149122807017544
NORESTE 2,2023-08-04,208,195,13,0.0625
NORESTE 2,2023-08-05,279,260,19,0.0681003584229391
NORESTE 2,2023-08-06,148,138,10,0.0675675675675676
NORESTE 2,2023-08-07,180,173,7,0.0388888888888889
NORESTE 2,2023-08-08,170,160,10,0.0588235294117647
NORESTE 2,2023-08-09,206,195,11,0.0533980582524272
NORESTE 2,2023-08-10,186,180,6,0.032258064516129
NORESTE 2,2023-08-11,243,233,10,0.0411522633744856
NORESTE 2,2023-08-12,187,173,14,0.0748663101604278
NORESTE 2,2023-08-13,137,127,10,0.072992700729927
NORESTE 2,2023-08-14,175,165,10,0.0571428571428571
NORESTE 2,2023-08-15,221,214,7,0.0316742081447964
NORESTE 2,2023-08-16,211,205,6,0.028436018957346
NORESTE 2,2023-08-17,248,238,10,0.0403225806451613
NORESTE 2,2023-08-18,304,297,7,0.0230263157894737
NORESTE 2,2023-08-19,331,314,17,0.0513595166163142
NORESTE 2,2023-08-20,205,201,4,0.0195121951219512
NORESTE 2,2023-08-21,181,176,5,0.0276243093922652
NORESTE 2,2023-08-22,208,203,5,0.0240384615384615
NORESTE 2,2023-08-23,225,216,9,0.04
NORESTE 2,2023-08-24,199,187,12,0.0603015075376884
NORESTE 2,2023-08-25,268,263,5,0.0186567164179104
NORESTE 2,2023-08-26,299,290,9,0.0301003344481605
NORESTE 2,2023-08-27,246,236,10,0.040650406504065
NORESTE 2,2023-08-28,229,217,12,0.0524017467248908
NORESTE 2,2023-08-29,215,202,13,0.0604651162790698
NORESTE 2,2023-08-30,178,172,6,0.0337078651685393
NORESTE 2,2023-08-31,212,206,6,0.0283018867924528
NORESTE 2,2023-09-01,192,188,4,0.0208333333333333
NORESTE 2,2023-09-02,223,219,4,0.0179372197309417
NORESTE 2,2023-09-03,161,158,3,0.0186335403726708
NORESTE 2,2023-09-04,191,187,4,0.0209424083769634
NORESTE 2,2023-09-05,218,212,6,0.0275229357798165
NORESTE 2,2023-09-06,200,199,1,0.005
NORESTE 2,2023-09-07,183,179,4,0.0218579234972678
NORESTE 2,2023-09-08,220,217,3,0.0136363636363636
NORESTE 2,2023-09-09,242,234,8,0.0330578512396694
NORESTE 2,2023-09-10,154,153,1,0.00649350649350649
NORESTE 2,2023-09-11,177,174,3,0.0169491525423729
NORESTE 2,2023-09-12,197,191,6,0.0304568527918782
NORESTE 2,2023-09-13,181,175,6,0.0331491712707182
NORESTE 2,2023-09-14,129,128,1,0.00775193798449612
NORESTE 2,2023-09-15,222,213,9,0.0405405405405405
NORESTE 2,2023-09-16,145,143,2,0.0137931034482759
NORESTE 2,2023-09-17,146,143,3,0.0205479452054795
NORESTE 2,2023-09-18,165,160,5,0.0303030303030303
NORESTE 2,2023-09-19,100,100,0,0
NORESTE 2,2023-09-20,93,91,2,0.021505376344086
NORESTE 2,2023-09-21,75,70,5,0.0666666666666667
NORESTE 2,2023-09-22,253,252,1,0.00395256916996047
NORESTE 2,2023-09-23,255,247,8,0.0313725490196078
NORESTE 2,2023-09-24,186,182,4,0.021505376344086
NORESTE 2,2023-09-25,195,191,4,0.0205128205128205
NORESTE 2,2023-09-26,223,217,6,0.0269058295964126
NORESTE 2,2023-09-27,175,170,5,0.0285714285714286
NORESTE 2,2023-09-28,210,201,9,0.0428571428571429
NORESTE 2,2023-09-29,209,193,16,0.076555023923445
NORESTE 2,2023-09-30,255,241,14,0.0549019607843137
NORESTE 2,2023-10-01,165,150,15,0.0909090909090909
NORESTE 2,2023-10-02,182,174,8,0.043956043956044
NORESTE 2,2023-10-03,90,84,6,0.0666666666666667
NORESTE 2,2023-10-04,228,215,13,0.0570175438596491
NORESTE 2,2023-10-05,177,170,7,0.0395480225988701
NORESTE 2,2023-10-06,192,185,7,0.0364583333333333
NORESTE 2,2023-10-07,217,203,14,0.0645161290322581
NORESTE 2,2023-10-08,156,145,11,0.0705128205128205
NORESTE 2,2023-10-09,175,164,11,0.0628571428571429
NORESTE 2,2023-10-10,137,131,6,0.0437956204379562
NORESTE 2,2023-10-11,144,140,4,0.0277777777777778
NORESTE 2,2023-10-12,135,129,6,0.0444444444444444
NORESTE 2,2023-10-13,126,124,2,0.0158730158730159
NORESTE 2,2023-10-14,172,169,3,0.0174418604651163
NORESTE 2,2023-10-15,157,151,6,0.0382165605095541
NORESTE 2,2023-10-16,195,190,5,0.0256410256410256
NORESTE 2,2023-10-17,193,188,5,0.0259067357512953
NORESTE 2,2023-10-18,235,228,7,0.0297872340425532
NORESTE 2,2023-10-19,215,209,6,0.027906976744186
NORESTE 2,2023-10-20,193,188,5,0.0259067357512953
NORESTE 2,2023-10-21,269,259,10,0.0371747211895911
NORESTE 2,2023-10-22,160,157,3,0.01875
NORESTE 2,2023-10-23,214,206,8,0.0373831775700935
NORESTE 2,2023-10-24,169,163,6,0.0355029585798817
NORESTE 2,2023-10-25,194,193,1,0.00515463917525773
NORESTE 2,2023-10-26,201,196,5,0.0248756218905473
NORESTE 2,2023-10-27,209,204,5,0.0239234449760766
NORESTE 2,2023-10-28,262,258,4,0.0152671755725191
NORESTE 2,2023-10-29,191,184,7,0.0366492146596859
NORESTE 2,2023-10-30,157,153,4,0.0254777070063694
NORESTE 2,2023-10-31,188,183,5,0.0265957446808511
NORESTE 2,2023-11-01,155,152,3,0.0193548387096774
NORESTE 2,2023-11-02,188,185,3,0.0159574468085106
NORESTE 2,2023-11-03,193,190,3,0.0155440414507772
NORESTE 2,2023-11-04,264,259,5,0.0189393939393939
NORESTE 2,2023-11-05,184,178,6,0.0326086956521739
NORESTE 2,2023-11-06,168,162,6,0.0357142857142857
NORESTE 2,2023-11-07,188,178,10,0.0531914893617021
NORESTE 2,2023-11-08,222,216,6,0.027027027027027
NORESTE 2,2023-11-09,218,213,5,0.0229357798165138
NORESTE 2,2023-11-10,201,199,2,0.00995024875621891
NORESTE 2,2023-11-11,293,285,8,0.0273037542662116
NORESTE 2,2023-11-12,101,96,5,0.0495049504950495
NORESTE 2,2023-11-13,200,191,9,0.045
NORESTE 2,2023-11-14,190,188,2,0.0105263157894737
NORESTE 2,2023-11-15,188,182,6,0.0319148936170213
NORESTE 2,2023-11-16,193,186,7,0.0362694300518135
NORESTE 2,2023-11-17,253,245,8,0.0316205533596838
NORESTE 2,2023-11-18,312,307,5,0.016025641025641
NORESTE 2,2023-11-19,190,186,4,0.0210526315789474
NORESTE 2,2023-11-20,200,198,2,0.01
NORESTE 2,2023-11-21,169,163,6,0.0355029585798817
NORESTE 2,2023-11-22,180,171,9,0.05
NORESTE 2,2023-11-23,235,229,6,0.025531914893617
NORESTE 2,2023-11-24,267,255,12,0.0449438202247191
NORESTE 2,2023-11-25,269,263,6,0.0223048327137546
NORESTE 2,2023-11-26,254,245,9,0.0354330708661417
NORESTE 2,2023-11-27,171,167,4,0.0233918128654971
NORESTE 2,2023-11-28,231,225,6,0.025974025974026
NORESTE 2,2023-11-29,202,187,15,0.0742574257425743
NORESTE 2,2023-11-30,224,208,16,0.0714285714285714
NORESTE 2,2023-12-01,186,179,7,0.0376344086021505
NORESTE 2,2023-12-02,292,285,7,0.023972602739726
NORESTE 2,2023-12-03,194,190,4,0.0206185567010309
NORESTE 2,2023-12-04,190,174,16,0.0842105263157895
NORESTE 2,2023-12-05,199,189,10,0.050251256281407
NORESTE 2,2023-12-06,177,168,9,0.0508474576271186
NORESTE 2,2023-12-07,219,211,8,0.0365296803652968
NORESTE 2,2023-12-08,207,201,6,0.0289855072463768
NORESTE 2,2023-12-09,276,265,11,0.0398550724637681
NORESTE 2,2023-12-10,224,213,11,0.0491071428571429
NORESTE 2,2023-12-11,121,115,6,0.0495867768595041
NORESTE 2,2023-12-12,222,213,9,0.0405405405405405
NORESTE 2,2023-12-13,158,153,5,0.0316455696202532
NORESTE 2,2023-12-14,194,186,8,0.0412371134020619
NORESTE 2,2023-12-15,206,200,6,0.029126213592233
NORESTE 2,2023-12-16,219,210,9,0.0410958904109589
NORESTE 2,2023-12-17,158,152,6,0.0379746835443038
NORESTE 2,2023-12-18,168,161,7,0.0416666666666667
NORESTE 2,2023-12-19,212,206,6,0.0283018867924528
NORESTE 2,2023-12-20,243,237,6,0.0246913580246914
NORESTE 2,2023-12-21,196,185,11,0.0561224489795918
NORESTE 2,2023-12-22,219,213,6,0.0273972602739726
NORESTE 2,2023-12-23,244,235,9,0.0368852459016393
NORESTE 2,2023-12-24,134,132,2,0.0149253731343284
NORESTE 2,2023-12-25,48,48,0,0
NORESTE 2,2023-12-26,168,163,5,0.0297619047619048
NORESTE 2,2023-12-27,218,208,10,0.0458715596330275
NORESTE 2,2023-12-28,219,213,6,0.0273972602739726
NORESTE 2,2023-12-29,263,253,10,0.0380228136882129
NORESTE 2,2023-12-30,249,246,3,0.0120481927710843
NORESTE 2,2023-12-31,124,119,5,0.0403225806451613
NORESTE 2,2024-01-01,30,29,1,0.0333333333333333
NORESTE 2,2024-01-02,143,137,6,0.041958041958042
NORESTE 2,2024-01-03,217,209,8,0.0368663594470046
NORESTE 2,2024-01-04,199,193,6,0.0301507537688442
NORESTE 2,2024-01-05,227,214,13,0.0572687224669604
NORESTE 2,2024-01-06,301,285,16,0.053156146179402
NORESTE 2,2024-01-07,167,164,3,0.0179640718562874
NORESTE 2,2024-01-08,153,148,5,0.0326797385620915
NORESTE 2,2024-01-09,189,179,10,0.0529100529100529
NORESTE 2,2024-01-10,189,179,10,0.0529100529100529
NORESTE 2,2024-01-11,216,213,3,0.0138888888888889
NORESTE 2,2024-01-12,260,253,7,0.0269230769230769
NORESTE 2,2024-01-13,275,273,2,0.00727272727272727
NORESTE 2,2024-01-14,216,214,2,0.00925925925925926
NORESTE 2,2024-01-15,186,180,6,0.032258064516129
NORESTE 2,2024-01-16,219,215,4,0.0182648401826484
NORESTE 2,2024-01-17,219,212,7,0.0319634703196347
NORESTE 2,2024-01-18,240,231,9,0.0375
NORESTE 2,2024-01-19,208,204,4,0.0192307692307692
NORESTE 2,2024-01-20,250,240,10,0.04
NORESTE 2,2024-01-21,208,202,6,0.0288461538461538
NORESTE 2,2024-01-22,181,179,2,0.0110497237569061
NORESTE 2,2024-01-23,226,213,13,0.0575221238938053
NORESTE 2,2024-01-24,213,204,9,0.0422535211267606
NORESTE 2,2024-01-25,254,246,8,0.031496062992126
NORESTE 2,2024-01-26,237,226,11,0.0464135021097046
NORESTE 2,2024-01-27,250,246,4,0.016
NORESTE 2,2024-01-28,190,183,7,0.0368421052631579
NORESTE 2,2024-01-29,196,182,14,0.0714285714285714
NORESTE 2,2024-01-30,179,172,7,0.0391061452513966
NORESTE 2,2024-01-31,211,207,4,0.018957345971564
NORESTE 2,2024-02-01,189,179,10,0.0529100529100529
NORESTE 2,2024-02-02,221,211,10,0.0452488687782805
NORESTE 2,2024-02-03,240,226,14,0.0583333333333333
NORESTE 2,2024-02-04,161,156,5,0.031055900621118
NORESTE 2,2024-02-05,118,117,1,0.00847457627118644
NORESTE 2,2024-02-06,161,159,2,0.0124223602484472
NORESTE 2,2024-02-07,175,168,7,0.04
NORESTE 2,2024-02-08,226,226,0,0
NORESTE 2,2024-02-09,209,201,8,0.0382775119617225
NORESTE 2,2024-02-10,234,228,6,0.0256410256410256
NORESTE 2,2024-02-11,170,167,3,0.0176470588235294
NORESTE 2,2024-02-12,130,125,5,0.0384615384615385
NORESTE 2,2024-02-13,226,222,4,0.0176991150442478
NORESTE 2,2024-02-14,176,170,6,0.0340909090909091
NORESTE 2,2024-02-15,188,181,7,0.0372340425531915
NORESTE 2,2024-02-16,214,206,8,0.0373831775700935
NORESTE 2,2024-02-17,166,162,4,0.0240963855421687
NORESTE 2,2024-02-18,201,198,3,0.0149253731343284
NORESTE 2,2024-02-19,181,177,4,0.0220994475138122
NORESTE 2,2024-02-20,191,188,3,0.0157068062827225
NORESTE 2,2024-02-21,215,213,2,0.00930232558139535
NORESTE 2,2024-02-22,224,222,2,0.00892857142857143
NORESTE 2,2024-02-23,198,169,29,0.146464646464646
NORESTE 2,2024-02-24,276,269,7,0.0253623188405797
NORESTE 2,2024-02-25,168,165,3,0.0178571428571429
NORESTE 2,2024-02-26,187,178,9,0.0481283422459893
NORESTE 2,2024-02-27,219,213,6,0.0273972602739726
NORESTE 2,2024-02-28,167,160,7,0.0419161676646707
NORESTE 2,2024-02-29,197,188,9,0.0456852791878173
NORESTE 2,2024-03-01,212,206,6,0.0283018867924528
NORESTE 2,2024-03-02,223,218,5,0.0224215246636771
NORESTE 2,2024-03-03,168,164,4,0.0238095238095238
NORESTE 2,2024-03-04,189,183,6,0.0317460317460317
NORESTE 2,2024-03-05,201,198,3,0.0149253731343284
NORESTE 2,2024-03-06,193,188,5,0.0259067357512953
NORESTE 2,2024-03-07,195,190,5,0.0256410256410256
NORESTE 2,2024-03-08,175,170,5,0.0285714285714286
NORESTE 2,2024-03-09,238,232,6,0.0252100840336134
NORESTE 2,2024-03-10,174,171,3,0.0172413793103448
NORESTE 2,2024-03-11,196,191,5,0.0255102040816327
NORTE BARRANCA,2023-03-12,117,84,33,0.282051282051282
NORTE BARRANCA,2023-03-13,140,104,36,0.257142857142857
NORTE BARRANCA,2023-03-14,149,102,47,0.315436241610738
NORTE BARRANCA,2023-03-15,146,124,22,0.150684931506849
NORTE BARRANCA,2023-03-16,149,139,10,0.0671140939597315
NORTE BARRANCA,2023-03-17,151,137,14,0.0927152317880795
NORTE BARRANCA,2023-03-18,186,166,20,0.10752688172043
NORTE BARRANCA,2023-03-19,132,112,20,0.151515151515152
NORTE BARRANCA,2023-03-20,169,146,23,0.136094674556213
NORTE BARRANCA,2023-03-21,147,132,15,0.102040816326531
NORTE BARRANCA,2023-03-22,146,132,14,0.0958904109589041
NORTE BARRANCA,2023-03-23,159,146,13,0.0817610062893082
NORTE BARRANCA,2023-03-24,156,147,9,0.0576923076923077
NORTE BARRANCA,2023-03-25,226,197,29,0.128318584070796
NORTE BARRANCA,2023-03-26,143,135,8,0.0559440559440559
NORTE BARRANCA,2023-03-27,127,117,10,0.078740157480315
NORTE BARRANCA,2023-03-28,120,115,5,0.0416666666666667
NORTE BARRANCA,2023-03-29,141,134,7,0.049645390070922
NORTE BARRANCA,2023-03-30,148,141,7,0.0472972972972973
NORTE BARRANCA,2023-03-31,190,187,3,0.0157894736842105
NORTE BARRANCA,2023-04-01,216,202,14,0.0648148148148148
NORTE BARRANCA,2023-04-02,107,100,7,0.0654205607476635
NORTE BARRANCA,2023-04-03,164,155,9,0.0548780487804878
NORTE BARRANCA,2023-04-04,140,136,4,0.0285714285714286
NORTE BARRANCA,2023-04-05,145,139,6,0.0413793103448276
NORTE BARRANCA,2023-04-06,169,164,5,0.029585798816568
NORTE BARRANCA,2023-04-07,168,165,3,0.0178571428571429
NORTE BARRANCA,2023-04-08,135,132,3,0.0222222222222222
NORTE BARRANCA,2023-04-09,58,57,1,0.0172413793103448
NORTE BARRANCA,2023-04-10,129,126,3,0.0232558139534884
NORTE BARRANCA,2023-04-11,125,123,2,0.016
NORTE BARRANCA,2023-04-12,149,147,2,0.0134228187919463
NORTE BARRANCA,2023-04-13,149,142,7,0.0469798657718121
NORTE BARRANCA,2023-04-14,148,139,9,0.0608108108108108
NORTE BARRANCA,2023-04-15,247,243,4,0.0161943319838057
NORTE BARRANCA,2023-04-16,147,145,2,0.0136054421768707
NORTE BARRANCA,2023-04-17,157,150,7,0.0445859872611465
NORTE BARRANCA,2023-04-18,140,137,3,0.0214285714285714
NORTE BARRANCA,2023-04-19,133,126,7,0.0526315789473684
NORTE BARRANCA,2023-04-20,152,145,7,0.0460526315789474
NORTE BARRANCA,2023-04-21,153,144,9,0.0588235294117647
NORTE BARRANCA,2023-04-22,199,187,12,0.0603015075376884
NORTE BARRANCA,2023-04-23,108,103,5,0.0462962962962963
NORTE BARRANCA,2023-04-24,142,134,8,0.0563380281690141
NORTE BARRANCA,2023-04-25,175,150,25,0.142857142857143
NORTE BARRANCA,2023-04-26,168,142,26,0.154761904761905
NORTE BARRANCA,2023-04-27,141,128,13,0.0921985815602837
NORTE BARRANCA,2023-04-28,190,177,13,0.068421052631579
NORTE BARRANCA,2023-04-29,245,224,21,0.0857142857142857
NORTE BARRANCA,2023-04-30,126,119,7,0.0555555555555556
NORTE BARRANCA,2023-05-01,120,110,10,0.0833333333333333
NORTE BARRANCA,2023-05-02,148,138,10,0.0675675675675676
NORTE BARRANCA,2023-05-03,137,130,7,0.0510948905109489
NORTE BARRANCA,2023-05-04,149,136,13,0.087248322147651
NORTE BARRANCA,2023-05-05,163,152,11,0.0674846625766871
NORTE BARRANCA,2023-05-06,149,140,9,0.0604026845637584
NORTE BARRANCA,2023-05-07,100,97,3,0.03
NORTE BARRANCA,2023-05-08,147,138,9,0.0612244897959184
NORTE BARRANCA,2023-05-09,157,150,7,0.0445859872611465
NORTE BARRANCA,2023-05-10,137,135,2,0.0145985401459854
NORTE BARRANCA,2023-05-11,168,163,5,0.0297619047619048
NORTE BARRANCA,2023-05-12,160,154,6,0.0375
NORTE BARRANCA,2023-05-13,242,229,13,0.0537190082644628
NORTE BARRANCA,2023-05-14,152,147,5,0.0328947368421053
NORTE BARRANCA,2023-05-15,177,166,11,0.0621468926553672
NORTE BARRANCA,2023-05-16,182,170,12,0.0659340659340659
NORTE BARRANCA,2023-05-17,169,156,13,0.0769230769230769
NORTE BARRANCA,2023-05-18,148,140,8,0.0540540540540541
NORTE BARRANCA,2023-05-19,142,133,9,0.0633802816901408
NORTE BARRANCA,2023-05-20,194,180,14,0.0721649484536082
NORTE BARRANCA,2023-05-21,145,134,11,0.0758620689655172
NORTE BARRANCA,2023-05-22,152,145,7,0.0460526315789474
NORTE BARRANCA,2023-05-23,141,117,24,0.170212765957447
NORTE BARRANCA,2023-05-24,145,137,8,0.0551724137931034
NORTE BARRANCA,2023-05-25,142,133,9,0.0633802816901408
NORTE BARRANCA,2023-05-26,182,162,20,0.10989010989011
NORTE BARRANCA,2023-05-27,214,178,36,0.168224299065421
NORTE BARRANCA,2023-05-28,89,79,10,0.112359550561798
NORTE BARRANCA,2023-05-29,159,149,10,0.0628930817610063
NORTE BARRANCA,2023-05-30,153,136,17,0.111111111111111
NORTE BARRANCA,2023-05-31,181,166,15,0.0828729281767956
NORTE BARRANCA,2023-06-01,133,124,9,0.0676691729323308
NORTE BARRANCA,2023-06-02,149,138,11,0.0738255033557047
NORTE BARRANCA,2023-06-03,190,168,22,0.115789473684211
NORTE BARRANCA,2023-06-04,104,83,21,0.201923076923077
NORTE BARRANCA,2023-06-05,132,122,10,0.0757575757575758
NORTE BARRANCA,2023-06-06,126,118,8,0.0634920634920635
NORTE BARRANCA,2023-06-07,160,147,13,0.08125
NORTE BARRANCA,2023-06-08,148,139,9,0.0608108108108108
NORTE BARRANCA,2023-06-09,158,144,14,0.0886075949367089
NORTE BARRANCA,2023-06-10,228,211,17,0.0745614035087719
NORTE BARRANCA,2023-06-11,149,123,26,0.174496644295302
NORTE BARRANCA,2023-06-12,168,155,13,0.0773809523809524
NORTE BARRANCA,2023-06-13,191,180,11,0.0575916230366492
NORTE BARRANCA,2023-06-14,170,156,14,0.0823529411764706
NORTE BARRANCA,2023-06-15,162,152,10,0.0617283950617284
NORTE BARRANCA,2023-06-16,153,140,13,0.0849673202614379
NORTE BARRANCA,2023-06-17,177,163,14,0.0790960451977401
NORTE BARRANCA,2023-06-18,101,83,18,0.178217821782178
NORTE BARRANCA,2023-06-19,156,145,11,0.0705128205128205
NORTE BARRANCA,2023-06-20,120,115,5,0.0416666666666667
NORTE BARRANCA,2023-06-21,155,144,11,0.0709677419354839
NORTE BARRANCA,2023-06-22,121,109,12,0.0991735537190083
NORTE BARRANCA,2023-06-23,103,99,4,0.0388349514563107
NORTE BARRANCA,2023-06-24,159,158,1,0.00628930817610063
NORTE BARRANCA,2023-06-25,85,80,5,0.0588235294117647
NORTE BARRANCA,2023-06-26,131,125,6,0.0458015267175573
NORTE BARRANCA,2023-06-27,134,132,2,0.0149253731343284
NORTE BARRANCA,2023-06-28,147,144,3,0.0204081632653061
NORTE BARRANCA,2023-06-29,146,144,2,0.0136986301369863
NORTE BARRANCA,2023-06-30,90,86,4,0.0444444444444444
NORTE BARRANCA,2023-07-01,160,159,1,0.00625
NORTE BARRANCA,2023-07-02,30,28,2,0.0666666666666667
NORTE BARRANCA,2023-07-03,162,158,4,0.0246913580246914
NORTE BARRANCA,2023-07-04,139,134,5,0.0359712230215827
NORTE BARRANCA,2023-07-05,120,114,6,0.05
NORTE BARRANCA,2023-07-06,77,76,1,0.012987012987013
NORTE BARRANCA,2023-07-07,52,52,0,0
NORTE BARRANCA,2023-07-08,127,127,0,0
NORTE BARRANCA,2023-07-09,88,87,1,0.0113636363636364
NORTE BARRANCA,2023-07-10,123,117,6,0.0487804878048781
NORTE BARRANCA,2023-07-11,84,80,4,0.0476190476190476
NORTE BARRANCA,2023-07-12,116,115,1,0.00862068965517241
NORTE BARRANCA,2023-07-13,74,73,1,0.0135135135135135
NORTE BARRANCA,2023-07-14,138,134,4,0.0289855072463768
NORTE BARRANCA,2023-07-15,108,103,5,0.0462962962962963
NORTE BARRANCA,2023-07-16,53,51,2,0.0377358490566038
NORTE BARRANCA,2023-07-17,118,113,5,0.0423728813559322
NORTE BARRANCA,2023-07-18,115,115,0,0
NORTE BARRANCA,2023-07-19,116,114,2,0.0172413793103448
NORTE BARRANCA,2023-07-20,168,167,1,0.00595238095238095
NORTE BARRANCA,2023-07-21,159,158,1,0.00628930817610063
NORTE BARRANCA,2023-07-22,181,178,3,0.0165745856353591
NORTE BARRANCA,2023-07-23,73,72,1,0.0136986301369863
NORTE BARRANCA,2023-07-24,139,137,2,0.0143884892086331
NORTE BARRANCA,2023-07-25,161,159,2,0.0124223602484472
NORTE BARRANCA,2023-07-26,133,131,2,0.0150375939849624
NORTE BARRANCA,2023-07-27,150,147,3,0.02
NORTE BARRANCA,2023-07-28,181,179,2,0.0110497237569061
NORTE BARRANCA,2023-07-29,155,151,4,0.0258064516129032
NORTE BARRANCA,2023-07-30,92,91,1,0.0108695652173913
NORTE BARRANCA,2023-07-31,126,126,0,0
NORTE BARRANCA,2023-08-01,147,145,2,0.0136054421768707
NORTE BARRANCA,2023-08-02,151,145,6,0.0397350993377483
NORTE BARRANCA,2023-08-03,134,116,18,0.134328358208955
NORTE BARRANCA,2023-08-04,188,182,6,0.0319148936170213
NORTE BARRANCA,2023-08-05,169,167,2,0.0118343195266272
NORTE BARRANCA,2023-08-06,99,96,3,0.0303030303030303
NORTE BARRANCA,2023-08-07,126,124,2,0.0158730158730159
NORTE BARRANCA,2023-08-08,112,107,5,0.0446428571428571
NORTE BARRANCA,2023-08-09,137,136,1,0.0072992700729927
NORTE BARRANCA,2023-08-10,140,138,2,0.0142857142857143
NORTE BARRANCA,2023-08-11,162,159,3,0.0185185185185185
NORTE BARRANCA,2023-08-12,145,142,3,0.0206896551724138
NORTE BARRANCA,2023-08-13,114,113,1,0.0087719298245614
NORTE BARRANCA,2023-08-14,113,111,2,0.0176991150442478
NORTE BARRANCA,2023-08-15,122,119,3,0.0245901639344262
NORTE BARRANCA,2023-08-16,77,75,2,0.025974025974026
NORTE BARRANCA,2023-08-17,112,109,3,0.0267857142857143
NORTE BARRANCA,2023-08-18,106,102,4,0.0377358490566038
NORTE BARRANCA,2023-08-19,121,120,1,0.00826446280991736
NORTE BARRANCA,2023-08-20,58,58,0,0
NORTE BARRANCA,2023-08-21,154,154,0,0
NORTE BARRANCA,2023-08-22,126,126,0,0
NORTE BARRANCA,2023-08-23,146,144,2,0.0136986301369863
NORTE BARRANCA,2023-08-24,116,116,0,0
NORTE BARRANCA,2023-08-25,148,147,1,0.00675675675675676
NORTE BARRANCA,2023-08-26,204,203,1,0.00490196078431373
NORTE BARRANCA,2023-08-27,122,122,0,0
NORTE BARRANCA,2023-08-28,150,150,0,0
NORTE BARRANCA,2023-08-29,145,145,0,0
NORTE BARRANCA,2023-08-30,142,142,0,0
NORTE BARRANCA,2023-08-31,146,146,0,0
NORTE BARRANCA,2023-09-01,133,133,0,0
NORTE BARRANCA,2023-09-02,153,153,0,0
NORTE BARRANCA,2023-09-03,102,102,0,0
NORTE BARRANCA,2023-09-04,154,154,0,0
NORTE BARRANCA,2023-09-05,155,154,1,0.00645161290322581
NORTE BARRANCA,2023-09-06,146,146,0,0
NORTE BARRANCA,2023-09-07,131,131,0,0
NORTE BARRANCA,2023-09-08,176,175,1,0.00568181818181818
NORTE BARRANCA,2023-09-09,159,159,0,0
NORTE BARRANCA,2023-09-10,88,87,1,0.0113636363636364
NORTE BARRANCA,2023-09-11,141,141,0,0
NORTE BARRANCA,2023-09-12,132,132,0,0
NORTE BARRANCA,2023-09-13,139,138,1,0.00719424460431655
NORTE BARRANCA,2023-09-14,111,111,0,0
NORTE BARRANCA,2023-09-15,137,137,0,0
NORTE BARRANCA,2023-09-16,93,93,0,0
NORTE BARRANCA,2023-09-17,100,100,0,0
NORTE BARRANCA,2023-09-18,182,182,0,0
NORTE BARRANCA,2023-09-19,159,159,0,0
NORTE BARRANCA,2023-09-20,143,143,0,0
NORTE BARRANCA,2023-09-21,129,128,1,0.00775193798449612
NORTE BARRANCA,2023-09-22,165,164,1,0.00606060606060606
NORTE BARRANCA,2023-09-23,198,197,1,0.00505050505050505
NORTE BARRANCA,2023-09-24,95,94,1,0.0105263157894737
NORTE BARRANCA,2023-09-25,137,137,0,0
NORTE BARRANCA,2023-09-26,145,145,0,0
NORTE BARRANCA,2023-09-27,124,124,0,0
NORTE BARRANCA,2023-09-28,147,147,0,0
NORTE BARRANCA,2023-09-29,116,115,1,0.00862068965517241
NORTE BARRANCA,2023-09-30,172,171,1,0.00581395348837209
NORTE BARRANCA,2023-10-01,90,89,1,0.0111111111111111
NORTE BARRANCA,2023-10-02,120,119,1,0.00833333333333333
NORTE BARRANCA,2023-10-03,133,130,3,0.0225563909774436
NORTE BARRANCA,2023-10-04,141,138,3,0.0212765957446809
NORTE BARRANCA,2023-10-05,132,129,3,0.0227272727272727
NORTE BARRANCA,2023-10-06,163,159,4,0.0245398773006135
NORTE BARRANCA,2023-10-07,184,182,2,0.0108695652173913
NORTE BARRANCA,2023-10-08,105,104,1,0.00952380952380952
NORTE BARRANCA,2023-10-09,136,134,2,0.0147058823529412
NORTE BARRANCA,2023-10-10,134,130,4,0.0298507462686567
NORTE BARRANCA,2023-10-11,126,125,1,0.00793650793650794
NORTE BARRANCA,2023-10-12,121,119,2,0.0165289256198347
NORTE BARRANCA,2023-10-13,134,128,6,0.0447761194029851
NORTE BARRANCA,2023-10-14,153,151,2,0.0130718954248366
NORTE BARRANCA,2023-10-15,117,117,0,0
NORTE BARRANCA,2023-10-16,144,142,2,0.0138888888888889
NORTE BARRANCA,2023-10-17,126,124,2,0.0158730158730159
NORTE BARRANCA,2023-10-18,125,122,3,0.024
NORTE BARRANCA,2023-10-19,134,130,4,0.0298507462686567
NORTE BARRANCA,2023-10-20,145,143,2,0.0137931034482759
NORTE BARRANCA,2023-10-21,204,200,4,0.0196078431372549
NORTE BARRANCA,2023-10-22,103,99,4,0.0388349514563107
NORTE BARRANCA,2023-10-23,141,137,4,0.0283687943262411
NORTE BARRANCA,2023-10-24,131,128,3,0.0229007633587786
NORTE BARRANCA,2023-10-25,131,124,7,0.0534351145038168
NORTE BARRANCA,2023-10-26,159,155,4,0.0251572327044025
NORTE BARRANCA,2023-10-27,150,149,1,0.00666666666666667
NORTE BARRANCA,2023-10-28,159,158,1,0.00628930817610063
NORTE BARRANCA,2023-10-29,90,89,1,0.0111111111111111
NORTE BARRANCA,2023-10-30,123,120,3,0.024390243902439
NORTE BARRANCA,2023-10-31,110,108,2,0.0181818181818182
NORTE BARRANCA,2023-11-01,134,132,2,0.0149253731343284
NORTE BARRANCA,2023-11-02,165,162,3,0.0181818181818182
NORTE BARRANCA,2023-11-03,122,119,3,0.0245901639344262
NORTE BARRANCA,2023-11-04,173,172,1,0.00578034682080925
NORTE BARRANCA,2023-11-05,130,129,1,0.00769230769230769
NORTE BARRANCA,2023-11-06,134,132,2,0.0149253731343284
NORTE BARRANCA,2023-11-07,163,159,4,0.0245398773006135
NORTE BARRANCA,2023-11-08,164,161,3,0.0182926829268293
NORTE BARRANCA,2023-11-09,173,170,3,0.0173410404624277
NORTE BARRANCA,2023-11-10,156,152,4,0.0256410256410256
NORTE BARRANCA,2023-11-11,212,209,3,0.0141509433962264
NORTE BARRANCA,2023-11-12,117,115,2,0.0170940170940171
NORTE BARRANCA,2023-11-13,147,144,3,0.0204081632653061
NORTE BARRANCA,2023-11-14,161,159,2,0.0124223602484472
NORTE BARRANCA,2023-11-15,176,176,0,0
NORTE BARRANCA,2023-11-16,151,145,6,0.0397350993377483
NORTE BARRANCA,2023-11-17,178,175,3,0.0168539325842697
NORTE BARRANCA,2023-11-18,212,209,3,0.0141509433962264
NORTE BARRANCA,2023-11-19,146,143,3,0.0205479452054795
NORTE BARRANCA,2023-11-20,154,152,2,0.012987012987013
NORTE BARRANCA,2023-11-21,178,172,6,0.0337078651685393
NORTE BARRANCA,2023-11-22,176,174,2,0.0113636363636364
NORTE BARRANCA,2023-11-23,179,175,4,0.0223463687150838
NORTE BARRANCA,2023-11-24,198,193,5,0.0252525252525253
NORTE BARRANCA,2023-11-25,202,200,2,0.0099009900990099
NORTE BARRANCA,2023-11-26,117,117,0,0
NORTE BARRANCA,2023-11-27,165,164,1,0.00606060606060606
NORTE BARRANCA,2023-11-28,157,151,6,0.0382165605095541
NORTE BARRANCA,2023-11-29,157,151,6,0.0382165605095541
NORTE BARRANCA,2023-11-30,159,158,1,0.00628930817610063
NORTE BARRANCA,2023-12-01,166,161,5,0.0301204819277108
NORTE BARRANCA,2023-12-02,215,209,6,0.027906976744186
NORTE BARRANCA,2023-12-03,156,153,3,0.0192307692307692
NORTE BARRANCA,2023-12-04,171,161,10,0.0584795321637427
NORTE BARRANCA,2023-12-05,171,165,6,0.0350877192982456
NORTE BARRANCA,2023-12-06,174,172,2,0.0114942528735632
NORTE BARRANCA,2023-12-07,185,180,5,0.027027027027027
NORTE BARRANCA,2023-12-08,180,176,4,0.0222222222222222
NORTE BARRANCA,2023-12-09,197,195,2,0.0101522842639594
NORTE BARRANCA,2023-12-10,140,135,5,0.0357142857142857
NORTE BARRANCA,2023-12-11,159,157,2,0.0125786163522013
NORTE BARRANCA,2023-12-12,166,164,2,0.0120481927710843
NORTE BARRANCA,2023-12-13,159,155,4,0.0251572327044025
NORTE BARRANCA,2023-12-14,157,155,2,0.0127388535031847
NORTE BARRANCA,2023-12-15,162,158,4,0.0246913580246914
NORTE BARRANCA,2023-12-16,177,175,2,0.0112994350282486
NORTE BARRANCA,2023-12-17,135,133,2,0.0148148148148148
NORTE BARRANCA,2023-12-18,142,139,3,0.0211267605633803
NORTE BARRANCA,2023-12-19,198,191,7,0.0353535353535354
NORTE BARRANCA,2023-12-20,160,152,8,0.05
NORTE BARRANCA,2023-12-21,168,165,3,0.0178571428571429
NORTE BARRANCA,2023-12-22,147,145,2,0.0136054421768707
NORTE BARRANCA,2023-12-23,157,157,0,0
NORTE BARRANCA,2023-12-24,72,70,2,0.0277777777777778
NORTE BARRANCA,2023-12-25,8,7,1,0.125
NORTE BARRANCA,2023-12-26,161,158,3,0.0186335403726708
NORTE BARRANCA,2023-12-27,172,168,4,0.0232558139534884
NORTE BARRANCA,2023-12-28,181,177,4,0.0220994475138122
NORTE BARRANCA,2023-12-29,174,172,2,0.0114942528735632
NORTE BARRANCA,2023-12-30,177,173,4,0.0225988700564972
NORTE BARRANCA,2023-12-31,67,65,2,0.0298507462686567
NORTE BARRANCA,2024-01-01,5,5,0,0
NORTE BARRANCA,2024-01-02,131,130,1,0.00763358778625954
NORTE BARRANCA,2024-01-03,184,182,2,0.0108695652173913
NORTE BARRANCA,2024-01-04,178,175,3,0.0168539325842697
NORTE BARRANCA,2024-01-05,186,182,4,0.021505376344086
NORTE BARRANCA,2024-01-06,215,213,2,0.00930232558139535
NORTE BARRANCA,2024-01-07,127,127,0,0
NORTE BARRANCA,2024-01-08,109,104,5,0.0458715596330275
NORTE BARRANCA,2024-01-09,205,202,3,0.0146341463414634
NORTE BARRANCA,2024-01-10,199,195,4,0.0201005025125628
NORTE BARRANCA,2024-01-11,89,85,4,0.0449438202247191
NORTE BARRANCA,2024-01-12,182,179,3,0.0164835164835165
NORTE BARRANCA,2024-01-13,219,216,3,0.0136986301369863
NORTE BARRANCA,2024-01-14,133,132,1,0.0075187969924812
NORTE BARRANCA,2024-01-15,92,88,4,0.0434782608695652
NORTE BARRANCA,2024-01-16,200,197,3,0.015
NORTE BARRANCA,2024-01-17,168,166,2,0.0119047619047619
NORTE BARRANCA,2024-01-18,195,192,3,0.0153846153846154
NORTE BARRANCA,2024-01-19,168,163,5,0.0297619047619048
NORTE BARRANCA,2024-01-20,187,183,4,0.0213903743315508
NORTE BARRANCA,2024-01-21,151,151,0,0
NORTE BARRANCA,2024-01-22,175,170,5,0.0285714285714286
NORTE BARRANCA,2024-01-23,166,163,3,0.0180722891566265
NORTE BARRANCA,2024-01-24,144,138,6,0.0416666666666667
NORTE BARRANCA,2024-01-25,149,147,2,0.0134228187919463
NORTE BARRANCA,2024-01-26,204,202,2,0.00980392156862745
NORTE BARRANCA,2024-01-27,215,212,3,0.013953488372093
NORTE BARRANCA,2024-01-28,129,129,0,0
NORTE BARRANCA,2024-01-29,154,151,3,0.0194805194805195
NORTE BARRANCA,2024-01-30,146,142,4,0.0273972602739726
NORTE BARRANCA,2024-01-31,151,149,2,0.0132450331125828
NORTE BARRANCA,2024-02-01,173,167,6,0.0346820809248555
NORTE BARRANCA,2024-02-02,164,161,3,0.0182926829268293
NORTE BARRANCA,2024-02-03,178,176,2,0.0112359550561798
NORTE BARRANCA,2024-02-04,164,162,2,0.0121951219512195
NORTE BARRANCA,2024-02-05,156,156,0,0
NORTE BARRANCA,2024-02-06,185,182,3,0.0162162162162162
NORTE BARRANCA,2024-02-07,170,162,8,0.0470588235294118
NORTE BARRANCA,2024-02-08,162,157,5,0.0308641975308642
NORTE BARRANCA,2024-02-09,175,174,1,0.00571428571428571
NORTE BARRANCA,2024-02-10,207,206,1,0.00483091787439614
NORTE BARRANCA,2024-02-11,141,140,1,0.00709219858156028
NORTE BARRANCA,2024-02-12,112,107,5,0.0446428571428571
NORTE BARRANCA,2024-02-13,162,161,1,0.00617283950617284
NORTE BARRANCA,2024-02-14,166,165,1,0.00602409638554217
NORTE BARRANCA,2024-02-15,144,142,2,0.0138888888888889
NORTE BARRANCA,2024-02-16,189,186,3,0.0158730158730159
NORTE BARRANCA,2024-02-17,207,205,2,0.00966183574879227
NORTE BARRANCA,2024-02-18,119,119,0,0
NORTE BARRANCA,2024-02-19,160,158,2,0.0125
NORTE BARRANCA,2024-02-20,157,155,2,0.0127388535031847
NORTE BARRANCA,2024-02-21,174,172,2,0.0114942528735632
NORTE BARRANCA,2024-02-22,191,189,2,0.0104712041884817
NORTE BARRANCA,2024-02-23,103,84,19,0.184466019417476
NORTE BARRANCA,2024-02-24,211,209,2,0.00947867298578199
NORTE BARRANCA,2024-02-25,121,121,0,0
NORTE BARRANCA,2024-02-26,137,135,2,0.0145985401459854
NORTE BARRANCA,2024-02-27,143,139,4,0.027972027972028
NORTE BARRANCA,2024-02-28,136,132,4,0.0294117647058824
NORTE BARRANCA,2024-02-29,166,162,4,0.0240963855421687
NORTE BARRANCA,2024-03-01,162,161,1,0.00617283950617284
NORTE BARRANCA,2024-03-02,188,187,1,0.00531914893617021
NORTE BARRANCA,2024-03-03,127,127,0,0
NORTE BARRANCA,2024-03-04,140,137,3,0.0214285714285714
NORTE BARRANCA,2024-03-05,163,163,0,0
NORTE BARRANCA,2024-03-06,148,146,2,0.0135135135135135
NORTE BARRANCA,2024-03-07,159,157,2,0.0125786163522013
NORTE BARRANCA,2024-03-08,165,162,3,0.0181818181818182
NORTE BARRANCA,2024-03-09,176,175,1,0.00568181818181818
NORTE BARRANCA,2024-03-10,105,105,0,0
NORTE BARRANCA,2024-03-11,127,126,1,0.0078740157480315
NORTE LA BAJA,2023-03-12,225,73,152,0.675555555555556
NORTE LA BAJA,2023-03-13,172,51,121,0.703488372093023
NORTE LA BAJA,2023-03-14,151,60,91,0.602649006622517
NORTE LA BAJA,2023-03-15,143,111,32,0.223776223776224
NORTE LA BAJA,2023-03-16,137,99,38,0.277372262773723
NORTE LA BAJA,2023-03-17,223,166,57,0.255605381165919
NORTE LA BAJA,2023-03-18,217,169,48,0.221198156682028
NORTE LA BAJA,2023-03-19,164,130,34,0.207317073170732
NORTE LA BAJA,2023-03-20,147,111,36,0.244897959183673
NORTE LA BAJA,2023-03-21,97,80,17,0.175257731958763
NORTE LA BAJA,2023-03-22,139,111,28,0.201438848920863
NORTE LA BAJA,2023-03-23,160,124,36,0.225
NORTE LA BAJA,2023-03-24,208,169,39,0.1875
NORTE LA BAJA,2023-03-25,197,166,31,0.157360406091371
NORTE LA BAJA,2023-03-26,186,149,37,0.198924731182796
NORTE LA BAJA,2023-03-27,158,138,20,0.126582278481013
NORTE LA BAJA,2023-03-28,174,152,22,0.126436781609195
NORTE LA BAJA,2023-03-29,158,141,17,0.107594936708861
NORTE LA BAJA,2023-03-30,194,165,29,0.149484536082474
NORTE LA BAJA,2023-03-31,212,175,37,0.174528301886792
NORTE LA BAJA,2023-04-01,247,214,33,0.133603238866397
NORTE LA BAJA,2023-04-02,170,150,20,0.117647058823529
NORTE LA BAJA,2023-04-03,186,167,19,0.102150537634409
NORTE LA BAJA,2023-04-04,217,200,17,0.0783410138248848
NORTE LA BAJA,2023-04-05,219,200,19,0.0867579908675799
NORTE LA BAJA,2023-04-06,180,158,22,0.122222222222222
NORTE LA BAJA,2023-04-07,163,149,14,0.0858895705521472
NORTE LA BAJA,2023-04-08,198,182,16,0.0808080808080808
NORTE LA BAJA,2023-04-09,159,144,15,0.0943396226415094
NORTE LA BAJA,2023-04-10,177,165,12,0.0677966101694915
NORTE LA BAJA,2023-04-11,228,212,16,0.0701754385964912
NORTE LA BAJA,2023-04-12,204,191,13,0.0637254901960784
NORTE LA BAJA,2023-04-13,196,192,4,0.0204081632653061
NORTE LA BAJA,2023-04-14,204,190,14,0.0686274509803922
NORTE LA BAJA,2023-04-15,232,222,10,0.0431034482758621
NORTE LA BAJA,2023-04-16,240,224,16,0.0666666666666667
NORTE LA BAJA,2023-04-17,211,204,7,0.033175355450237
NORTE LA BAJA,2023-04-18,199,189,10,0.050251256281407
NORTE LA BAJA,2023-04-19,185,178,7,0.0378378378378378
NORTE LA BAJA,2023-04-20,177,168,9,0.0508474576271186
NORTE LA BAJA,2023-04-21,205,187,18,0.0878048780487805
NORTE LA BAJA,2023-04-22,236,227,9,0.038135593220339
NORTE LA BAJA,2023-04-23,190,176,14,0.0736842105263158
NORTE LA BAJA,2023-04-24,186,180,6,0.032258064516129
NORTE LA BAJA,2023-04-25,245,236,9,0.036734693877551
NORTE LA BAJA,2023-04-26,178,171,7,0.0393258426966292
NORTE LA BAJA,2023-04-27,188,177,11,0.0585106382978723
NORTE LA BAJA,2023-04-28,224,209,15,0.0669642857142857
NORTE LA BAJA,2023-04-29,239,223,16,0.0669456066945607
NORTE LA BAJA,2023-04-30,186,174,12,0.0645161290322581
NORTE LA BAJA,2023-05-01,137,128,9,0.0656934306569343
NORTE LA BAJA,2023-05-02,191,184,7,0.0366492146596859
NORTE LA BAJA,2023-05-03,182,174,8,0.043956043956044
NORTE LA BAJA,2023-05-04,197,187,10,0.050761421319797
NORTE LA BAJA,2023-05-05,226,216,10,0.0442477876106195
NORTE LA BAJA,2023-05-06,260,247,13,0.05
NORTE LA BAJA,2023-05-07,212,205,7,0.0330188679245283
NORTE LA BAJA,2023-05-08,219,205,14,0.0639269406392694
NORTE LA BAJA,2023-05-09,227,217,10,0.0440528634361234
NORTE LA BAJA,2023-05-10,181,171,10,0.0552486187845304
NORTE LA BAJA,2023-05-11,190,181,9,0.0473684210526316
NORTE LA BAJA,2023-05-12,200,193,7,0.035
NORTE LA BAJA,2023-05-13,312,294,18,0.0576923076923077
NORTE LA BAJA,2023-05-14,236,220,16,0.0677966101694915
NORTE LA BAJA,2023-05-15,261,248,13,0.0498084291187739
NORTE LA BAJA,2023-05-16,257,232,25,0.0972762645914397
NORTE LA BAJA,2023-05-17,241,208,33,0.136929460580913
NORTE LA BAJA,2023-05-18,191,173,18,0.0942408376963351
NORTE LA BAJA,2023-05-19,186,164,22,0.118279569892473
NORTE LA BAJA,2023-05-20,260,242,18,0.0692307692307692
NORTE LA BAJA,2023-05-21,235,221,14,0.0595744680851064
NORTE LA BAJA,2023-05-22,230,212,18,0.0782608695652174
NORTE LA BAJA,2023-05-23,195,182,13,0.0666666666666667
NORTE LA BAJA,2023-05-24,203,195,8,0.0394088669950739
NORTE LA BAJA,2023-05-25,226,201,25,0.110619469026549
NORTE LA BAJA,2023-05-26,255,224,31,0.12156862745098
NORTE LA BAJA,2023-05-27,275,245,30,0.109090909090909
NORTE LA BAJA,2023-05-28,209,192,17,0.0813397129186603
NORTE LA BAJA,2023-05-29,266,250,16,0.0601503759398496
NORTE LA BAJA,2023-05-30,204,184,20,0.0980392156862745
NORTE LA BAJA,2023-05-31,240,218,22,0.0916666666666667
NORTE LA BAJA,2023-06-01,178,166,12,0.0674157303370786
NORTE LA BAJA,2023-06-02,185,170,15,0.0810810810810811
NORTE LA BAJA,2023-06-03,264,238,26,0.0984848484848485
NORTE LA BAJA,2023-06-04,222,200,22,0.0990990990990991
NORTE LA BAJA,2023-06-05,214,197,17,0.0794392523364486
NORTE LA BAJA,2023-06-06,235,216,19,0.0808510638297872
NORTE LA BAJA,2023-06-07,185,165,20,0.108108108108108
NORTE LA BAJA,2023-06-08,206,193,13,0.0631067961165049
NORTE LA BAJA,2023-06-09,223,201,22,0.0986547085201794
NORTE LA BAJA,2023-06-10,250,225,25,0.1
NORTE LA BAJA,2023-06-11,244,227,17,0.069672131147541
NORTE LA BAJA,2023-06-12,220,200,20,0.0909090909090909
NORTE LA BAJA,2023-06-13,259,236,23,0.0888030888030888
NORTE LA BAJA,2023-06-14,222,213,9,0.0405405405405405
NORTE LA BAJA,2023-06-15,191,176,15,0.0785340314136126
NORTE LA BAJA,2023-06-16,216,202,14,0.0648148148148148
NORTE LA BAJA,2023-06-17,262,243,19,0.0725190839694656
NORTE LA BAJA,2023-06-18,208,193,15,0.0721153846153846
NORTE LA BAJA,2023-06-19,227,211,16,0.0704845814977974
NORTE LA BAJA,2023-06-20,208,193,15,0.0721153846153846
NORTE LA BAJA,2023-06-21,205,190,15,0.0731707317073171
NORTE LA BAJA,2023-06-22,154,145,9,0.0584415584415584
NORTE LA BAJA,2023-06-23,177,169,8,0.0451977401129944
NORTE LA BAJA,2023-06-24,231,212,19,0.0822510822510823
NORTE LA BAJA,2023-06-25,207,184,23,0.111111111111111
NORTE LA BAJA,2023-06-26,202,187,15,0.0742574257425743
NORTE LA BAJA,2023-06-27,205,191,14,0.0682926829268293
NORTE LA BAJA,2023-06-28,168,159,9,0.0535714285714286
NORTE LA BAJA,2023-06-29,173,166,7,0.0404624277456647
NORTE LA BAJA,2023-06-30,137,117,20,0.145985401459854
NORTE LA BAJA,2023-07-01,217,199,18,0.0829493087557604
NORTE LA BAJA,2023-07-02,155,148,7,0.0451612903225806
NORTE LA BAJA,2023-07-03,162,153,9,0.0555555555555556
NORTE LA BAJA,2023-07-04,181,178,3,0.0165745856353591
NORTE LA BAJA,2023-07-05,103,101,2,0.0194174757281553
NORTE LA BAJA,2023-07-06,111,104,7,0.0630630630630631
NORTE LA BAJA,2023-07-07,135,134,1,0.00740740740740741
NORTE LA BAJA,2023-07-08,188,186,2,0.0106382978723404
NORTE LA BAJA,2023-07-09,189,189,0,0
NORTE LA BAJA,2023-07-10,201,189,12,0.0597014925373134
NORTE LA BAJA,2023-07-11,160,156,4,0.025
NORTE LA BAJA,2023-07-12,192,182,10,0.0520833333333333
NORTE LA BAJA,2023-07-13,191,184,7,0.0366492146596859
NORTE LA BAJA,2023-07-14,153,149,4,0.0261437908496732
NORTE LA BAJA,2023-07-15,182,176,6,0.032967032967033
NORTE LA BAJA,2023-07-16,146,139,7,0.0479452054794521
NORTE LA BAJA,2023-07-17,185,181,4,0.0216216216216216
NORTE LA BAJA,2023-07-18,185,178,7,0.0378378378378378
NORTE LA BAJA,2023-07-19,177,169,8,0.0451977401129944
NORTE LA BAJA,2023-07-20,189,186,3,0.0158730158730159
NORTE LA BAJA,2023-07-21,180,176,4,0.0222222222222222
NORTE LA BAJA,2023-07-22,204,198,6,0.0294117647058824
NORTE LA BAJA,2023-07-23,159,154,5,0.0314465408805031
NORTE LA BAJA,2023-07-24,174,171,3,0.0172413793103448
NORTE LA BAJA,2023-07-25,170,165,5,0.0294117647058824
NORTE LA BAJA,2023-07-26,189,181,8,0.0423280423280423
NORTE LA BAJA,2023-07-27,151,150,1,0.00662251655629139
NORTE LA BAJA,2023-07-28,191,185,6,0.031413612565445
NORTE LA BAJA,2023-07-29,219,213,6,0.0273972602739726
NORTE LA BAJA,2023-07-30,159,154,5,0.0314465408805031
NORTE LA BAJA,2023-07-31,176,171,5,0.0284090909090909
NORTE LA BAJA,2023-08-01,193,180,13,0.0673575129533679
NORTE LA BAJA,2023-08-02,165,157,8,0.0484848484848485
NORTE LA BAJA,2023-08-03,200,169,31,0.155
NORTE LA BAJA,2023-08-04,155,142,13,0.0838709677419355
NORTE LA BAJA,2023-08-05,172,159,13,0.0755813953488372
NORTE LA BAJA,2023-08-06,174,160,14,0.0804597701149425
NORTE LA BAJA,2023-08-07,153,147,6,0.0392156862745098
NORTE LA BAJA,2023-08-08,191,185,6,0.031413612565445
NORTE LA BAJA,2023-08-09,170,163,7,0.0411764705882353
NORTE LA BAJA,2023-08-10,174,154,20,0.114942528735632
NORTE LA BAJA,2023-08-11,224,213,11,0.0491071428571429
NORTE LA BAJA,2023-08-12,217,188,29,0.133640552995392
NORTE LA BAJA,2023-08-13,177,157,20,0.112994350282486
NORTE LA BAJA,2023-08-14,171,158,13,0.0760233918128655
NORTE LA BAJA,2023-08-15,184,176,8,0.0434782608695652
NORTE LA BAJA,2023-08-16,148,138,10,0.0675675675675676
NORTE LA BAJA,2023-08-17,161,155,6,0.0372670807453416
NORTE LA BAJA,2023-08-18,213,204,9,0.0422535211267606
NORTE LA BAJA,2023-08-19,240,231,9,0.0375
NORTE LA BAJA,2023-08-20,7,7,0,0
NORTE LA BAJA,2023-08-21,35,31,4,0.114285714285714
NORTE LA BAJA,2023-08-22,167,158,9,0.0538922155688623
NORTE LA BAJA,2023-08-23,148,141,7,0.0472972972972973
NORTE LA BAJA,2023-08-24,184,181,3,0.016304347826087
NORTE LA BAJA,2023-08-25,161,150,11,0.0683229813664596
NORTE LA BAJA,2023-08-26,168,159,9,0.0535714285714286
NORTE LA BAJA,2023-08-27,179,175,4,0.0223463687150838
NORTE LA BAJA,2023-08-28,211,202,9,0.042654028436019
NORTE LA BAJA,2023-08-29,187,187,0,0
NORTE LA BAJA,2023-08-30,217,217,0,0
NORTE LA BAJA,2023-08-31,218,217,1,0.00458715596330275
NORTE LA BAJA,2023-09-01,167,164,3,0.0179640718562874
NORTE LA BAJA,2023-09-02,220,217,3,0.0136363636363636
NORTE LA BAJA,2023-09-03,178,176,2,0.0112359550561798
NORTE LA BAJA,2023-09-04,165,164,1,0.00606060606060606
NORTE LA BAJA,2023-09-05,172,171,1,0.00581395348837209
NORTE LA BAJA,2023-09-06,161,158,3,0.0186335403726708
NORTE LA BAJA,2023-09-07,173,173,0,0
NORTE LA BAJA,2023-09-08,199,198,1,0.0050251256281407
NORTE LA BAJA,2023-09-09,245,240,5,0.0204081632653061
NORTE LA BAJA,2023-09-10,204,202,2,0.00980392156862745
NORTE LA BAJA,2023-09-11,178,173,5,0.0280898876404494
NORTE LA BAJA,2023-09-12,177,177,0,0
NORTE LA BAJA,2023-09-13,166,165,1,0.00602409638554217
NORTE LA BAJA,2023-09-14,169,168,1,0.00591715976331361
NORTE LA BAJA,2023-09-15,184,183,1,0.00543478260869565
NORTE LA BAJA,2023-09-16,148,146,2,0.0135135135135135
NORTE LA BAJA,2023-09-17,202,201,1,0.00495049504950495
NORTE LA BAJA,2023-09-18,206,206,0,0
NORTE LA BAJA,2023-09-19,206,203,3,0.0145631067961165
NORTE LA BAJA,2023-09-20,173,170,3,0.0173410404624277
NORTE LA BAJA,2023-09-21,216,212,4,0.0185185185185185
NORTE LA BAJA,2023-09-22,199,192,7,0.0351758793969849
NORTE LA BAJA,2023-09-23,226,218,8,0.0353982300884956
NORTE LA BAJA,2023-09-24,207,205,2,0.00966183574879227
NORTE LA BAJA,2023-09-25,158,156,2,0.0126582278481013
NORTE LA BAJA,2023-09-26,199,194,5,0.0251256281407035
NORTE LA BAJA,2023-09-27,198,195,3,0.0151515151515152
NORTE LA BAJA,2023-09-28,184,183,1,0.00543478260869565
NORTE LA BAJA,2023-09-29,232,228,4,0.0172413793103448
NORTE LA BAJA,2023-09-30,224,222,2,0.00892857142857143
NORTE LA BAJA,2023-10-01,184,182,2,0.0108695652173913
NORTE LA BAJA,2023-10-02,152,151,1,0.00657894736842105
NORTE LA BAJA,2023-10-03,196,191,5,0.0255102040816327
NORTE LA BAJA,2023-10-04,170,166,4,0.0235294117647059
NORTE LA BAJA,2023-10-05,206,205,1,0.00485436893203883
NORTE LA BAJA,2023-10-06,212,201,11,0.0518867924528302
NORTE LA BAJA,2023-10-07,203,198,5,0.0246305418719212
NORTE LA BAJA,2023-10-08,207,202,5,0.0241545893719807
NORTE LA BAJA,2023-10-09,170,165,5,0.0294117647058824
NORTE LA BAJA,2023-10-10,188,184,4,0.0212765957446809
NORTE LA BAJA,2023-10-11,149,147,2,0.0134228187919463
NORTE LA BAJA,2023-10-12,198,194,4,0.0202020202020202
NORTE LA BAJA,2023-10-13,177,170,7,0.0395480225988701
NORTE LA BAJA,2023-10-14,205,199,6,0.0292682926829268
NORTE LA BAJA,2023-10-15,195,190,5,0.0256410256410256
NORTE LA BAJA,2023-10-16,189,185,4,0.0211640211640212
NORTE LA BAJA,2023-10-17,188,186,2,0.0106382978723404
NORTE LA BAJA,2023-10-18,159,152,7,0.0440251572327044
NORTE LA BAJA,2023-10-19,185,183,2,0.0108108108108108
NORTE LA BAJA,2023-10-20,211,207,4,0.018957345971564
NORTE LA BAJA,2023-10-21,257,251,6,0.0233463035019455
NORTE LA BAJA,2023-10-22,187,182,5,0.0267379679144385
NORTE LA BAJA,2023-10-23,171,168,3,0.0175438596491228
NORTE LA BAJA,2023-10-24,187,181,6,0.0320855614973262
NORTE LA BAJA,2023-10-25,189,184,5,0.0264550264550265
NORTE LA BAJA,2023-10-26,160,158,2,0.0125
NORTE LA BAJA,2023-10-27,200,194,6,0.03
NORTE LA BAJA,2023-10-28,201,200,1,0.00497512437810945
NORTE LA BAJA,2023-10-29,175,170,5,0.0285714285714286
NORTE LA BAJA,2023-10-30,160,154,6,0.0375
NORTE LA BAJA,2023-10-31,164,161,3,0.0182926829268293
NORTE LA BAJA,2023-11-01,180,176,4,0.0222222222222222
NORTE LA BAJA,2023-11-02,194,190,4,0.0206185567010309
NORTE LA BAJA,2023-11-03,192,186,6,0.03125
NORTE LA BAJA,2023-11-04,255,245,10,0.0392156862745098
NORTE LA BAJA,2023-11-05,197,194,3,0.0152284263959391
NORTE LA BAJA,2023-11-06,203,197,6,0.0295566502463054
NORTE LA BAJA,2023-11-07,195,192,3,0.0153846153846154
NORTE LA BAJA,2023-11-08,213,206,7,0.0328638497652582
NORTE LA BAJA,2023-11-09,189,185,4,0.0211640211640212
NORTE LA BAJA,2023-11-10,231,228,3,0.012987012987013
NORTE LA BAJA,2023-11-11,245,240,5,0.0204081632653061
NORTE LA BAJA,2023-11-12,237,227,10,0.0421940928270042
NORTE LA BAJA,2023-11-13,171,167,4,0.0233918128654971
NORTE LA BAJA,2023-11-14,216,207,9,0.0416666666666667
NORTE LA BAJA,2023-11-15,150,146,4,0.0266666666666667
NORTE LA BAJA,2023-11-16,208,205,3,0.0144230769230769
NORTE LA BAJA,2023-11-17,202,200,2,0.0099009900990099
NORTE LA BAJA,2023-11-18,285,277,8,0.0280701754385965
NORTE LA BAJA,2023-11-19,231,225,6,0.025974025974026
NORTE LA BAJA,2023-11-20,142,136,6,0.0422535211267606
NORTE LA BAJA,2023-11-21,247,241,6,0.0242914979757085
NORTE LA BAJA,2023-11-22,174,169,5,0.028735632183908
NORTE LA BAJA,2023-11-23,223,216,7,0.031390134529148
NORTE LA BAJA,2023-11-24,228,226,2,0.0087719298245614
NORTE LA BAJA,2023-11-25,258,251,7,0.0271317829457364
NORTE LA BAJA,2023-11-26,227,225,2,0.00881057268722467
NORTE LA BAJA,2023-11-27,183,178,5,0.0273224043715847
NORTE LA BAJA,2023-11-28,237,237,0,0
NORTE LA BAJA,2023-11-29,192,184,8,0.0416666666666667
NORTE LA BAJA,2023-11-30,161,158,3,0.0186335403726708
NORTE LA BAJA,2023-12-01,210,202,8,0.0380952380952381
NORTE LA BAJA,2023-12-02,246,243,3,0.0121951219512195
NORTE LA BAJA,2023-12-03,198,194,4,0.0202020202020202
NORTE LA BAJA,2023-12-04,211,206,5,0.023696682464455
NORTE LA BAJA,2023-12-05,216,210,6,0.0277777777777778
NORTE LA BAJA,2023-12-06,197,191,6,0.0304568527918782
NORTE LA BAJA,2023-12-07,181,173,8,0.0441988950276243
NORTE LA BAJA,2023-12-08,209,207,2,0.00956937799043062
NORTE LA BAJA,2023-12-09,213,209,4,0.0187793427230047
NORTE LA BAJA,2023-12-10,209,205,4,0.0191387559808612
NORTE LA BAJA,2023-12-11,183,180,3,0.0163934426229508
NORTE LA BAJA,2023-12-12,194,191,3,0.0154639175257732
NORTE LA BAJA,2023-12-13,201,195,6,0.0298507462686567
NORTE LA BAJA,2023-12-14,183,176,7,0.0382513661202186
NORTE LA BAJA,2023-12-15,178,174,4,0.0224719101123595
NORTE LA BAJA,2023-12-16,220,216,4,0.0181818181818182
NORTE LA BAJA,2023-12-17,206,203,3,0.0145631067961165
NORTE LA BAJA,2023-12-18,191,188,3,0.0157068062827225
NORTE LA BAJA,2023-12-19,206,205,1,0.00485436893203883
NORTE LA BAJA,2023-12-20,232,223,9,0.0387931034482759
NORTE LA BAJA,2023-12-21,239,233,6,0.0251046025104603
NORTE LA BAJA,2023-12-22,213,207,6,0.028169014084507
NORTE LA BAJA,2023-12-23,245,240,5,0.0204081632653061
NORTE LA BAJA,2023-12-24,83,80,3,0.036144578313253
NORTE LA BAJA,2023-12-25,8,8,0,0
NORTE LA BAJA,2023-12-26,223,218,5,0.0224215246636771
NORTE LA BAJA,2023-12-27,204,197,7,0.0343137254901961
NORTE LA BAJA,2023-12-28,232,224,8,0.0344827586206897
NORTE LA BAJA,2023-12-29,232,230,2,0.00862068965517241
NORTE LA BAJA,2023-12-30,208,203,5,0.0240384615384615
NORTE LA BAJA,2023-12-31,93,92,1,0.010752688172043
NORTE LA BAJA,2024-01-01,6,6,0,0
NORTE LA BAJA,2024-01-02,206,201,5,0.0242718446601942
NORTE LA BAJA,2024-01-03,152,147,5,0.0328947368421053
NORTE LA BAJA,2024-01-04,224,218,6,0.0267857142857143
NORTE LA BAJA,2024-01-05,248,242,6,0.0241935483870968
NORTE LA BAJA,2024-01-06,249,243,6,0.0240963855421687
NORTE LA BAJA,2024-01-07,241,236,5,0.020746887966805
NORTE LA BAJA,2024-01-08,184,180,4,0.0217391304347826
NORTE LA BAJA,2024-01-09,227,220,7,0.0308370044052863
NORTE LA BAJA,2024-01-10,226,221,5,0.0221238938053097
NORTE LA BAJA,2024-01-11,230,224,6,0.0260869565217391
NORTE LA BAJA,2024-01-12,225,219,6,0.0266666666666667
NORTE LA BAJA,2024-01-13,269,263,6,0.0223048327137546
NORTE LA BAJA,2024-01-14,234,232,2,0.00854700854700855
NORTE LA BAJA,2024-01-15,175,167,8,0.0457142857142857
NORTE LA BAJA,2024-01-16,257,251,6,0.0233463035019455
NORTE LA BAJA,2024-01-17,226,222,4,0.0176991150442478
NORTE LA BAJA,2024-01-18,258,255,3,0.0116279069767442
NORTE LA BAJA,2024-01-19,213,208,5,0.0234741784037559
NORTE LA BAJA,2024-01-20,186,182,4,0.021505376344086
NORTE LA BAJA,2024-01-21,220,214,6,0.0272727272727273
NORTE LA BAJA,2024-01-22,36,35,1,0.0277777777777778
NORTE LA BAJA,2024-01-23,206,204,2,0.00970873786407767
NORTE LA BAJA,2024-01-24,255,240,15,0.0588235294117647
NORTE LA BAJA,2024-01-25,197,194,3,0.0152284263959391
NORTE LA BAJA,2024-01-26,215,210,5,0.0232558139534884
NORTE LA BAJA,2024-01-27,282,275,7,0.024822695035461
NORTE LA BAJA,2024-01-28,220,218,2,0.00909090909090909
NORTE LA BAJA,2024-01-29,152,147,5,0.0328947368421053
NORTE LA BAJA,2024-01-30,219,213,6,0.0273972602739726
NORTE LA BAJA,2024-01-31,234,230,4,0.0170940170940171
NORTE LA BAJA,2024-02-01,52,51,1,0.0192307692307692
NORTE LA BAJA,2024-02-02,249,242,7,0.0281124497991968
NORTE LA BAJA,2024-02-03,287,277,10,0.0348432055749129
NORTE LA BAJA,2024-02-04,256,247,9,0.03515625
NORTE LA BAJA,2024-02-05,64,60,4,0.0625
NORTE LA BAJA,2024-02-06,156,150,6,0.0384615384615385
NORTE LA BAJA,2024-02-07,213,208,5,0.0234741784037559
NORTE LA BAJA,2024-02-08,219,219,0,0
NORTE LA BAJA,2024-02-09,213,207,6,0.028169014084507
NORTE LA BAJA,2024-02-10,297,288,9,0.0303030303030303
NORTE LA BAJA,2024-02-11,213,209,4,0.0187793427230047
NORTE LA BAJA,2024-02-12,165,161,4,0.0242424242424242
NORTE LA BAJA,2024-02-13,270,268,2,0.00740740740740741
NORTE LA BAJA,2024-02-14,221,220,1,0.00452488687782805
NORTE LA BAJA,2024-02-15,159,157,2,0.0125786163522013
NORTE LA BAJA,2024-02-16,259,254,5,0.0193050193050193
NORTE LA BAJA,2024-02-17,292,290,2,0.00684931506849315
NORTE LA BAJA,2024-02-18,261,257,4,0.0153256704980843
NORTE LA BAJA,2024-02-19,214,212,2,0.00934579439252336
NORTE LA BAJA,2024-02-20,236,229,7,0.0296610169491525
NORTE LA BAJA,2024-02-21,225,221,4,0.0177777777777778
NORTE LA BAJA,2024-02-22,193,185,8,0.0414507772020725
NORTE LA BAJA,2024-02-23,140,126,14,0.1
NORTE LA BAJA,2024-02-24,297,293,4,0.0134680134680135
NORTE LA BAJA,2024-02-25,220,216,4,0.0181818181818182
NORTE LA BAJA,2024-02-26,205,203,2,0.00975609756097561
NORTE LA BAJA,2024-02-27,233,224,9,0.0386266094420601
NORTE LA BAJA,2024-02-28,210,199,11,0.0523809523809524
NORTE LA BAJA,2024-02-29,196,193,3,0.0153061224489796
NORTE LA BAJA,2024-03-01,207,203,4,0.0193236714975845
NORTE LA BAJA,2024-03-02,230,225,5,0.0217391304347826
NORTE LA BAJA,2024-03-03,218,214,4,0.018348623853211
NORTE LA BAJA,2024-03-04,208,203,5,0.0240384615384615
NORTE LA BAJA,2024-03-05,189,184,5,0.0264550264550265
NORTE LA BAJA,2024-03-06,195,193,2,0.0102564102564103
NORTE LA BAJA,2024-03-07,213,210,3,0.0140845070422535
NORTE LA BAJA,2024-03-08,229,223,6,0.0262008733624454
NORTE LA BAJA,2024-03-09,266,262,4,0.0150375939849624
NORTE LA BAJA,2024-03-10,246,242,4,0.016260162601626
NORTE LA BAJA,2024-03-11,204,197,7,0.0343137254901961
OCCIDENTE 1,2023-03-12,148,134,14,0.0945945945945946
OCCIDENTE 1,2023-03-13,157,130,27,0.171974522292994
OCCIDENTE 1,2023-03-14,175,146,29,0.165714285714286
OCCIDENTE 1,2023-03-15,185,170,15,0.0810810810810811
OCCIDENTE 1,2023-03-16,214,199,15,0.0700934579439252
OCCIDENTE 1,2023-03-17,224,208,16,0.0714285714285714
OCCIDENTE 1,2023-03-18,261,230,31,0.118773946360153
OCCIDENTE 1,2023-03-19,209,187,22,0.105263157894737
OCCIDENTE 1,2023-03-20,246,227,19,0.0772357723577236
OCCIDENTE 1,2023-03-21,200,184,16,0.08
OCCIDENTE 1,2023-03-22,164,155,9,0.0548780487804878
OCCIDENTE 1,2023-03-23,171,161,10,0.0584795321637427
OCCIDENTE 1,2023-03-24,174,165,9,0.0517241379310345
OCCIDENTE 1,2023-03-25,234,221,13,0.0555555555555556
OCCIDENTE 1,2023-03-26,164,156,8,0.0487804878048781
OCCIDENTE 1,2023-03-27,135,126,9,0.0666666666666667
OCCIDENTE 1,2023-03-28,170,165,5,0.0294117647058824
OCCIDENTE 1,2023-03-29,175,160,15,0.0857142857142857
OCCIDENTE 1,2023-03-30,208,193,15,0.0721153846153846
OCCIDENTE 1,2023-03-31,268,252,16,0.0597014925373134
OCCIDENTE 1,2023-04-01,226,213,13,0.0575221238938053
OCCIDENTE 1,2023-04-02,109,103,6,0.055045871559633
OCCIDENTE 1,2023-04-03,191,182,9,0.0471204188481675
OCCIDENTE 1,2023-04-04,236,221,15,0.0635593220338983
OCCIDENTE 1,2023-04-05,176,167,9,0.0511363636363636
OCCIDENTE 1,2023-04-06,177,165,12,0.0677966101694915
OCCIDENTE 1,2023-04-07,128,121,7,0.0546875
OCCIDENTE 1,2023-04-08,117,107,10,0.0854700854700855
OCCIDENTE 1,2023-04-09,72,70,2,0.0277777777777778
OCCIDENTE 1,2023-04-10,147,129,18,0.122448979591837
OCCIDENTE 1,2023-04-11,178,158,20,0.112359550561798
OCCIDENTE 1,2023-04-12,169,152,17,0.100591715976331
OCCIDENTE 1,2023-04-13,158,145,13,0.0822784810126582
OCCIDENTE 1,2023-04-14,225,203,22,0.0977777777777778
OCCIDENTE 1,2023-04-15,241,217,24,0.0995850622406639
OCCIDENTE 1,2023-04-16,150,135,15,0.1
OCCIDENTE 1,2023-04-17,171,158,13,0.0760233918128655
OCCIDENTE 1,2023-04-18,180,154,26,0.144444444444444
OCCIDENTE 1,2023-04-19,178,160,18,0.101123595505618
OCCIDENTE 1,2023-04-20,175,164,11,0.0628571428571429
OCCIDENTE 1,2023-04-21,169,151,18,0.106508875739645
OCCIDENTE 1,2023-04-22,206,189,17,0.0825242718446602
OCCIDENTE 1,2023-04-23,130,116,14,0.107692307692308
OCCIDENTE 1,2023-04-24,197,183,14,0.0710659898477157
OCCIDENTE 1,2023-04-25,222,194,28,0.126126126126126
OCCIDENTE 1,2023-04-26,205,182,23,0.11219512195122
OCCIDENTE 1,2023-04-27,178,164,14,0.0786516853932584
OCCIDENTE 1,2023-04-28,215,187,28,0.130232558139535
OCCIDENTE 1,2023-04-29,239,215,24,0.100418410041841
OCCIDENTE 1,2023-04-30,146,129,17,0.116438356164384
OCCIDENTE 1,2023-05-01,156,139,17,0.108974358974359
OCCIDENTE 1,2023-05-02,184,165,19,0.103260869565217
OCCIDENTE 1,2023-05-03,170,158,12,0.0705882352941176
OCCIDENTE 1,2023-05-04,163,138,25,0.153374233128834
OCCIDENTE 1,2023-05-05,185,167,18,0.0972972972972973
OCCIDENTE 1,2023-05-06,162,146,16,0.0987654320987654
OCCIDENTE 1,2023-05-07,123,117,6,0.0487804878048781
OCCIDENTE 1,2023-05-08,164,146,18,0.109756097560976
OCCIDENTE 1,2023-05-09,180,163,17,0.0944444444444444
OCCIDENTE 1,2023-05-10,153,140,13,0.0849673202614379
OCCIDENTE 1,2023-05-11,157,143,14,0.089171974522293
OCCIDENTE 1,2023-05-12,139,129,10,0.0719424460431655
OCCIDENTE 1,2023-05-13,229,200,29,0.126637554585153
OCCIDENTE 1,2023-05-14,181,167,14,0.0773480662983425
OCCIDENTE 1,2023-05-15,187,173,14,0.0748663101604278
OCCIDENTE 1,2023-05-16,296,248,48,0.162162162162162
OCCIDENTE 1,2023-05-17,189,174,15,0.0793650793650794
OCCIDENTE 1,2023-05-18,166,153,13,0.0783132530120482
OCCIDENTE 1,2023-05-19,181,157,24,0.132596685082873
OCCIDENTE 1,2023-05-20,227,193,34,0.149779735682819
OCCIDENTE 1,2023-05-21,158,135,23,0.145569620253165
OCCIDENTE 1,2023-05-22,169,144,25,0.14792899408284
OCCIDENTE 1,2023-05-23,180,159,21,0.116666666666667
OCCIDENTE 1,2023-05-24,186,168,18,0.0967741935483871
OCCIDENTE 1,2023-05-25,201,172,29,0.144278606965174
OCCIDENTE 1,2023-05-26,181,163,18,0.0994475138121547
OCCIDENTE 1,2023-05-27,215,187,28,0.130232558139535
OCCIDENTE 1,2023-05-28,152,126,26,0.171052631578947
OCCIDENTE 1,2023-05-29,157,130,27,0.171974522292994
OCCIDENTE 1,2023-05-30,212,175,37,0.174528301886792
OCCIDENTE 1,2023-05-31,271,228,43,0.158671586715867
OCCIDENTE 1,2023-06-01,211,182,29,0.137440758293839
OCCIDENTE 1,2023-06-02,180,159,21,0.116666666666667
OCCIDENTE 1,2023-06-03,213,193,20,0.0938967136150235
OCCIDENTE 1,2023-06-04,163,146,17,0.104294478527607
OCCIDENTE 1,2023-06-05,166,147,19,0.114457831325301
OCCIDENTE 1,2023-06-06,191,174,17,0.0890052356020942
OCCIDENTE 1,2023-06-07,176,151,25,0.142045454545455
OCCIDENTE 1,2023-06-08,192,170,22,0.114583333333333
OCCIDENTE 1,2023-06-09,165,145,20,0.121212121212121
OCCIDENTE 1,2023-06-10,236,208,28,0.11864406779661
OCCIDENTE 1,2023-06-11,142,126,16,0.112676056338028
OCCIDENTE 1,2023-06-12,178,151,27,0.151685393258427
OCCIDENTE 1,2023-06-13,187,163,24,0.128342245989305
OCCIDENTE 1,2023-06-14,193,173,20,0.103626943005181
OCCIDENTE 1,2023-06-15,167,156,11,0.0658682634730539
OCCIDENTE 1,2023-06-16,177,160,17,0.096045197740113
OCCIDENTE 1,2023-06-17,190,173,17,0.0894736842105263
OCCIDENTE 1,2023-06-18,131,123,8,0.0610687022900763
OCCIDENTE 1,2023-06-19,169,149,20,0.118343195266272
OCCIDENTE 1,2023-06-20,180,165,15,0.0833333333333333
OCCIDENTE 1,2023-06-21,189,165,24,0.126984126984127
OCCIDENTE 1,2023-06-22,170,152,18,0.105882352941176
OCCIDENTE 1,2023-06-23,134,127,7,0.0522388059701493
OCCIDENTE 1,2023-06-24,186,169,17,0.0913978494623656
OCCIDENTE 1,2023-06-25,137,130,7,0.0510948905109489
OCCIDENTE 1,2023-06-26,163,152,11,0.0674846625766871
OCCIDENTE 1,2023-06-27,187,172,15,0.0802139037433155
OCCIDENTE 1,2023-06-28,183,170,13,0.0710382513661202
OCCIDENTE 1,2023-06-29,148,136,12,0.0810810810810811
OCCIDENTE 1,2023-06-30,113,84,29,0.256637168141593
OCCIDENTE 1,2023-07-01,252,241,11,0.0436507936507936
OCCIDENTE 1,2023-07-02,146,138,8,0.0547945205479452
OCCIDENTE 1,2023-07-03,183,176,7,0.0382513661202186
OCCIDENTE 1,2023-07-04,215,205,10,0.0465116279069767
OCCIDENTE 1,2023-07-05,127,119,8,0.062992125984252
OCCIDENTE 1,2023-07-06,107,101,6,0.0560747663551402
OCCIDENTE 1,2023-07-07,155,148,7,0.0451612903225806
OCCIDENTE 1,2023-07-08,289,273,16,0.055363321799308
OCCIDENTE 1,2023-07-09,157,149,8,0.0509554140127389
OCCIDENTE 1,2023-07-10,150,140,10,0.0666666666666667
OCCIDENTE 1,2023-07-11,190,174,16,0.0842105263157895
OCCIDENTE 1,2023-07-12,203,188,15,0.0738916256157636
OCCIDENTE 1,2023-07-13,189,177,12,0.0634920634920635
OCCIDENTE 1,2023-07-14,173,160,13,0.0751445086705202
OCCIDENTE 1,2023-07-15,278,256,22,0.079136690647482
OCCIDENTE 1,2023-07-16,130,127,3,0.0230769230769231
OCCIDENTE 1,2023-07-17,172,162,10,0.0581395348837209
OCCIDENTE 1,2023-07-18,173,167,6,0.0346820809248555
OCCIDENTE 1,2023-07-19,158,144,14,0.0886075949367089
OCCIDENTE 1,2023-07-20,208,196,12,0.0576923076923077
OCCIDENTE 1,2023-07-21,166,158,8,0.0481927710843374
OCCIDENTE 1,2023-07-22,238,224,14,0.0588235294117647
OCCIDENTE 1,2023-07-23,135,130,5,0.037037037037037
OCCIDENTE 1,2023-07-24,139,134,5,0.0359712230215827
OCCIDENTE 1,2023-07-25,200,183,17,0.085
OCCIDENTE 1,2023-07-26,211,191,20,0.0947867298578199
OCCIDENTE 1,2023-07-27,190,181,9,0.0473684210526316
OCCIDENTE 1,2023-07-28,191,174,17,0.0890052356020942
OCCIDENTE 1,2023-07-29,235,213,22,0.0936170212765957
OCCIDENTE 1,2023-07-30,166,147,19,0.114457831325301
OCCIDENTE 1,2023-07-31,197,183,14,0.0710659898477157
OCCIDENTE 1,2023-08-01,210,183,27,0.128571428571429
OCCIDENTE 1,2023-08-02,204,184,20,0.0980392156862745
OCCIDENTE 1,2023-08-03,163,122,41,0.251533742331288
OCCIDENTE 1,2023-08-04,171,147,24,0.140350877192982
OCCIDENTE 1,2023-08-05,224,205,19,0.0848214285714286
OCCIDENTE 1,2023-08-06,141,129,12,0.0851063829787234
OCCIDENTE 1,2023-08-07,170,162,8,0.0470588235294118
OCCIDENTE 1,2023-08-08,210,205,5,0.0238095238095238
OCCIDENTE 1,2023-08-09,185,168,17,0.0918918918918919
OCCIDENTE 1,2023-08-10,205,186,19,0.0926829268292683
OCCIDENTE 1,2023-08-11,227,214,13,0.0572687224669604
OCCIDENTE 1,2023-08-12,217,202,15,0.0691244239631336
OCCIDENTE 1,2023-08-13,155,142,13,0.0838709677419355
OCCIDENTE 1,2023-08-14,196,183,13,0.0663265306122449
OCCIDENTE 1,2023-08-15,223,211,12,0.0538116591928251
OCCIDENTE 1,2023-08-16,219,210,9,0.0410958904109589
OCCIDENTE 1,2023-08-17,226,209,17,0.0752212389380531
OCCIDENTE 1,2023-08-18,199,190,9,0.0452261306532663
OCCIDENTE 1,2023-08-19,253,236,17,0.0671936758893281
OCCIDENTE 1,2023-08-20,155,149,6,0.0387096774193548
OCCIDENTE 1,2023-08-21,192,185,7,0.0364583333333333
OCCIDENTE 1,2023-08-22,188,183,5,0.0265957446808511
OCCIDENTE 1,2023-08-23,182,169,13,0.0714285714285714
OCCIDENTE 1,2023-08-24,188,180,8,0.0425531914893617
OCCIDENTE 1,2023-08-25,190,184,6,0.0315789473684211
OCCIDENTE 1,2023-08-26,235,227,8,0.0340425531914894
OCCIDENTE 1,2023-08-27,171,161,10,0.0584795321637427
OCCIDENTE 1,2023-08-28,175,170,5,0.0285714285714286
OCCIDENTE 1,2023-08-29,193,188,5,0.0259067357512953
OCCIDENTE 1,2023-08-30,177,176,1,0.00564971751412429
OCCIDENTE 1,2023-08-31,186,180,6,0.032258064516129
OCCIDENTE 1,2023-09-01,170,167,3,0.0176470588235294
OCCIDENTE 1,2023-09-02,194,187,7,0.0360824742268041
OCCIDENTE 1,2023-09-03,134,132,2,0.0149253731343284
OCCIDENTE 1,2023-09-04,176,173,3,0.0170454545454545
OCCIDENTE 1,2023-09-05,201,198,3,0.0149253731343284
OCCIDENTE 1,2023-09-06,182,175,7,0.0384615384615385
OCCIDENTE 1,2023-09-07,213,207,6,0.028169014084507
OCCIDENTE 1,2023-09-08,169,168,1,0.00591715976331361
OCCIDENTE 1,2023-09-09,209,206,3,0.0143540669856459
OCCIDENTE 1,2023-09-10,117,117,0,0
OCCIDENTE 1,2023-09-11,168,165,3,0.0178571428571429
OCCIDENTE 1,2023-09-12,167,165,2,0.0119760479041916
OCCIDENTE 1,2023-09-13,174,173,1,0.00574712643678161
OCCIDENTE 1,2023-09-14,179,177,2,0.0111731843575419
OCCIDENTE 1,2023-09-15,207,201,6,0.0289855072463768
OCCIDENTE 1,2023-09-16,175,172,3,0.0171428571428571
OCCIDENTE 1,2023-09-17,155,154,1,0.00645161290322581
OCCIDENTE 1,2023-09-18,178,177,1,0.00561797752808989
OCCIDENTE 1,2023-09-19,182,178,4,0.021978021978022
OCCIDENTE 1,2023-09-20,149,148,1,0.00671140939597315
OCCIDENTE 1,2023-09-21,156,153,3,0.0192307692307692
OCCIDENTE 1,2023-09-22,197,193,4,0.0203045685279188
OCCIDENTE 1,2023-09-23,198,195,3,0.0151515151515152
OCCIDENTE 1,2023-09-24,124,123,1,0.00806451612903226
OCCIDENTE 1,2023-09-25,146,143,3,0.0205479452054795
OCCIDENTE 1,2023-09-26,174,168,6,0.0344827586206897
OCCIDENTE 1,2023-09-27,170,166,4,0.0235294117647059
OCCIDENTE 1,2023-09-28,177,174,3,0.0169491525423729
OCCIDENTE 1,2023-09-29,207,204,3,0.0144927536231884
OCCIDENTE 1,2023-09-30,237,234,3,0.0126582278481013
OCCIDENTE 1,2023-10-01,147,144,3,0.0204081632653061
OCCIDENTE 1,2023-10-02,160,156,4,0.025
OCCIDENTE 1,2023-10-03,164,162,2,0.0121951219512195
OCCIDENTE 1,2023-10-04,158,152,6,0.0379746835443038
OCCIDENTE 1,2023-10-05,167,160,7,0.0419161676646707
OCCIDENTE 1,2023-10-06,148,139,9,0.0608108108108108
OCCIDENTE 1,2023-10-07,178,170,8,0.0449438202247191
OCCIDENTE 1,2023-10-08,129,126,3,0.0232558139534884
OCCIDENTE 1,2023-10-09,176,172,4,0.0227272727272727
OCCIDENTE 1,2023-10-10,148,142,6,0.0405405405405405
OCCIDENTE 1,2023-10-11,144,135,9,0.0625
OCCIDENTE 1,2023-10-12,137,132,5,0.0364963503649635
OCCIDENTE 1,2023-10-13,131,123,8,0.0610687022900763
OCCIDENTE 1,2023-10-14,199,191,8,0.0402010050251256
OCCIDENTE 1,2023-10-15,136,131,5,0.0367647058823529
OCCIDENTE 1,2023-10-16,180,174,6,0.0333333333333333
OCCIDENTE 1,2023-10-17,146,144,2,0.0136986301369863
OCCIDENTE 1,2023-10-18,158,154,4,0.0253164556962025
OCCIDENTE 1,2023-10-19,146,138,8,0.0547945205479452
OCCIDENTE 1,2023-10-20,170,165,5,0.0294117647058824
OCCIDENTE 1,2023-10-21,193,186,7,0.0362694300518135
OCCIDENTE 1,2023-10-22,131,130,1,0.00763358778625954
OCCIDENTE 1,2023-10-23,159,155,4,0.0251572327044025
OCCIDENTE 1,2023-10-24,165,162,3,0.0181818181818182
OCCIDENTE 1,2023-10-25,159,156,3,0.0188679245283019
OCCIDENTE 1,2023-10-26,138,133,5,0.036231884057971
OCCIDENTE 1,2023-10-27,155,151,4,0.0258064516129032
OCCIDENTE 1,2023-10-28,172,170,2,0.0116279069767442
OCCIDENTE 1,2023-10-29,98,97,1,0.0102040816326531
OCCIDENTE 1,2023-10-30,136,134,2,0.0147058823529412
OCCIDENTE 1,2023-10-31,176,170,6,0.0340909090909091
OCCIDENTE 1,2023-11-01,186,180,6,0.032258064516129
OCCIDENTE 1,2023-11-02,198,191,7,0.0353535353535354
OCCIDENTE 1,2023-11-03,144,141,3,0.0208333333333333
OCCIDENTE 1,2023-11-04,190,187,3,0.0157894736842105
OCCIDENTE 1,2023-11-05,127,124,3,0.0236220472440945
OCCIDENTE 1,2023-11-06,162,159,3,0.0185185185185185
OCCIDENTE 1,2023-11-07,181,180,1,0.00552486187845304
OCCIDENTE 1,2023-11-08,183,172,11,0.0601092896174863
OCCIDENTE 1,2023-11-09,182,176,6,0.032967032967033
OCCIDENTE 1,2023-11-10,158,151,7,0.0443037974683544
OCCIDENTE 1,2023-11-11,205,193,12,0.0585365853658537
OCCIDENTE 1,2023-11-12,124,122,2,0.0161290322580645
OCCIDENTE 1,2023-11-13,153,147,6,0.0392156862745098
OCCIDENTE 1,2023-11-14,180,177,3,0.0166666666666667
OCCIDENTE 1,2023-11-15,180,178,2,0.0111111111111111
OCCIDENTE 1,2023-11-16,159,152,7,0.0440251572327044
OCCIDENTE 1,2023-11-17,175,168,7,0.04
OCCIDENTE 1,2023-11-18,211,205,6,0.028436018957346
OCCIDENTE 1,2023-11-19,166,163,3,0.0180722891566265
OCCIDENTE 1,2023-11-20,181,179,2,0.0110497237569061
OCCIDENTE 1,2023-11-21,196,184,12,0.0612244897959184
OCCIDENTE 1,2023-11-22,153,148,5,0.0326797385620915
OCCIDENTE 1,2023-11-23,176,169,7,0.0397727272727273
OCCIDENTE 1,2023-11-24,207,201,6,0.0289855072463768
OCCIDENTE 1,2023-11-25,211,208,3,0.014218009478673
OCCIDENTE 1,2023-11-26,125,121,4,0.032
OCCIDENTE 1,2023-11-27,184,176,8,0.0434782608695652
OCCIDENTE 1,2023-11-28,201,192,9,0.0447761194029851
OCCIDENTE 1,2023-11-29,185,172,13,0.0702702702702703
OCCIDENTE 1,2023-11-30,193,188,5,0.0259067357512953
OCCIDENTE 1,2023-12-01,168,156,12,0.0714285714285714
OCCIDENTE 1,2023-12-02,184,178,6,0.0326086956521739
OCCIDENTE 1,2023-12-03,149,142,7,0.0469798657718121
OCCIDENTE 1,2023-12-04,146,142,4,0.0273972602739726
OCCIDENTE 1,2023-12-05,175,168,7,0.04
OCCIDENTE 1,2023-12-06,185,179,6,0.0324324324324324
OCCIDENTE 1,2023-12-07,183,180,3,0.0163934426229508
OCCIDENTE 1,2023-12-08,164,158,6,0.0365853658536585
OCCIDENTE 1,2023-12-09,208,200,8,0.0384615384615385
OCCIDENTE 1,2023-12-10,112,110,2,0.0178571428571429
OCCIDENTE 1,2023-12-11,151,148,3,0.0198675496688742
OCCIDENTE 1,2023-12-12,191,187,4,0.0209424083769634
OCCIDENTE 1,2023-12-13,164,160,4,0.024390243902439
OCCIDENTE 1,2023-12-14,168,161,7,0.0416666666666667
OCCIDENTE 1,2023-12-15,165,159,6,0.0363636363636364
OCCIDENTE 1,2023-12-16,186,185,1,0.00537634408602151
OCCIDENTE 1,2023-12-17,132,128,4,0.0303030303030303
OCCIDENTE 1,2023-12-18,189,188,1,0.00529100529100529
OCCIDENTE 1,2023-12-19,185,177,8,0.0432432432432432
OCCIDENTE 1,2023-12-20,167,160,7,0.0419161676646707
OCCIDENTE 1,2023-12-21,170,159,11,0.0647058823529412
OCCIDENTE 1,2023-12-22,179,176,3,0.0167597765363128
OCCIDENTE 1,2023-12-23,165,162,3,0.0181818181818182
OCCIDENTE 1,2023-12-24,91,88,3,0.032967032967033
OCCIDENTE 1,2023-12-25,39,39,0,0
OCCIDENTE 1,2023-12-26,153,148,5,0.0326797385620915
OCCIDENTE 1,2023-12-27,191,187,4,0.0209424083769634
OCCIDENTE 1,2023-12-28,211,204,7,0.033175355450237
OCCIDENTE 1,2023-12-29,191,184,7,0.0366492146596859
OCCIDENTE 1,2023-12-30,245,239,6,0.0244897959183673
OCCIDENTE 1,2023-12-31,112,111,1,0.00892857142857143
OCCIDENTE 1,2024-01-01,35,34,1,0.0285714285714286
OCCIDENTE 1,2024-01-02,160,158,2,0.0125
OCCIDENTE 1,2024-01-03,232,227,5,0.021551724137931
OCCIDENTE 1,2024-01-04,174,168,6,0.0344827586206897
OCCIDENTE 1,2024-01-05,177,173,4,0.0225988700564972
OCCIDENTE 1,2024-01-06,198,197,1,0.00505050505050505
OCCIDENTE 1,2024-01-07,133,131,2,0.0150375939849624
OCCIDENTE 1,2024-01-08,215,210,5,0.0232558139534884
OCCIDENTE 1,2024-01-09,201,199,2,0.00995024875621891
OCCIDENTE 1,2024-01-10,174,172,2,0.0114942528735632
OCCIDENTE 1,2024-01-11,211,209,2,0.00947867298578199
OCCIDENTE 1,2024-01-12,220,215,5,0.0227272727272727
OCCIDENTE 1,2024-01-13,193,187,6,0.0310880829015544
OCCIDENTE 1,2024-01-14,139,134,5,0.0359712230215827
OCCIDENTE 1,2024-01-15,196,189,7,0.0357142857142857
OCCIDENTE 1,2024-01-16,223,216,7,0.031390134529148
OCCIDENTE 1,2024-01-17,193,189,4,0.0207253886010363
OCCIDENTE 1,2024-01-18,188,184,4,0.0212765957446809
OCCIDENTE 1,2024-01-19,171,166,5,0.0292397660818713
OCCIDENTE 1,2024-01-20,190,188,2,0.0105263157894737
OCCIDENTE 1,2024-01-21,119,114,5,0.0420168067226891
OCCIDENTE 1,2024-01-22,167,160,7,0.0419161676646707
OCCIDENTE 1,2024-01-23,184,176,8,0.0434782608695652
OCCIDENTE 1,2024-01-24,194,191,3,0.0154639175257732
OCCIDENTE 1,2024-01-25,169,168,1,0.00591715976331361
OCCIDENTE 1,2024-01-26,183,178,5,0.0273224043715847
OCCIDENTE 1,2024-01-27,205,200,5,0.024390243902439
OCCIDENTE 1,2024-01-28,151,148,3,0.0198675496688742
OCCIDENTE 1,2024-01-29,154,151,3,0.0194805194805195
OCCIDENTE 1,2024-01-30,199,194,5,0.0251256281407035
OCCIDENTE 1,2024-01-31,189,184,5,0.0264550264550265
OCCIDENTE 1,2024-02-01,169,166,3,0.0177514792899408
OCCIDENTE 1,2024-02-02,163,159,4,0.0245398773006135
OCCIDENTE 1,2024-02-03,220,214,6,0.0272727272727273
OCCIDENTE 1,2024-02-04,149,146,3,0.0201342281879195
OCCIDENTE 1,2024-02-05,155,153,2,0.0129032258064516
OCCIDENTE 1,2024-02-06,187,182,5,0.0267379679144385
OCCIDENTE 1,2024-02-07,175,171,4,0.0228571428571429
OCCIDENTE 1,2024-02-08,176,176,0,0
OCCIDENTE 1,2024-02-09,153,150,3,0.0196078431372549
OCCIDENTE 1,2024-02-10,192,190,2,0.0104166666666667
OCCIDENTE 1,2024-02-11,114,111,3,0.0263157894736842
OCCIDENTE 1,2024-02-12,135,129,6,0.0444444444444444
OCCIDENTE 1,2024-02-13,158,151,7,0.0443037974683544
OCCIDENTE 1,2024-02-14,145,142,3,0.0206896551724138
OCCIDENTE 1,2024-02-15,166,162,4,0.0240963855421687
OCCIDENTE 1,2024-02-16,155,151,4,0.0258064516129032
OCCIDENTE 1,2024-02-17,194,190,4,0.0206185567010309
OCCIDENTE 1,2024-02-18,126,126,0,0
OCCIDENTE 1,2024-02-19,179,174,5,0.0279329608938547
OCCIDENTE 1,2024-02-20,194,191,3,0.0154639175257732
OCCIDENTE 1,2024-02-21,185,183,2,0.0108108108108108
OCCIDENTE 1,2024-02-22,191,190,1,0.00523560209424084
OCCIDENTE 1,2024-02-23,129,114,15,0.116279069767442
OCCIDENTE 1,2024-02-24,234,226,8,0.0341880341880342
OCCIDENTE 1,2024-02-25,142,142,0,0
OCCIDENTE 1,2024-02-26,175,171,4,0.0228571428571429
OCCIDENTE 1,2024-02-27,191,182,9,0.0471204188481675
OCCIDENTE 1,2024-02-28,178,173,5,0.0280898876404494
OCCIDENTE 1,2024-02-29,215,212,3,0.013953488372093
OCCIDENTE 1,2024-03-01,197,193,4,0.0203045685279188
OCCIDENTE 1,2024-03-02,246,240,6,0.024390243902439
OCCIDENTE 1,2024-03-03,139,138,1,0.00719424460431655
OCCIDENTE 1,2024-03-04,171,170,1,0.00584795321637427
OCCIDENTE 1,2024-03-05,195,194,1,0.00512820512820513
OCCIDENTE 1,2024-03-06,170,166,4,0.0235294117647059
OCCIDENTE 1,2024-03-07,186,184,2,0.010752688172043
OCCIDENTE 1,2024-03-08,214,206,8,0.0373831775700935
OCCIDENTE 1,2024-03-09,211,210,1,0.004739336492891
OCCIDENTE 1,2024-03-10,156,152,4,0.0256410256410256
OCCIDENTE 1,2024-03-11,175,173,2,0.0114285714285714
OCCIDENTE 2,2023-03-12,105,90,15,0.142857142857143
OCCIDENTE 2,2023-03-13,147,134,13,0.0884353741496599
OCCIDENTE 2,2023-03-14,215,187,28,0.130232558139535
OCCIDENTE 2,2023-03-15,189,163,26,0.137566137566138
OCCIDENTE 2,2023-03-16,206,186,20,0.0970873786407767
OCCIDENTE 2,2023-03-17,228,206,22,0.0964912280701754
OCCIDENTE 2,2023-03-18,257,229,28,0.108949416342412
OCCIDENTE 2,2023-03-19,152,143,9,0.0592105263157895
OCCIDENTE 2,2023-03-20,196,175,21,0.107142857142857
OCCIDENTE 2,2023-03-21,224,201,23,0.102678571428571
OCCIDENTE 2,2023-03-22,221,199,22,0.0995475113122172
OCCIDENTE 2,2023-03-23,183,169,14,0.0765027322404372
OCCIDENTE 2,2023-03-24,212,193,19,0.089622641509434
OCCIDENTE 2,2023-03-25,246,229,17,0.0691056910569106
OCCIDENTE 2,2023-03-26,174,164,10,0.0574712643678161
OCCIDENTE 2,2023-03-27,190,178,12,0.0631578947368421
OCCIDENTE 2,2023-03-28,143,131,12,0.0839160839160839
OCCIDENTE 2,2023-03-29,205,192,13,0.0634146341463415
OCCIDENTE 2,2023-03-30,221,202,19,0.085972850678733
OCCIDENTE 2,2023-03-31,265,235,30,0.113207547169811
OCCIDENTE 2,2023-04-01,249,237,12,0.0481927710843374
OCCIDENTE 2,2023-04-02,119,110,9,0.0756302521008403
OCCIDENTE 2,2023-04-03,208,200,8,0.0384615384615385
OCCIDENTE 2,2023-04-04,222,205,17,0.0765765765765766
OCCIDENTE 2,2023-04-05,180,161,19,0.105555555555556
OCCIDENTE 2,2023-04-06,177,169,8,0.0451977401129944
OCCIDENTE 2,2023-04-07,141,132,9,0.0638297872340425
OCCIDENTE 2,2023-04-08,92,88,4,0.0434782608695652
OCCIDENTE 2,2023-04-09,82,79,3,0.0365853658536585
OCCIDENTE 2,2023-04-10,145,138,7,0.0482758620689655
OCCIDENTE 2,2023-04-11,182,165,17,0.0934065934065934
OCCIDENTE 2,2023-04-12,189,170,19,0.100529100529101
OCCIDENTE 2,2023-04-13,154,136,18,0.116883116883117
OCCIDENTE 2,2023-04-14,169,158,11,0.0650887573964497
OCCIDENTE 2,2023-04-15,247,228,19,0.0769230769230769
OCCIDENTE 2,2023-04-16,139,134,5,0.0359712230215827
OCCIDENTE 2,2023-04-17,179,170,9,0.0502793296089385
OCCIDENTE 2,2023-04-18,178,152,26,0.146067415730337
OCCIDENTE 2,2023-04-19,179,157,22,0.122905027932961
OCCIDENTE 2,2023-04-20,176,164,12,0.0681818181818182
OCCIDENTE 2,2023-04-21,168,150,18,0.107142857142857
OCCIDENTE 2,2023-04-22,200,177,23,0.115
OCCIDENTE 2,2023-04-23,103,94,9,0.087378640776699
OCCIDENTE 2,2023-04-24,194,178,16,0.0824742268041237
OCCIDENTE 2,2023-04-25,222,209,13,0.0585585585585586
OCCIDENTE 2,2023-04-26,188,175,13,0.0691489361702128
OCCIDENTE 2,2023-04-27,156,148,8,0.0512820512820513
OCCIDENTE 2,2023-04-28,192,175,17,0.0885416666666667
OCCIDENTE 2,2023-04-29,234,210,24,0.102564102564103
OCCIDENTE 2,2023-04-30,146,136,10,0.0684931506849315
OCCIDENTE 2,2023-05-01,150,140,10,0.0666666666666667
OCCIDENTE 2,2023-05-02,175,164,11,0.0628571428571429
OCCIDENTE 2,2023-05-03,170,152,18,0.105882352941176
OCCIDENTE 2,2023-05-04,176,161,15,0.0852272727272727
OCCIDENTE 2,2023-05-05,191,177,14,0.0732984293193717
OCCIDENTE 2,2023-05-06,206,183,23,0.111650485436893
OCCIDENTE 2,2023-05-07,104,101,3,0.0288461538461538
OCCIDENTE 2,2023-05-08,156,141,15,0.0961538461538462
OCCIDENTE 2,2023-05-09,183,172,11,0.0601092896174863
OCCIDENTE 2,2023-05-10,154,137,17,0.11038961038961
OCCIDENTE 2,2023-05-11,156,146,10,0.0641025641025641
OCCIDENTE 2,2023-05-12,164,152,12,0.0731707317073171
OCCIDENTE 2,2023-05-13,227,208,19,0.0837004405286344
OCCIDENTE 2,2023-05-14,164,147,17,0.103658536585366
OCCIDENTE 2,2023-05-15,241,207,34,0.141078838174274
OCCIDENTE 2,2023-05-16,261,212,49,0.187739463601533
OCCIDENTE 2,2023-05-17,262,224,38,0.145038167938931
OCCIDENTE 2,2023-05-18,211,190,21,0.0995260663507109
OCCIDENTE 2,2023-05-19,191,168,23,0.120418848167539
OCCIDENTE 2,2023-05-20,247,226,21,0.0850202429149798
OCCIDENTE 2,2023-05-21,170,156,14,0.0823529411764706
OCCIDENTE 2,2023-05-22,208,188,20,0.0961538461538462
OCCIDENTE 2,2023-05-23,207,186,21,0.101449275362319
OCCIDENTE 2,2023-05-24,195,165,30,0.153846153846154
OCCIDENTE 2,2023-05-25,197,168,29,0.147208121827411
OCCIDENTE 2,2023-05-26,206,172,34,0.16504854368932
OCCIDENTE 2,2023-05-27,246,202,44,0.178861788617886
OCCIDENTE 2,2023-05-28,161,126,35,0.217391304347826
OCCIDENTE 2,2023-05-29,208,163,45,0.216346153846154
OCCIDENTE 2,2023-05-30,271,217,54,0.199261992619926
OCCIDENTE 2,2023-05-31,254,210,44,0.173228346456693
OCCIDENTE 2,2023-06-01,237,190,47,0.19831223628692
OCCIDENTE 2,2023-06-02,194,157,37,0.190721649484536
OCCIDENTE 2,2023-06-03,226,195,31,0.13716814159292
OCCIDENTE 2,2023-06-04,173,150,23,0.132947976878613
OCCIDENTE 2,2023-06-05,241,201,40,0.16597510373444
OCCIDENTE 2,2023-06-06,229,205,24,0.104803493449782
OCCIDENTE 2,2023-06-07,199,173,26,0.130653266331658
OCCIDENTE 2,2023-06-08,201,172,29,0.144278606965174
OCCIDENTE 2,2023-06-09,205,184,21,0.102439024390244
OCCIDENTE 2,2023-06-10,221,193,28,0.126696832579186
OCCIDENTE 2,2023-06-11,138,123,15,0.108695652173913
OCCIDENTE 2,2023-06-12,201,175,26,0.129353233830846
OCCIDENTE 2,2023-06-13,213,179,34,0.15962441314554
OCCIDENTE 2,2023-06-14,241,223,18,0.0746887966804979
OCCIDENTE 2,2023-06-15,239,213,26,0.108786610878661
OCCIDENTE 2,2023-06-16,220,199,21,0.0954545454545455
OCCIDENTE 2,2023-06-17,229,199,30,0.131004366812227
OCCIDENTE 2,2023-06-18,139,116,23,0.165467625899281
OCCIDENTE 2,2023-06-19,195,172,23,0.117948717948718
OCCIDENTE 2,2023-06-20,197,175,22,0.111675126903553
OCCIDENTE 2,2023-06-21,181,164,17,0.0939226519337017
OCCIDENTE 2,2023-06-22,196,180,16,0.0816326530612245
OCCIDENTE 2,2023-06-23,177,161,16,0.0903954802259887
OCCIDENTE 2,2023-06-24,206,192,14,0.0679611650485437
OCCIDENTE 2,2023-06-25,132,124,8,0.0606060606060606
OCCIDENTE 2,2023-06-26,210,198,12,0.0571428571428571
OCCIDENTE 2,2023-06-27,202,193,9,0.0445544554455446
OCCIDENTE 2,2023-06-28,206,193,13,0.0631067961165049
OCCIDENTE 2,2023-06-29,199,184,15,0.0753768844221105
OCCIDENTE 2,2023-06-30,126,92,34,0.26984126984127
OCCIDENTE 2,2023-07-01,217,198,19,0.0875576036866359
OCCIDENTE 2,2023-07-02,127,119,8,0.062992125984252
OCCIDENTE 2,2023-07-03,192,183,9,0.046875
OCCIDENTE 2,2023-07-04,207,189,18,0.0869565217391304
OCCIDENTE 2,2023-07-05,151,132,19,0.125827814569536
OCCIDENTE 2,2023-07-06,95,82,13,0.136842105263158
OCCIDENTE 2,2023-07-07,179,163,16,0.0893854748603352
OCCIDENTE 2,2023-07-08,317,297,20,0.0630914826498423
OCCIDENTE 2,2023-07-09,145,136,9,0.0620689655172414
OCCIDENTE 2,2023-07-10,216,204,12,0.0555555555555556
OCCIDENTE 2,2023-07-11,222,204,18,0.0810810810810811
OCCIDENTE 2,2023-07-12,220,202,18,0.0818181818181818
OCCIDENTE 2,2023-07-13,197,177,20,0.101522842639594
OCCIDENTE 2,2023-07-14,173,162,11,0.0635838150289017
OCCIDENTE 2,2023-07-15,304,290,14,0.0460526315789474
OCCIDENTE 2,2023-07-16,120,112,8,0.0666666666666667
OCCIDENTE 2,2023-07-17,201,183,18,0.0895522388059701
OCCIDENTE 2,2023-07-18,177,162,15,0.0847457627118644
OCCIDENTE 2,2023-07-19,168,161,7,0.0416666666666667
OCCIDENTE 2,2023-07-20,241,229,12,0.0497925311203319
OCCIDENTE 2,2023-07-21,218,203,15,0.0688073394495413
OCCIDENTE 2,2023-07-22,334,314,20,0.0598802395209581
OCCIDENTE 2,2023-07-23,137,129,8,0.0583941605839416
OCCIDENTE 2,2023-07-24,162,152,10,0.0617283950617284
OCCIDENTE 2,2023-07-25,210,195,15,0.0714285714285714
OCCIDENTE 2,2023-07-26,219,196,23,0.105022831050228
OCCIDENTE 2,2023-07-27,202,196,6,0.0297029702970297
OCCIDENTE 2,2023-07-28,241,223,18,0.0746887966804979
OCCIDENTE 2,2023-07-29,255,242,13,0.0509803921568627
OCCIDENTE 2,2023-07-30,159,145,14,0.0880503144654088
OCCIDENTE 2,2023-07-31,242,232,10,0.0413223140495868
OCCIDENTE 2,2023-08-01,240,224,16,0.0666666666666667
OCCIDENTE 2,2023-08-02,258,244,14,0.0542635658914729
OCCIDENTE 2,2023-08-03,213,157,56,0.262910798122066
OCCIDENTE 2,2023-08-04,233,213,20,0.0858369098712446
OCCIDENTE 2,2023-08-05,247,234,13,0.0526315789473684
OCCIDENTE 2,2023-08-06,159,152,7,0.0440251572327044
OCCIDENTE 2,2023-08-07,217,209,8,0.0368663594470046
OCCIDENTE 2,2023-08-08,206,198,8,0.0388349514563107
OCCIDENTE 2,2023-08-09,228,217,11,0.0482456140350877
OCCIDENTE 2,2023-08-10,235,228,7,0.0297872340425532
OCCIDENTE 2,2023-08-11,232,215,17,0.0732758620689655
OCCIDENTE 2,2023-08-12,271,252,19,0.0701107011070111
OCCIDENTE 2,2023-08-13,165,154,11,0.0666666666666667
OCCIDENTE 2,2023-08-14,203,193,10,0.0492610837438424
OCCIDENTE 2,2023-08-15,249,228,21,0.0843373493975904
OCCIDENTE 2,2023-08-16,220,205,15,0.0681818181818182
OCCIDENTE 2,2023-08-17,205,190,15,0.0731707317073171
OCCIDENTE 2,2023-08-18,225,211,14,0.0622222222222222
OCCIDENTE 2,2023-08-19,251,232,19,0.0756972111553785
OCCIDENTE 2,2023-08-20,159,148,11,0.0691823899371069
OCCIDENTE 2,2023-08-21,218,209,9,0.0412844036697248
OCCIDENTE 2,2023-08-22,234,226,8,0.0341880341880342
OCCIDENTE 2,2023-08-23,222,214,8,0.036036036036036
OCCIDENTE 2,2023-08-24,251,236,15,0.0597609561752988
OCCIDENTE 2,2023-08-25,250,243,7,0.028
OCCIDENTE 2,2023-08-26,272,259,13,0.0477941176470588
OCCIDENTE 2,2023-08-27,161,155,6,0.0372670807453416
OCCIDENTE 2,2023-08-28,224,211,13,0.0580357142857143
OCCIDENTE 2,2023-08-29,250,238,12,0.048
OCCIDENTE 2,2023-08-30,211,204,7,0.033175355450237
OCCIDENTE 2,2023-08-31,238,228,10,0.0420168067226891
OCCIDENTE 2,2023-09-01,204,195,9,0.0441176470588235
OCCIDENTE 2,2023-09-02,242,239,3,0.012396694214876
OCCIDENTE 2,2023-09-03,165,160,5,0.0303030303030303
OCCIDENTE 2,2023-09-04,182,175,7,0.0384615384615385
OCCIDENTE 2,2023-09-05,220,216,4,0.0181818181818182
OCCIDENTE 2,2023-09-06,223,217,6,0.0269058295964126
OCCIDENTE 2,2023-09-07,202,192,10,0.0495049504950495
OCCIDENTE 2,2023-09-08,202,197,5,0.0247524752475248
OCCIDENTE 2,2023-09-09,202,193,9,0.0445544554455446
OCCIDENTE 2,2023-09-10,140,135,5,0.0357142857142857
OCCIDENTE 2,2023-09-11,192,184,8,0.0416666666666667
OCCIDENTE 2,2023-09-12,200,196,4,0.02
OCCIDENTE 2,2023-09-13,204,194,10,0.0490196078431373
OCCIDENTE 2,2023-09-14,206,196,10,0.0485436893203883
OCCIDENTE 2,2023-09-15,226,223,3,0.0132743362831858
OCCIDENTE 2,2023-09-16,215,211,4,0.0186046511627907
OCCIDENTE 2,2023-09-17,135,131,4,0.0296296296296296
OCCIDENTE 2,2023-09-18,214,205,9,0.0420560747663551
OCCIDENTE 2,2023-09-19,223,216,7,0.031390134529148
OCCIDENTE 2,2023-09-20,181,174,7,0.0386740331491713
OCCIDENTE 2,2023-09-21,199,191,8,0.0402010050251256
OCCIDENTE 2,2023-09-22,209,200,9,0.0430622009569378
OCCIDENTE 2,2023-09-23,242,232,10,0.0413223140495868
OCCIDENTE 2,2023-09-24,151,147,4,0.0264900662251656
OCCIDENTE 2,2023-09-25,179,172,7,0.0391061452513966
OCCIDENTE 2,2023-09-26,214,208,6,0.0280373831775701
OCCIDENTE 2,2023-09-27,198,191,7,0.0353535353535354
OCCIDENTE 2,2023-09-28,218,203,15,0.0688073394495413
OCCIDENTE 2,2023-09-29,251,236,15,0.0597609561752988
OCCIDENTE 2,2023-09-30,271,251,20,0.0738007380073801
OCCIDENTE 2,2023-10-01,171,163,8,0.0467836257309941
OCCIDENTE 2,2023-10-02,208,198,10,0.0480769230769231
OCCIDENTE 2,2023-10-03,203,190,13,0.0640394088669951
OCCIDENTE 2,2023-10-04,177,163,14,0.0790960451977401
OCCIDENTE 2,2023-10-05,178,162,16,0.0898876404494382
OCCIDENTE 2,2023-10-06,175,161,14,0.08
OCCIDENTE 2,2023-10-07,229,219,10,0.0436681222707424
OCCIDENTE 2,2023-10-08,142,136,6,0.0422535211267606
OCCIDENTE 2,2023-10-09,197,184,13,0.065989847715736
OCCIDENTE 2,2023-10-10,160,149,11,0.06875
OCCIDENTE 2,2023-10-11,161,147,14,0.0869565217391304
OCCIDENTE 2,2023-10-12,175,159,16,0.0914285714285714
OCCIDENTE 2,2023-10-13,170,157,13,0.0764705882352941
OCCIDENTE 2,2023-10-14,171,161,10,0.0584795321637427
OCCIDENTE 2,2023-10-15,147,139,8,0.054421768707483
OCCIDENTE 2,2023-10-16,181,173,8,0.0441988950276243
OCCIDENTE 2,2023-10-17,163,156,7,0.0429447852760736
OCCIDENTE 2,2023-10-18,188,174,14,0.074468085106383
OCCIDENTE 2,2023-10-19,169,162,7,0.0414201183431953
OCCIDENTE 2,2023-10-20,200,189,11,0.055
OCCIDENTE 2,2023-10-21,188,184,4,0.0212765957446809
OCCIDENTE 2,2023-10-22,134,131,3,0.0223880597014925
OCCIDENTE 2,2023-10-23,155,151,4,0.0258064516129032
OCCIDENTE 2,2023-10-24,172,164,8,0.0465116279069767
OCCIDENTE 2,2023-10-25,186,179,7,0.0376344086021505
OCCIDENTE 2,2023-10-26,182,166,16,0.0879120879120879
OCCIDENTE 2,2023-10-27,178,172,6,0.0337078651685393
OCCIDENTE 2,2023-10-28,186,181,5,0.0268817204301075
OCCIDENTE 2,2023-10-29,110,108,2,0.0181818181818182
OCCIDENTE 2,2023-10-30,172,163,9,0.0523255813953488
OCCIDENTE 2,2023-10-31,226,217,9,0.0398230088495575
OCCIDENTE 2,2023-11-01,201,194,7,0.0348258706467662
OCCIDENTE 2,2023-11-02,197,192,5,0.0253807106598985
OCCIDENTE 2,2023-11-03,205,195,10,0.0487804878048781
OCCIDENTE 2,2023-11-04,225,216,9,0.04
OCCIDENTE 2,2023-11-05,176,173,3,0.0170454545454545
OCCIDENTE 2,2023-11-06,196,182,14,0.0714285714285714
OCCIDENTE 2,2023-11-07,214,208,6,0.0280373831775701
OCCIDENTE 2,2023-11-08,200,193,7,0.035
OCCIDENTE 2,2023-11-09,188,179,9,0.0478723404255319
OCCIDENTE 2,2023-11-10,204,196,8,0.0392156862745098
OCCIDENTE 2,2023-11-11,266,260,6,0.0225563909774436
OCCIDENTE 2,2023-11-12,156,151,5,0.032051282051282
OCCIDENTE 2,2023-11-13,215,212,3,0.013953488372093
OCCIDENTE 2,2023-11-14,220,207,13,0.0590909090909091
OCCIDENTE 2,2023-11-15,225,216,9,0.04
OCCIDENTE 2,2023-11-16,209,195,14,0.0669856459330144
OCCIDENTE 2,2023-11-17,222,213,9,0.0405405405405405
OCCIDENTE 2,2023-11-18,257,252,5,0.0194552529182879
OCCIDENTE 2,2023-11-19,171,166,5,0.0292397660818713
OCCIDENTE 2,2023-11-20,233,221,12,0.0515021459227468
OCCIDENTE 2,2023-11-21,231,227,4,0.0173160173160173
OCCIDENTE 2,2023-11-22,214,206,8,0.0373831775700935
OCCIDENTE 2,2023-11-23,213,205,8,0.0375586854460094
OCCIDENTE 2,2023-11-24,236,227,9,0.038135593220339
OCCIDENTE 2,2023-11-25,222,216,6,0.027027027027027
OCCIDENTE 2,2023-11-26,157,154,3,0.0191082802547771
OCCIDENTE 2,2023-11-27,182,177,5,0.0274725274725275
OCCIDENTE 2,2023-11-28,223,211,12,0.0538116591928251
OCCIDENTE 2,2023-11-29,235,216,19,0.0808510638297872
OCCIDENTE 2,2023-11-30,225,215,10,0.0444444444444444
OCCIDENTE 2,2023-12-01,215,203,12,0.0558139534883721
OCCIDENTE 2,2023-12-02,255,238,17,0.0666666666666667
OCCIDENTE 2,2023-12-03,146,138,8,0.0547945205479452
OCCIDENTE 2,2023-12-04,231,216,15,0.0649350649350649
OCCIDENTE 2,2023-12-05,222,205,17,0.0765765765765766
OCCIDENTE 2,2023-12-06,227,214,13,0.0572687224669604
OCCIDENTE 2,2023-12-07,205,193,12,0.0585365853658537
OCCIDENTE 2,2023-12-08,215,204,11,0.0511627906976744
OCCIDENTE 2,2023-12-09,224,207,17,0.0758928571428571
OCCIDENTE 2,2023-12-10,171,165,6,0.0350877192982456
OCCIDENTE 2,2023-12-11,181,167,14,0.0773480662983425
OCCIDENTE 2,2023-12-12,208,191,17,0.0817307692307692
OCCIDENTE 2,2023-12-13,202,192,10,0.0495049504950495
OCCIDENTE 2,2023-12-14,187,176,11,0.0588235294117647
OCCIDENTE 2,2023-12-15,192,180,12,0.0625
OCCIDENTE 2,2023-12-16,222,211,11,0.0495495495495495
OCCIDENTE 2,2023-12-17,161,157,4,0.0248447204968944
OCCIDENTE 2,2023-12-18,209,195,14,0.0669856459330144
OCCIDENTE 2,2023-12-19,226,213,13,0.0575221238938053
OCCIDENTE 2,2023-12-20,243,231,12,0.0493827160493827
OCCIDENTE 2,2023-12-21,215,206,9,0.0418604651162791
OCCIDENTE 2,2023-12-22,224,216,8,0.0357142857142857
OCCIDENTE 2,2023-12-23,245,237,8,0.0326530612244898
OCCIDENTE 2,2023-12-24,124,119,5,0.0403225806451613
OCCIDENTE 2,2023-12-25,30,29,1,0.0333333333333333
OCCIDENTE 2,2023-12-26,163,157,6,0.0368098159509202
OCCIDENTE 2,2023-12-27,211,203,8,0.037914691943128
OCCIDENTE 2,2023-12-28,239,231,8,0.0334728033472803
OCCIDENTE 2,2023-12-29,240,231,9,0.0375
OCCIDENTE 2,2023-12-30,225,218,7,0.0311111111111111
OCCIDENTE 2,2023-12-31,141,140,1,0.00709219858156028
OCCIDENTE 2,2024-01-01,38,35,3,0.0789473684210526
OCCIDENTE 2,2024-01-02,185,180,5,0.027027027027027
OCCIDENTE 2,2024-01-03,241,237,4,0.016597510373444
OCCIDENTE 2,2024-01-04,232,223,9,0.0387931034482759
OCCIDENTE 2,2024-01-05,246,237,9,0.0365853658536585
OCCIDENTE 2,2024-01-06,250,239,11,0.044
OCCIDENTE 2,2024-01-07,147,141,6,0.0408163265306122
OCCIDENTE 2,2024-01-08,222,212,10,0.045045045045045
OCCIDENTE 2,2024-01-09,268,255,13,0.0485074626865672
OCCIDENTE 2,2024-01-10,256,246,10,0.0390625
OCCIDENTE 2,2024-01-11,230,223,7,0.0304347826086957
OCCIDENTE 2,2024-01-12,220,216,4,0.0181818181818182
OCCIDENTE 2,2024-01-13,267,253,14,0.052434456928839
OCCIDENTE 2,2024-01-14,161,153,8,0.0496894409937888
OCCIDENTE 2,2024-01-15,228,218,10,0.043859649122807
OCCIDENTE 2,2024-01-16,229,222,7,0.0305676855895196
OCCIDENTE 2,2024-01-17,241,231,10,0.04149377593361
OCCIDENTE 2,2024-01-18,225,219,6,0.0266666666666667
OCCIDENTE 2,2024-01-19,218,208,10,0.0458715596330275
OCCIDENTE 2,2024-01-20,258,252,6,0.0232558139534884
OCCIDENTE 2,2024-01-21,166,160,6,0.036144578313253
OCCIDENTE 2,2024-01-22,179,170,9,0.0502793296089385
OCCIDENTE 2,2024-01-23,206,195,11,0.0533980582524272
OCCIDENTE 2,2024-01-24,229,213,16,0.0698689956331878
OCCIDENTE 2,2024-01-25,208,199,9,0.0432692307692308
OCCIDENTE 2,2024-01-26,220,209,11,0.05
OCCIDENTE 2,2024-01-27,219,213,6,0.0273972602739726
OCCIDENTE 2,2024-01-28,146,139,7,0.0479452054794521
OCCIDENTE 2,2024-01-29,211,196,15,0.0710900473933649
OCCIDENTE 2,2024-01-30,209,194,15,0.0717703349282297
OCCIDENTE 2,2024-01-31,227,216,11,0.0484581497797357
OCCIDENTE 2,2024-02-01,201,194,7,0.0348258706467662
OCCIDENTE 2,2024-02-02,216,196,20,0.0925925925925926
OCCIDENTE 2,2024-02-03,249,239,10,0.0401606425702811
OCCIDENTE 2,2024-02-04,157,154,3,0.0191082802547771
OCCIDENTE 2,2024-02-05,134,127,7,0.0522388059701493
OCCIDENTE 2,2024-02-06,237,226,11,0.0464135021097046
OCCIDENTE 2,2024-02-07,232,224,8,0.0344827586206897
OCCIDENTE 2,2024-02-08,201,197,4,0.0199004975124378
OCCIDENTE 2,2024-02-09,221,216,5,0.0226244343891403
OCCIDENTE 2,2024-02-10,227,222,5,0.0220264317180617
OCCIDENTE 2,2024-02-11,146,143,3,0.0205479452054795
OCCIDENTE 2,2024-02-12,152,144,8,0.0526315789473684
OCCIDENTE 2,2024-02-13,205,198,7,0.0341463414634146
OCCIDENTE 2,2024-02-14,181,177,4,0.0220994475138122
OCCIDENTE 2,2024-02-15,193,189,4,0.0207253886010363
OCCIDENTE 2,2024-02-16,178,175,3,0.0168539325842697
OCCIDENTE 2,2024-02-17,261,252,9,0.0344827586206897
OCCIDENTE 2,2024-02-18,173,167,6,0.0346820809248555
OCCIDENTE 2,2024-02-19,222,217,5,0.0225225225225225
OCCIDENTE 2,2024-02-20,198,192,6,0.0303030303030303
OCCIDENTE 2,2024-02-21,214,205,9,0.0420560747663551
OCCIDENTE 2,2024-02-22,240,235,5,0.0208333333333333
OCCIDENTE 2,2024-02-23,156,124,32,0.205128205128205
OCCIDENTE 2,2024-02-24,249,241,8,0.0321285140562249
OCCIDENTE 2,2024-02-25,184,181,3,0.016304347826087
OCCIDENTE 2,2024-02-26,196,188,8,0.0408163265306122
OCCIDENTE 2,2024-02-27,251,243,8,0.0318725099601594
OCCIDENTE 2,2024-02-28,194,187,7,0.0360824742268041
OCCIDENTE 2,2024-02-29,235,223,12,0.051063829787234
OCCIDENTE 2,2024-03-01,266,256,10,0.037593984962406
OCCIDENTE 2,2024-03-02,304,296,8,0.0263157894736842
OCCIDENTE 2,2024-03-03,161,158,3,0.0186335403726708
OCCIDENTE 2,2024-03-04,225,220,5,0.0222222222222222
OCCIDENTE 2,2024-03-05,227,213,14,0.0616740088105727
OCCIDENTE 2,2024-03-06,235,230,5,0.0212765957446809
OCCIDENTE 2,2024-03-07,225,221,4,0.0177777777777778
OCCIDENTE 2,2024-03-08,221,211,10,0.0452488687782805
OCCIDENTE 2,2024-03-09,262,256,6,0.0229007633587786
OCCIDENTE 2,2024-03-10,140,136,4,0.0285714285714286
OCCIDENTE 2,2024-03-11,188,173,15,0.0797872340425532
ORIENTE GOLFO,2023-03-12,102,94,8,0.0784313725490196
ORIENTE GOLFO,2023-03-13,150,135,15,0.1
ORIENTE GOLFO,2023-03-14,145,134,11,0.0758620689655172
ORIENTE GOLFO,2023-03-15,162,142,20,0.123456790123457
ORIENTE GOLFO,2023-03-16,206,197,9,0.0436893203883495
ORIENTE GOLFO,2023-03-17,203,194,9,0.0443349753694581
ORIENTE GOLFO,2023-03-18,213,202,11,0.0516431924882629
ORIENTE GOLFO,2023-03-19,142,133,9,0.0633802816901408
ORIENTE GOLFO,2023-03-20,203,192,11,0.0541871921182266
ORIENTE GOLFO,2023-03-21,181,176,5,0.0276243093922652
ORIENTE GOLFO,2023-03-22,164,160,4,0.024390243902439
ORIENTE GOLFO,2023-03-23,168,166,2,0.0119047619047619
ORIENTE GOLFO,2023-03-24,179,176,3,0.0167597765363128
ORIENTE GOLFO,2023-03-25,190,184,6,0.0315789473684211
ORIENTE GOLFO,2023-03-26,150,147,3,0.02
ORIENTE GOLFO,2023-03-27,112,110,2,0.0178571428571429
ORIENTE GOLFO,2023-03-28,123,118,5,0.040650406504065
ORIENTE GOLFO,2023-03-29,142,141,1,0.00704225352112676
ORIENTE GOLFO,2023-03-30,173,166,7,0.0404624277456647
ORIENTE GOLFO,2023-03-31,263,253,10,0.0380228136882129
ORIENTE GOLFO,2023-04-01,188,180,8,0.0425531914893617
ORIENTE GOLFO,2023-04-02,107,102,5,0.0467289719626168
ORIENTE GOLFO,2023-04-03,185,180,5,0.027027027027027
ORIENTE GOLFO,2023-04-04,165,160,5,0.0303030303030303
ORIENTE GOLFO,2023-04-05,128,118,10,0.078125
ORIENTE GOLFO,2023-04-06,138,130,8,0.0579710144927536
ORIENTE GOLFO,2023-04-07,88,86,2,0.0227272727272727
ORIENTE GOLFO,2023-04-08,106,104,2,0.0188679245283019
ORIENTE GOLFO,2023-04-09,80,77,3,0.0375
ORIENTE GOLFO,2023-04-10,122,114,8,0.0655737704918033
ORIENTE GOLFO,2023-04-11,132,123,9,0.0681818181818182
ORIENTE GOLFO,2023-04-12,151,138,13,0.0860927152317881
ORIENTE GOLFO,2023-04-13,134,127,7,0.0522388059701493
ORIENTE GOLFO,2023-04-14,176,160,16,0.0909090909090909
ORIENTE GOLFO,2023-04-15,257,228,29,0.11284046692607
ORIENTE GOLFO,2023-04-16,178,165,13,0.0730337078651685
ORIENTE GOLFO,2023-04-17,152,143,9,0.0592105263157895
ORIENTE GOLFO,2023-04-18,138,124,14,0.101449275362319
ORIENTE GOLFO,2023-04-19,132,122,10,0.0757575757575758
ORIENTE GOLFO,2023-04-20,145,131,14,0.096551724137931
ORIENTE GOLFO,2023-04-21,148,136,12,0.0810810810810811
ORIENTE GOLFO,2023-04-22,193,180,13,0.0673575129533679
ORIENTE GOLFO,2023-04-23,125,112,13,0.104
ORIENTE GOLFO,2023-04-24,162,156,6,0.037037037037037
ORIENTE GOLFO,2023-04-25,227,200,27,0.118942731277533
ORIENTE GOLFO,2023-04-26,168,161,7,0.0416666666666667
ORIENTE GOLFO,2023-04-27,124,108,16,0.129032258064516
ORIENTE GOLFO,2023-04-28,195,171,24,0.123076923076923
ORIENTE GOLFO,2023-04-29,217,201,16,0.0737327188940092
ORIENTE GOLFO,2023-04-30,172,161,11,0.063953488372093
ORIENTE GOLFO,2023-05-01,161,153,8,0.0496894409937888
ORIENTE GOLFO,2023-05-02,138,130,8,0.0579710144927536
ORIENTE GOLFO,2023-05-03,154,146,8,0.051948051948052
ORIENTE GOLFO,2023-05-04,151,140,11,0.0728476821192053
ORIENTE GOLFO,2023-05-05,173,164,9,0.0520231213872832
ORIENTE GOLFO,2023-05-06,173,163,10,0.0578034682080925
ORIENTE GOLFO,2023-05-07,94,85,9,0.0957446808510638
ORIENTE GOLFO,2023-05-08,130,119,11,0.0846153846153846
ORIENTE GOLFO,2023-05-09,172,162,10,0.0581395348837209
ORIENTE GOLFO,2023-05-10,118,110,8,0.0677966101694915
ORIENTE GOLFO,2023-05-11,141,126,15,0.106382978723404
ORIENTE GOLFO,2023-05-12,125,120,5,0.04
ORIENTE GOLFO,2023-05-13,192,179,13,0.0677083333333333
ORIENTE GOLFO,2023-05-14,193,181,12,0.0621761658031088
ORIENTE GOLFO,2023-05-15,271,259,12,0.044280442804428
ORIENTE GOLFO,2023-05-16,279,266,13,0.046594982078853
ORIENTE GOLFO,2023-05-17,188,169,19,0.101063829787234
ORIENTE GOLFO,2023-05-18,140,131,9,0.0642857142857143
ORIENTE GOLFO,2023-05-19,141,128,13,0.0921985815602837
ORIENTE GOLFO,2023-05-20,195,178,17,0.0871794871794872
ORIENTE GOLFO,2023-05-21,173,162,11,0.0635838150289017
ORIENTE GOLFO,2023-05-22,143,127,16,0.111888111888112
ORIENTE GOLFO,2023-05-23,134,123,11,0.082089552238806
ORIENTE GOLFO,2023-05-24,163,155,8,0.049079754601227
ORIENTE GOLFO,2023-05-25,162,154,8,0.0493827160493827
ORIENTE GOLFO,2023-05-26,171,156,15,0.087719298245614
ORIENTE GOLFO,2023-05-27,170,154,16,0.0941176470588235
ORIENTE GOLFO,2023-05-28,102,91,11,0.107843137254902
ORIENTE GOLFO,2023-05-29,160,149,11,0.06875
ORIENTE GOLFO,2023-05-30,195,182,13,0.0666666666666667
ORIENTE GOLFO,2023-05-31,234,224,10,0.0427350427350427
ORIENTE GOLFO,2023-06-01,172,158,14,0.0813953488372093
ORIENTE GOLFO,2023-06-02,134,122,12,0.0895522388059701
ORIENTE GOLFO,2023-06-03,154,145,9,0.0584415584415584
ORIENTE GOLFO,2023-06-04,162,150,12,0.0740740740740741
ORIENTE GOLFO,2023-06-05,143,136,7,0.048951048951049
ORIENTE GOLFO,2023-06-06,143,134,9,0.0629370629370629
ORIENTE GOLFO,2023-06-07,134,123,11,0.082089552238806
ORIENTE GOLFO,2023-06-08,133,124,9,0.0676691729323308
ORIENTE GOLFO,2023-06-09,148,139,9,0.0608108108108108
ORIENTE GOLFO,2023-06-10,186,177,9,0.0483870967741935
ORIENTE GOLFO,2023-06-11,141,131,10,0.0709219858156028
ORIENTE GOLFO,2023-06-12,138,131,7,0.0507246376811594
ORIENTE GOLFO,2023-06-13,143,138,5,0.034965034965035
ORIENTE GOLFO,2023-06-14,169,160,9,0.0532544378698225
ORIENTE GOLFO,2023-06-15,190,182,8,0.0421052631578947
ORIENTE GOLFO,2023-06-16,179,172,7,0.0391061452513966
ORIENTE GOLFO,2023-06-17,187,180,7,0.0374331550802139
ORIENTE GOLFO,2023-06-18,136,130,6,0.0441176470588235
ORIENTE GOLFO,2023-06-19,182,179,3,0.0164835164835165
ORIENTE GOLFO,2023-06-20,202,197,5,0.0247524752475248
ORIENTE GOLFO,2023-06-21,164,157,7,0.0426829268292683
ORIENTE GOLFO,2023-06-22,129,120,9,0.0697674418604651
ORIENTE GOLFO,2023-06-23,147,140,7,0.0476190476190476
ORIENTE GOLFO,2023-06-24,163,162,1,0.00613496932515337
ORIENTE GOLFO,2023-06-25,162,158,4,0.0246913580246914
ORIENTE GOLFO,2023-06-26,154,146,8,0.051948051948052
ORIENTE GOLFO,2023-06-27,179,175,4,0.0223463687150838
ORIENTE GOLFO,2023-06-28,139,132,7,0.0503597122302158
ORIENTE GOLFO,2023-06-29,168,160,8,0.0476190476190476
ORIENTE GOLFO,2023-06-30,169,150,19,0.112426035502959
ORIENTE GOLFO,2023-07-01,204,193,11,0.053921568627451
ORIENTE GOLFO,2023-07-02,125,118,7,0.056
ORIENTE GOLFO,2023-07-03,164,160,4,0.024390243902439
ORIENTE GOLFO,2023-07-04,156,149,7,0.0448717948717949
ORIENTE GOLFO,2023-07-05,145,140,5,0.0344827586206897
ORIENTE GOLFO,2023-07-06,164,151,13,0.0792682926829268
ORIENTE GOLFO,2023-07-07,160,147,13,0.08125
ORIENTE GOLFO,2023-07-08,187,182,5,0.0267379679144385
ORIENTE GOLFO,2023-07-09,143,140,3,0.020979020979021
ORIENTE GOLFO,2023-07-10,152,148,4,0.0263157894736842
ORIENTE GOLFO,2023-07-11,174,166,8,0.0459770114942529
ORIENTE GOLFO,2023-07-12,143,140,3,0.020979020979021
ORIENTE GOLFO,2023-07-13,160,153,7,0.04375
ORIENTE GOLFO,2023-07-14,156,150,6,0.0384615384615385
ORIENTE GOLFO,2023-07-15,195,189,6,0.0307692307692308
ORIENTE GOLFO,2023-07-16,142,139,3,0.0211267605633803
ORIENTE GOLFO,2023-07-17,145,138,7,0.0482758620689655
ORIENTE GOLFO,2023-07-18,154,148,6,0.038961038961039
ORIENTE GOLFO,2023-07-19,145,142,3,0.0206896551724138
ORIENTE GOLFO,2023-07-20,165,161,4,0.0242424242424242
ORIENTE GOLFO,2023-07-21,157,153,4,0.0254777070063694
ORIENTE GOLFO,2023-07-22,147,144,3,0.0204081632653061
ORIENTE GOLFO,2023-07-23,118,113,5,0.0423728813559322
ORIENTE GOLFO,2023-07-24,154,149,5,0.0324675324675325
ORIENTE GOLFO,2023-07-25,154,147,7,0.0454545454545455
ORIENTE GOLFO,2023-07-26,158,150,8,0.0506329113924051
ORIENTE GOLFO,2023-07-27,148,143,5,0.0337837837837838
ORIENTE GOLFO,2023-07-28,175,170,5,0.0285714285714286
ORIENTE GOLFO,2023-07-29,213,203,10,0.0469483568075117
ORIENTE GOLFO,2023-07-30,161,157,4,0.0248447204968944
ORIENTE GOLFO,2023-07-31,228,222,6,0.0263157894736842
ORIENTE GOLFO,2023-08-01,200,182,18,0.09
ORIENTE GOLFO,2023-08-02,157,148,9,0.0573248407643312
ORIENTE GOLFO,2023-08-03,175,148,27,0.154285714285714
ORIENTE GOLFO,2023-08-04,148,144,4,0.027027027027027
ORIENTE GOLFO,2023-08-05,165,163,2,0.0121212121212121
ORIENTE GOLFO,2023-08-06,112,109,3,0.0267857142857143
ORIENTE GOLFO,2023-08-07,163,163,0,0
ORIENTE GOLFO,2023-08-08,173,165,8,0.046242774566474
ORIENTE GOLFO,2023-08-09,168,164,4,0.0238095238095238
ORIENTE GOLFO,2023-08-10,183,181,2,0.0109289617486339
ORIENTE GOLFO,2023-08-11,159,156,3,0.0188679245283019
ORIENTE GOLFO,2023-08-12,185,175,10,0.0540540540540541
ORIENTE GOLFO,2023-08-13,124,120,4,0.032258064516129
ORIENTE GOLFO,2023-08-14,172,171,1,0.00581395348837209
ORIENTE GOLFO,2023-08-15,167,164,3,0.0179640718562874
ORIENTE GOLFO,2023-08-16,201,194,7,0.0348258706467662
ORIENTE GOLFO,2023-08-17,190,175,15,0.0789473684210526
ORIENTE GOLFO,2023-08-18,190,182,8,0.0421052631578947
ORIENTE GOLFO,2023-08-19,196,187,9,0.0459183673469388
ORIENTE GOLFO,2023-08-20,138,132,6,0.0434782608695652
ORIENTE GOLFO,2023-08-21,150,148,2,0.0133333333333333
ORIENTE GOLFO,2023-08-22,174,173,1,0.00574712643678161
ORIENTE GOLFO,2023-08-23,167,164,3,0.0179640718562874
ORIENTE GOLFO,2023-08-24,182,177,5,0.0274725274725275
ORIENTE GOLFO,2023-08-25,196,190,6,0.0306122448979592
ORIENTE GOLFO,2023-08-26,193,190,3,0.0155440414507772
ORIENTE GOLFO,2023-08-27,118,115,3,0.0254237288135593
ORIENTE GOLFO,2023-08-28,155,153,2,0.0129032258064516
ORIENTE GOLFO,2023-08-29,156,155,1,0.00641025641025641
ORIENTE GOLFO,2023-08-30,164,162,2,0.0121951219512195
ORIENTE GOLFO,2023-08-31,182,182,0,0
ORIENTE GOLFO,2023-09-01,158,151,7,0.0443037974683544
ORIENTE GOLFO,2023-09-02,152,152,0,0
ORIENTE GOLFO,2023-09-03,126,125,1,0.00793650793650794
ORIENTE GOLFO,2023-09-04,162,161,1,0.00617283950617284
ORIENTE GOLFO,2023-09-05,199,198,1,0.0050251256281407
ORIENTE GOLFO,2023-09-06,163,162,1,0.00613496932515337
ORIENTE GOLFO,2023-09-07,144,141,3,0.0208333333333333
ORIENTE GOLFO,2023-09-08,157,155,2,0.0127388535031847
ORIENTE GOLFO,2023-09-09,166,164,2,0.0120481927710843
ORIENTE GOLFO,2023-09-10,106,105,1,0.00943396226415094
ORIENTE GOLFO,2023-09-11,110,109,1,0.00909090909090909
ORIENTE GOLFO,2023-09-12,184,181,3,0.016304347826087
ORIENTE GOLFO,2023-09-13,143,140,3,0.020979020979021
ORIENTE GOLFO,2023-09-14,161,159,2,0.0124223602484472
ORIENTE GOLFO,2023-09-15,199,195,4,0.0201005025125628
ORIENTE GOLFO,2023-09-16,157,154,3,0.0191082802547771
ORIENTE GOLFO,2023-09-17,122,121,1,0.00819672131147541
ORIENTE GOLFO,2023-09-18,165,165,0,0
ORIENTE GOLFO,2023-09-19,157,155,2,0.0127388535031847
ORIENTE GOLFO,2023-09-20,125,125,0,0
ORIENTE GOLFO,2023-09-21,143,141,2,0.013986013986014
ORIENTE GOLFO,2023-09-22,146,145,1,0.00684931506849315
ORIENTE GOLFO,2023-09-23,145,144,1,0.00689655172413793
ORIENTE GOLFO,2023-09-24,128,126,2,0.015625
ORIENTE GOLFO,2023-09-25,148,148,0,0
ORIENTE GOLFO,2023-09-26,159,156,3,0.0188679245283019
ORIENTE GOLFO,2023-09-27,138,137,1,0.0072463768115942
ORIENTE GOLFO,2023-09-28,157,157,0,0
ORIENTE GOLFO,2023-09-29,195,192,3,0.0153846153846154
ORIENTE GOLFO,2023-09-30,213,211,2,0.00938967136150235
ORIENTE GOLFO,2023-10-01,132,131,1,0.00757575757575758
ORIENTE GOLFO,2023-10-02,149,146,3,0.0201342281879195
ORIENTE GOLFO,2023-10-03,151,147,4,0.0264900662251656
ORIENTE GOLFO,2023-10-04,130,126,4,0.0307692307692308
ORIENTE GOLFO,2023-10-05,146,144,2,0.0136986301369863
ORIENTE GOLFO,2023-10-06,155,147,8,0.0516129032258065
ORIENTE GOLFO,2023-10-07,161,157,4,0.0248447204968944
ORIENTE GOLFO,2023-10-08,122,119,3,0.0245901639344262
ORIENTE GOLFO,2023-10-09,129,123,6,0.0465116279069767
ORIENTE GOLFO,2023-10-10,112,106,6,0.0535714285714286
ORIENTE GOLFO,2023-10-11,132,126,6,0.0454545454545455
ORIENTE GOLFO,2023-10-12,137,135,2,0.0145985401459854
ORIENTE GOLFO,2023-10-13,170,165,5,0.0294117647058824
ORIENTE GOLFO,2023-10-14,183,175,8,0.0437158469945355
ORIENTE GOLFO,2023-10-15,131,128,3,0.0229007633587786
ORIENTE GOLFO,2023-10-16,156,154,2,0.0128205128205128
ORIENTE GOLFO,2023-10-17,129,125,4,0.0310077519379845
ORIENTE GOLFO,2023-10-18,138,136,2,0.0144927536231884
ORIENTE GOLFO,2023-10-19,144,142,2,0.0138888888888889
ORIENTE GOLFO,2023-10-20,147,143,4,0.0272108843537415
ORIENTE GOLFO,2023-10-21,191,190,1,0.00523560209424084
ORIENTE GOLFO,2023-10-22,144,140,4,0.0277777777777778
ORIENTE GOLFO,2023-10-23,164,160,4,0.024390243902439
ORIENTE GOLFO,2023-10-24,132,130,2,0.0151515151515152
ORIENTE GOLFO,2023-10-25,146,140,6,0.0410958904109589
ORIENTE GOLFO,2023-10-26,173,167,6,0.0346820809248555
ORIENTE GOLFO,2023-10-27,143,138,5,0.034965034965035
ORIENTE GOLFO,2023-10-28,184,177,7,0.0380434782608696
ORIENTE GOLFO,2023-10-29,130,127,3,0.0230769230769231
ORIENTE GOLFO,2023-10-30,159,157,2,0.0125786163522013
ORIENTE GOLFO,2023-10-31,202,198,4,0.0198019801980198
ORIENTE GOLFO,2023-11-01,157,152,5,0.0318471337579618
ORIENTE GOLFO,2023-11-02,128,127,1,0.0078125
ORIENTE GOLFO,2023-11-03,135,131,4,0.0296296296296296
ORIENTE GOLFO,2023-11-04,144,141,3,0.0208333333333333
ORIENTE GOLFO,2023-11-05,135,133,2,0.0148148148148148
ORIENTE GOLFO,2023-11-06,170,160,10,0.0588235294117647
ORIENTE GOLFO,2023-11-07,163,159,4,0.0245398773006135
ORIENTE GOLFO,2023-11-08,166,161,5,0.0301204819277108
ORIENTE GOLFO,2023-11-09,175,168,7,0.04
ORIENTE GOLFO,2023-11-10,175,169,6,0.0342857142857143
ORIENTE GOLFO,2023-11-11,173,169,4,0.023121387283237
ORIENTE GOLFO,2023-11-12,136,131,5,0.0367647058823529
ORIENTE GOLFO,2023-11-13,164,159,5,0.0304878048780488
ORIENTE GOLFO,2023-11-14,195,191,4,0.0205128205128205
ORIENTE GOLFO,2023-11-15,208,201,7,0.0336538461538462
ORIENTE GOLFO,2023-11-16,194,191,3,0.0154639175257732
ORIENTE GOLFO,2023-11-17,200,193,7,0.035
ORIENTE GOLFO,2023-11-18,218,216,2,0.00917431192660551
ORIENTE GOLFO,2023-11-19,169,160,9,0.0532544378698225
ORIENTE GOLFO,2023-11-20,180,175,5,0.0277777777777778
ORIENTE GOLFO,2023-11-21,157,153,4,0.0254777070063694
ORIENTE GOLFO,2023-11-22,159,156,3,0.0188679245283019
ORIENTE GOLFO,2023-11-23,173,169,4,0.023121387283237
ORIENTE GOLFO,2023-11-24,171,165,6,0.0350877192982456
ORIENTE GOLFO,2023-11-25,186,184,2,0.010752688172043
ORIENTE GOLFO,2023-11-26,136,132,4,0.0294117647058824
ORIENTE GOLFO,2023-11-27,160,157,3,0.01875
ORIENTE GOLFO,2023-11-28,182,179,3,0.0164835164835165
ORIENTE GOLFO,2023-11-29,183,169,14,0.0765027322404372
ORIENTE GOLFO,2023-11-30,235,222,13,0.0553191489361702
ORIENTE GOLFO,2023-12-01,206,198,8,0.0388349514563107
ORIENTE GOLFO,2023-12-02,193,189,4,0.0207253886010363
ORIENTE GOLFO,2023-12-03,170,164,6,0.0352941176470588
ORIENTE GOLFO,2023-12-04,153,149,4,0.0261437908496732
ORIENTE GOLFO,2023-12-05,162,157,5,0.0308641975308642
ORIENTE GOLFO,2023-12-06,186,181,5,0.0268817204301075
ORIENTE GOLFO,2023-12-07,198,189,9,0.0454545454545455
ORIENTE GOLFO,2023-12-08,215,211,4,0.0186046511627907
ORIENTE GOLFO,2023-12-09,197,190,7,0.0355329949238579
ORIENTE GOLFO,2023-12-10,112,107,5,0.0446428571428571
ORIENTE GOLFO,2023-12-11,156,155,1,0.00641025641025641
ORIENTE GOLFO,2023-12-12,148,146,2,0.0135135135135135
ORIENTE GOLFO,2023-12-13,160,156,4,0.025
ORIENTE GOLFO,2023-12-14,156,148,8,0.0512820512820513
ORIENTE GOLFO,2023-12-15,170,163,7,0.0411764705882353
ORIENTE GOLFO,2023-12-16,171,167,4,0.0233918128654971
ORIENTE GOLFO,2023-12-17,150,144,6,0.04
ORIENTE GOLFO,2023-12-18,191,186,5,0.0261780104712042
ORIENTE GOLFO,2023-12-19,206,197,9,0.0436893203883495
ORIENTE GOLFO,2023-12-20,159,154,5,0.0314465408805031
ORIENTE GOLFO,2023-12-21,203,198,5,0.0246305418719212
ORIENTE GOLFO,2023-12-22,193,188,5,0.0259067357512953
ORIENTE GOLFO,2023-12-23,215,207,8,0.0372093023255814
ORIENTE GOLFO,2023-12-24,107,103,4,0.0373831775700935
ORIENTE GOLFO,2023-12-25,42,42,0,0
ORIENTE GOLFO,2023-12-26,158,155,3,0.0189873417721519
ORIENTE GOLFO,2023-12-27,190,186,4,0.0210526315789474
ORIENTE GOLFO,2023-12-28,203,198,5,0.0246305418719212
ORIENTE GOLFO,2023-12-29,174,168,6,0.0344827586206897
ORIENTE GOLFO,2023-12-30,184,179,5,0.0271739130434783
ORIENTE GOLFO,2023-12-31,77,73,4,0.051948051948052
ORIENTE GOLFO,2024-01-01,37,36,1,0.027027027027027
ORIENTE GOLFO,2024-01-02,145,140,5,0.0344827586206897
ORIENTE GOLFO,2024-01-03,178,176,2,0.0112359550561798
ORIENTE GOLFO,2024-01-04,160,158,2,0.0125
ORIENTE GOLFO,2024-01-05,170,165,5,0.0294117647058824
ORIENTE GOLFO,2024-01-06,163,158,5,0.0306748466257669
ORIENTE GOLFO,2024-01-07,114,111,3,0.0263157894736842
ORIENTE GOLFO,2024-01-08,163,155,8,0.049079754601227
ORIENTE GOLFO,2024-01-09,188,180,8,0.0425531914893617
ORIENTE GOLFO,2024-01-10,190,186,4,0.0210526315789474
ORIENTE GOLFO,2024-01-11,170,165,5,0.0294117647058824
ORIENTE GOLFO,2024-01-12,176,172,4,0.0227272727272727
ORIENTE GOLFO,2024-01-13,173,167,6,0.0346820809248555
ORIENTE GOLFO,2024-01-14,163,160,3,0.0184049079754601
ORIENTE GOLFO,2024-01-15,198,193,5,0.0252525252525253
ORIENTE GOLFO,2024-01-16,185,179,6,0.0324324324324324
ORIENTE GOLFO,2024-01-17,200,196,4,0.02
ORIENTE GOLFO,2024-01-18,187,183,4,0.0213903743315508
ORIENTE GOLFO,2024-01-19,148,145,3,0.0202702702702703
ORIENTE GOLFO,2024-01-20,178,174,4,0.0224719101123595
ORIENTE GOLFO,2024-01-21,120,118,2,0.0166666666666667
ORIENTE GOLFO,2024-01-22,188,183,5,0.0265957446808511
ORIENTE GOLFO,2024-01-23,156,152,4,0.0256410256410256
ORIENTE GOLFO,2024-01-24,165,161,4,0.0242424242424242
ORIENTE GOLFO,2024-01-25,158,153,5,0.0316455696202532
ORIENTE GOLFO,2024-01-26,157,153,4,0.0254777070063694
ORIENTE GOLFO,2024-01-27,181,174,7,0.0386740331491713
ORIENTE GOLFO,2024-01-28,118,115,3,0.0254237288135593
ORIENTE GOLFO,2024-01-29,157,155,2,0.0127388535031847
ORIENTE GOLFO,2024-01-30,193,186,7,0.0362694300518135
ORIENTE GOLFO,2024-01-31,227,222,5,0.0220264317180617
ORIENTE GOLFO,2024-02-01,178,171,7,0.0393258426966292
ORIENTE GOLFO,2024-02-02,175,167,8,0.0457142857142857
ORIENTE GOLFO,2024-02-03,164,158,6,0.0365853658536585
ORIENTE GOLFO,2024-02-04,130,128,2,0.0153846153846154
ORIENTE GOLFO,2024-02-05,150,148,2,0.0133333333333333
ORIENTE GOLFO,2024-02-06,174,168,6,0.0344827586206897
ORIENTE GOLFO,2024-02-07,173,169,4,0.023121387283237
ORIENTE GOLFO,2024-02-08,169,166,3,0.0177514792899408
ORIENTE GOLFO,2024-02-09,167,164,3,0.0179640718562874
ORIENTE GOLFO,2024-02-10,165,161,4,0.0242424242424242
ORIENTE GOLFO,2024-02-11,93,89,4,0.043010752688172
ORIENTE GOLFO,2024-02-12,159,156,3,0.0188679245283019
ORIENTE GOLFO,2024-02-13,163,158,5,0.0306748466257669
ORIENTE GOLFO,2024-02-14,166,163,3,0.0180722891566265
ORIENTE GOLFO,2024-02-15,182,181,1,0.00549450549450549
ORIENTE GOLFO,2024-02-16,168,167,1,0.00595238095238095
ORIENTE GOLFO,2024-02-17,162,158,4,0.0246913580246914
ORIENTE GOLFO,2024-02-18,145,140,5,0.0344827586206897
ORIENTE GOLFO,2024-02-19,161,154,7,0.0434782608695652
ORIENTE GOLFO,2024-02-20,181,179,2,0.0110497237569061
ORIENTE GOLFO,2024-02-21,203,200,3,0.0147783251231527
ORIENTE GOLFO,2024-02-22,154,151,3,0.0194805194805195
ORIENTE GOLFO,2024-02-23,101,89,12,0.118811881188119
ORIENTE GOLFO,2024-02-24,200,192,8,0.04
ORIENTE GOLFO,2024-02-25,126,121,5,0.0396825396825397
ORIENTE GOLFO,2024-02-26,152,149,3,0.0197368421052632
ORIENTE GOLFO,2024-02-27,177,172,5,0.0282485875706215
ORIENTE GOLFO,2024-02-28,195,189,6,0.0307692307692308
ORIENTE GOLFO,2024-02-29,179,173,6,0.0335195530726257
ORIENTE GOLFO,2024-03-01,175,173,2,0.0114285714285714
ORIENTE GOLFO,2024-03-02,173,170,3,0.0173410404624277
ORIENTE GOLFO,2024-03-03,125,122,3,0.024
ORIENTE GOLFO,2024-03-04,176,172,4,0.0227272727272727
ORIENTE GOLFO,2024-03-05,160,153,7,0.04375
ORIENTE GOLFO,2024-03-06,160,157,3,0.01875
ORIENTE GOLFO,2024-03-07,178,177,1,0.00561797752808989
ORIENTE GOLFO,2024-03-08,152,150,2,0.0131578947368421
ORIENTE GOLFO,2024-03-09,158,156,2,0.0126582278481013
ORIENTE GOLFO,2024-03-10,122,117,5,0.040983606557377
ORIENTE GOLFO,2024-03-11,161,160,1,0.0062111801242236
ORIENTE PACIFICO,2023-03-12,133,119,14,0.105263157894737
ORIENTE PACIFICO,2023-03-13,138,132,6,0.0434782608695652
ORIENTE PACIFICO,2023-03-14,172,167,5,0.0290697674418605
ORIENTE PACIFICO,2023-03-15,185,179,6,0.0324324324324324
ORIENTE PACIFICO,2023-03-16,206,196,10,0.0485436893203883
ORIENTE PACIFICO,2023-03-17,211,194,17,0.0805687203791469
ORIENTE PACIFICO,2023-03-18,290,276,14,0.0482758620689655
ORIENTE PACIFICO,2023-03-19,208,195,13,0.0625
ORIENTE PACIFICO,2023-03-20,220,210,10,0.0454545454545455
ORIENTE PACIFICO,2023-03-21,201,192,9,0.0447761194029851
ORIENTE PACIFICO,2023-03-22,183,173,10,0.0546448087431694
ORIENTE PACIFICO,2023-03-23,177,170,7,0.0395480225988701
ORIENTE PACIFICO,2023-03-24,175,169,6,0.0342857142857143
ORIENTE PACIFICO,2023-03-25,198,194,4,0.0202020202020202
ORIENTE PACIFICO,2023-03-26,168,162,6,0.0357142857142857
ORIENTE PACIFICO,2023-03-27,170,162,8,0.0470588235294118
ORIENTE PACIFICO,2023-03-28,164,156,8,0.0487804878048781
ORIENTE PACIFICO,2023-03-29,179,175,4,0.0223463687150838
ORIENTE PACIFICO,2023-03-30,208,202,6,0.0288461538461538
ORIENTE PACIFICO,2023-03-31,269,262,7,0.0260223048327138
ORIENTE PACIFICO,2023-04-01,230,226,4,0.0173913043478261
ORIENTE PACIFICO,2023-04-02,142,140,2,0.0140845070422535
ORIENTE PACIFICO,2023-04-03,203,200,3,0.0147783251231527
ORIENTE PACIFICO,2023-04-04,201,193,8,0.0398009950248756
ORIENTE PACIFICO,2023-04-05,181,175,6,0.0331491712707182
ORIENTE PACIFICO,2023-04-06,213,210,3,0.0140845070422535
ORIENTE PACIFICO,2023-04-07,154,147,7,0.0454545454545455
ORIENTE PACIFICO,2023-04-08,128,127,1,0.0078125
ORIENTE PACIFICO,2023-04-09,83,82,1,0.0120481927710843
ORIENTE PACIFICO,2023-04-10,133,128,5,0.037593984962406
ORIENTE PACIFICO,2023-04-11,176,166,10,0.0568181818181818
ORIENTE PACIFICO,2023-04-12,174,168,6,0.0344827586206897
ORIENTE PACIFICO,2023-04-13,149,145,4,0.0268456375838926
ORIENTE PACIFICO,2023-04-14,200,195,5,0.025
ORIENTE PACIFICO,2023-04-15,266,260,6,0.0225563909774436
ORIENTE PACIFICO,2023-04-16,220,217,3,0.0136363636363636
ORIENTE PACIFICO,2023-04-17,192,187,5,0.0260416666666667
ORIENTE PACIFICO,2023-04-18,155,152,3,0.0193548387096774
ORIENTE PACIFICO,2023-04-19,157,152,5,0.0318471337579618
ORIENTE PACIFICO,2023-04-20,169,168,1,0.00591715976331361
ORIENTE PACIFICO,2023-04-21,171,169,2,0.0116959064327485
ORIENTE PACIFICO,2023-04-22,194,190,4,0.0206185567010309
ORIENTE PACIFICO,2023-04-23,161,157,4,0.0248447204968944
ORIENTE PACIFICO,2023-04-24,190,186,4,0.0210526315789474
ORIENTE PACIFICO,2023-04-25,242,237,5,0.0206611570247934
ORIENTE PACIFICO,2023-04-26,216,208,8,0.037037037037037
ORIENTE PACIFICO,2023-04-27,180,174,6,0.0333333333333333
ORIENTE PACIFICO,2023-04-28,212,206,6,0.0283018867924528
ORIENTE PACIFICO,2023-04-29,262,254,8,0.0305343511450382
ORIENTE PACIFICO,2023-04-30,223,217,6,0.0269058295964126
ORIENTE PACIFICO,2023-05-01,161,156,5,0.031055900621118
ORIENTE PACIFICO,2023-05-02,188,183,5,0.0265957446808511
ORIENTE PACIFICO,2023-05-03,172,169,3,0.0174418604651163
ORIENTE PACIFICO,2023-05-04,155,150,5,0.032258064516129
ORIENTE PACIFICO,2023-05-05,163,158,5,0.0306748466257669
ORIENTE PACIFICO,2023-05-06,192,189,3,0.015625
ORIENTE PACIFICO,2023-05-07,117,115,2,0.0170940170940171
ORIENTE PACIFICO,2023-05-08,136,132,4,0.0294117647058824
ORIENTE PACIFICO,2023-05-09,184,177,7,0.0380434782608696
ORIENTE PACIFICO,2023-05-10,170,164,6,0.0352941176470588
ORIENTE PACIFICO,2023-05-11,149,146,3,0.0201342281879195
ORIENTE PACIFICO,2023-05-12,156,152,4,0.0256410256410256
ORIENTE PACIFICO,2023-05-13,262,250,12,0.0458015267175573
ORIENTE PACIFICO,2023-05-14,230,225,5,0.0217391304347826
ORIENTE PACIFICO,2023-05-15,242,231,11,0.0454545454545455
ORIENTE PACIFICO,2023-05-16,266,254,12,0.0451127819548872
ORIENTE PACIFICO,2023-05-17,244,236,8,0.0327868852459016
ORIENTE PACIFICO,2023-05-18,167,162,5,0.029940119760479
ORIENTE PACIFICO,2023-05-19,173,167,6,0.0346820809248555
ORIENTE PACIFICO,2023-05-20,243,235,8,0.0329218106995885
ORIENTE PACIFICO,2023-05-21,199,193,6,0.0301507537688442
ORIENTE PACIFICO,2023-05-22,211,205,6,0.028436018957346
ORIENTE PACIFICO,2023-05-23,219,214,5,0.0228310502283105
ORIENTE PACIFICO,2023-05-24,178,172,6,0.0337078651685393
ORIENTE PACIFICO,2023-05-25,209,201,8,0.0382775119617225
ORIENTE PACIFICO,2023-05-26,214,205,9,0.0420560747663551
ORIENTE PACIFICO,2023-05-27,263,247,16,0.0608365019011407
ORIENTE PACIFICO,2023-05-28,161,148,13,0.0807453416149068
ORIENTE PACIFICO,2023-05-29,185,177,8,0.0432432432432432
ORIENTE PACIFICO,2023-05-30,209,196,13,0.062200956937799
ORIENTE PACIFICO,2023-05-31,249,237,12,0.0481927710843374
ORIENTE PACIFICO,2023-06-01,203,194,9,0.0443349753694581
ORIENTE PACIFICO,2023-06-02,174,172,2,0.0114942528735632
ORIENTE PACIFICO,2023-06-03,195,187,8,0.041025641025641
ORIENTE PACIFICO,2023-06-04,190,176,14,0.0736842105263158
ORIENTE PACIFICO,2023-06-05,183,180,3,0.0163934426229508
ORIENTE PACIFICO,2023-06-06,155,154,1,0.00645161290322581
ORIENTE PACIFICO,2023-06-07,158,152,6,0.0379746835443038
ORIENTE PACIFICO,2023-06-08,178,172,6,0.0337078651685393
ORIENTE PACIFICO,2023-06-09,175,171,4,0.0228571428571429
ORIENTE PACIFICO,2023-06-10,217,212,5,0.0230414746543779
ORIENTE PACIFICO,2023-06-11,197,194,3,0.0152284263959391
ORIENTE PACIFICO,2023-06-12,165,160,5,0.0303030303030303
ORIENTE PACIFICO,2023-06-13,166,159,7,0.0421686746987952
ORIENTE PACIFICO,2023-06-14,178,170,8,0.0449438202247191
ORIENTE PACIFICO,2023-06-15,207,200,7,0.0338164251207729
ORIENTE PACIFICO,2023-06-16,172,165,7,0.0406976744186047
ORIENTE PACIFICO,2023-06-17,192,182,10,0.0520833333333333
ORIENTE PACIFICO,2023-06-18,197,191,6,0.0304568527918782
ORIENTE PACIFICO,2023-06-19,192,187,5,0.0260416666666667
ORIENTE PACIFICO,2023-06-20,198,192,6,0.0303030303030303
ORIENTE PACIFICO,2023-06-21,190,182,8,0.0421052631578947
ORIENTE PACIFICO,2023-06-22,179,171,8,0.0446927374301676
ORIENTE PACIFICO,2023-06-23,165,160,5,0.0303030303030303
ORIENTE PACIFICO,2023-06-24,173,165,8,0.046242774566474
ORIENTE PACIFICO,2023-06-25,165,159,6,0.0363636363636364
ORIENTE PACIFICO,2023-06-26,168,163,5,0.0297619047619048
ORIENTE PACIFICO,2023-06-27,210,204,6,0.0285714285714286
ORIENTE PACIFICO,2023-06-28,192,185,7,0.0364583333333333
ORIENTE PACIFICO,2023-06-29,214,208,6,0.0280373831775701
ORIENTE PACIFICO,2023-06-30,134,125,9,0.0671641791044776
ORIENTE PACIFICO,2023-07-01,237,232,5,0.0210970464135021
ORIENTE PACIFICO,2023-07-02,121,118,3,0.0247933884297521
ORIENTE PACIFICO,2023-07-03,195,193,2,0.0102564102564103
ORIENTE PACIFICO,2023-07-04,175,170,5,0.0285714285714286
ORIENTE PACIFICO,2023-07-05,203,194,9,0.0443349753694581
ORIENTE PACIFICO,2023-07-06,160,156,4,0.025
ORIENTE PACIFICO,2023-07-07,206,202,4,0.0194174757281553
ORIENTE PACIFICO,2023-07-08,230,226,4,0.0173913043478261
ORIENTE PACIFICO,2023-07-09,160,155,5,0.03125
ORIENTE PACIFICO,2023-07-10,166,161,5,0.0301204819277108
ORIENTE PACIFICO,2023-07-11,186,181,5,0.0268817204301075
ORIENTE PACIFICO,2023-07-12,194,189,5,0.0257731958762887
ORIENTE PACIFICO,2023-07-13,147,140,7,0.0476190476190476
ORIENTE PACIFICO,2023-07-14,183,179,4,0.0218579234972678
ORIENTE PACIFICO,2023-07-15,218,216,2,0.00917431192660551
ORIENTE PACIFICO,2023-07-16,176,172,4,0.0227272727272727
ORIENTE PACIFICO,2023-07-17,172,166,6,0.0348837209302326
ORIENTE PACIFICO,2023-07-18,149,146,3,0.0201342281879195
ORIENTE PACIFICO,2023-07-19,174,171,3,0.0172413793103448
ORIENTE PACIFICO,2023-07-20,205,198,7,0.0341463414634146
ORIENTE PACIFICO,2023-07-21,175,173,2,0.0114285714285714
ORIENTE PACIFICO,2023-07-22,192,187,5,0.0260416666666667
ORIENTE PACIFICO,2023-07-23,171,168,3,0.0175438596491228
ORIENTE PACIFICO,2023-07-24,192,188,4,0.0208333333333333
ORIENTE PACIFICO,2023-07-25,206,206,0,0
ORIENTE PACIFICO,2023-07-26,191,187,4,0.0209424083769634
ORIENTE PACIFICO,2023-07-27,209,203,6,0.0287081339712919
ORIENTE PACIFICO,2023-07-28,196,192,4,0.0204081632653061
ORIENTE PACIFICO,2023-07-29,244,240,4,0.0163934426229508
ORIENTE PACIFICO,2023-07-30,188,186,2,0.0106382978723404
ORIENTE PACIFICO,2023-07-31,237,236,1,0.00421940928270042
ORIENTE PACIFICO,2023-08-01,189,186,3,0.0158730158730159
ORIENTE PACIFICO,2023-08-02,199,196,3,0.0150753768844221
ORIENTE PACIFICO,2023-08-03,189,170,19,0.100529100529101
ORIENTE PACIFICO,2023-08-04,154,147,7,0.0454545454545455
ORIENTE PACIFICO,2023-08-05,199,195,4,0.0201005025125628
ORIENTE PACIFICO,2023-08-06,174,170,4,0.0229885057471264
ORIENTE PACIFICO,2023-08-07,192,186,6,0.03125
ORIENTE PACIFICO,2023-08-08,180,177,3,0.0166666666666667
ORIENTE PACIFICO,2023-08-09,222,214,8,0.036036036036036
ORIENTE PACIFICO,2023-08-10,225,222,3,0.0133333333333333
ORIENTE PACIFICO,2023-08-11,226,224,2,0.00884955752212389
ORIENTE PACIFICO,2023-08-12,202,199,3,0.0148514851485149
ORIENTE PACIFICO,2023-08-13,183,176,7,0.0382513661202186
ORIENTE PACIFICO,2023-08-14,203,197,6,0.0295566502463054
ORIENTE PACIFICO,2023-08-15,209,207,2,0.00956937799043062
ORIENTE PACIFICO,2023-08-16,204,200,4,0.0196078431372549
ORIENTE PACIFICO,2023-08-17,203,197,6,0.0295566502463054
ORIENTE PACIFICO,2023-08-18,208,204,4,0.0192307692307692
ORIENTE PACIFICO,2023-08-19,213,213,0,0
ORIENTE PACIFICO,2023-08-20,160,156,4,0.025
ORIENTE PACIFICO,2023-08-21,173,171,2,0.0115606936416185
ORIENTE PACIFICO,2023-08-22,165,165,0,0
ORIENTE PACIFICO,2023-08-23,163,163,0,0
ORIENTE PACIFICO,2023-08-24,189,189,0,0
ORIENTE PACIFICO,2023-08-25,216,216,0,0
ORIENTE PACIFICO,2023-08-26,219,218,1,0.0045662100456621
ORIENTE PACIFICO,2023-08-27,185,184,1,0.00540540540540541
ORIENTE PACIFICO,2023-08-28,201,201,0,0
ORIENTE PACIFICO,2023-08-29,208,207,1,0.00480769230769231
ORIENTE PACIFICO,2023-08-30,195,195,0,0
ORIENTE PACIFICO,2023-08-31,183,182,1,0.00546448087431694
ORIENTE PACIFICO,2023-09-01,150,150,0,0
ORIENTE PACIFICO,2023-09-02,169,169,0,0
ORIENTE PACIFICO,2023-09-03,138,138,0,0
ORIENTE PACIFICO,2023-09-04,172,172,0,0
ORIENTE PACIFICO,2023-09-05,181,181,0,0
ORIENTE PACIFICO,2023-09-06,178,178,0,0
ORIENTE PACIFICO,2023-09-07,167,167,0,0
ORIENTE PACIFICO,2023-09-08,160,159,1,0.00625
ORIENTE PACIFICO,2023-09-09,205,205,0,0
ORIENTE PACIFICO,2023-09-10,156,156,0,0
ORIENTE PACIFICO,2023-09-11,189,188,1,0.00529100529100529
ORIENTE PACIFICO,2023-09-12,186,185,1,0.00537634408602151
ORIENTE PACIFICO,2023-09-13,166,165,1,0.00602409638554217
ORIENTE PACIFICO,2023-09-14,208,208,0,0
ORIENTE PACIFICO,2023-09-15,227,227,0,0
ORIENTE PACIFICO,2023-09-16,156,156,0,0
ORIENTE PACIFICO,2023-09-17,136,136,0,0
ORIENTE PACIFICO,2023-09-18,173,173,0,0
ORIENTE PACIFICO,2023-09-19,184,184,0,0
ORIENTE PACIFICO,2023-09-20,162,161,1,0.00617283950617284
ORIENTE PACIFICO,2023-09-21,166,165,1,0.00602409638554217
ORIENTE PACIFICO,2023-09-22,168,168,0,0
ORIENTE PACIFICO,2023-09-23,229,228,1,0.00436681222707424
ORIENTE PACIFICO,2023-09-24,176,176,0,0
ORIENTE PACIFICO,2023-09-25,198,196,2,0.0101010101010101
ORIENTE PACIFICO,2023-09-26,216,216,0,0
ORIENTE PACIFICO,2023-09-27,177,177,0,0
ORIENTE PACIFICO,2023-09-28,173,172,1,0.00578034682080925
ORIENTE PACIFICO,2023-09-29,220,220,0,0
ORIENTE PACIFICO,2023-09-30,293,292,1,0.00341296928327645
ORIENTE PACIFICO,2023-10-01,177,177,0,0
ORIENTE PACIFICO,2023-10-02,150,150,0,0
ORIENTE PACIFICO,2023-10-03,150,148,2,0.0133333333333333
ORIENTE PACIFICO,2023-10-04,176,175,1,0.00568181818181818
ORIENTE PACIFICO,2023-10-05,154,152,2,0.012987012987013
ORIENTE PACIFICO,2023-10-06,201,198,3,0.0149253731343284
ORIENTE PACIFICO,2023-10-07,190,187,3,0.0157894736842105
ORIENTE PACIFICO,2023-10-08,114,110,4,0.0350877192982456
ORIENTE PACIFICO,2023-10-09,137,136,1,0.0072992700729927
ORIENTE PACIFICO,2023-10-10,144,143,1,0.00694444444444444
ORIENTE PACIFICO,2023-10-11,168,166,2,0.0119047619047619
ORIENTE PACIFICO,2023-10-12,135,134,1,0.00740740740740741
ORIENTE PACIFICO,2023-10-13,153,149,4,0.0261437908496732
ORIENTE PACIFICO,2023-10-14,192,190,2,0.0104166666666667
ORIENTE PACIFICO,2023-10-15,155,155,0,0
ORIENTE PACIFICO,2023-10-16,185,183,2,0.0108108108108108
ORIENTE PACIFICO,2023-10-17,167,163,4,0.0239520958083832
ORIENTE PACIFICO,2023-10-18,171,163,8,0.0467836257309941
ORIENTE PACIFICO,2023-10-19,174,170,4,0.0229885057471264
ORIENTE PACIFICO,2023-10-20,159,151,8,0.050314465408805
ORIENTE PACIFICO,2023-10-21,225,217,8,0.0355555555555556
ORIENTE PACIFICO,2023-10-22,165,163,2,0.0121212121212121
ORIENTE PACIFICO,2023-10-23,180,176,4,0.0222222222222222
ORIENTE PACIFICO,2023-10-24,190,185,5,0.0263157894736842
ORIENTE PACIFICO,2023-10-25,125,124,1,0.008
ORIENTE PACIFICO,2023-10-26,143,138,5,0.034965034965035
ORIENTE PACIFICO,2023-10-27,164,155,9,0.0548780487804878
ORIENTE PACIFICO,2023-10-28,189,183,6,0.0317460317460317
ORIENTE PACIFICO,2023-10-29,137,130,7,0.0510948905109489
ORIENTE PACIFICO,2023-10-30,134,133,1,0.00746268656716418
ORIENTE PACIFICO,2023-10-31,200,197,3,0.015
ORIENTE PACIFICO,2023-11-01,164,157,7,0.0426829268292683
ORIENTE PACIFICO,2023-11-02,131,127,4,0.0305343511450382
ORIENTE PACIFICO,2023-11-03,135,132,3,0.0222222222222222
ORIENTE PACIFICO,2023-11-04,167,164,3,0.0179640718562874
ORIENTE PACIFICO,2023-11-05,139,137,2,0.0143884892086331
ORIENTE PACIFICO,2023-11-06,177,175,2,0.0112994350282486
ORIENTE PACIFICO,2023-11-07,175,173,2,0.0114285714285714
ORIENTE PACIFICO,2023-11-08,160,158,2,0.0125
ORIENTE PACIFICO,2023-11-09,161,158,3,0.0186335403726708
ORIENTE PACIFICO,2023-11-10,159,156,3,0.0188679245283019
ORIENTE PACIFICO,2023-11-11,216,212,4,0.0185185185185185
ORIENTE PACIFICO,2023-11-12,148,143,5,0.0337837837837838
ORIENTE PACIFICO,2023-11-13,129,124,5,0.0387596899224806
ORIENTE PACIFICO,2023-11-14,187,185,2,0.0106951871657754
ORIENTE PACIFICO,2023-11-15,194,190,4,0.0206185567010309
ORIENTE PACIFICO,2023-11-16,171,167,4,0.0233918128654971
ORIENTE PACIFICO,2023-11-17,192,189,3,0.015625
ORIENTE PACIFICO,2023-11-18,192,188,4,0.0208333333333333
ORIENTE PACIFICO,2023-11-19,173,172,1,0.00578034682080925
ORIENTE PACIFICO,2023-11-20,169,167,2,0.0118343195266272
ORIENTE PACIFICO,2023-11-21,182,179,3,0.0164835164835165
ORIENTE PACIFICO,2023-11-22,152,150,2,0.0131578947368421
ORIENTE PACIFICO,2023-11-23,164,160,4,0.024390243902439
ORIENTE PACIFICO,2023-11-24,167,164,3,0.0179640718562874
ORIENTE PACIFICO,2023-11-25,211,210,1,0.004739336492891
ORIENTE PACIFICO,2023-11-26,124,122,2,0.0161290322580645
ORIENTE PACIFICO,2023-11-27,185,182,3,0.0162162162162162
ORIENTE PACIFICO,2023-11-28,157,151,6,0.0382165605095541
ORIENTE PACIFICO,2023-11-29,208,200,8,0.0384615384615385
ORIENTE PACIFICO,2023-11-30,241,237,4,0.016597510373444
ORIENTE PACIFICO,2023-12-01,167,161,6,0.0359281437125748
ORIENTE PACIFICO,2023-12-02,219,214,5,0.0228310502283105
ORIENTE PACIFICO,2023-12-03,146,140,6,0.0410958904109589
ORIENTE PACIFICO,2023-12-04,171,168,3,0.0175438596491228
ORIENTE PACIFICO,2023-12-05,197,192,5,0.0253807106598985
ORIENTE PACIFICO,2023-12-06,205,200,5,0.024390243902439
ORIENTE PACIFICO,2023-12-07,191,187,4,0.0209424083769634
ORIENTE PACIFICO,2023-12-08,195,187,8,0.041025641025641
ORIENTE PACIFICO,2023-12-09,213,210,3,0.0140845070422535
ORIENTE PACIFICO,2023-12-10,170,164,6,0.0352941176470588
ORIENTE PACIFICO,2023-12-11,177,173,4,0.0225988700564972
ORIENTE PACIFICO,2023-12-12,214,208,6,0.0280373831775701
ORIENTE PACIFICO,2023-12-13,169,167,2,0.0118343195266272
ORIENTE PACIFICO,2023-12-14,173,169,4,0.023121387283237
ORIENTE PACIFICO,2023-12-15,177,174,3,0.0169491525423729
ORIENTE PACIFICO,2023-12-16,225,222,3,0.0133333333333333
ORIENTE PACIFICO,2023-12-17,198,191,7,0.0353535353535354
ORIENTE PACIFICO,2023-12-18,208,205,3,0.0144230769230769
ORIENTE PACIFICO,2023-12-19,219,211,8,0.0365296803652968
ORIENTE PACIFICO,2023-12-20,199,195,4,0.0201005025125628
ORIENTE PACIFICO,2023-12-21,219,215,4,0.0182648401826484
ORIENTE PACIFICO,2023-12-22,187,185,2,0.0106951871657754
ORIENTE PACIFICO,2023-12-23,217,211,6,0.0276497695852535
ORIENTE PACIFICO,2023-12-24,132,129,3,0.0227272727272727
ORIENTE PACIFICO,2023-12-25,43,43,0,0
ORIENTE PACIFICO,2023-12-26,176,175,1,0.00568181818181818
ORIENTE PACIFICO,2023-12-27,225,219,6,0.0266666666666667
ORIENTE PACIFICO,2023-12-28,214,210,4,0.0186915887850467
ORIENTE PACIFICO,2023-12-29,232,225,7,0.0301724137931034
ORIENTE PACIFICO,2023-12-30,231,225,6,0.025974025974026
ORIENTE PACIFICO,2023-12-31,97,97,0,0
ORIENTE PACIFICO,2024-01-01,37,34,3,0.0810810810810811
ORIENTE PACIFICO,2024-01-02,131,130,1,0.00763358778625954
ORIENTE PACIFICO,2024-01-03,181,175,6,0.0331491712707182
ORIENTE PACIFICO,2024-01-04,218,215,3,0.0137614678899083
ORIENTE PACIFICO,2024-01-05,201,195,6,0.0298507462686567
ORIENTE PACIFICO,2024-01-06,223,222,1,0.00448430493273543
ORIENTE PACIFICO,2024-01-07,149,147,2,0.0134228187919463
ORIENTE PACIFICO,2024-01-08,195,195,0,0
ORIENTE PACIFICO,2024-01-09,230,223,7,0.0304347826086957
ORIENTE PACIFICO,2024-01-10,232,228,4,0.0172413793103448
ORIENTE PACIFICO,2024-01-11,215,207,8,0.0372093023255814
ORIENTE PACIFICO,2024-01-12,217,214,3,0.0138248847926267
ORIENTE PACIFICO,2024-01-13,287,282,5,0.0174216027874564
ORIENTE PACIFICO,2024-01-14,216,212,4,0.0185185185185185
ORIENTE PACIFICO,2024-01-15,219,209,10,0.045662100456621
ORIENTE PACIFICO,2024-01-16,282,274,8,0.0283687943262411
ORIENTE PACIFICO,2024-01-17,242,238,4,0.0165289256198347
ORIENTE PACIFICO,2024-01-18,216,210,6,0.0277777777777778
ORIENTE PACIFICO,2024-01-19,186,179,7,0.0376344086021505
ORIENTE PACIFICO,2024-01-20,226,222,4,0.0176991150442478
ORIENTE PACIFICO,2024-01-21,159,155,4,0.0251572327044025
ORIENTE PACIFICO,2024-01-22,168,163,5,0.0297619047619048
ORIENTE PACIFICO,2024-01-23,184,180,4,0.0217391304347826
ORIENTE PACIFICO,2024-01-24,193,188,5,0.0259067357512953
ORIENTE PACIFICO,2024-01-25,159,157,2,0.0125786163522013
ORIENTE PACIFICO,2024-01-26,177,172,5,0.0282485875706215
ORIENTE PACIFICO,2024-01-27,189,188,1,0.00529100529100529
ORIENTE PACIFICO,2024-01-28,152,148,4,0.0263157894736842
ORIENTE PACIFICO,2024-01-29,176,170,6,0.0340909090909091
ORIENTE PACIFICO,2024-01-30,176,172,4,0.0227272727272727
ORIENTE PACIFICO,2024-01-31,236,230,6,0.0254237288135593
ORIENTE PACIFICO,2024-02-01,178,177,1,0.00561797752808989
ORIENTE PACIFICO,2024-02-02,165,162,3,0.0181818181818182
ORIENTE PACIFICO,2024-02-03,218,212,6,0.0275229357798165
ORIENTE PACIFICO,2024-02-04,177,176,1,0.00564971751412429
ORIENTE PACIFICO,2024-02-05,191,186,5,0.0261780104712042
ORIENTE PACIFICO,2024-02-06,170,167,3,0.0176470588235294
ORIENTE PACIFICO,2024-02-07,183,176,7,0.0382513661202186
ORIENTE PACIFICO,2024-02-08,183,183,0,0
ORIENTE PACIFICO,2024-02-09,176,170,6,0.0340909090909091
ORIENTE PACIFICO,2024-02-10,206,199,7,0.0339805825242718
ORIENTE PACIFICO,2024-02-11,148,138,10,0.0675675675675676
ORIENTE PACIFICO,2024-02-12,151,144,7,0.0463576158940397
ORIENTE PACIFICO,2024-02-13,175,170,5,0.0285714285714286
ORIENTE PACIFICO,2024-02-14,143,140,3,0.020979020979021
ORIENTE PACIFICO,2024-02-15,168,165,3,0.0178571428571429
ORIENTE PACIFICO,2024-02-16,184,177,7,0.0380434782608696
ORIENTE PACIFICO,2024-02-17,181,177,4,0.0220994475138122
ORIENTE PACIFICO,2024-02-18,197,194,3,0.0152284263959391
ORIENTE PACIFICO,2024-02-19,194,189,5,0.0257731958762887
ORIENTE PACIFICO,2024-02-20,196,185,11,0.0561224489795918
ORIENTE PACIFICO,2024-02-21,213,202,11,0.0516431924882629
ORIENTE PACIFICO,2024-02-22,184,183,1,0.00543478260869565
ORIENTE PACIFICO,2024-02-23,120,108,12,0.1
ORIENTE PACIFICO,2024-02-24,259,250,9,0.0347490347490347
ORIENTE PACIFICO,2024-02-25,150,145,5,0.0333333333333333
ORIENTE PACIFICO,2024-02-26,174,164,10,0.0574712643678161
ORIENTE PACIFICO,2024-02-27,193,186,7,0.0362694300518135
ORIENTE PACIFICO,2024-02-28,198,194,4,0.0202020202020202
ORIENTE PACIFICO,2024-02-29,238,233,5,0.0210084033613445
ORIENTE PACIFICO,2024-03-01,204,201,3,0.0147058823529412
ORIENTE PACIFICO,2024-03-02,207,202,5,0.0241545893719807
ORIENTE PACIFICO,2024-03-03,186,181,5,0.0268817204301075
ORIENTE PACIFICO,2024-03-04,211,207,4,0.018957345971564
ORIENTE PACIFICO,2024-03-05,212,209,3,0.0141509433962264
ORIENTE PACIFICO,2024-03-06,191,187,4,0.0209424083769634
ORIENTE PACIFICO,2024-03-07,182,179,3,0.0164835164835165
ORIENTE PACIFICO,2024-03-08,198,193,5,0.0252525252525253
ORIENTE PACIFICO,2024-03-09,220,212,8,0.0363636363636364
ORIENTE PACIFICO,2024-03-10,152,151,1,0.00657894736842105
ORIENTE PACIFICO,2024-03-11,168,165,3,0.0178571428571429
PACIFICO,2023-03-12,70,45,25,0.357142857142857
PACIFICO,2023-03-13,102,78,24,0.235294117647059
PACIFICO,2023-03-14,122,105,17,0.139344262295082
PACIFICO,2023-03-15,96,88,8,0.0833333333333333
PACIFICO,2023-03-16,117,104,13,0.111111111111111
PACIFICO,2023-03-17,161,150,11,0.0683229813664596
PACIFICO,2023-03-18,184,161,23,0.125
PACIFICO,2023-03-19,123,113,10,0.0813008130081301
PACIFICO,2023-03-20,156,138,18,0.115384615384615
PACIFICO,2023-03-21,135,118,17,0.125925925925926
PACIFICO,2023-03-22,133,120,13,0.0977443609022556
PACIFICO,2023-03-23,129,120,9,0.0697674418604651
PACIFICO,2023-03-24,153,142,11,0.0718954248366013
PACIFICO,2023-03-25,176,171,5,0.0284090909090909
PACIFICO,2023-03-26,142,132,10,0.0704225352112676
PACIFICO,2023-03-27,84,80,4,0.0476190476190476
PACIFICO,2023-03-28,119,107,12,0.100840336134454
PACIFICO,2023-03-29,145,131,14,0.096551724137931
PACIFICO,2023-03-30,168,160,8,0.0476190476190476
PACIFICO,2023-03-31,184,171,13,0.0706521739130435
PACIFICO,2023-04-01,129,122,7,0.0542635658914729
PACIFICO,2023-04-02,89,85,4,0.0449438202247191
PACIFICO,2023-04-03,149,139,10,0.0671140939597315
PACIFICO,2023-04-04,155,147,8,0.0516129032258065
PACIFICO,2023-04-05,103,92,11,0.106796116504854
PACIFICO,2023-04-06,104,101,3,0.0288461538461538
PACIFICO,2023-04-07,60,56,4,0.0666666666666667
PACIFICO,2023-04-08,50,50,0,0
PACIFICO,2023-04-09,45,43,2,0.0444444444444444
PACIFICO,2023-04-10,109,95,14,0.128440366972477
PACIFICO,2023-04-11,113,99,14,0.123893805309735
PACIFICO,2023-04-12,108,97,11,0.101851851851852
PACIFICO,2023-04-13,110,101,9,0.0818181818181818
PACIFICO,2023-04-14,161,147,14,0.0869565217391304
PACIFICO,2023-04-15,217,196,21,0.0967741935483871
PACIFICO,2023-04-16,170,162,8,0.0470588235294118
PACIFICO,2023-04-17,122,114,8,0.0655737704918033
PACIFICO,2023-04-18,133,130,3,0.0225563909774436
PACIFICO,2023-04-19,126,121,5,0.0396825396825397
PACIFICO,2023-04-20,113,108,5,0.0442477876106195
PACIFICO,2023-04-21,115,109,6,0.0521739130434783
PACIFICO,2023-04-22,123,117,6,0.0487804878048781
PACIFICO,2023-04-23,100,97,3,0.03
PACIFICO,2023-04-24,125,124,1,0.008
PACIFICO,2023-04-25,169,165,4,0.0236686390532544
PACIFICO,2023-04-26,145,141,4,0.0275862068965517
PACIFICO,2023-04-27,110,108,2,0.0181818181818182
PACIFICO,2023-04-28,162,151,11,0.0679012345679012
PACIFICO,2023-04-29,185,177,8,0.0432432432432432
PACIFICO,2023-04-30,126,118,8,0.0634920634920635
PACIFICO,2023-05-01,116,107,9,0.0775862068965517
PACIFICO,2023-05-02,120,116,4,0.0333333333333333
PACIFICO,2023-05-03,132,128,4,0.0303030303030303
PACIFICO,2023-05-04,132,129,3,0.0227272727272727
PACIFICO,2023-05-05,125,113,12,0.096
PACIFICO,2023-05-06,131,127,4,0.0305343511450382
PACIFICO,2023-05-07,94,85,9,0.0957446808510638
PACIFICO,2023-05-08,117,111,6,0.0512820512820513
PACIFICO,2023-05-09,138,135,3,0.0217391304347826
PACIFICO,2023-05-10,101,95,6,0.0594059405940594
PACIFICO,2023-05-11,129,125,4,0.0310077519379845
PACIFICO,2023-05-12,119,113,6,0.0504201680672269
PACIFICO,2023-05-13,161,155,6,0.0372670807453416
PACIFICO,2023-05-14,132,123,9,0.0681818181818182
PACIFICO,2023-05-15,165,153,12,0.0727272727272727
PACIFICO,2023-05-16,162,156,6,0.037037037037037
PACIFICO,2023-05-17,128,125,3,0.0234375
PACIFICO,2023-05-18,122,116,6,0.0491803278688525
PACIFICO,2023-05-19,125,118,7,0.056
PACIFICO,2023-05-20,147,142,5,0.0340136054421769
PACIFICO,2023-05-21,111,107,4,0.036036036036036
PACIFICO,2023-05-22,115,111,4,0.0347826086956522
PACIFICO,2023-05-23,125,121,4,0.032
PACIFICO,2023-05-24,127,123,4,0.031496062992126
PACIFICO,2023-05-25,138,132,6,0.0434782608695652
PACIFICO,2023-05-26,152,147,5,0.0328947368421053
PACIFICO,2023-05-27,176,167,9,0.0511363636363636
PACIFICO,2023-05-28,104,99,5,0.0480769230769231
PACIFICO,2023-05-29,123,119,4,0.032520325203252
PACIFICO,2023-05-30,138,132,6,0.0434782608695652
PACIFICO,2023-05-31,165,152,13,0.0787878787878788
PACIFICO,2023-06-01,128,122,6,0.046875
PACIFICO,2023-06-02,107,98,9,0.0841121495327103
PACIFICO,2023-06-03,131,121,10,0.0763358778625954
PACIFICO,2023-06-04,113,104,9,0.079646017699115
PACIFICO,2023-06-05,107,104,3,0.0280373831775701
PACIFICO,2023-06-06,134,129,5,0.0373134328358209
PACIFICO,2023-06-07,119,109,10,0.0840336134453782
PACIFICO,2023-06-08,143,138,5,0.034965034965035
PACIFICO,2023-06-09,138,125,13,0.0942028985507246
PACIFICO,2023-06-10,154,144,10,0.0649350649350649
PACIFICO,2023-06-11,107,99,8,0.0747663551401869
PACIFICO,2023-06-12,127,122,5,0.0393700787401575
PACIFICO,2023-06-13,139,134,5,0.0359712230215827
PACIFICO,2023-06-14,141,135,6,0.0425531914893617
PACIFICO,2023-06-15,153,147,6,0.0392156862745098
PACIFICO,2023-06-16,135,127,8,0.0592592592592593
PACIFICO,2023-06-17,169,160,9,0.0532544378698225
PACIFICO,2023-06-18,124,116,8,0.0645161290322581
PACIFICO,2023-06-19,156,148,8,0.0512820512820513
PACIFICO,2023-06-20,146,141,5,0.0342465753424658
PACIFICO,2023-06-21,157,147,10,0.0636942675159236
PACIFICO,2023-06-22,135,125,10,0.0740740740740741
PACIFICO,2023-06-23,135,129,6,0.0444444444444444
PACIFICO,2023-06-24,154,151,3,0.0194805194805195
PACIFICO,2023-06-25,109,106,3,0.0275229357798165
PACIFICO,2023-06-26,105,104,1,0.00952380952380952
PACIFICO,2023-06-27,150,145,5,0.0333333333333333
PACIFICO,2023-06-28,161,158,3,0.0186335403726708
PACIFICO,2023-06-29,131,126,5,0.0381679389312977
PACIFICO,2023-06-30,93,84,9,0.0967741935483871
PACIFICO,2023-07-01,161,156,5,0.031055900621118
PACIFICO,2023-07-02,148,143,5,0.0337837837837838
PACIFICO,2023-07-03,102,100,2,0.0196078431372549
PACIFICO,2023-07-04,71,71,0,0
PACIFICO,2023-07-05,74,72,2,0.027027027027027
PACIFICO,2023-07-06,104,101,3,0.0288461538461538
PACIFICO,2023-07-07,101,100,1,0.0099009900990099
PACIFICO,2023-07-08,150,145,5,0.0333333333333333
PACIFICO,2023-07-09,142,138,4,0.028169014084507
PACIFICO,2023-07-10,138,136,2,0.0144927536231884
PACIFICO,2023-07-11,133,130,3,0.0225563909774436
PACIFICO,2023-07-12,135,131,4,0.0296296296296296
PACIFICO,2023-07-13,116,112,4,0.0344827586206897
PACIFICO,2023-07-14,105,97,8,0.0761904761904762
PACIFICO,2023-07-15,146,142,4,0.0273972602739726
PACIFICO,2023-07-16,103,99,4,0.0388349514563107
PACIFICO,2023-07-17,126,124,2,0.0158730158730159
PACIFICO,2023-07-18,113,108,5,0.0442477876106195
PACIFICO,2023-07-19,135,128,7,0.0518518518518519
PACIFICO,2023-07-20,134,128,6,0.0447761194029851
PACIFICO,2023-07-21,145,139,6,0.0413793103448276
PACIFICO,2023-07-22,137,133,4,0.0291970802919708
PACIFICO,2023-07-23,110,102,8,0.0727272727272727
PACIFICO,2023-07-24,115,112,3,0.0260869565217391
PACIFICO,2023-07-25,151,147,4,0.0264900662251656
PACIFICO,2023-07-26,130,124,6,0.0461538461538462
PACIFICO,2023-07-27,155,154,1,0.00645161290322581
PACIFICO,2023-07-28,148,144,4,0.027027027027027
PACIFICO,2023-07-29,166,164,2,0.0120481927710843
PACIFICO,2023-07-30,129,127,2,0.0155038759689922
PACIFICO,2023-07-31,144,135,9,0.0625
PACIFICO,2023-08-01,131,127,4,0.0305343511450382
PACIFICO,2023-08-02,143,135,8,0.0559440559440559
PACIFICO,2023-08-03,143,117,26,0.181818181818182
PACIFICO,2023-08-04,143,137,6,0.041958041958042
PACIFICO,2023-08-05,158,154,4,0.0253164556962025
PACIFICO,2023-08-06,120,115,5,0.0416666666666667
PACIFICO,2023-08-07,147,140,7,0.0476190476190476
PACIFICO,2023-08-08,150,146,4,0.0266666666666667
PACIFICO,2023-08-09,143,137,6,0.041958041958042
PACIFICO,2023-08-10,132,124,8,0.0606060606060606
PACIFICO,2023-08-11,160,155,5,0.03125
PACIFICO,2023-08-12,147,139,8,0.054421768707483
PACIFICO,2023-08-13,122,117,5,0.040983606557377
PACIFICO,2023-08-14,126,123,3,0.0238095238095238
PACIFICO,2023-08-15,144,134,10,0.0694444444444444
PACIFICO,2023-08-16,165,155,10,0.0606060606060606
PACIFICO,2023-08-17,142,138,4,0.028169014084507
PACIFICO,2023-08-18,167,157,10,0.0598802395209581
PACIFICO,2023-08-19,152,144,8,0.0526315789473684
PACIFICO,2023-08-20,127,121,6,0.047244094488189
PACIFICO,2023-08-21,140,138,2,0.0142857142857143
PACIFICO,2023-08-22,126,126,0,0
PACIFICO,2023-08-23,120,117,3,0.025
PACIFICO,2023-08-24,159,154,5,0.0314465408805031
PACIFICO,2023-08-25,136,133,3,0.0220588235294118
PACIFICO,2023-08-26,162,156,6,0.037037037037037
PACIFICO,2023-08-27,120,120,0,0
PACIFICO,2023-08-28,126,123,3,0.0238095238095238
PACIFICO,2023-08-29,110,109,1,0.00909090909090909
PACIFICO,2023-08-30,94,92,2,0.0212765957446809
PACIFICO,2023-08-31,150,148,2,0.0133333333333333
PACIFICO,2023-09-01,75,72,3,0.04
PACIFICO,2023-09-02,158,157,1,0.00632911392405063
PACIFICO,2023-09-03,113,112,1,0.00884955752212389
PACIFICO,2023-09-04,122,122,0,0
PACIFICO,2023-09-05,142,140,2,0.0140845070422535
PACIFICO,2023-09-06,159,158,1,0.00628930817610063
PACIFICO,2023-09-07,129,129,0,0
PACIFICO,2023-09-08,130,127,3,0.0230769230769231
PACIFICO,2023-09-09,157,156,1,0.00636942675159236
PACIFICO,2023-09-10,116,116,0,0
PACIFICO,2023-09-11,113,113,0,0
PACIFICO,2023-09-12,150,150,0,0
PACIFICO,2023-09-13,127,126,1,0.0078740157480315
PACIFICO,2023-09-14,129,126,3,0.0232558139534884
PACIFICO,2023-09-15,121,120,1,0.00826446280991736
PACIFICO,2023-09-16,127,125,2,0.015748031496063
PACIFICO,2023-09-17,99,98,1,0.0101010101010101
PACIFICO,2023-09-18,105,104,1,0.00952380952380952
PACIFICO,2023-09-19,112,111,1,0.00892857142857143
PACIFICO,2023-09-20,104,104,0,0
PACIFICO,2023-09-21,133,132,1,0.0075187969924812
PACIFICO,2023-09-22,127,126,1,0.0078740157480315
PACIFICO,2023-09-23,149,147,2,0.0134228187919463
PACIFICO,2023-09-24,111,109,2,0.018018018018018
PACIFICO,2023-09-25,122,118,4,0.0327868852459016
PACIFICO,2023-09-26,116,115,1,0.00862068965517241
PACIFICO,2023-09-27,124,123,1,0.00806451612903226
PACIFICO,2023-09-28,143,141,2,0.013986013986014
PACIFICO,2023-09-29,141,141,0,0
PACIFICO,2023-09-30,166,166,0,0
PACIFICO,2023-10-01,94,94,0,0
PACIFICO,2023-10-02,99,98,1,0.0101010101010101
PACIFICO,2023-10-03,129,126,3,0.0232558139534884
PACIFICO,2023-10-04,138,135,3,0.0217391304347826
PACIFICO,2023-10-05,124,122,2,0.0161290322580645
PACIFICO,2023-10-06,147,142,5,0.0340136054421769
PACIFICO,2023-10-07,159,152,7,0.0440251572327044
PACIFICO,2023-10-08,105,99,6,0.0571428571428571
PACIFICO,2023-10-09,119,119,0,0
PACIFICO,2023-10-10,104,101,3,0.0288461538461538
PACIFICO,2023-10-11,115,110,5,0.0434782608695652
PACIFICO,2023-10-12,104,100,4,0.0384615384615385
PACIFICO,2023-10-13,125,122,3,0.024
PACIFICO,2023-10-14,144,140,4,0.0277777777777778
PACIFICO,2023-10-15,105,104,1,0.00952380952380952
PACIFICO,2023-10-16,104,98,6,0.0576923076923077
PACIFICO,2023-10-17,115,112,3,0.0260869565217391
PACIFICO,2023-10-18,105,103,2,0.019047619047619
PACIFICO,2023-10-19,112,110,2,0.0178571428571429
PACIFICO,2023-10-20,99,96,3,0.0303030303030303
PACIFICO,2023-10-21,92,92,0,0
PACIFICO,2023-10-22,60,59,1,0.0166666666666667
PACIFICO,2023-10-23,57,54,3,0.0526315789473684
PACIFICO,2023-10-24,117,115,2,0.0170940170940171
PACIFICO,2023-10-25,104,98,6,0.0576923076923077
PACIFICO,2023-10-26,122,122,0,0
PACIFICO,2023-10-27,113,110,3,0.0265486725663717
PACIFICO,2023-10-28,123,121,2,0.016260162601626
PACIFICO,2023-10-29,78,75,3,0.0384615384615385
PACIFICO,2023-10-30,105,103,2,0.019047619047619
PACIFICO,2023-10-31,151,150,1,0.00662251655629139
PACIFICO,2023-11-01,139,139,0,0
PACIFICO,2023-11-02,132,128,4,0.0303030303030303
PACIFICO,2023-11-03,122,118,4,0.0327868852459016
PACIFICO,2023-11-04,141,140,1,0.00709219858156028
PACIFICO,2023-11-05,100,98,2,0.02
PACIFICO,2023-11-06,136,133,3,0.0220588235294118
PACIFICO,2023-11-07,159,156,3,0.0188679245283019
PACIFICO,2023-11-08,146,143,3,0.0205479452054795
PACIFICO,2023-11-09,143,138,5,0.034965034965035
PACIFICO,2023-11-10,134,131,3,0.0223880597014925
PACIFICO,2023-11-11,141,141,0,0
PACIFICO,2023-11-12,106,103,3,0.0283018867924528
PACIFICO,2023-11-13,138,133,5,0.036231884057971
PACIFICO,2023-11-14,137,135,2,0.0145985401459854
PACIFICO,2023-11-15,158,153,5,0.0316455696202532
PACIFICO,2023-11-16,165,161,4,0.0242424242424242
PACIFICO,2023-11-17,128,125,3,0.0234375
PACIFICO,2023-11-18,147,145,2,0.0136054421768707
PACIFICO,2023-11-19,98,97,1,0.0102040816326531
PACIFICO,2023-11-20,135,133,2,0.0148148148148148
PACIFICO,2023-11-21,121,117,4,0.0330578512396694
PACIFICO,2023-11-22,145,141,4,0.0275862068965517
PACIFICO,2023-11-23,151,149,2,0.0132450331125828
PACIFICO,2023-11-24,147,146,1,0.00680272108843537
PACIFICO,2023-11-25,152,148,4,0.0263157894736842
PACIFICO,2023-11-26,104,104,0,0
PACIFICO,2023-11-27,96,92,4,0.0416666666666667
PACIFICO,2023-11-28,128,123,5,0.0390625
PACIFICO,2023-11-29,155,154,1,0.00645161290322581
PACIFICO,2023-11-30,154,150,4,0.025974025974026
PACIFICO,2023-12-01,140,139,1,0.00714285714285714
PACIFICO,2023-12-02,158,155,3,0.0189873417721519
PACIFICO,2023-12-03,122,119,3,0.0245901639344262
PACIFICO,2023-12-04,120,116,4,0.0333333333333333
PACIFICO,2023-12-05,151,144,7,0.0463576158940397
PACIFICO,2023-12-06,149,143,6,0.0402684563758389
PACIFICO,2023-12-07,161,161,0,0
PACIFICO,2023-12-08,155,151,4,0.0258064516129032
PACIFICO,2023-12-09,149,148,1,0.00671140939597315
PACIFICO,2023-12-10,131,131,0,0
PACIFICO,2023-12-11,138,137,1,0.0072463768115942
PACIFICO,2023-12-12,136,133,3,0.0220588235294118
PACIFICO,2023-12-13,144,144,0,0
PACIFICO,2023-12-14,118,115,3,0.0254237288135593
PACIFICO,2023-12-15,137,134,3,0.0218978102189781
PACIFICO,2023-12-16,142,139,3,0.0211267605633803
PACIFICO,2023-12-17,108,106,2,0.0185185185185185
PACIFICO,2023-12-18,150,147,3,0.02
PACIFICO,2023-12-19,144,143,1,0.00694444444444444
PACIFICO,2023-12-20,144,142,2,0.0138888888888889
PACIFICO,2023-12-21,172,167,5,0.0290697674418605
PACIFICO,2023-12-22,121,119,2,0.0165289256198347
PACIFICO,2023-12-23,127,126,1,0.0078740157480315
PACIFICO,2023-12-24,94,94,0,0
PACIFICO,2023-12-25,18,18,0,0
PACIFICO,2023-12-26,115,114,1,0.00869565217391304
PACIFICO,2023-12-27,134,132,2,0.0149253731343284
PACIFICO,2023-12-28,130,128,2,0.0153846153846154
PACIFICO,2023-12-29,137,134,3,0.0218978102189781
PACIFICO,2023-12-30,136,134,2,0.0147058823529412
PACIFICO,2023-12-31,80,80,0,0
PACIFICO,2024-01-01,18,18,0,0
PACIFICO,2024-01-02,103,100,3,0.029126213592233
PACIFICO,2024-01-03,137,135,2,0.0145985401459854
PACIFICO,2024-01-04,145,144,1,0.00689655172413793
PACIFICO,2024-01-05,147,143,4,0.0272108843537415
PACIFICO,2024-01-06,169,163,6,0.0355029585798817
PACIFICO,2024-01-07,101,100,1,0.0099009900990099
PACIFICO,2024-01-08,146,142,4,0.0273972602739726
PACIFICO,2024-01-09,159,154,5,0.0314465408805031
PACIFICO,2024-01-10,138,136,2,0.0144927536231884
PACIFICO,2024-01-11,128,124,4,0.03125
PACIFICO,2024-01-12,151,149,2,0.0132450331125828
PACIFICO,2024-01-13,158,155,3,0.0189873417721519
PACIFICO,2024-01-14,112,108,4,0.0357142857142857
PACIFICO,2024-01-15,132,126,6,0.0454545454545455
PACIFICO,2024-01-16,168,164,4,0.0238095238095238
PACIFICO,2024-01-17,131,129,2,0.0152671755725191
PACIFICO,2024-01-18,151,146,5,0.033112582781457
PACIFICO,2024-01-19,147,141,6,0.0408163265306122
PACIFICO,2024-01-20,148,148,0,0
PACIFICO,2024-01-21,88,88,0,0
PACIFICO,2024-01-22,107,104,3,0.0280373831775701
PACIFICO,2024-01-23,141,139,2,0.0141843971631206
PACIFICO,2024-01-24,136,133,3,0.0220588235294118
PACIFICO,2024-01-25,139,137,2,0.0143884892086331
PACIFICO,2024-01-26,136,134,2,0.0147058823529412
PACIFICO,2024-01-27,127,124,3,0.0236220472440945
PACIFICO,2024-01-28,93,90,3,0.032258064516129
PACIFICO,2024-01-29,119,118,1,0.00840336134453781
PACIFICO,2024-01-30,127,125,2,0.015748031496063
PACIFICO,2024-01-31,130,127,3,0.0230769230769231
PACIFICO,2024-02-01,109,108,1,0.00917431192660551
PACIFICO,2024-02-02,132,130,2,0.0151515151515152
PACIFICO,2024-02-03,127,123,4,0.031496062992126
PACIFICO,2024-02-04,103,100,3,0.029126213592233
PACIFICO,2024-02-05,122,122,0,0
PACIFICO,2024-02-06,132,129,3,0.0227272727272727
PACIFICO,2024-02-07,144,142,2,0.0138888888888889
PACIFICO,2024-02-08,119,117,2,0.0168067226890756
PACIFICO,2024-02-09,110,107,3,0.0272727272727273
PACIFICO,2024-02-10,148,144,4,0.027027027027027
PACIFICO,2024-02-11,96,92,4,0.0416666666666667
PACIFICO,2024-02-12,111,111,0,0
PACIFICO,2024-02-13,118,114,4,0.0338983050847458
PACIFICO,2024-02-14,90,90,0,0
PACIFICO,2024-02-15,105,104,1,0.00952380952380952
PACIFICO,2024-02-16,114,110,4,0.0350877192982456
PACIFICO,2024-02-17,154,154,0,0
PACIFICO,2024-02-18,120,120,0,0
PACIFICO,2024-02-19,110,108,2,0.0181818181818182
PACIFICO,2024-02-20,151,146,5,0.033112582781457
PACIFICO,2024-02-21,119,115,4,0.0336134453781513
PACIFICO,2024-02-22,133,130,3,0.0225563909774436
PACIFICO,2024-02-23,82,71,11,0.134146341463415
PACIFICO,2024-02-24,166,163,3,0.0180722891566265
PACIFICO,2024-02-25,92,89,3,0.0326086956521739
PACIFICO,2024-02-26,123,120,3,0.024390243902439
PACIFICO,2024-02-27,128,126,2,0.015625
PACIFICO,2024-02-28,136,133,3,0.0220588235294118
PACIFICO,2024-02-29,149,147,2,0.0134228187919463
PACIFICO,2024-03-01,138,136,2,0.0144927536231884
PACIFICO,2024-03-02,145,144,1,0.00689655172413793
PACIFICO,2024-03-03,102,101,1,0.00980392156862745
PACIFICO,2024-03-04,130,129,1,0.00769230769230769
PACIFICO,2024-03-05,133,131,2,0.0150375939849624
PACIFICO,2024-03-06,153,152,1,0.0065359477124183
PACIFICO,2024-03-07,147,144,3,0.0204081632653061
PACIFICO,2024-03-08,161,158,3,0.0186335403726708
PACIFICO,2024-03-09,144,143,1,0.00694444444444444
PACIFICO,2024-03-10,98,96,2,0.0204081632653061
PACIFICO,2024-03-11,144,141,3,0.0208333333333333
SURESTE,2023-03-12,188,148,40,0.212765957446809
SURESTE,2023-03-13,191,147,44,0.230366492146597
SURESTE,2023-03-14,179,143,36,0.201117318435754
SURESTE,2023-03-15,186,159,27,0.145161290322581
SURESTE,2023-03-16,198,178,20,0.101010101010101
SURESTE,2023-03-17,269,223,46,0.171003717472119
SURESTE,2023-03-18,282,247,35,0.124113475177305
SURESTE,2023-03-19,189,163,26,0.137566137566138
SURESTE,2023-03-20,232,199,33,0.142241379310345
SURESTE,2023-03-21,243,214,29,0.119341563786008
SURESTE,2023-03-22,204,181,23,0.112745098039216
SURESTE,2023-03-23,211,191,20,0.0947867298578199
SURESTE,2023-03-24,220,203,17,0.0772727272727273
SURESTE,2023-03-25,225,207,18,0.08
SURESTE,2023-03-26,189,170,19,0.100529100529101
SURESTE,2023-03-27,176,160,16,0.0909090909090909
SURESTE,2023-03-28,200,185,15,0.075
SURESTE,2023-03-29,206,195,11,0.0533980582524272
SURESTE,2023-03-30,254,235,19,0.0748031496062992
SURESTE,2023-03-31,292,257,35,0.11986301369863
SURESTE,2023-04-01,255,232,23,0.0901960784313725
SURESTE,2023-04-02,163,151,12,0.0736196319018405
SURESTE,2023-04-03,208,197,11,0.0528846153846154
SURESTE,2023-04-04,203,177,26,0.12807881773399
SURESTE,2023-04-05,177,139,38,0.214689265536723
SURESTE,2023-04-06,180,163,17,0.0944444444444444
SURESTE,2023-04-07,187,178,9,0.0481283422459893
SURESTE,2023-04-08,160,143,17,0.10625
SURESTE,2023-04-09,109,102,7,0.0642201834862385
SURESTE,2023-04-10,172,154,18,0.104651162790698
SURESTE,2023-04-11,176,164,12,0.0681818181818182
SURESTE,2023-04-12,184,164,20,0.108695652173913
SURESTE,2023-04-13,166,158,8,0.0481927710843374
SURESTE,2023-04-14,216,208,8,0.037037037037037
SURESTE,2023-04-15,271,260,11,0.040590405904059
SURESTE,2023-04-16,274,271,3,0.0109489051094891
SURESTE,2023-04-17,240,233,7,0.0291666666666667
SURESTE,2023-04-18,197,192,5,0.0253807106598985
SURESTE,2023-04-19,209,201,8,0.0382775119617225
SURESTE,2023-04-20,214,201,13,0.0607476635514019
SURESTE,2023-04-21,207,202,5,0.0241545893719807
SURESTE,2023-04-22,229,218,11,0.0480349344978166
SURESTE,2023-04-23,198,190,8,0.0404040404040404
SURESTE,2023-04-24,242,235,7,0.0289256198347107
SURESTE,2023-04-25,275,267,8,0.0290909090909091
SURESTE,2023-04-26,243,234,9,0.037037037037037
SURESTE,2023-04-27,213,205,8,0.0375586854460094
SURESTE,2023-04-28,223,215,8,0.0358744394618834
SURESTE,2023-04-29,295,287,8,0.0271186440677966
SURESTE,2023-04-30,216,206,10,0.0462962962962963
SURESTE,2023-05-01,223,214,9,0.0403587443946188
SURESTE,2023-05-02,194,188,6,0.0309278350515464
SURESTE,2023-05-03,169,163,6,0.0355029585798817
SURESTE,2023-05-04,135,129,6,0.0444444444444444
SURESTE,2023-05-05,194,189,5,0.0257731958762887
SURESTE,2023-05-06,210,206,4,0.019047619047619
SURESTE,2023-05-07,157,151,6,0.0382165605095541
SURESTE,2023-05-08,163,158,5,0.0306748466257669
SURESTE,2023-05-09,171,168,3,0.0175438596491228
SURESTE,2023-05-10,151,140,11,0.0728476821192053
SURESTE,2023-05-11,158,147,11,0.069620253164557
SURESTE,2023-05-12,200,196,4,0.02
SURESTE,2023-05-13,275,268,7,0.0254545454545455
SURESTE,2023-05-14,230,221,9,0.0391304347826087
SURESTE,2023-05-15,240,235,5,0.0208333333333333
SURESTE,2023-05-16,287,274,13,0.0452961672473868
SURESTE,2023-05-17,216,206,10,0.0462962962962963
SURESTE,2023-05-18,183,174,9,0.0491803278688525
SURESTE,2023-05-19,189,183,6,0.0317460317460317
SURESTE,2023-05-20,253,249,4,0.0158102766798419
SURESTE,2023-05-21,225,218,7,0.0311111111111111
SURESTE,2023-05-22,198,188,10,0.0505050505050505
SURESTE,2023-05-23,203,194,9,0.0443349753694581
SURESTE,2023-05-24,202,196,6,0.0297029702970297
SURESTE,2023-05-25,187,177,10,0.053475935828877
SURESTE,2023-05-26,205,198,7,0.0341463414634146
SURESTE,2023-05-27,237,233,4,0.0168776371308017
SURESTE,2023-05-28,155,154,1,0.00645161290322581
SURESTE,2023-05-29,204,196,8,0.0392156862745098
SURESTE,2023-05-30,237,234,3,0.0126582278481013
SURESTE,2023-05-31,216,207,9,0.0416666666666667
SURESTE,2023-06-01,199,190,9,0.0452261306532663
SURESTE,2023-06-02,198,192,6,0.0303030303030303
SURESTE,2023-06-03,206,203,3,0.0145631067961165
SURESTE,2023-06-04,207,200,7,0.0338164251207729
SURESTE,2023-06-05,193,190,3,0.0155440414507772
SURESTE,2023-06-06,182,172,10,0.0549450549450549
SURESTE,2023-06-07,166,154,12,0.072289156626506
SURESTE,2023-06-08,183,181,2,0.0109289617486339
SURESTE,2023-06-09,180,173,7,0.0388888888888889
SURESTE,2023-06-10,221,208,13,0.0588235294117647
SURESTE,2023-06-11,217,210,7,0.032258064516129
SURESTE,2023-06-12,170,165,5,0.0294117647058824
SURESTE,2023-06-13,156,154,2,0.0128205128205128
SURESTE,2023-06-14,186,181,5,0.0268817204301075
SURESTE,2023-06-15,193,189,4,0.0207253886010363
SURESTE,2023-06-16,177,173,4,0.0225988700564972
SURESTE,2023-06-17,257,250,7,0.0272373540856031
SURESTE,2023-06-18,218,213,5,0.0229357798165138
SURESTE,2023-06-19,203,198,5,0.0246305418719212
SURESTE,2023-06-20,209,201,8,0.0382775119617225
SURESTE,2023-06-21,212,202,10,0.0471698113207547
SURESTE,2023-06-22,184,174,10,0.0543478260869565
SURESTE,2023-06-23,159,151,8,0.050314465408805
SURESTE,2023-06-24,182,180,2,0.010989010989011
SURESTE,2023-06-25,196,190,6,0.0306122448979592
SURESTE,2023-06-26,203,199,4,0.0197044334975369
SURESTE,2023-06-27,193,186,7,0.0362694300518135
SURESTE,2023-06-28,194,189,5,0.0257731958762887
SURESTE,2023-06-29,207,203,4,0.0193236714975845
SURESTE,2023-06-30,124,112,12,0.0967741935483871
SURESTE,2023-07-01,231,224,7,0.0303030303030303
SURESTE,2023-07-02,204,204,0,0
SURESTE,2023-07-03,206,199,7,0.0339805825242718
SURESTE,2023-07-04,187,183,4,0.0213903743315508
SURESTE,2023-07-05,174,169,5,0.028735632183908
SURESTE,2023-07-06,167,163,4,0.0239520958083832
SURESTE,2023-07-07,228,221,7,0.0307017543859649
SURESTE,2023-07-08,242,236,6,0.0247933884297521
SURESTE,2023-07-09,208,204,4,0.0192307692307692
SURESTE,2023-07-10,270,262,8,0.0296296296296296
SURESTE,2023-07-11,221,218,3,0.0135746606334842
SURESTE,2023-07-12,210,205,5,0.0238095238095238
SURESTE,2023-07-13,198,192,6,0.0303030303030303
SURESTE,2023-07-14,199,195,4,0.0201005025125628
SURESTE,2023-07-15,222,218,4,0.018018018018018
SURESTE,2023-07-16,207,205,2,0.00966183574879227
SURESTE,2023-07-17,222,217,5,0.0225225225225225
SURESTE,2023-07-18,196,192,4,0.0204081632653061
SURESTE,2023-07-19,172,167,5,0.0290697674418605
SURESTE,2023-07-20,235,229,6,0.025531914893617
SURESTE,2023-07-21,189,183,6,0.0317460317460317
SURESTE,2023-07-22,228,226,2,0.0087719298245614
SURESTE,2023-07-23,200,198,2,0.01
SURESTE,2023-07-24,207,206,1,0.00483091787439614
SURESTE,2023-07-25,216,208,8,0.037037037037037
SURESTE,2023-07-26,209,203,6,0.0287081339712919
SURESTE,2023-07-27,181,176,5,0.0276243093922652
SURESTE,2023-07-28,201,197,4,0.0199004975124378
SURESTE,2023-07-29,264,262,2,0.00757575757575758
SURESTE,2023-07-30,217,216,1,0.00460829493087558
SURESTE,2023-07-31,271,267,4,0.014760147601476
SURESTE,2023-08-01,213,206,7,0.0328638497652582
SURESTE,2023-08-02,214,211,3,0.014018691588785
SURESTE,2023-08-03,181,159,22,0.121546961325967
SURESTE,2023-08-04,191,186,5,0.0261780104712042
SURESTE,2023-08-05,201,190,11,0.054726368159204
SURESTE,2023-08-06,202,200,2,0.0099009900990099
SURESTE,2023-08-07,200,192,8,0.04
SURESTE,2023-08-08,181,175,6,0.0331491712707182
SURESTE,2023-08-09,205,202,3,0.0146341463414634
SURESTE,2023-08-10,198,194,4,0.0202020202020202
SURESTE,2023-08-11,178,165,13,0.0730337078651685
SURESTE,2023-08-12,201,193,8,0.0398009950248756
SURESTE,2023-08-13,217,210,7,0.032258064516129
SURESTE,2023-08-14,187,180,7,0.0374331550802139
SURESTE,2023-08-15,198,195,3,0.0151515151515152
SURESTE,2023-08-16,209,203,6,0.0287081339712919
SURESTE,2023-08-17,195,185,10,0.0512820512820513
SURESTE,2023-08-18,252,245,7,0.0277777777777778
SURESTE,2023-08-19,236,228,8,0.0338983050847458
SURESTE,2023-08-20,211,204,7,0.033175355450237
SURESTE,2023-08-21,199,199,0,0
SURESTE,2023-08-22,178,175,3,0.0168539325842697
SURESTE,2023-08-23,178,177,1,0.00561797752808989
SURESTE,2023-08-24,219,218,1,0.0045662100456621
SURESTE,2023-08-25,209,206,3,0.0143540669856459
SURESTE,2023-08-26,241,238,3,0.012448132780083
SURESTE,2023-08-27,199,199,0,0
SURESTE,2023-08-28,209,204,5,0.0239234449760766
SURESTE,2023-08-29,207,206,1,0.00483091787439614
SURESTE,2023-08-30,198,197,1,0.00505050505050505
SURESTE,2023-08-31,200,199,1,0.005
SURESTE,2023-09-01,191,191,0,0
SURESTE,2023-09-02,203,201,2,0.00985221674876847
SURESTE,2023-09-03,176,175,1,0.00568181818181818
SURESTE,2023-09-04,162,161,1,0.00617283950617284
SURESTE,2023-09-05,223,222,1,0.00448430493273543
SURESTE,2023-09-06,202,201,1,0.00495049504950495
SURESTE,2023-09-07,228,227,1,0.0043859649122807
SURESTE,2023-09-08,220,220,0,0
SURESTE,2023-09-09,225,224,1,0.00444444444444444
SURESTE,2023-09-10,180,180,0,0
SURESTE,2023-09-11,202,200,2,0.0099009900990099
SURESTE,2023-09-12,234,233,1,0.00427350427350427
SURESTE,2023-09-13,211,209,2,0.00947867298578199
SURESTE,2023-09-14,204,202,2,0.00980392156862745
SURESTE,2023-09-15,222,220,2,0.00900900900900901
SURESTE,2023-09-16,207,206,1,0.00483091787439614
SURESTE,2023-09-17,169,168,1,0.00591715976331361
SURESTE,2023-09-18,189,189,0,0
SURESTE,2023-09-19,189,188,1,0.00529100529100529
SURESTE,2023-09-20,182,179,3,0.0164835164835165
SURESTE,2023-09-21,187,186,1,0.0053475935828877
SURESTE,2023-09-22,196,195,1,0.00510204081632653
SURESTE,2023-09-23,224,222,2,0.00892857142857143
SURESTE,2023-09-24,180,178,2,0.0111111111111111
SURESTE,2023-09-25,192,190,2,0.0104166666666667
SURESTE,2023-09-26,205,204,1,0.0048780487804878
SURESTE,2023-09-27,212,212,0,0
SURESTE,2023-09-28,188,186,2,0.0106382978723404
SURESTE,2023-09-29,238,237,1,0.00420168067226891
SURESTE,2023-09-30,249,248,1,0.00401606425702811
SURESTE,2023-10-01,196,196,0,0
SURESTE,2023-10-02,198,198,0,0
SURESTE,2023-10-03,195,192,3,0.0153846153846154
SURESTE,2023-10-04,167,164,3,0.0179640718562874
SURESTE,2023-10-05,176,172,4,0.0227272727272727
SURESTE,2023-10-06,187,182,5,0.0267379679144385
SURESTE,2023-10-07,199,196,3,0.0150753768844221
SURESTE,2023-10-08,156,152,4,0.0256410256410256
SURESTE,2023-10-09,162,158,4,0.0246913580246914
SURESTE,2023-10-10,155,149,6,0.0387096774193548
SURESTE,2023-10-11,176,169,7,0.0397727272727273
SURESTE,2023-10-12,144,142,2,0.0138888888888889
SURESTE,2023-10-13,180,179,1,0.00555555555555556
SURESTE,2023-10-14,189,189,0,0
SURESTE,2023-10-15,174,170,4,0.0229885057471264
SURESTE,2023-10-16,179,177,2,0.0111731843575419
SURESTE,2023-10-17,189,182,7,0.037037037037037
SURESTE,2023-10-18,214,207,7,0.0327102803738318
SURESTE,2023-10-19,193,188,5,0.0259067357512953
SURESTE,2023-10-20,197,193,4,0.0203045685279188
SURESTE,2023-10-21,212,207,5,0.0235849056603774
SURESTE,2023-10-22,160,151,9,0.05625
SURESTE,2023-10-23,144,140,4,0.0277777777777778
SURESTE,2023-10-24,174,168,6,0.0344827586206897
SURESTE,2023-10-25,181,177,4,0.0220994475138122
SURESTE,2023-10-26,189,183,6,0.0317460317460317
SURESTE,2023-10-27,195,189,6,0.0307692307692308
SURESTE,2023-10-28,214,213,1,0.00467289719626168
SURESTE,2023-10-29,146,142,4,0.0273972602739726
SURESTE,2023-10-30,209,202,7,0.0334928229665072
SURESTE,2023-10-31,211,207,4,0.018957345971564
SURESTE,2023-11-01,202,199,3,0.0148514851485149
SURESTE,2023-11-02,184,181,3,0.016304347826087
SURESTE,2023-11-03,197,192,5,0.0253807106598985
SURESTE,2023-11-04,185,178,7,0.0378378378378378
SURESTE,2023-11-05,174,171,3,0.0172413793103448
SURESTE,2023-11-06,200,193,7,0.035
SURESTE,2023-11-07,211,209,2,0.00947867298578199
SURESTE,2023-11-08,229,220,9,0.0393013100436681
SURESTE,2023-11-09,217,214,3,0.0138248847926267
SURESTE,2023-11-10,190,187,3,0.0157894736842105
SURESTE,2023-11-11,223,220,3,0.0134529147982063
SURESTE,2023-11-12,218,215,3,0.0137614678899083
SURESTE,2023-11-13,203,195,8,0.0394088669950739
SURESTE,2023-11-14,229,223,6,0.0262008733624454
SURESTE,2023-11-15,275,260,15,0.0545454545454545
SURESTE,2023-11-16,240,233,7,0.0291666666666667
SURESTE,2023-11-17,232,224,8,0.0344827586206897
SURESTE,2023-11-18,285,279,6,0.0210526315789474
SURESTE,2023-11-19,246,238,8,0.032520325203252
SURESTE,2023-11-20,256,254,2,0.0078125
SURESTE,2023-11-21,234,229,5,0.0213675213675214
SURESTE,2023-11-22,212,206,6,0.0283018867924528
SURESTE,2023-11-23,228,225,3,0.0131578947368421
SURESTE,2023-11-24,201,196,5,0.0248756218905473
SURESTE,2023-11-25,237,230,7,0.029535864978903
SURESTE,2023-11-26,209,205,4,0.0191387559808612
SURESTE,2023-11-27,242,236,6,0.0247933884297521
SURESTE,2023-11-28,242,237,5,0.0206611570247934
SURESTE,2023-11-29,247,239,8,0.0323886639676113
SURESTE,2023-11-30,263,255,8,0.0304182509505703
SURESTE,2023-12-01,223,212,11,0.0493273542600897
SURESTE,2023-12-02,238,233,5,0.0210084033613445
SURESTE,2023-12-03,164,160,4,0.024390243902439
SURESTE,2023-12-04,180,179,1,0.00555555555555556
SURESTE,2023-12-05,199,192,7,0.0351758793969849
SURESTE,2023-12-06,209,204,5,0.0239234449760766
SURESTE,2023-12-07,227,222,5,0.0220264317180617
SURESTE,2023-12-08,232,224,8,0.0344827586206897
SURESTE,2023-12-09,248,242,6,0.0241935483870968
SURESTE,2023-12-10,195,188,7,0.0358974358974359
SURESTE,2023-12-11,196,191,5,0.0255102040816327
SURESTE,2023-12-12,198,191,7,0.0353535353535354
SURESTE,2023-12-13,197,194,3,0.0152284263959391
SURESTE,2023-12-14,213,205,8,0.0375586854460094
SURESTE,2023-12-15,177,174,3,0.0169491525423729
SURESTE,2023-12-16,212,210,2,0.00943396226415094
SURESTE,2023-12-17,199,197,2,0.0100502512562814
SURESTE,2023-12-18,210,202,8,0.0380952380952381
SURESTE,2023-12-19,240,238,2,0.00833333333333333
SURESTE,2023-12-20,210,203,7,0.0333333333333333
SURESTE,2023-12-21,224,218,6,0.0267857142857143
SURESTE,2023-12-22,202,200,2,0.0099009900990099
SURESTE,2023-12-23,246,240,6,0.024390243902439
SURESTE,2023-12-24,176,172,4,0.0227272727272727
SURESTE,2023-12-25,60,60,0,0
SURESTE,2023-12-26,203,200,3,0.0147783251231527
SURESTE,2023-12-27,250,244,6,0.024
SURESTE,2023-12-28,252,248,4,0.0158730158730159
SURESTE,2023-12-29,225,222,3,0.0133333333333333
SURESTE,2023-12-30,262,259,3,0.0114503816793893
SURESTE,2023-12-31,110,108,2,0.0181818181818182
SURESTE,2024-01-01,42,41,1,0.0238095238095238
SURESTE,2024-01-02,174,172,2,0.0114942528735632
SURESTE,2024-01-03,231,228,3,0.012987012987013
SURESTE,2024-01-04,219,214,5,0.0228310502283105
SURESTE,2024-01-05,214,210,4,0.0186915887850467
SURESTE,2024-01-06,242,237,5,0.0206611570247934
SURESTE,2024-01-07,170,166,4,0.0235294117647059
SURESTE,2024-01-08,220,214,6,0.0272727272727273
SURESTE,2024-01-09,208,205,3,0.0144230769230769
SURESTE,2024-01-10,209,208,1,0.00478468899521531
SURESTE,2024-01-11,229,224,5,0.0218340611353712
SURESTE,2024-01-12,217,213,4,0.0184331797235023
SURESTE,2024-01-13,241,236,5,0.020746887966805
SURESTE,2024-01-14,214,209,5,0.0233644859813084
SURESTE,2024-01-15,238,229,9,0.0378151260504202
SURESTE,2024-01-16,226,222,4,0.0176991150442478
SURESTE,2024-01-17,200,198,2,0.01
SURESTE,2024-01-18,192,190,2,0.0104166666666667
SURESTE,2024-01-19,235,230,5,0.0212765957446809
SURESTE,2024-01-20,219,216,3,0.0136986301369863
SURESTE,2024-01-21,176,171,5,0.0284090909090909
SURESTE,2024-01-22,184,183,1,0.00543478260869565
SURESTE,2024-01-23,226,218,8,0.0353982300884956
SURESTE,2024-01-24,268,256,12,0.0447761194029851
SURESTE,2024-01-25,215,210,5,0.0232558139534884
SURESTE,2024-01-26,235,230,5,0.0212765957446809
SURESTE,2024-01-27,233,226,7,0.0300429184549356
SURESTE,2024-01-28,193,188,5,0.0259067357512953
SURESTE,2024-01-29,186,180,6,0.032258064516129
SURESTE,2024-01-30,177,168,9,0.0508474576271186
SURESTE,2024-01-31,212,204,8,0.0377358490566038
SURESTE,2024-02-01,220,217,3,0.0136363636363636
SURESTE,2024-02-02,200,192,8,0.04
SURESTE,2024-02-03,242,232,10,0.0413223140495868
SURESTE,2024-02-04,186,182,4,0.021505376344086
SURESTE,2024-02-05,173,168,5,0.0289017341040462
SURESTE,2024-02-06,202,200,2,0.0099009900990099
SURESTE,2024-02-07,206,204,2,0.00970873786407767
SURESTE,2024-02-08,204,199,5,0.0245098039215686
SURESTE,2024-02-09,220,215,5,0.0227272727272727
SURESTE,2024-02-10,188,182,6,0.0319148936170213
SURESTE,2024-02-11,157,154,3,0.0191082802547771
SURESTE,2024-02-12,162,158,4,0.0246913580246914
SURESTE,2024-02-13,220,217,3,0.0136363636363636
SURESTE,2024-02-14,191,182,9,0.0471204188481675
SURESTE,2024-02-15,226,221,5,0.0221238938053097
SURESTE,2024-02-16,208,205,3,0.0144230769230769
SURESTE,2024-02-17,207,204,3,0.0144927536231884
SURESTE,2024-02-18,161,158,3,0.0186335403726708
SURESTE,2024-02-19,205,199,6,0.0292682926829268
SURESTE,2024-02-20,199,195,4,0.0201005025125628
SURESTE,2024-02-21,231,227,4,0.0173160173160173
SURESTE,2024-02-22,203,196,7,0.0344827586206897
SURESTE,2024-02-23,155,135,20,0.129032258064516
SURESTE,2024-02-24,258,248,10,0.0387596899224806
SURESTE,2024-02-25,185,183,2,0.0108108108108108
SURESTE,2024-02-26,220,211,9,0.0409090909090909
SURESTE,2024-02-27,223,216,7,0.031390134529148
SURESTE,2024-02-28,217,212,5,0.0230414746543779
SURESTE,2024-02-29,219,211,8,0.0365296803652968
SURESTE,2024-03-01,227,222,5,0.0220264317180617
SURESTE,2024-03-02,250,244,6,0.024
SURESTE,2024-03-03,176,169,7,0.0397727272727273
SURESTE,2024-03-04,201,197,4,0.0199004975124378
SURESTE,2024-03-05,188,182,6,0.0319148936170213
SURESTE,2024-03-06,182,175,7,0.0384615384615385
SURESTE,2024-03-07,189,182,7,0.037037037037037
SURESTE,2024-03-08,208,199,9,0.0432692307692308
SURESTE,2024-03-09,215,209,6,0.027906976744186
SURESTE,2024-03-10,166,165,1,0.00602409638554217
SURESTE,2024-03-11,194,185,9,0.0463917525773196