REGION,Fecha,Instalaciones,Activaciones_automaticas,Activaciones_manuales,PorcAM
BAJIO,2023-01-02,49,33,16,0.326530612244898
BAJIO,2023-01-03,47,37,10,0.212765957446809
BAJIO,2023-01-04,40,33,7,0.175
BAJIO,2023-01-05,42,33,9,0.214285714285714
BAJIO,2023-01-06,50,40,10,0.2
BAJIO,2023-01-07,48,35,13,0.270833333333333
BAJIO,2023-01-08,28,19,9,0.321428571428571
BAJIO,2023-01-09,52,39,13,0.25
BAJIO,2023-01-10,58,40,18,0.310344827586207
BAJIO,2023-01-11,61,40,21,0.344262295081967
BAJIO,2023-01-12,55,40,15,0.272727272727273
BAJIO,2023-01-13,43,33,10,0.232558139534884
BAJIO,2023-01-14,52,38,14,0.269230769230769
BAJIO,2023-01-15,44,38,6,0.136363636363636
BAJIO,2023-01-16,26,22,4,0.153846153846154
BAJIO,2023-01-17,54,40,14,0.259259259259259
BAJIO,2023-01-18,47,37,10,0.212765957446809
BAJIO,2023-01-19,46,34,12,0.260869565217391
BAJIO,2023-01-20,52,37,15,0.288461538461538
BAJIO,2023-01-21,43,32,11,0.255813953488372
BAJIO,2023-01-22,42,32,10,0.238095238095238
BAJIO,2023-01-23,46,35,11,0.239130434782609
BAJIO,2023-01-24,52,41,11,0.211538461538462
BAJIO,2023-01-25,47,40,7,0.148936170212766
BAJIO,2023-01-26,50,36,14,0.28
BAJIO,2023-01-27,62,46,16,0.258064516129032
BAJIO,2023-01-28,72,60,12,0.166666666666667
BAJIO,2023-01-29,35,26,9,0.257142857142857
BAJIO,2023-01-30,72,56,16,0.222222222222222
BAJIO,2023-01-31,67,53,14,0.208955223880597
BAJIO,2023-02-01,37,30,7,0.189189189189189
BAJIO,2023-02-02,47,30,17,0.361702127659574
BAJIO,2023-02-03,58,44,14,0.241379310344828
BAJIO,2023-02-04,67,58,9,0.134328358208955
BAJIO,2023-02-05,19,17,2,0.105263157894737
BAJIO,2023-02-06,57,49,8,0.140350877192982
BAJIO,2023-02-07,49,41,8,0.163265306122449
BAJIO,2023-02-08,48,39,9,0.1875
BAJIO,2023-02-09,43,38,5,0.116279069767442
BAJIO,2023-02-10,52,39,13,0.25
BAJIO,2023-02-11,55,44,11,0.2
BAJIO,2023-02-12,27,19,8,0.296296296296296
BAJIO,2023-02-13,44,33,11,0.25
BAJIO,2023-02-14,27,16,11,0.407407407407407
BAJIO,2023-02-15,56,29,27,0.482142857142857
BAJIO,2023-02-16,46,29,17,0.369565217391304
BAJIO,2023-02-17,44,19,25,0.568181818181818
BAJIO,2023-02-18,54,34,20,0.37037037037037
BAJIO,2023-02-19,26,13,13,0.5
BAJIO,2023-02-20,48,32,16,0.333333333333333
BAJIO,2023-02-21,56,34,22,0.392857142857143
BAJIO,2023-02-22,45,32,13,0.288888888888889
BAJIO,2023-02-23,47,29,18,0.382978723404255
BAJIO,2023-02-24,51,32,19,0.372549019607843
BAJIO,2023-02-25,67,45,22,0.328358208955224
BAJIO,2023-02-26,28,15,13,0.464285714285714
BAJIO,2023-02-27,60,37,23,0.383333333333333
BAJIO,2023-02-28,65,44,21,0.323076923076923
BAJIO,2023-03-01,44,26,18,0.409090909090909
BAJIO,2023-03-02,56,31,25,0.446428571428571
BAJIO,2023-03-03,49,22,27,0.551020408163265
BAJIO,2023-03-04,56,31,25,0.446428571428571
BAJIO,2023-03-05,25,22,3,0.12
BAJIO,2023-03-06,41,26,15,0.365853658536585
BAJIO,2023-03-07,55,42,13,0.236363636363636
BAJIO,2023-03-08,46,39,7,0.152173913043478
BAJIO,2023-03-09,48,42,6,0.125
BAJIO,2023-03-10,45,41,4,0.0888888888888889
BAJIO,2023-03-11,55,48,7,0.127272727272727
BAJIO,2023-03-12,35,34,1,0.0285714285714286
BAJIO,2023-03-13,45,42,3,0.0666666666666667
BAJIO,2023-03-14,37,33,4,0.108108108108108
BAJIO,2023-03-15,44,44,0,0
BAJIO,2023-03-16,50,48,2,0.04
BAJIO,2023-03-17,81,75,6,0.0740740740740741
BAJIO,2023-03-18,87,81,6,0.0689655172413793
BAJIO,2023-03-19,35,34,1,0.0285714285714286
BAJIO,2023-03-20,59,55,4,0.0677966101694915
BAJIO,2023-03-21,69,67,2,0.0289855072463768
BAJIO,2023-03-22,62,61,1,0.0161290322580645
BAJIO,2023-03-23,49,48,1,0.0204081632653061
BAJIO,2023-03-24,53,50,3,0.0566037735849057
BAJIO,2023-03-25,68,67,1,0.0147058823529412
BAJIO,2023-03-26,36,36,0,0
BAJIO,2023-03-27,43,40,3,0.0697674418604651
BAJIO,2023-03-28,47,46,1,0.0212765957446809
BAJIO,2023-03-29,64,62,2,0.03125
BAJIO,2023-03-30,55,51,4,0.0727272727272727
BAJIO,2023-03-31,88,81,7,0.0795454545454545
BAJIO,2023-04-01,62,60,2,0.032258064516129
BAJIO,2023-04-02,40,40,0,0
BAJIO,2023-04-03,49,48,1,0.0204081632653061
BAJIO,2023-04-04,53,49,4,0.0754716981132075
BAJIO,2023-04-05,45,37,8,0.177777777777778
BAJIO,2023-04-06,58,49,9,0.155172413793103
BAJIO,2023-04-07,43,41,2,0.0465116279069767
BAJIO,2023-04-08,42,42,0,0
BAJIO,2023-04-09,28,26,2,0.0714285714285714
BAJIO,2023-04-10,47,47,0,0
BAJIO,2023-04-11,50,46,4,0.08
BAJIO,2023-04-12,46,43,3,0.0652173913043478
BAJIO,2023-04-13,50,47,3,0.06
BAJIO,2023-04-14,40,39,1,0.025
BAJIO,2023-04-15,95,84,11,0.115789473684211
BAJIO,2023-04-16,55,54,1,0.0181818181818182
BAJIO,2023-04-17,64,60,4,0.0625
BAJIO,2023-04-18,62,56,6,0.0967741935483871
BAJIO,2023-04-19,45,40,5,0.111111111111111
BAJIO,2023-04-20,55,49,6,0.109090909090909
BAJIO,2023-04-21,50,46,4,0.08
BAJIO,2023-04-22,56,53,3,0.0535714285714286
BAJIO,2023-04-23,47,43,4,0.0851063829787234
BAJIO,2023-04-24,56,51,5,0.0892857142857143
BAJIO,2023-04-25,72,66,6,0.0833333333333333
BAJIO,2023-04-26,48,44,4,0.0833333333333333
BAJIO,2023-04-27,63,59,4,0.0634920634920635
BAJIO,2023-04-28,65,59,6,0.0923076923076923
BAJIO,2023-04-29,101,91,10,0.099009900990099
BAJIO,2023-04-30,38,34,4,0.105263157894737
BAJIO,2023-05-01,57,52,5,0.087719298245614
BAJIO,2023-05-02,45,44,1,0.0222222222222222
BAJIO,2023-05-03,48,44,4,0.0833333333333333
BAJIO,2023-05-04,46,39,7,0.152173913043478
BAJIO,2023-05-05,60,53,7,0.116666666666667
BAJIO,2023-05-06,64,59,5,0.078125
BAJIO,2023-05-07,38,31,7,0.184210526315789
BAJIO,2023-05-08,53,50,3,0.0566037735849057
BAJIO,2023-05-09,41,40,1,0.024390243902439
BAJIO,2023-05-10,34,30,4,0.117647058823529
BAJIO,2023-05-11,49,44,5,0.102040816326531
BAJIO,2023-05-12,34,30,4,0.117647058823529
BAJIO,2023-05-13,66,56,10,0.151515151515152
BAJIO,2023-05-14,65,63,2,0.0307692307692308
BAJIO,2023-05-15,97,91,6,0.0618556701030928
BAJIO,2023-05-16,83,79,4,0.0481927710843374
BAJIO,2023-05-17,55,48,7,0.127272727272727
BAJIO,2023-05-18,51,46,5,0.0980392156862745
BAJIO,2023-05-19,43,36,7,0.162790697674419
BAJIO,2023-05-20,68,61,7,0.102941176470588
BAJIO,2023-05-21,50,45,5,0.1
BAJIO,2023-05-22,47,42,5,0.106382978723404
BAJIO,2023-05-23,51,47,4,0.0784313725490196
BAJIO,2023-05-24,57,46,11,0.192982456140351
BAJIO,2023-05-25,53,47,6,0.113207547169811
BAJIO,2023-05-26,88,79,9,0.102272727272727
BAJIO,2023-05-27,95,90,5,0.0526315789473684
BAJIO,2023-05-28,70,64,6,0.0857142857142857
BAJIO,2023-05-29,74,66,8,0.108108108108108
BAJIO,2023-05-30,81,76,5,0.0617283950617284
BAJIO,2023-05-31,94,91,3,0.0319148936170213
BAJIO,2023-06-01,122,119,3,0.0245901639344262
BAJIO,2023-06-02,131,123,8,0.0610687022900763
BAJIO,2023-06-03,147,129,18,0.122448979591837
BAJIO,2023-06-04,126,106,20,0.158730158730159
BAJIO,2023-06-05,52,46,6,0.115384615384615
BAJIO,2023-06-06,66,60,6,0.0909090909090909
BAJIO,2023-06-07,49,44,5,0.102040816326531
BAJIO,2023-06-08,59,57,2,0.0338983050847458
BAJIO,2023-06-09,77,74,3,0.038961038961039
BAJIO,2023-06-10,81,79,2,0.0246913580246914
BAJIO,2023-06-11,66,60,6,0.0909090909090909
BAJIO,2023-06-12,56,51,5,0.0892857142857143
BAJIO,2023-06-13,70,68,2,0.0285714285714286
BAJIO,2023-06-14,61,56,5,0.0819672131147541
BAJIO,2023-06-15,73,66,7,0.0958904109589041
BAJIO,2023-06-16,80,76,4,0.05
BAJIO,2023-06-17,92,88,4,0.0434782608695652
BAJIO,2023-06-18,53,50,3,0.0566037735849057
BAJIO,2023-06-19,70,65,5,0.0714285714285714
BAJIO,2023-06-20,75,70,5,0.0666666666666667
BAJIO,2023-06-21,82,78,4,0.0487804878048781
BAJIO,2023-06-22,58,57,1,0.0172413793103448
BAJIO,2023-06-23,62,57,5,0.0806451612903226
BAJIO,2023-06-24,65,60,5,0.0769230769230769
BAJIO,2023-06-25,48,46,2,0.0416666666666667
BAJIO,2023-06-26,55,49,6,0.109090909090909
BAJIO,2023-06-27,66,63,3,0.0454545454545455
BAJIO,2023-06-28,54,48,6,0.111111111111111
BAJIO,2023-06-29,79,74,5,0.0632911392405063
BAJIO,2023-06-30,53,45,8,0.150943396226415
BAJIO,2023-07-01,85,76,9,0.105882352941176
BAJIO,2023-07-02,67,64,3,0.0447761194029851
BAJIO,2023-07-03,62,60,2,0.032258064516129
BAJIO,2023-07-04,138,133,5,0.036231884057971
BAJIO,2023-07-05,122,117,5,0.040983606557377
BAJIO,2023-07-06,96,92,4,0.0416666666666667
BAJIO,2023-07-07,163,163,0,0
BAJIO,2023-07-08,204,202,2,0.00980392156862745
BAJIO,2023-07-09,133,127,6,0.0451127819548872
BAJIO,2023-07-10,155,150,5,0.032258064516129
BAJIO,2023-07-11,139,133,6,0.0431654676258993
BAJIO,2023-07-12,128,126,2,0.015625
BAJIO,2023-07-13,118,113,5,0.0423728813559322
BAJIO,2023-07-14,130,128,2,0.0153846153846154
BAJIO,2023-07-15,254,248,6,0.0236220472440945
BAJIO,2023-07-16,108,102,6,0.0555555555555556
BAJIO,2023-07-17,136,133,3,0.0220588235294118
BAJIO,2023-07-18,147,143,4,0.0272108843537415
BAJIO,2023-07-19,188,184,4,0.0212765957446809
BAJIO,2023-07-20,183,176,7,0.0382513661202186
BAJIO,2023-07-21,183,181,2,0.0109289617486339
BAJIO,2023-07-22,198,192,6,0.0303030303030303
BAJIO,2023-07-23,128,126,2,0.015625
BAJIO,2023-07-24,153,149,4,0.0261437908496732
BAJIO,2023-07-25,179,173,6,0.0335195530726257
BAJIO,2023-07-26,150,147,3,0.02
BAJIO,2023-07-27,160,158,2,0.0125
BAJIO,2023-07-28,170,165,5,0.0294117647058824
BAJIO,2023-07-29,248,244,4,0.0161290322580645
BAJIO,2023-07-30,122,118,4,0.0327868852459016
BAJIO,2023-07-31,186,180,6,0.032258064516129
BAJIO,2023-08-01,174,171,3,0.0172413793103448
BAJIO,2023-08-02,151,150,1,0.00662251655629139
BAJIO,2023-08-03,173,154,19,0.109826589595376
BAJIO,2023-08-04,134,132,2,0.0149253731343284
BAJIO,2023-08-05,174,171,3,0.0172413793103448
BAJIO,2023-08-06,126,123,3,0.0238095238095238
BAJIO,2023-08-07,130,128,2,0.0153846153846154
BAJIO,2023-08-08,149,148,1,0.00671140939597315
BAJIO,2023-08-09,163,160,3,0.0184049079754601
BAJIO,2023-08-10,183,177,6,0.0327868852459016
BAJIO,2023-08-11,184,182,2,0.0108695652173913
BAJIO,2023-08-12,199,194,5,0.0251256281407035
BAJIO,2023-08-13,121,116,5,0.0413223140495868
BAJIO,2023-08-14,134,130,4,0.0298507462686567
BAJIO,2023-08-15,206,199,7,0.0339805825242718
BAJIO,2023-08-16,190,186,4,0.0210526315789474
BAJIO,2023-08-17,161,157,4,0.0248447204968944
BAJIO,2023-08-18,180,174,6,0.0333333333333333
BAJIO,2023-08-19,192,189,3,0.015625
BAJIO,2023-08-20,129,124,5,0.0387596899224806
BAJIO,2023-08-21,139,135,4,0.0287769784172662
BAJIO,2023-08-22,162,157,5,0.0308641975308642
BAJIO,2023-08-23,162,158,4,0.0246913580246914
BAJIO,2023-08-24,152,152,0,0
BAJIO,2023-08-25,197,196,1,0.0050761421319797
BAJIO,2023-08-26,226,222,4,0.0176991150442478
BAJIO,2023-08-27,146,146,0,0
BAJIO,2023-08-28,151,151,0,0
BAJIO,2023-08-29,203,201,2,0.00985221674876847
BAJIO,2023-08-30,166,163,3,0.0180722891566265
BAJIO,2023-08-31,172,168,4,0.0232558139534884
BAJIO,2023-09-01,167,164,3,0.0179640718562874
BAJIO,2023-09-02,158,158,0,0
BAJIO,2023-09-03,115,114,1,0.00869565217391304
BAJIO,2023-09-04,123,123,0,0
BAJIO,2023-09-05,163,161,2,0.0122699386503067
BAJIO,2023-09-06,139,136,3,0.0215827338129496
BAJIO,2023-09-07,155,154,1,0.00645161290322581
BAJIO,2023-09-08,160,158,2,0.0125
BAJIO,2023-09-09,187,187,0,0
BAJIO,2023-09-10,129,126,3,0.0232558139534884
BAJIO,2023-09-11,150,148,2,0.0133333333333333
BAJIO,2023-09-12,176,174,2,0.0113636363636364
BAJIO,2023-09-13,164,164,0,0
BAJIO,2023-09-14,149,146,3,0.0201342281879195
BAJIO,2023-09-15,181,178,3,0.0165745856353591
BAJIO,2023-09-16,147,144,3,0.0204081632653061
BAJIO,2023-09-17,120,118,2,0.0166666666666667
BAJIO,2023-09-18,133,133,0,0
BAJIO,2023-09-19,138,131,7,0.0507246376811594
BAJIO,2023-09-20,116,115,1,0.00862068965517241
BAJIO,2023-09-21,137,135,2,0.0145985401459854
BAJIO,2023-09-22,134,130,4,0.0298507462686567
BAJIO,2023-09-23,201,197,4,0.0199004975124378
BAJIO,2023-09-24,101,99,2,0.0198019801980198
BAJIO,2023-09-25,161,160,1,0.0062111801242236
BAJIO,2023-09-26,137,135,2,0.0145985401459854
BAJIO,2023-09-27,150,149,1,0.00666666666666667
BAJIO,2023-09-28,169,169,0,0
BAJIO,2023-09-29,145,143,2,0.0137931034482759
BAJIO,2023-09-30,228,223,5,0.0219298245614035
BAJIO,2023-10-01,114,113,1,0.0087719298245614
BAJIO,2023-10-02,132,132,0,0
BAJIO,2023-10-03,132,126,6,0.0454545454545455
BAJIO,2023-10-04,126,123,3,0.0238095238095238
BAJIO,2023-10-05,126,123,3,0.0238095238095238
BAJIO,2023-10-06,167,163,4,0.0239520958083832
BAJIO,2023-10-07,209,204,5,0.0239234449760766
BAJIO,2023-10-08,115,107,8,0.0695652173913043
BAJIO,2023-10-09,142,135,7,0.0492957746478873
BAJIO,2023-10-10,124,117,7,0.0564516129032258
BAJIO,2023-10-11,109,104,5,0.0458715596330275
BAJIO,2023-10-12,137,134,3,0.0218978102189781
BAJIO,2023-10-13,114,108,6,0.0526315789473684
BAJIO,2023-10-14,146,140,6,0.0410958904109589
BAJIO,2023-10-15,121,115,6,0.0495867768595041
BAJIO,2023-10-16,156,149,7,0.0448717948717949
BAJIO,2023-10-17,135,134,1,0.00740740740740741
BAJIO,2023-10-18,134,128,6,0.0447761194029851
BAJIO,2023-10-19,139,134,5,0.0359712230215827
BAJIO,2023-10-20,153,147,6,0.0392156862745098
BAJIO,2023-10-21,224,216,8,0.0357142857142857
BAJIO,2023-10-22,137,134,3,0.0218978102189781
BAJIO,2023-10-23,154,148,6,0.038961038961039
BAJIO,2023-10-24,154,150,4,0.025974025974026
BAJIO,2023-10-25,153,149,4,0.0261437908496732
BAJIO,2023-10-26,154,151,3,0.0194805194805195
BAJIO,2023-10-27,151,147,4,0.0264900662251656
BAJIO,2023-10-28,175,167,8,0.0457142857142857
BAJIO,2023-10-29,120,117,3,0.025
BAJIO,2023-10-30,172,165,7,0.0406976744186047
BAJIO,2023-10-31,198,191,7,0.0353535353535354
BAJIO,2023-11-01,158,155,3,0.0189873417721519
BAJIO,2023-11-02,143,141,2,0.013986013986014
BAJIO,2023-11-03,142,138,4,0.028169014084507
BAJIO,2023-11-04,173,169,4,0.023121387283237
BAJIO,2023-11-05,115,112,3,0.0260869565217391
BAJIO,2023-11-06,155,150,5,0.032258064516129
BAJIO,2023-11-07,200,199,1,0.005
BAJIO,2023-11-08,149,141,8,0.0536912751677852
BAJIO,2023-11-09,124,118,6,0.0483870967741935
BAJIO,2023-11-10,137,134,3,0.0218978102189781
BAJIO,2023-11-11,189,183,6,0.0317460317460317
BAJIO,2023-11-12,135,132,3,0.0222222222222222
BAJIO,2023-11-13,182,173,9,0.0494505494505494
BAJIO,2023-11-14,194,188,6,0.0309278350515464
BAJIO,2023-11-15,189,185,4,0.0211640211640212
BAJIO,2023-11-16,185,182,3,0.0162162162162162
BAJIO,2023-11-17,184,182,2,0.0108695652173913
BAJIO,2023-11-18,264,259,5,0.0189393939393939
BAJIO,2023-11-19,135,132,3,0.0222222222222222
BAJIO,2023-11-20,173,167,6,0.0346820809248555
BAJIO,2023-11-21,189,182,7,0.037037037037037
BAJIO,2023-11-22,181,178,3,0.0165745856353591
BAJIO,2023-11-23,173,168,5,0.0289017341040462
BAJIO,2023-11-24,170,166,4,0.0235294117647059
BAJIO,2023-11-25,219,213,6,0.0273972602739726
BAJIO,2023-11-26,159,152,7,0.0440251572327044
BAJIO,2023-11-27,156,150,6,0.0384615384615385
BAJIO,2023-11-28,181,176,5,0.0276243093922652
BAJIO,2023-11-29,187,182,5,0.0267379679144385
BAJIO,2023-11-30,220,213,7,0.0318181818181818
BAJIO,2023-12-01,174,170,4,0.0229885057471264
BAJIO,2023-12-02,180,174,6,0.0333333333333333
BAJIO,2023-12-03,148,140,8,0.0540540540540541
BAJIO,2023-12-04,166,162,4,0.0240963855421687
BAJIO,2023-12-05,198,193,5,0.0252525252525253
BAJIO,2023-12-06,193,186,7,0.0362694300518135
BAJIO,2023-12-07,122,119,3,0.0245901639344262
BAJIO,2023-12-08,189,185,4,0.0211640211640212
BAJIO,2023-12-09,188,180,8,0.0425531914893617
BAJIO,2023-12-10,158,153,5,0.0316455696202532
BAJIO,2023-12-11,144,139,5,0.0347222222222222
BAJIO,2023-12-12,173,168,5,0.0289017341040462
BAJIO,2023-12-13,147,139,8,0.054421768707483
BAJIO,2023-12-14,172,167,5,0.0290697674418605
BAJIO,2023-12-15,127,125,2,0.015748031496063
BAJIO,2023-12-16,250,241,9,0.036
BAJIO,2023-12-17,156,154,2,0.0128205128205128
BAJIO,2023-12-18,196,189,7,0.0357142857142857
BAJIO,2023-12-19,168,163,5,0.0297619047619048
BAJIO,2023-12-20,204,193,11,0.053921568627451
BAJIO,2023-12-21,182,178,4,0.021978021978022
BAJIO,2023-12-22,177,170,7,0.0395480225988701
BAJIO,2023-12-23,196,191,5,0.0255102040816327
BAJIO,2023-12-24,109,107,2,0.018348623853211
BAJIO,2023-12-25,43,40,3,0.0697674418604651
BAJIO,2023-12-26,154,152,2,0.012987012987013
BAJIO,2023-12-27,204,197,7,0.0343137254901961
BAJIO,2023-12-28,199,193,6,0.0301507537688442
BAJIO,2023-12-29,208,203,5,0.0240384615384615
BAJIO,2023-12-30,198,197,1,0.00505050505050505
BAJIO,2023-12-31,94,93,1,0.0106382978723404
BAJIO,2024-01-01,43,42,1,0.0232558139534884
BAJIO,2024-01-02,138,134,4,0.0289855072463768
BAJIO,2024-01-03,211,204,7,0.033175355450237
BAJIO,2024-01-04,202,197,5,0.0247524752475248
BAJIO,2024-01-05,187,178,9,0.0481283422459893
BAJIO,2024-01-06,193,190,3,0.0155440414507772
BAJIO,2024-01-07,132,126,6,0.0454545454545455
BAJIO,2024-01-08,179,166,13,0.0726256983240224
BAJIO,2024-01-09,209,200,9,0.0430622009569378
BAJIO,2024-01-10,175,168,7,0.04
BAJIO,2024-01-11,192,183,9,0.046875
BAJIO,2024-01-12,167,164,3,0.0179640718562874
BAJIO,2024-01-13,233,224,9,0.0386266094420601
BAJIO,2024-01-14,182,178,4,0.021978021978022
CDMX FORANEAS,2023-05-26,50,50,0,0
CDMX FORANEAS,2023-05-27,61,59,2,0.0327868852459016
CDMX FORANEAS,2023-05-28,36,36,0,0
CDMX FORANEAS,2023-05-29,25,25,0,0
CDMX FORANEAS,2023-05-30,49,49,0,0
CDMX FORANEAS,2023-05-31,56,55,1,0.0178571428571429
CDMX FORANEAS,2023-06-01,114,111,3,0.0263157894736842
CDMX FORANEAS,2023-06-02,36,36,0,0
CDMX FORANEAS,2023-06-03,58,58,0,0
CDMX FORANEAS,2023-06-04,43,43,0,0
CDMX FORANEAS,2023-06-05,58,57,1,0.0172413793103448
CDMX FORANEAS,2023-06-06,48,48,0,0
CDMX FORANEAS,2023-06-07,41,40,1,0.024390243902439
CDMX FORANEAS,2023-06-08,52,50,2,0.0384615384615385
CDMX FORANEAS,2023-06-09,53,52,1,0.0188679245283019
CDMX FORANEAS,2023-06-10,62,60,2,0.032258064516129
CDMX FORANEAS,2023-06-11,57,54,3,0.0526315789473684
CDMX FORANEAS,2023-06-12,48,48,0,0
CDMX FORANEAS,2023-06-13,50,50,0,0
CDMX FORANEAS,2023-06-14,50,50,0,0
CDMX FORANEAS,2023-06-15,55,54,1,0.0181818181818182
CDMX FORANEAS,2023-06-16,63,60,3,0.0476190476190476
CDMX FORANEAS,2023-06-17,61,60,1,0.0163934426229508
CDMX FORANEAS,2023-06-18,37,37,0,0
CDMX FORANEAS,2023-06-19,49,49,0,0
CDMX FORANEAS,2023-06-20,52,51,1,0.0192307692307692
CDMX FORANEAS,2023-06-21,57,55,2,0.0350877192982456
CDMX FORANEAS,2023-06-22,47,46,1,0.0212765957446809
CDMX FORANEAS,2023-06-23,30,30,0,0
CDMX FORANEAS,2023-06-24,58,56,2,0.0344827586206897
CDMX FORANEAS,2023-06-25,47,46,1,0.0212765957446809
CDMX FORANEAS,2023-06-26,42,42,0,0
CDMX FORANEAS,2023-06-27,33,32,1,0.0303030303030303
CDMX FORANEAS,2023-06-28,44,44,0,0
CDMX FORANEAS,2023-06-29,43,42,1,0.0232558139534884
CDMX FORANEAS,2023-06-30,35,30,5,0.142857142857143
CDMX FORANEAS,2023-07-01,44,43,1,0.0227272727272727
CDMX FORANEAS,2023-07-02,49,49,0,0
CDMX FORANEAS,2023-07-03,67,67,0,0
CDMX FORANEAS,2023-07-04,138,135,3,0.0217391304347826
CDMX FORANEAS,2023-07-05,162,160,2,0.0123456790123457
CDMX FORANEAS,2023-07-06,143,142,1,0.00699300699300699
CDMX FORANEAS,2023-07-07,212,207,5,0.0235849056603774
CDMX FORANEAS,2023-07-08,156,153,3,0.0192307692307692
CDMX FORANEAS,2023-07-09,161,155,6,0.0372670807453416
CDMX FORANEAS,2023-07-10,142,141,1,0.00704225352112676
CDMX FORANEAS,2023-07-11,160,157,3,0.01875
CDMX FORANEAS,2023-07-12,187,181,6,0.0320855614973262
CDMX FORANEAS,2023-07-13,148,144,4,0.027027027027027
CDMX FORANEAS,2023-07-14,170,164,6,0.0352941176470588
CDMX FORANEAS,2023-07-15,180,177,3,0.0166666666666667
CDMX FORANEAS,2023-07-16,139,134,5,0.0359712230215827
CDMX FORANEAS,2023-07-17,157,150,7,0.0445859872611465
CDMX FORANEAS,2023-07-18,187,187,0,0
CDMX FORANEAS,2023-07-19,162,159,3,0.0185185185185185
CDMX FORANEAS,2023-07-20,179,175,4,0.0223463687150838
CDMX FORANEAS,2023-07-21,158,153,5,0.0316455696202532
CDMX FORANEAS,2023-07-22,190,185,5,0.0263157894736842
CDMX FORANEAS,2023-07-23,159,156,3,0.0188679245283019
CDMX FORANEAS,2023-07-24,179,173,6,0.0335195530726257
CDMX FORANEAS,2023-07-25,175,167,8,0.0457142857142857
CDMX FORANEAS,2023-07-26,201,193,8,0.0398009950248756
CDMX FORANEAS,2023-07-27,202,198,4,0.0198019801980198
CDMX FORANEAS,2023-07-28,210,206,4,0.019047619047619
CDMX FORANEAS,2023-07-29,193,191,2,0.0103626943005181
CDMX FORANEAS,2023-07-30,154,152,2,0.012987012987013
CDMX FORANEAS,2023-07-31,176,173,3,0.0170454545454545
CDMX FORANEAS,2023-08-01,195,189,6,0.0307692307692308
CDMX FORANEAS,2023-08-02,208,204,4,0.0192307692307692
CDMX FORANEAS,2023-08-03,162,154,8,0.0493827160493827
CDMX FORANEAS,2023-08-04,188,184,4,0.0212765957446809
CDMX FORANEAS,2023-08-05,167,166,1,0.00598802395209581
CDMX FORANEAS,2023-08-06,149,146,3,0.0201342281879195
CDMX FORANEAS,2023-08-07,164,162,2,0.0121951219512195
CDMX FORANEAS,2023-08-08,160,156,4,0.025
CDMX FORANEAS,2023-08-09,185,181,4,0.0216216216216216
CDMX FORANEAS,2023-08-10,187,181,6,0.0320855614973262
CDMX FORANEAS,2023-08-11,198,196,2,0.0101010101010101
CDMX FORANEAS,2023-08-12,187,183,4,0.0213903743315508
CDMX FORANEAS,2023-08-13,163,154,9,0.0552147239263804
CDMX FORANEAS,2023-08-14,160,159,1,0.00625
CDMX FORANEAS,2023-08-15,208,206,2,0.00961538461538462
CDMX FORANEAS,2023-08-16,183,180,3,0.0163934426229508
CDMX FORANEAS,2023-08-17,161,158,3,0.0186335403726708
CDMX FORANEAS,2023-08-18,163,161,2,0.0122699386503067
CDMX FORANEAS,2023-08-19,193,189,4,0.0207253886010363
CDMX FORANEAS,2023-08-20,144,142,2,0.0138888888888889
CDMX FORANEAS,2023-08-21,167,166,1,0.00598802395209581
CDMX FORANEAS,2023-08-22,170,169,1,0.00588235294117647
CDMX FORANEAS,2023-08-23,192,190,2,0.0104166666666667
CDMX FORANEAS,2023-08-24,188,187,1,0.00531914893617021
CDMX FORANEAS,2023-08-25,164,164,0,0
CDMX FORANEAS,2023-08-26,195,195,0,0
CDMX FORANEAS,2023-08-27,173,172,1,0.00578034682080925
CDMX FORANEAS,2023-08-28,156,156,0,0
CDMX FORANEAS,2023-08-29,183,183,0,0
CDMX FORANEAS,2023-08-30,166,166,0,0
CDMX FORANEAS,2023-08-31,162,161,1,0.00617283950617284
CDMX FORANEAS,2023-09-01,148,147,1,0.00675675675675676
CDMX FORANEAS,2023-09-02,158,156,2,0.0126582278481013
CDMX FORANEAS,2023-09-03,148,148,0,0
CDMX FORANEAS,2023-09-04,185,185,0,0
CDMX FORANEAS,2023-09-05,154,153,1,0.00649350649350649
CDMX FORANEAS,2023-09-06,171,170,1,0.00584795321637427
CDMX FORANEAS,2023-09-07,203,201,2,0.00985221674876847
CDMX FORANEAS,2023-09-08,148,148,0,0
CDMX FORANEAS,2023-09-09,170,170,0,0
CDMX FORANEAS,2023-09-10,149,147,2,0.0134228187919463
CDMX FORANEAS,2023-09-11,173,172,1,0.00578034682080925
CDMX FORANEAS,2023-09-12,201,200,1,0.00497512437810945
CDMX FORANEAS,2023-09-13,170,170,0,0
CDMX FORANEAS,2023-09-14,178,178,0,0
CDMX FORANEAS,2023-09-15,176,171,5,0.0284090909090909
CDMX FORANEAS,2023-09-16,121,121,0,0
CDMX FORANEAS,2023-09-17,122,121,1,0.00819672131147541
CDMX FORANEAS,2023-09-18,166,166,0,0
CDMX FORANEAS,2023-09-19,152,152,0,0
CDMX FORANEAS,2023-09-20,149,148,1,0.00671140939597315
CDMX FORANEAS,2023-09-21,135,135,0,0
CDMX FORANEAS,2023-09-22,179,178,1,0.00558659217877095
CDMX FORANEAS,2023-09-23,186,186,0,0
CDMX FORANEAS,2023-09-24,168,167,1,0.00595238095238095
CDMX FORANEAS,2023-09-25,154,152,2,0.012987012987013
CDMX FORANEAS,2023-09-26,180,179,1,0.00555555555555556
CDMX FORANEAS,2023-09-27,166,164,2,0.0120481927710843
CDMX FORANEAS,2023-09-28,172,170,2,0.0116279069767442
CDMX FORANEAS,2023-09-29,184,183,1,0.00543478260869565
CDMX FORANEAS,2023-09-30,243,240,3,0.0123456790123457
CDMX FORANEAS,2023-10-01,159,157,2,0.0125786163522013
CDMX FORANEAS,2023-10-02,144,144,0,0
CDMX FORANEAS,2023-10-03,159,157,2,0.0125786163522013
CDMX FORANEAS,2023-10-04,142,140,2,0.0140845070422535
CDMX FORANEAS,2023-10-05,128,125,3,0.0234375
CDMX FORANEAS,2023-10-06,144,138,6,0.0416666666666667
CDMX FORANEAS,2023-10-07,181,174,7,0.0386740331491713
CDMX FORANEAS,2023-10-08,143,139,4,0.027972027972028
CDMX FORANEAS,2023-10-09,172,164,8,0.0465116279069767
CDMX FORANEAS,2023-10-10,149,146,3,0.0201342281879195
CDMX FORANEAS,2023-10-11,158,154,4,0.0253164556962025
CDMX FORANEAS,2023-10-12,128,121,7,0.0546875
CDMX FORANEAS,2023-10-13,148,146,2,0.0135135135135135
CDMX FORANEAS,2023-10-14,189,183,6,0.0317460317460317
CDMX FORANEAS,2023-10-15,175,171,4,0.0228571428571429
CDMX FORANEAS,2023-10-16,165,161,4,0.0242424242424242
CDMX FORANEAS,2023-10-17,154,152,2,0.012987012987013
CDMX FORANEAS,2023-10-18,141,134,7,0.049645390070922
CDMX FORANEAS,2023-10-19,179,175,4,0.0223463687150838
CDMX FORANEAS,2023-10-20,179,175,4,0.0223463687150838
CDMX FORANEAS,2023-10-21,209,204,5,0.0239234449760766
CDMX FORANEAS,2023-10-22,143,137,6,0.041958041958042
CDMX FORANEAS,2023-10-23,142,137,5,0.0352112676056338
CDMX FORANEAS,2023-10-24,169,160,9,0.0532544378698225
CDMX FORANEAS,2023-10-25,136,132,4,0.0294117647058824
CDMX FORANEAS,2023-10-26,171,166,5,0.0292397660818713
CDMX FORANEAS,2023-10-27,153,146,7,0.0457516339869281
CDMX FORANEAS,2023-10-28,176,172,4,0.0227272727272727
CDMX FORANEAS,2023-10-29,147,143,4,0.0272108843537415
CDMX FORANEAS,2023-10-30,165,154,11,0.0666666666666667
CDMX FORANEAS,2023-10-31,204,198,6,0.0294117647058824
CDMX FORANEAS,2023-11-01,174,170,4,0.0229885057471264
CDMX FORANEAS,2023-11-02,150,148,2,0.0133333333333333
CDMX FORANEAS,2023-11-03,164,157,7,0.0426829268292683
CDMX FORANEAS,2023-11-04,180,178,2,0.0111111111111111
CDMX FORANEAS,2023-11-05,201,193,8,0.0398009950248756
CDMX FORANEAS,2023-11-06,198,196,2,0.0101010101010101
CDMX FORANEAS,2023-11-07,224,215,9,0.0401785714285714
CDMX FORANEAS,2023-11-08,212,208,4,0.0188679245283019
CDMX FORANEAS,2023-11-09,191,179,12,0.06282722513089
CDMX FORANEAS,2023-11-10,180,179,1,0.00555555555555556
CDMX FORANEAS,2023-11-11,207,206,1,0.00483091787439614
CDMX FORANEAS,2023-11-12,201,198,3,0.0149253731343284
CDMX FORANEAS,2023-11-13,190,182,8,0.0421052631578947
CDMX FORANEAS,2023-11-14,204,197,7,0.0343137254901961
CDMX FORANEAS,2023-11-15,250,240,10,0.04
CDMX FORANEAS,2023-11-16,267,263,4,0.0149812734082397
CDMX FORANEAS,2023-11-17,265,260,5,0.0188679245283019
CDMX FORANEAS,2023-11-18,263,257,6,0.0228136882129278
CDMX FORANEAS,2023-11-19,239,233,6,0.0251046025104603
CDMX FORANEAS,2023-11-20,226,223,3,0.0132743362831858
CDMX FORANEAS,2023-11-21,237,231,6,0.0253164556962025
CDMX FORANEAS,2023-11-22,204,198,6,0.0294117647058824
CDMX FORANEAS,2023-11-23,182,179,3,0.0164835164835165
CDMX FORANEAS,2023-11-24,218,212,6,0.0275229357798165
CDMX FORANEAS,2023-11-25,216,212,4,0.0185185185185185
CDMX FORANEAS,2023-11-26,166,165,1,0.00602409638554217
CDMX FORANEAS,2023-11-27,218,214,4,0.018348623853211
CDMX FORANEAS,2023-11-28,214,208,6,0.0280373831775701
CDMX FORANEAS,2023-11-29,242,239,3,0.012396694214876
CDMX FORANEAS,2023-11-30,285,271,14,0.0491228070175439
CDMX FORANEAS,2023-12-01,202,197,5,0.0247524752475248
CDMX FORANEAS,2023-12-02,226,219,7,0.0309734513274336
CDMX FORANEAS,2023-12-03,208,199,9,0.0432692307692308
CDMX FORANEAS,2023-12-04,206,199,7,0.0339805825242718
CDMX FORANEAS,2023-12-05,234,227,7,0.0299145299145299
CDMX FORANEAS,2023-12-06,204,198,6,0.0294117647058824
CDMX FORANEAS,2023-12-07,198,197,1,0.00505050505050505
CDMX FORANEAS,2023-12-08,195,193,2,0.0102564102564103
CDMX FORANEAS,2023-12-09,204,197,7,0.0343137254901961
CDMX FORANEAS,2023-12-10,185,181,4,0.0216216216216216
CDMX FORANEAS,2023-12-11,175,174,1,0.00571428571428571
CDMX FORANEAS,2023-12-12,228,225,3,0.0131578947368421
CDMX FORANEAS,2023-12-13,173,169,4,0.023121387283237
CDMX FORANEAS,2023-12-14,184,176,8,0.0434782608695652
CDMX FORANEAS,2023-12-15,162,160,2,0.0123456790123457
CDMX FORANEAS,2023-12-16,202,194,8,0.0396039603960396
CDMX FORANEAS,2023-12-17,178,174,4,0.0224719101123595
CDMX FORANEAS,2023-12-18,195,191,4,0.0205128205128205
CDMX FORANEAS,2023-12-19,199,194,5,0.0251256281407035
CDMX FORANEAS,2023-12-20,220,212,8,0.0363636363636364
CDMX FORANEAS,2023-12-21,209,203,6,0.0287081339712919
CDMX FORANEAS,2023-12-22,156,152,4,0.0256410256410256
CDMX FORANEAS,2023-12-23,174,170,4,0.0229885057471264
CDMX FORANEAS,2023-12-24,133,129,4,0.0300751879699248
CDMX FORANEAS,2023-12-25,60,59,1,0.0166666666666667
CDMX FORANEAS,2023-12-26,157,153,4,0.0254777070063694
CDMX FORANEAS,2023-12-27,205,201,4,0.0195121951219512
CDMX FORANEAS,2023-12-28,202,198,4,0.0198019801980198
CDMX FORANEAS,2023-12-29,197,194,3,0.0152284263959391
CDMX FORANEAS,2023-12-30,198,192,6,0.0303030303030303
CDMX FORANEAS,2023-12-31,94,93,1,0.0106382978723404
CDMX FORANEAS,2024-01-01,27,27,0,0
CDMX FORANEAS,2024-01-02,144,137,7,0.0486111111111111
CDMX FORANEAS,2024-01-03,235,232,3,0.0127659574468085
CDMX FORANEAS,2024-01-04,242,237,5,0.0206611570247934
CDMX FORANEAS,2024-01-05,179,176,3,0.0167597765363128
CDMX FORANEAS,2024-01-06,192,184,8,0.0416666666666667
CDMX FORANEAS,2024-01-07,188,183,5,0.0265957446808511
CDMX FORANEAS,2024-01-08,194,187,7,0.0360824742268041
CDMX FORANEAS,2024-01-09,218,213,5,0.0229357798165138
CDMX FORANEAS,2024-01-10,222,215,7,0.0315315315315315
CDMX FORANEAS,2024-01-11,228,222,6,0.0263157894736842
CDMX FORANEAS,2024-01-12,216,213,3,0.0138888888888889
CDMX FORANEAS,2024-01-13,232,227,5,0.021551724137931
CDMX FORANEAS,2024-01-14,183,181,2,0.0109289617486339
CDMX NORORIENTE,2023-01-02,131,93,38,0.290076335877863
CDMX NORORIENTE,2023-01-03,162,104,58,0.358024691358025
CDMX NORORIENTE,2023-01-04,156,100,56,0.358974358974359
CDMX NORORIENTE,2023-01-05,202,132,70,0.346534653465347
CDMX NORORIENTE,2023-01-06,162,115,47,0.290123456790123
CDMX NORORIENTE,2023-01-07,236,157,79,0.334745762711864
CDMX NORORIENTE,2023-01-08,193,127,66,0.341968911917098
CDMX NORORIENTE,2023-01-09,173,115,58,0.335260115606936
CDMX NORORIENTE,2023-01-10,175,122,53,0.302857142857143
CDMX NORORIENTE,2023-01-11,192,126,66,0.34375
CDMX NORORIENTE,2023-01-12,186,131,55,0.295698924731183
CDMX NORORIENTE,2023-01-13,192,127,65,0.338541666666667
CDMX NORORIENTE,2023-01-14,211,151,60,0.28436018957346
CDMX NORORIENTE,2023-01-15,190,123,67,0.352631578947368
CDMX NORORIENTE,2023-01-16,181,127,54,0.298342541436464
CDMX NORORIENTE,2023-01-17,181,122,59,0.325966850828729
CDMX NORORIENTE,2023-01-18,176,104,72,0.409090909090909
CDMX NORORIENTE,2023-01-19,139,86,53,0.381294964028777
CDMX NORORIENTE,2023-01-20,153,102,51,0.333333333333333
CDMX NORORIENTE,2023-01-21,195,109,86,0.441025641025641
CDMX NORORIENTE,2023-01-22,176,99,77,0.4375
CDMX NORORIENTE,2023-01-23,183,111,72,0.39344262295082
CDMX NORORIENTE,2023-01-24,173,108,65,0.375722543352601
CDMX NORORIENTE,2023-01-25,171,94,77,0.450292397660819
CDMX NORORIENTE,2023-01-26,160,88,72,0.45
CDMX NORORIENTE,2023-01-27,177,94,83,0.468926553672316
CDMX NORORIENTE,2023-01-28,215,122,93,0.432558139534884
CDMX NORORIENTE,2023-01-29,187,111,76,0.406417112299465
CDMX NORORIENTE,2023-01-30,178,100,78,0.438202247191011
CDMX NORORIENTE,2023-01-31,195,110,85,0.435897435897436
CDMX NORORIENTE,2023-02-01,157,98,59,0.375796178343949
CDMX NORORIENTE,2023-02-02,181,106,75,0.414364640883978
CDMX NORORIENTE,2023-02-03,170,94,76,0.447058823529412
CDMX NORORIENTE,2023-02-04,188,94,94,0.5
CDMX NORORIENTE,2023-02-05,175,113,62,0.354285714285714
CDMX NORORIENTE,2023-02-06,199,112,87,0.437185929648241
CDMX NORORIENTE,2023-02-07,214,103,111,0.518691588785047
CDMX NORORIENTE,2023-02-08,165,81,84,0.509090909090909
CDMX NORORIENTE,2023-02-09,167,77,90,0.538922155688623
CDMX NORORIENTE,2023-02-10,165,67,98,0.593939393939394
CDMX NORORIENTE,2023-02-11,183,83,100,0.546448087431694
CDMX NORORIENTE,2023-02-12,173,84,89,0.514450867052023
CDMX NORORIENTE,2023-02-13,158,80,78,0.493670886075949
CDMX NORORIENTE,2023-02-14,159,77,82,0.515723270440252
CDMX NORORIENTE,2023-02-15,159,82,77,0.484276729559748
CDMX NORORIENTE,2023-02-16,163,85,78,0.478527607361963
CDMX NORORIENTE,2023-02-17,164,81,83,0.50609756097561
CDMX NORORIENTE,2023-02-18,206,89,117,0.567961165048544
CDMX NORORIENTE,2023-02-19,177,101,76,0.429378531073446
CDMX NORORIENTE,2023-02-20,184,97,87,0.472826086956522
CDMX NORORIENTE,2023-02-21,161,124,37,0.229813664596273
CDMX NORORIENTE,2023-02-22,136,99,37,0.272058823529412
CDMX NORORIENTE,2023-02-23,143,112,31,0.216783216783217
CDMX NORORIENTE,2023-02-24,175,149,26,0.148571428571429
CDMX NORORIENTE,2023-02-25,198,160,38,0.191919191919192
CDMX NORORIENTE,2023-02-26,174,112,62,0.35632183908046
CDMX NORORIENTE,2023-02-27,184,149,35,0.190217391304348
CDMX NORORIENTE,2023-02-28,212,156,56,0.264150943396226
CDMX NORORIENTE,2023-03-01,175,144,31,0.177142857142857
CDMX NORORIENTE,2023-03-02,146,114,32,0.219178082191781
CDMX NORORIENTE,2023-03-03,184,149,35,0.190217391304348
CDMX NORORIENTE,2023-03-04,209,167,42,0.200956937799043
CDMX NORORIENTE,2023-03-05,178,129,49,0.275280898876405
CDMX NORORIENTE,2023-03-06,175,143,32,0.182857142857143
CDMX NORORIENTE,2023-03-07,147,122,25,0.170068027210884
CDMX NORORIENTE,2023-03-08,190,166,24,0.126315789473684
CDMX NORORIENTE,2023-03-09,179,153,26,0.145251396648045
CDMX NORORIENTE,2023-03-10,162,143,19,0.117283950617284
CDMX NORORIENTE,2023-03-11,211,190,21,0.0995260663507109
CDMX NORORIENTE,2023-03-12,163,140,23,0.141104294478528
CDMX NORORIENTE,2023-03-13,153,134,19,0.124183006535948
CDMX NORORIENTE,2023-03-14,175,161,14,0.08
CDMX NORORIENTE,2023-03-15,194,191,3,0.0154639175257732
CDMX NORORIENTE,2023-03-16,217,216,1,0.00460829493087558
CDMX NORORIENTE,2023-03-17,314,313,1,0.00318471337579618
CDMX NORORIENTE,2023-03-18,327,322,5,0.0152905198776758
CDMX NORORIENTE,2023-03-19,307,303,4,0.0130293159609121
CDMX NORORIENTE,2023-03-20,308,304,4,0.012987012987013
CDMX NORORIENTE,2023-03-21,236,236,0,0
CDMX NORORIENTE,2023-03-22,230,229,1,0.00434782608695652
CDMX NORORIENTE,2023-03-23,187,186,1,0.0053475935828877
CDMX NORORIENTE,2023-03-24,198,197,1,0.00505050505050505
CDMX NORORIENTE,2023-03-25,244,244,0,0
CDMX NORORIENTE,2023-03-26,240,240,0,0
CDMX NORORIENTE,2023-03-27,176,176,0,0
CDMX NORORIENTE,2023-03-28,152,152,0,0
CDMX NORORIENTE,2023-03-29,174,174,0,0
CDMX NORORIENTE,2023-03-30,208,208,0,0
CDMX NORORIENTE,2023-03-31,268,268,0,0
CDMX NORORIENTE,2023-04-01,253,252,1,0.00395256916996047
CDMX NORORIENTE,2023-04-02,224,222,2,0.00892857142857143
CDMX NORORIENTE,2023-04-03,242,241,1,0.00413223140495868
CDMX NORORIENTE,2023-04-04,133,133,0,0
CDMX NORORIENTE,2023-04-05,190,190,0,0
CDMX NORORIENTE,2023-04-06,196,196,0,0
CDMX NORORIENTE,2023-04-07,169,169,0,0
CDMX NORORIENTE,2023-04-08,141,141,0,0
CDMX NORORIENTE,2023-04-09,112,112,0,0
CDMX NORORIENTE,2023-04-10,146,146,0,0
CDMX NORORIENTE,2023-04-11,143,143,0,0
CDMX NORORIENTE,2023-04-12,193,193,0,0
CDMX NORORIENTE,2023-04-13,177,177,0,0
CDMX NORORIENTE,2023-04-14,212,212,0,0
CDMX NORORIENTE,2023-04-15,316,316,0,0
CDMX NORORIENTE,2023-04-16,244,244,0,0
CDMX NORORIENTE,2023-04-17,230,230,0,0
CDMX NORORIENTE,2023-04-18,183,183,0,0
CDMX NORORIENTE,2023-04-19,159,159,0,0
CDMX NORORIENTE,2023-04-20,148,148,0,0
CDMX NORORIENTE,2023-04-21,195,195,0,0
CDMX NORORIENTE,2023-04-22,234,234,0,0
CDMX NORORIENTE,2023-04-23,212,212,0,0
CDMX NORORIENTE,2023-04-24,246,246,0,0
CDMX NORORIENTE,2023-04-25,242,242,0,0
CDMX NORORIENTE,2023-04-26,216,216,0,0
CDMX NORORIENTE,2023-04-27,151,151,0,0
CDMX NORORIENTE,2023-04-28,192,192,0,0
CDMX NORORIENTE,2023-04-29,261,261,0,0
CDMX NORORIENTE,2023-04-30,246,246,0,0
CDMX NORORIENTE,2023-05-01,224,224,0,0
CDMX NORORIENTE,2023-05-02,199,199,0,0
CDMX NORORIENTE,2023-05-03,146,146,0,0
CDMX NORORIENTE,2023-05-04,152,152,0,0
CDMX NORORIENTE,2023-05-05,197,197,0,0
CDMX NORORIENTE,2023-05-06,170,170,0,0
CDMX NORORIENTE,2023-05-07,171,171,0,0
CDMX NORORIENTE,2023-05-08,164,164,0,0
CDMX NORORIENTE,2023-05-09,152,152,0,0
CDMX NORORIENTE,2023-05-10,150,150,0,0
CDMX NORORIENTE,2023-05-11,167,167,0,0
CDMX NORORIENTE,2023-05-12,146,146,0,0
CDMX NORORIENTE,2023-05-13,235,235,0,0
CDMX NORORIENTE,2023-05-14,280,280,0,0
CDMX NORORIENTE,2023-05-15,308,308,0,0
CDMX NORORIENTE,2023-05-16,318,318,0,0
CDMX NORORIENTE,2023-05-17,229,229,0,0
CDMX NORORIENTE,2023-05-18,188,188,0,0
CDMX NORORIENTE,2023-05-19,192,192,0,0
CDMX NORORIENTE,2023-05-20,261,261,0,0
CDMX NORORIENTE,2023-05-21,226,226,0,0
CDMX NORORIENTE,2023-05-22,229,229,0,0
CDMX NORORIENTE,2023-05-23,213,213,0,0
CDMX NORORIENTE,2023-05-24,181,181,0,0
CDMX NORORIENTE,2023-05-25,177,177,0,0
CDMX NORORIENTE,2023-05-26,225,218,7,0.0311111111111111
CDMX NORORIENTE,2023-05-27,246,242,4,0.016260162601626
CDMX NORORIENTE,2023-05-28,197,195,2,0.0101522842639594
CDMX NORORIENTE,2023-05-29,165,163,2,0.0121212121212121
CDMX NORORIENTE,2023-05-30,223,221,2,0.00896860986547085
CDMX NORORIENTE,2023-05-31,261,256,5,0.0191570881226054
CDMX NORORIENTE,2023-06-01,222,217,5,0.0225225225225225
CDMX NORORIENTE,2023-06-02,269,257,12,0.0446096654275093
CDMX NORORIENTE,2023-06-03,263,259,4,0.0152091254752852
CDMX NORORIENTE,2023-06-04,238,238,0,0
CDMX NORORIENTE,2023-06-05,227,220,7,0.0308370044052863
CDMX NORORIENTE,2023-06-06,163,160,3,0.0184049079754601
CDMX NORORIENTE,2023-06-07,240,233,7,0.0291666666666667
CDMX NORORIENTE,2023-06-08,203,201,2,0.00985221674876847
CDMX NORORIENTE,2023-06-09,256,250,6,0.0234375
CDMX NORORIENTE,2023-06-10,318,310,8,0.0251572327044025
CDMX NORORIENTE,2023-06-11,264,260,4,0.0151515151515152
CDMX NORORIENTE,2023-06-12,268,262,6,0.0223880597014925
CDMX NORORIENTE,2023-06-13,251,247,4,0.0159362549800797
CDMX NORORIENTE,2023-06-14,284,278,6,0.0211267605633803
CDMX NORORIENTE,2023-06-15,259,252,7,0.027027027027027
CDMX NORORIENTE,2023-06-16,236,233,3,0.0127118644067797
CDMX NORORIENTE,2023-06-17,353,347,6,0.0169971671388102
CDMX NORORIENTE,2023-06-18,234,230,4,0.0170940170940171
CDMX NORORIENTE,2023-06-19,263,259,4,0.0152091254752852
CDMX NORORIENTE,2023-06-20,253,250,3,0.0118577075098814
CDMX NORORIENTE,2023-06-21,190,188,2,0.0105263157894737
CDMX NORORIENTE,2023-06-22,248,246,2,0.00806451612903226
CDMX NORORIENTE,2023-06-23,235,226,9,0.0382978723404255
CDMX NORORIENTE,2023-06-24,252,244,8,0.0317460317460317
CDMX NORORIENTE,2023-06-25,262,256,6,0.0229007633587786
CDMX NORORIENTE,2023-06-26,266,261,5,0.018796992481203
CDMX NORORIENTE,2023-06-27,224,218,6,0.0267857142857143
CDMX NORORIENTE,2023-06-28,245,240,5,0.0204081632653061
CDMX NORORIENTE,2023-06-29,235,231,4,0.0170212765957447
CDMX NORORIENTE,2023-06-30,210,192,18,0.0857142857142857
CDMX NORORIENTE,2023-07-01,305,302,3,0.00983606557377049
CDMX NORORIENTE,2023-07-02,229,222,7,0.0305676855895196
CDMX NORORIENTE,2023-07-03,256,248,8,0.03125
CDMX NORORIENTE,2023-07-04,213,207,6,0.028169014084507
CDMX NORORIENTE,2023-07-05,269,266,3,0.0111524163568773
CDMX NORORIENTE,2023-07-06,190,179,11,0.0578947368421053
CDMX NORORIENTE,2023-07-07,263,258,5,0.0190114068441065
CDMX NORORIENTE,2023-07-08,268,258,10,0.0373134328358209
CDMX NORORIENTE,2023-07-09,239,234,5,0.0209205020920502
CDMX NORORIENTE,2023-07-10,228,223,5,0.0219298245614035
CDMX NORORIENTE,2023-07-11,231,225,6,0.025974025974026
CDMX NORORIENTE,2023-07-12,248,242,6,0.0241935483870968
CDMX NORORIENTE,2023-07-13,225,218,7,0.0311111111111111
CDMX NORORIENTE,2023-07-14,267,260,7,0.0262172284644195
CDMX NORORIENTE,2023-07-15,315,307,8,0.0253968253968254
CDMX NORORIENTE,2023-07-16,271,261,10,0.03690036900369
CDMX NORORIENTE,2023-07-17,248,242,6,0.0241935483870968
CDMX NORORIENTE,2023-07-18,288,280,8,0.0277777777777778
CDMX NORORIENTE,2023-07-19,209,200,9,0.0430622009569378
CDMX NORORIENTE,2023-07-20,259,256,3,0.0115830115830116
CDMX NORORIENTE,2023-07-21,262,260,2,0.00763358778625954
CDMX NORORIENTE,2023-07-22,307,305,2,0.00651465798045603
CDMX NORORIENTE,2023-07-23,276,271,5,0.0181159420289855
CDMX NORORIENTE,2023-07-24,209,206,3,0.0143540669856459
CDMX NORORIENTE,2023-07-25,284,278,6,0.0211267605633803
CDMX NORORIENTE,2023-07-26,319,313,6,0.0188087774294671
CDMX NORORIENTE,2023-07-27,259,253,6,0.0231660231660232
CDMX NORORIENTE,2023-07-28,260,257,3,0.0115384615384615
CDMX NORORIENTE,2023-07-29,309,307,2,0.00647249190938511
CDMX NORORIENTE,2023-07-30,335,326,9,0.026865671641791
CDMX NORORIENTE,2023-07-31,343,334,9,0.0262390670553936
CDMX NORORIENTE,2023-08-01,249,239,10,0.0401606425702811
CDMX NORORIENTE,2023-08-02,226,222,4,0.0176991150442478
CDMX NORORIENTE,2023-08-03,219,192,27,0.123287671232877
CDMX NORORIENTE,2023-08-04,297,287,10,0.0336700336700337
CDMX NORORIENTE,2023-08-05,335,327,8,0.0238805970149254
CDMX NORORIENTE,2023-08-06,266,257,9,0.0338345864661654
CDMX NORORIENTE,2023-08-07,287,280,7,0.024390243902439
CDMX NORORIENTE,2023-08-08,253,244,9,0.0355731225296443
CDMX NORORIENTE,2023-08-09,227,215,12,0.052863436123348
CDMX NORORIENTE,2023-08-10,250,242,8,0.032
CDMX NORORIENTE,2023-08-11,287,280,7,0.024390243902439
CDMX NORORIENTE,2023-08-12,262,252,10,0.0381679389312977
CDMX NORORIENTE,2023-08-13,343,325,18,0.0524781341107872
CDMX NORORIENTE,2023-08-14,284,271,13,0.0457746478873239
CDMX NORORIENTE,2023-08-15,335,323,12,0.0358208955223881
CDMX NORORIENTE,2023-08-16,269,264,5,0.0185873605947955
CDMX NORORIENTE,2023-08-17,232,227,5,0.021551724137931
CDMX NORORIENTE,2023-08-18,292,286,6,0.0205479452054795
CDMX NORORIENTE,2023-08-19,281,273,8,0.0284697508896797
CDMX NORORIENTE,2023-08-20,280,271,9,0.0321428571428571
CDMX NORORIENTE,2023-08-21,243,243,0,0
CDMX NORORIENTE,2023-08-22,263,263,0,0
CDMX NORORIENTE,2023-08-23,240,240,0,0
CDMX NORORIENTE,2023-08-24,268,267,1,0.00373134328358209
CDMX NORORIENTE,2023-08-25,291,291,0,0
CDMX NORORIENTE,2023-08-26,354,353,1,0.00282485875706215
CDMX NORORIENTE,2023-08-27,318,318,0,0
CDMX NORORIENTE,2023-08-28,346,344,2,0.00578034682080925
CDMX NORORIENTE,2023-08-29,302,300,2,0.00662251655629139
CDMX NORORIENTE,2023-08-30,295,293,2,0.00677966101694915
CDMX NORORIENTE,2023-08-31,275,270,5,0.0181818181818182
CDMX NORORIENTE,2023-09-01,269,269,0,0
CDMX NORORIENTE,2023-09-02,289,288,1,0.00346020761245675
CDMX NORORIENTE,2023-09-03,288,285,3,0.0104166666666667
CDMX NORORIENTE,2023-09-04,226,226,0,0
CDMX NORORIENTE,2023-09-05,251,251,0,0
CDMX NORORIENTE,2023-09-06,232,232,0,0
CDMX NORORIENTE,2023-09-07,271,270,1,0.003690036900369
CDMX NORORIENTE,2023-09-08,224,223,1,0.00446428571428571
CDMX NORORIENTE,2023-09-09,291,291,0,0
CDMX NORORIENTE,2023-09-10,257,257,0,0
CDMX NORORIENTE,2023-09-11,242,242,0,0
CDMX NORORIENTE,2023-09-12,204,203,1,0.00490196078431373
CDMX NORORIENTE,2023-09-13,165,164,1,0.00606060606060606
CDMX NORORIENTE,2023-09-14,253,252,1,0.00395256916996047
CDMX NORORIENTE,2023-09-15,230,229,1,0.00434782608695652
CDMX NORORIENTE,2023-09-16,200,197,3,0.015
CDMX NORORIENTE,2023-09-17,218,218,0,0
CDMX NORORIENTE,2023-09-18,265,264,1,0.00377358490566038
CDMX NORORIENTE,2023-09-19,217,214,3,0.0138248847926267
CDMX NORORIENTE,2023-09-20,189,189,0,0
CDMX NORORIENTE,2023-09-21,209,207,2,0.00956937799043062
CDMX NORORIENTE,2023-09-22,297,297,0,0
CDMX NORORIENTE,2023-09-23,260,259,1,0.00384615384615385
CDMX NORORIENTE,2023-09-24,290,289,1,0.00344827586206897
CDMX NORORIENTE,2023-09-25,234,234,0,0
CDMX NORORIENTE,2023-09-26,237,235,2,0.00843881856540084
CDMX NORORIENTE,2023-09-27,239,238,1,0.00418410041841004
CDMX NORORIENTE,2023-09-28,299,296,3,0.0100334448160535
CDMX NORORIENTE,2023-09-29,297,296,1,0.00336700336700337
CDMX NORORIENTE,2023-09-30,382,380,2,0.00523560209424084
CDMX NORORIENTE,2023-10-01,253,252,1,0.00395256916996047
CDMX NORORIENTE,2023-10-02,284,282,2,0.00704225352112676
CDMX NORORIENTE,2023-10-03,211,203,8,0.037914691943128
CDMX NORORIENTE,2023-10-04,221,216,5,0.0226244343891403
CDMX NORORIENTE,2023-10-05,247,236,11,0.0445344129554656
CDMX NORORIENTE,2023-10-06,288,275,13,0.0451388888888889
CDMX NORORIENTE,2023-10-07,340,331,9,0.0264705882352941
CDMX NORORIENTE,2023-10-08,283,277,6,0.0212014134275618
CDMX NORORIENTE,2023-10-09,244,236,8,0.0327868852459016
CDMX NORORIENTE,2023-10-10,202,195,7,0.0346534653465347
CDMX NORORIENTE,2023-10-11,199,194,5,0.0251256281407035
CDMX NORORIENTE,2023-10-12,201,198,3,0.0149253731343284
CDMX NORORIENTE,2023-10-13,228,216,12,0.0526315789473684
CDMX NORORIENTE,2023-10-14,294,286,8,0.0272108843537415
CDMX NORORIENTE,2023-10-15,306,295,11,0.0359477124183007
CDMX NORORIENTE,2023-10-16,292,287,5,0.0171232876712329
CDMX NORORIENTE,2023-10-17,257,247,10,0.0389105058365759
CDMX NORORIENTE,2023-10-18,246,235,11,0.0447154471544715
CDMX NORORIENTE,2023-10-19,217,212,5,0.0230414746543779
CDMX NORORIENTE,2023-10-20,246,241,5,0.0203252032520325
CDMX NORORIENTE,2023-10-21,305,294,11,0.0360655737704918
CDMX NORORIENTE,2023-10-22,280,267,13,0.0464285714285714
CDMX NORORIENTE,2023-10-23,296,285,11,0.0371621621621622
CDMX NORORIENTE,2023-10-24,248,240,8,0.032258064516129
CDMX NORORIENTE,2023-10-25,205,196,9,0.0439024390243902
CDMX NORORIENTE,2023-10-26,167,161,6,0.0359281437125748
CDMX NORORIENTE,2023-10-27,224,215,9,0.0401785714285714
CDMX NORORIENTE,2023-10-28,263,254,9,0.0342205323193916
CDMX NORORIENTE,2023-10-29,273,266,7,0.0256410256410256
CDMX NORORIENTE,2023-10-30,250,235,15,0.06
CDMX NORORIENTE,2023-10-31,314,302,12,0.0382165605095541
CDMX NORORIENTE,2023-11-01,248,237,11,0.0443548387096774
CDMX NORORIENTE,2023-11-02,244,234,10,0.040983606557377
CDMX NORORIENTE,2023-11-03,225,214,11,0.0488888888888889
CDMX NORORIENTE,2023-11-04,338,329,9,0.0266272189349112
CDMX NORORIENTE,2023-11-05,324,313,11,0.0339506172839506
CDMX NORORIENTE,2023-11-06,323,313,10,0.0309597523219814
CDMX NORORIENTE,2023-11-07,315,305,10,0.0317460317460317
CDMX NORORIENTE,2023-11-08,294,286,8,0.0272108843537415
CDMX NORORIENTE,2023-11-09,270,263,7,0.0259259259259259
CDMX NORORIENTE,2023-11-10,292,286,6,0.0205479452054795
CDMX NORORIENTE,2023-11-11,371,361,10,0.0269541778975741
CDMX NORORIENTE,2023-11-12,296,288,8,0.027027027027027
CDMX NORORIENTE,2023-11-13,312,297,15,0.0480769230769231
CDMX NORORIENTE,2023-11-14,297,289,8,0.0269360269360269
CDMX NORORIENTE,2023-11-15,288,283,5,0.0173611111111111
CDMX NORORIENTE,2023-11-16,330,316,14,0.0424242424242424
CDMX NORORIENTE,2023-11-17,358,350,8,0.0223463687150838
CDMX NORORIENTE,2023-11-18,437,425,12,0.0274599542334096
CDMX NORORIENTE,2023-11-19,451,437,14,0.0310421286031042
CDMX NORORIENTE,2023-11-20,441,426,15,0.0340136054421769
CDMX NORORIENTE,2023-11-21,383,375,8,0.02088772845953
CDMX NORORIENTE,2023-11-22,303,293,10,0.033003300330033
CDMX NORORIENTE,2023-11-23,322,311,11,0.0341614906832298
CDMX NORORIENTE,2023-11-24,297,281,16,0.0538720538720539
CDMX NORORIENTE,2023-11-25,385,378,7,0.0181818181818182
CDMX NORORIENTE,2023-11-26,343,331,12,0.0349854227405248
CDMX NORORIENTE,2023-11-27,330,313,17,0.0515151515151515
CDMX NORORIENTE,2023-11-28,346,336,10,0.0289017341040462
CDMX NORORIENTE,2023-11-29,301,290,11,0.0365448504983389
CDMX NORORIENTE,2023-11-30,379,360,19,0.050131926121372
CDMX NORORIENTE,2023-12-01,329,306,23,0.0699088145896656
CDMX NORORIENTE,2023-12-02,356,337,19,0.0533707865168539
CDMX NORORIENTE,2023-12-03,370,358,12,0.0324324324324324
CDMX NORORIENTE,2023-12-04,328,312,16,0.0487804878048781
CDMX NORORIENTE,2023-12-05,278,261,17,0.0611510791366906
CDMX NORORIENTE,2023-12-06,287,274,13,0.0452961672473868
CDMX NORORIENTE,2023-12-07,304,283,21,0.0690789473684211
CDMX NORORIENTE,2023-12-08,311,304,7,0.022508038585209
CDMX NORORIENTE,2023-12-09,352,339,13,0.0369318181818182
CDMX NORORIENTE,2023-12-10,348,327,21,0.0603448275862069
CDMX NORORIENTE,2023-12-11,289,280,9,0.0311418685121107
CDMX NORORIENTE,2023-12-12,282,273,9,0.0319148936170213
CDMX NORORIENTE,2023-12-13,295,281,14,0.0474576271186441
CDMX NORORIENTE,2023-12-14,267,257,10,0.0374531835205993
CDMX NORORIENTE,2023-12-15,309,293,16,0.0517799352750809
CDMX NORORIENTE,2023-12-16,361,347,14,0.038781163434903
CDMX NORORIENTE,2023-12-17,321,300,21,0.0654205607476635
CDMX NORORIENTE,2023-12-18,307,292,15,0.0488599348534202
CDMX NORORIENTE,2023-12-19,324,306,18,0.0555555555555556
CDMX NORORIENTE,2023-12-20,333,317,16,0.048048048048048
CDMX NORORIENTE,2023-12-21,356,342,14,0.0393258426966292
CDMX NORORIENTE,2023-12-22,303,287,16,0.0528052805280528
CDMX NORORIENTE,2023-12-23,360,344,16,0.0444444444444444
CDMX NORORIENTE,2023-12-24,250,235,15,0.06
CDMX NORORIENTE,2023-12-25,90,81,9,0.1
CDMX NORORIENTE,2023-12-26,257,245,12,0.0466926070038911
CDMX NORORIENTE,2023-12-27,340,332,8,0.0235294117647059
CDMX NORORIENTE,2023-12-28,347,336,11,0.031700288184438
CDMX NORORIENTE,2023-12-29,329,315,14,0.0425531914893617
CDMX NORORIENTE,2023-12-30,311,302,9,0.0289389067524116
CDMX NORORIENTE,2023-12-31,241,235,6,0.024896265560166
CDMX NORORIENTE,2024-01-01,68,63,5,0.0735294117647059
CDMX NORORIENTE,2024-01-02,250,241,9,0.036
CDMX NORORIENTE,2024-01-03,303,296,7,0.0231023102310231
CDMX NORORIENTE,2024-01-04,302,289,13,0.043046357615894
CDMX NORORIENTE,2024-01-05,329,324,5,0.0151975683890578
CDMX NORORIENTE,2024-01-06,299,288,11,0.0367892976588629
CDMX NORORIENTE,2024-01-07,306,300,6,0.0196078431372549
CDMX NORORIENTE,2024-01-08,315,300,15,0.0476190476190476
CDMX NORORIENTE,2024-01-09,306,295,11,0.0359477124183007
CDMX NORORIENTE,2024-01-10,305,292,13,0.0426229508196721
CDMX NORORIENTE,2024-01-11,331,320,11,0.0332326283987915
CDMX NORORIENTE,2024-01-12,351,338,13,0.037037037037037
CDMX NORORIENTE,2024-01-13,353,344,9,0.0254957507082153
CDMX NORORIENTE,2024-01-14,389,380,9,0.0231362467866324
CDMX NORPONIENTE,2023-01-02,139,101,38,0.273381294964029
CDMX NORPONIENTE,2023-01-03,179,134,45,0.251396648044693
CDMX NORPONIENTE,2023-01-04,188,151,37,0.196808510638298
CDMX NORPONIENTE,2023-01-05,164,125,39,0.23780487804878
CDMX NORPONIENTE,2023-01-06,189,144,45,0.238095238095238
CDMX NORPONIENTE,2023-01-07,212,161,51,0.240566037735849
CDMX NORPONIENTE,2023-01-08,171,131,40,0.233918128654971
CDMX NORPONIENTE,2023-01-09,167,106,61,0.365269461077844
CDMX NORPONIENTE,2023-01-10,196,134,62,0.316326530612245
CDMX NORPONIENTE,2023-01-11,201,134,67,0.333333333333333
CDMX NORPONIENTE,2023-01-12,173,120,53,0.30635838150289
CDMX NORPONIENTE,2023-01-13,209,122,87,0.416267942583732
CDMX NORPONIENTE,2023-01-14,262,169,93,0.354961832061069
CDMX NORPONIENTE,2023-01-15,259,164,95,0.366795366795367
CDMX NORPONIENTE,2023-01-16,215,73,142,0.66046511627907
CDMX NORPONIENTE,2023-01-17,206,84,122,0.592233009708738
CDMX NORPONIENTE,2023-01-18,194,97,97,0.5
CDMX NORPONIENTE,2023-01-19,180,110,70,0.388888888888889
CDMX NORPONIENTE,2023-01-20,201,119,82,0.407960199004975
CDMX NORPONIENTE,2023-01-21,250,131,119,0.476
CDMX NORPONIENTE,2023-01-22,217,128,89,0.410138248847926
CDMX NORPONIENTE,2023-01-23,180,103,77,0.427777777777778
CDMX NORPONIENTE,2023-01-24,198,110,88,0.444444444444444
CDMX NORPONIENTE,2023-01-25,172,114,58,0.337209302325581
CDMX NORPONIENTE,2023-01-26,192,117,75,0.390625
CDMX NORPONIENTE,2023-01-27,177,111,66,0.372881355932203
CDMX NORPONIENTE,2023-01-28,243,138,105,0.432098765432099
CDMX NORPONIENTE,2023-01-29,185,118,67,0.362162162162162
CDMX NORPONIENTE,2023-01-30,222,131,91,0.40990990990991
CDMX NORPONIENTE,2023-01-31,240,157,83,0.345833333333333
CDMX NORPONIENTE,2023-02-01,206,136,70,0.339805825242718
CDMX NORPONIENTE,2023-02-02,181,117,64,0.353591160220994
CDMX NORPONIENTE,2023-02-03,193,119,74,0.383419689119171
CDMX NORPONIENTE,2023-02-04,274,179,95,0.346715328467153
CDMX NORPONIENTE,2023-02-05,179,110,69,0.385474860335196
CDMX NORPONIENTE,2023-02-06,200,128,72,0.36
CDMX NORPONIENTE,2023-02-07,191,120,71,0.371727748691099
CDMX NORPONIENTE,2023-02-08,183,110,73,0.398907103825137
CDMX NORPONIENTE,2023-02-09,189,121,68,0.35978835978836
CDMX NORPONIENTE,2023-02-10,195,123,72,0.369230769230769
CDMX NORPONIENTE,2023-02-11,220,131,89,0.404545454545455
CDMX NORPONIENTE,2023-02-12,195,123,72,0.369230769230769
CDMX NORPONIENTE,2023-02-13,183,118,65,0.355191256830601
CDMX NORPONIENTE,2023-02-14,160,99,61,0.38125
CDMX NORPONIENTE,2023-02-15,202,130,72,0.356435643564356
CDMX NORPONIENTE,2023-02-16,193,131,62,0.321243523316062
CDMX NORPONIENTE,2023-02-17,209,127,82,0.392344497607655
CDMX NORPONIENTE,2023-02-18,251,159,92,0.366533864541833
CDMX NORPONIENTE,2023-02-19,203,121,82,0.403940886699507
CDMX NORPONIENTE,2023-02-20,172,118,54,0.313953488372093
CDMX NORPONIENTE,2023-02-21,188,131,57,0.303191489361702
CDMX NORPONIENTE,2023-02-22,174,122,52,0.298850574712644
CDMX NORPONIENTE,2023-02-23,174,115,59,0.339080459770115
CDMX NORPONIENTE,2023-02-24,179,115,64,0.357541899441341
CDMX NORPONIENTE,2023-02-25,201,128,73,0.36318407960199
CDMX NORPONIENTE,2023-02-26,196,139,57,0.290816326530612
CDMX NORPONIENTE,2023-02-27,202,140,62,0.306930693069307
CDMX NORPONIENTE,2023-02-28,214,156,58,0.271028037383178
CDMX NORPONIENTE,2023-03-01,199,138,61,0.306532663316583
CDMX NORPONIENTE,2023-03-02,165,115,50,0.303030303030303
CDMX NORPONIENTE,2023-03-03,220,157,63,0.286363636363636
CDMX NORPONIENTE,2023-03-04,258,182,76,0.294573643410853
CDMX NORPONIENTE,2023-03-05,201,135,66,0.328358208955224
CDMX NORPONIENTE,2023-03-06,192,132,60,0.3125
CDMX NORPONIENTE,2023-03-07,192,137,55,0.286458333333333
CDMX NORPONIENTE,2023-03-08,179,122,57,0.318435754189944
CDMX NORPONIENTE,2023-03-09,162,117,45,0.277777777777778
CDMX NORPONIENTE,2023-03-10,170,135,35,0.205882352941176
CDMX NORPONIENTE,2023-03-11,236,179,57,0.241525423728814
CDMX NORPONIENTE,2023-03-12,213,161,52,0.244131455399061
CDMX NORPONIENTE,2023-03-13,171,132,39,0.228070175438596
CDMX NORPONIENTE,2023-03-14,230,187,43,0.18695652173913
CDMX NORPONIENTE,2023-03-15,225,190,35,0.155555555555556
CDMX NORPONIENTE,2023-03-16,238,204,34,0.142857142857143
CDMX NORPONIENTE,2023-03-17,274,239,35,0.127737226277372
CDMX NORPONIENTE,2023-03-18,318,286,32,0.10062893081761
CDMX NORPONIENTE,2023-03-19,310,271,39,0.125806451612903
CDMX NORPONIENTE,2023-03-20,343,310,33,0.0962099125364431
CDMX NORPONIENTE,2023-03-21,238,228,10,0.0420168067226891
CDMX NORPONIENTE,2023-03-22,187,182,5,0.0267379679144385
CDMX NORPONIENTE,2023-03-23,221,212,9,0.0407239819004525
CDMX NORPONIENTE,2023-03-24,224,214,10,0.0446428571428571
CDMX NORPONIENTE,2023-03-25,267,264,3,0.0112359550561798
CDMX NORPONIENTE,2023-03-26,238,233,5,0.0210084033613445
CDMX NORPONIENTE,2023-03-27,173,171,2,0.0115606936416185
CDMX NORPONIENTE,2023-03-28,164,158,6,0.0365853658536585
CDMX NORPONIENTE,2023-03-29,189,187,2,0.0105820105820106
CDMX NORPONIENTE,2023-03-30,224,220,4,0.0178571428571429
CDMX NORPONIENTE,2023-03-31,339,327,12,0.0353982300884956
CDMX NORPONIENTE,2023-04-01,265,260,5,0.0188679245283019
CDMX NORPONIENTE,2023-04-02,206,190,16,0.0776699029126214
CDMX NORPONIENTE,2023-04-03,265,257,8,0.030188679245283
CDMX NORPONIENTE,2023-04-04,222,209,13,0.0585585585585586
CDMX NORPONIENTE,2023-04-05,209,191,18,0.0861244019138756
CDMX NORPONIENTE,2023-04-06,217,213,4,0.0184331797235023
CDMX NORPONIENTE,2023-04-07,158,153,5,0.0316455696202532
CDMX NORPONIENTE,2023-04-08,113,110,3,0.0265486725663717
CDMX NORPONIENTE,2023-04-09,118,114,4,0.0338983050847458
CDMX NORPONIENTE,2023-04-10,163,159,4,0.0245398773006135
CDMX NORPONIENTE,2023-04-11,193,185,8,0.0414507772020725
CDMX NORPONIENTE,2023-04-12,172,170,2,0.0116279069767442
CDMX NORPONIENTE,2023-04-13,168,165,3,0.0178571428571429
CDMX NORPONIENTE,2023-04-14,224,205,19,0.0848214285714286
CDMX NORPONIENTE,2023-04-15,309,287,22,0.0711974110032362
CDMX NORPONIENTE,2023-04-16,293,283,10,0.0341296928327645
CDMX NORPONIENTE,2023-04-17,273,265,8,0.0293040293040293
CDMX NORPONIENTE,2023-04-18,219,208,11,0.0502283105022831
CDMX NORPONIENTE,2023-04-19,179,168,11,0.0614525139664804
CDMX NORPONIENTE,2023-04-20,199,185,14,0.0703517587939698
CDMX NORPONIENTE,2023-04-21,208,204,4,0.0192307692307692
CDMX NORPONIENTE,2023-04-22,268,257,11,0.041044776119403
CDMX NORPONIENTE,2023-04-23,241,235,6,0.024896265560166
CDMX NORPONIENTE,2023-04-24,227,221,6,0.026431718061674
CDMX NORPONIENTE,2023-04-25,267,250,17,0.0636704119850187
CDMX NORPONIENTE,2023-04-26,207,199,8,0.0386473429951691
CDMX NORPONIENTE,2023-04-27,173,168,5,0.0289017341040462
CDMX NORPONIENTE,2023-04-28,232,223,9,0.0387931034482759
CDMX NORPONIENTE,2023-04-29,358,337,21,0.058659217877095
CDMX NORPONIENTE,2023-04-30,280,270,10,0.0357142857142857
CDMX NORPONIENTE,2023-05-01,157,153,4,0.0254777070063694
CDMX NORPONIENTE,2023-05-02,243,224,19,0.0781893004115226
CDMX NORPONIENTE,2023-05-03,217,207,10,0.0460829493087558
CDMX NORPONIENTE,2023-05-04,202,193,9,0.0445544554455446
CDMX NORPONIENTE,2023-05-05,196,186,10,0.0510204081632653
CDMX NORPONIENTE,2023-05-06,238,221,17,0.0714285714285714
CDMX NORPONIENTE,2023-05-07,178,167,11,0.0617977528089888
CDMX NORPONIENTE,2023-05-08,230,214,16,0.0695652173913043
CDMX NORPONIENTE,2023-05-09,191,181,10,0.0523560209424084
CDMX NORPONIENTE,2023-05-10,181,170,11,0.0607734806629834
CDMX NORPONIENTE,2023-05-11,158,147,11,0.069620253164557
CDMX NORPONIENTE,2023-05-12,181,174,7,0.0386740331491713
CDMX NORPONIENTE,2023-05-13,293,278,15,0.0511945392491468
CDMX NORPONIENTE,2023-05-14,311,290,21,0.067524115755627
CDMX NORPONIENTE,2023-05-15,353,331,22,0.0623229461756374
CDMX NORPONIENTE,2023-05-16,329,309,20,0.060790273556231
CDMX NORPONIENTE,2023-05-17,300,280,20,0.0666666666666667
CDMX NORPONIENTE,2023-05-18,227,217,10,0.0440528634361234
CDMX NORPONIENTE,2023-05-19,192,175,17,0.0885416666666667
CDMX NORPONIENTE,2023-05-20,295,279,16,0.0542372881355932
CDMX NORPONIENTE,2023-05-21,259,243,16,0.0617760617760618
CDMX NORPONIENTE,2023-05-22,249,240,9,0.036144578313253
CDMX NORPONIENTE,2023-05-23,222,215,7,0.0315315315315315
CDMX NORPONIENTE,2023-05-24,237,223,14,0.0590717299578059
CDMX NORPONIENTE,2023-05-25,228,211,17,0.0745614035087719
CDMX NORPONIENTE,2023-05-26,239,227,12,0.0502092050209205
CDMX NORPONIENTE,2023-05-27,277,254,23,0.0830324909747292
CDMX NORPONIENTE,2023-05-28,222,203,19,0.0855855855855856
CDMX NORPONIENTE,2023-05-29,239,219,20,0.0836820083682008
CDMX NORPONIENTE,2023-05-30,269,247,22,0.0817843866171004
CDMX NORPONIENTE,2023-05-31,294,280,14,0.0476190476190476
CDMX NORPONIENTE,2023-06-01,509,484,25,0.0491159135559921
CDMX NORPONIENTE,2023-06-02,352,322,30,0.0852272727272727
CDMX NORPONIENTE,2023-06-03,357,331,26,0.0728291316526611
CDMX NORPONIENTE,2023-06-04,417,377,40,0.0959232613908873
CDMX NORPONIENTE,2023-06-05,239,216,23,0.096234309623431
CDMX NORPONIENTE,2023-06-06,208,193,15,0.0721153846153846
CDMX NORPONIENTE,2023-06-07,208,197,11,0.0528846153846154
CDMX NORPONIENTE,2023-06-08,215,203,12,0.0558139534883721
CDMX NORPONIENTE,2023-06-09,197,181,16,0.0812182741116751
CDMX NORPONIENTE,2023-06-10,246,232,14,0.0569105691056911
CDMX NORPONIENTE,2023-06-11,231,214,17,0.0735930735930736
CDMX NORPONIENTE,2023-06-12,203,190,13,0.0640394088669951
CDMX NORPONIENTE,2023-06-13,199,185,14,0.0703517587939698
CDMX NORPONIENTE,2023-06-14,275,256,19,0.0690909090909091
CDMX NORPONIENTE,2023-06-15,251,231,20,0.0796812749003984
CDMX NORPONIENTE,2023-06-16,283,267,16,0.0565371024734982
CDMX NORPONIENTE,2023-06-17,291,278,13,0.0446735395189003
CDMX NORPONIENTE,2023-06-18,211,200,11,0.0521327014218009
CDMX NORPONIENTE,2023-06-19,244,226,18,0.0737704918032787
CDMX NORPONIENTE,2023-06-20,230,217,13,0.0565217391304348
CDMX NORPONIENTE,2023-06-21,263,252,11,0.0418250950570342
CDMX NORPONIENTE,2023-06-22,204,192,12,0.0588235294117647
CDMX NORPONIENTE,2023-06-23,241,222,19,0.0788381742738589
CDMX NORPONIENTE,2023-06-24,306,285,21,0.0686274509803922
CDMX NORPONIENTE,2023-06-25,212,197,15,0.0707547169811321
CDMX NORPONIENTE,2023-06-26,240,223,17,0.0708333333333333
CDMX NORPONIENTE,2023-06-27,202,196,6,0.0297029702970297
CDMX NORPONIENTE,2023-06-28,228,218,10,0.043859649122807
CDMX NORPONIENTE,2023-06-29,247,227,20,0.0809716599190283
CDMX NORPONIENTE,2023-06-30,159,137,22,0.138364779874214
CDMX NORPONIENTE,2023-07-01,293,282,11,0.037542662116041
CDMX NORPONIENTE,2023-07-02,175,170,5,0.0285714285714286
CDMX NORPONIENTE,2023-07-03,261,254,7,0.0268199233716475
CDMX NORPONIENTE,2023-07-04,320,309,11,0.034375
CDMX NORPONIENTE,2023-07-05,249,242,7,0.0281124497991968
CDMX NORPONIENTE,2023-07-06,213,200,13,0.0610328638497653
CDMX NORPONIENTE,2023-07-07,354,345,9,0.0254237288135593
CDMX NORPONIENTE,2023-07-08,430,421,9,0.0209302325581395
CDMX NORPONIENTE,2023-07-09,305,291,14,0.0459016393442623
CDMX NORPONIENTE,2023-07-10,333,318,15,0.045045045045045
CDMX NORPONIENTE,2023-07-11,342,327,15,0.043859649122807
CDMX NORPONIENTE,2023-07-12,300,288,12,0.04
CDMX NORPONIENTE,2023-07-13,302,288,14,0.0463576158940397
CDMX NORPONIENTE,2023-07-14,327,312,15,0.0458715596330275
CDMX NORPONIENTE,2023-07-15,414,401,13,0.0314009661835749
CDMX NORPONIENTE,2023-07-16,311,298,13,0.0418006430868167
CDMX NORPONIENTE,2023-07-17,324,316,8,0.0246913580246914
CDMX NORPONIENTE,2023-07-18,349,339,10,0.0286532951289398
CDMX NORPONIENTE,2023-07-19,341,328,13,0.0381231671554252
CDMX NORPONIENTE,2023-07-20,403,388,15,0.0372208436724566
CDMX NORPONIENTE,2023-07-21,374,363,11,0.0294117647058824
CDMX NORPONIENTE,2023-07-22,417,403,14,0.0335731414868106
CDMX NORPONIENTE,2023-07-23,265,256,9,0.0339622641509434
CDMX NORPONIENTE,2023-07-24,321,311,10,0.0311526479750779
CDMX NORPONIENTE,2023-07-25,361,348,13,0.03601108033241
CDMX NORPONIENTE,2023-07-26,387,374,13,0.0335917312661499
CDMX NORPONIENTE,2023-07-27,361,349,12,0.0332409972299169
CDMX NORPONIENTE,2023-07-28,410,396,14,0.0341463414634146
CDMX NORPONIENTE,2023-07-29,456,446,10,0.0219298245614035
CDMX NORPONIENTE,2023-07-30,387,380,7,0.0180878552971576
CDMX NORPONIENTE,2023-07-31,426,417,9,0.0211267605633803
CDMX NORPONIENTE,2023-08-01,391,377,14,0.0358056265984655
CDMX NORPONIENTE,2023-08-02,371,357,14,0.0377358490566038
CDMX NORPONIENTE,2023-08-03,387,315,72,0.186046511627907
CDMX NORPONIENTE,2023-08-04,365,353,12,0.0328767123287671
CDMX NORPONIENTE,2023-08-05,474,456,18,0.0379746835443038
CDMX NORPONIENTE,2023-08-06,371,361,10,0.0269541778975741
CDMX NORPONIENTE,2023-08-07,374,364,10,0.0267379679144385
CDMX NORPONIENTE,2023-08-08,374,363,11,0.0294117647058824
CDMX NORPONIENTE,2023-08-09,348,334,14,0.0402298850574713
CDMX NORPONIENTE,2023-08-10,348,336,12,0.0344827586206897
CDMX NORPONIENTE,2023-08-11,380,361,19,0.05
CDMX NORPONIENTE,2023-08-12,448,437,11,0.0245535714285714
CDMX NORPONIENTE,2023-08-13,371,359,12,0.032345013477089
CDMX NORPONIENTE,2023-08-14,318,302,16,0.050314465408805
CDMX NORPONIENTE,2023-08-15,430,418,12,0.027906976744186
CDMX NORPONIENTE,2023-08-16,347,335,12,0.0345821325648415
CDMX NORPONIENTE,2023-08-17,334,319,15,0.0449101796407186
CDMX NORPONIENTE,2023-08-18,386,375,11,0.0284974093264249
CDMX NORPONIENTE,2023-08-19,476,464,12,0.0252100840336134
CDMX NORPONIENTE,2023-08-20,314,303,11,0.035031847133758
CDMX NORPONIENTE,2023-08-21,361,358,3,0.00831024930747922
CDMX NORPONIENTE,2023-08-22,338,338,0,0
CDMX NORPONIENTE,2023-08-23,343,338,5,0.0145772594752187
CDMX NORPONIENTE,2023-08-24,345,339,6,0.0173913043478261
CDMX NORPONIENTE,2023-08-25,413,409,4,0.00968523002421308
CDMX NORPONIENTE,2023-08-26,467,465,2,0.00428265524625268
CDMX NORPONIENTE,2023-08-27,380,379,1,0.00263157894736842
CDMX NORPONIENTE,2023-08-28,411,408,3,0.0072992700729927
CDMX NORPONIENTE,2023-08-29,368,361,7,0.0190217391304348
CDMX NORPONIENTE,2023-08-30,403,401,2,0.00496277915632754
CDMX NORPONIENTE,2023-08-31,331,326,5,0.0151057401812689
CDMX NORPONIENTE,2023-09-01,355,353,2,0.00563380281690141
CDMX NORPONIENTE,2023-09-02,412,409,3,0.00728155339805825
CDMX NORPONIENTE,2023-09-03,316,316,0,0
CDMX NORPONIENTE,2023-09-04,331,329,2,0.00604229607250755
CDMX NORPONIENTE,2023-09-05,364,364,0,0
CDMX NORPONIENTE,2023-09-06,329,325,4,0.0121580547112462
CDMX NORPONIENTE,2023-09-07,319,319,0,0
CDMX NORPONIENTE,2023-09-08,300,296,4,0.0133333333333333
CDMX NORPONIENTE,2023-09-09,404,404,0,0
CDMX NORPONIENTE,2023-09-10,331,331,0,0
CDMX NORPONIENTE,2023-09-11,315,312,3,0.00952380952380952
CDMX NORPONIENTE,2023-09-12,318,314,4,0.0125786163522013
CDMX NORPONIENTE,2023-09-13,243,236,7,0.0288065843621399
CDMX NORPONIENTE,2023-09-14,279,276,3,0.010752688172043
CDMX NORPONIENTE,2023-09-15,406,401,5,0.0123152709359606
CDMX NORPONIENTE,2023-09-16,263,262,1,0.00380228136882129
CDMX NORPONIENTE,2023-09-17,339,335,4,0.0117994100294985
CDMX NORPONIENTE,2023-09-18,365,364,1,0.00273972602739726
CDMX NORPONIENTE,2023-09-19,321,317,4,0.0124610591900312
CDMX NORPONIENTE,2023-09-20,319,316,3,0.00940438871473354
CDMX NORPONIENTE,2023-09-21,367,361,6,0.0163487738419619
CDMX NORPONIENTE,2023-09-22,370,365,5,0.0135135135135135
CDMX NORPONIENTE,2023-09-23,460,454,6,0.0130434782608696
CDMX NORPONIENTE,2023-09-24,340,337,3,0.00882352941176471
CDMX NORPONIENTE,2023-09-25,344,336,8,0.0232558139534884
CDMX NORPONIENTE,2023-09-26,351,347,4,0.0113960113960114
CDMX NORPONIENTE,2023-09-27,312,310,2,0.00641025641025641
CDMX NORPONIENTE,2023-09-28,387,381,6,0.0155038759689922
CDMX NORPONIENTE,2023-09-29,391,384,7,0.0179028132992327
CDMX NORPONIENTE,2023-09-30,517,505,12,0.02321083172147
CDMX NORPONIENTE,2023-10-01,300,295,5,0.0166666666666667
CDMX NORPONIENTE,2023-10-02,313,309,4,0.012779552715655
CDMX NORPONIENTE,2023-10-03,317,312,5,0.0157728706624606
CDMX NORPONIENTE,2023-10-04,302,290,12,0.0397350993377483
CDMX NORPONIENTE,2023-10-05,295,283,12,0.0406779661016949
CDMX NORPONIENTE,2023-10-06,334,323,11,0.0329341317365269
CDMX NORPONIENTE,2023-10-07,377,369,8,0.0212201591511936
CDMX NORPONIENTE,2023-10-08,313,299,14,0.0447284345047923
CDMX NORPONIENTE,2023-10-09,299,290,9,0.0301003344481605
CDMX NORPONIENTE,2023-10-10,276,271,5,0.0181159420289855
CDMX NORPONIENTE,2023-10-11,281,268,13,0.0462633451957295
CDMX NORPONIENTE,2023-10-12,260,250,10,0.0384615384615385
CDMX NORPONIENTE,2023-10-13,244,234,10,0.040983606557377
CDMX NORPONIENTE,2023-10-14,445,428,17,0.0382022471910112
CDMX NORPONIENTE,2023-10-15,345,334,11,0.0318840579710145
CDMX NORPONIENTE,2023-10-16,351,341,10,0.0284900284900285
CDMX NORPONIENTE,2023-10-17,347,340,7,0.0201729106628242
CDMX NORPONIENTE,2023-10-18,334,323,11,0.0329341317365269
CDMX NORPONIENTE,2023-10-19,296,288,8,0.027027027027027
CDMX NORPONIENTE,2023-10-20,296,292,4,0.0135135135135135
CDMX NORPONIENTE,2023-10-21,396,384,12,0.0303030303030303
CDMX NORPONIENTE,2023-10-22,290,281,9,0.0310344827586207
CDMX NORPONIENTE,2023-10-23,306,296,10,0.0326797385620915
CDMX NORPONIENTE,2023-10-24,304,299,5,0.0164473684210526
CDMX NORPONIENTE,2023-10-25,300,293,7,0.0233333333333333
CDMX NORPONIENTE,2023-10-26,327,318,9,0.0275229357798165
CDMX NORPONIENTE,2023-10-27,331,324,7,0.0211480362537764
CDMX NORPONIENTE,2023-10-28,390,377,13,0.0333333333333333
CDMX NORPONIENTE,2023-10-29,315,307,8,0.0253968253968254
CDMX NORPONIENTE,2023-10-30,311,299,12,0.0385852090032154
CDMX NORPONIENTE,2023-10-31,362,351,11,0.0303867403314917
CDMX NORPONIENTE,2023-11-01,358,346,12,0.0335195530726257
CDMX NORPONIENTE,2023-11-02,317,308,9,0.028391167192429
CDMX NORPONIENTE,2023-11-03,327,318,9,0.0275229357798165
CDMX NORPONIENTE,2023-11-04,369,361,8,0.021680216802168
CDMX NORPONIENTE,2023-11-05,343,333,10,0.0291545189504373
CDMX NORPONIENTE,2023-11-06,343,334,9,0.0262390670553936
CDMX NORPONIENTE,2023-11-07,365,350,15,0.0410958904109589
CDMX NORPONIENTE,2023-11-08,357,349,8,0.0224089635854342
CDMX NORPONIENTE,2023-11-09,356,349,7,0.0196629213483146
CDMX NORPONIENTE,2023-11-10,339,325,14,0.0412979351032448
CDMX NORPONIENTE,2023-11-11,395,385,10,0.0253164556962025
CDMX NORPONIENTE,2023-11-12,346,336,10,0.0289017341040462
CDMX NORPONIENTE,2023-11-13,348,337,11,0.0316091954022989
CDMX NORPONIENTE,2023-11-14,354,340,14,0.0395480225988701
CDMX NORPONIENTE,2023-11-15,365,359,6,0.0164383561643836
CDMX NORPONIENTE,2023-11-16,372,361,11,0.0295698924731183
CDMX NORPONIENTE,2023-11-17,430,413,17,0.0395348837209302
CDMX NORPONIENTE,2023-11-18,502,486,16,0.0318725099601594
CDMX NORPONIENTE,2023-11-19,361,353,8,0.0221606648199446
CDMX NORPONIENTE,2023-11-20,425,415,10,0.0235294117647059
CDMX NORPONIENTE,2023-11-21,386,376,10,0.0259067357512953
CDMX NORPONIENTE,2023-11-22,398,381,17,0.042713567839196
CDMX NORPONIENTE,2023-11-23,376,367,9,0.023936170212766
CDMX NORPONIENTE,2023-11-24,356,351,5,0.0140449438202247
CDMX NORPONIENTE,2023-11-25,452,438,14,0.0309734513274336
CDMX NORPONIENTE,2023-11-26,381,369,12,0.031496062992126
CDMX NORPONIENTE,2023-11-27,377,367,10,0.026525198938992
CDMX NORPONIENTE,2023-11-28,414,402,12,0.0289855072463768
CDMX NORPONIENTE,2023-11-29,349,321,28,0.0802292263610315
CDMX NORPONIENTE,2023-11-30,472,452,20,0.0423728813559322
CDMX NORPONIENTE,2023-12-01,386,370,16,0.0414507772020725
CDMX NORPONIENTE,2023-12-02,437,418,19,0.0434782608695652
CDMX NORPONIENTE,2023-12-03,366,346,20,0.0546448087431694
CDMX NORPONIENTE,2023-12-04,319,312,7,0.0219435736677116
CDMX NORPONIENTE,2023-12-05,339,315,24,0.0707964601769911
CDMX NORPONIENTE,2023-12-06,343,336,7,0.0204081632653061
CDMX NORPONIENTE,2023-12-07,299,289,10,0.0334448160535117
CDMX NORPONIENTE,2023-12-08,371,356,15,0.0404312668463612
CDMX NORPONIENTE,2023-12-09,430,413,17,0.0395348837209302
CDMX NORPONIENTE,2023-12-10,321,315,6,0.0186915887850467
CDMX NORPONIENTE,2023-12-11,331,320,11,0.0332326283987915
CDMX NORPONIENTE,2023-12-12,401,383,18,0.0448877805486284
CDMX NORPONIENTE,2023-12-13,304,295,9,0.0296052631578947
CDMX NORPONIENTE,2023-12-14,322,305,17,0.0527950310559006
CDMX NORPONIENTE,2023-12-15,342,330,12,0.0350877192982456
CDMX NORPONIENTE,2023-12-16,389,379,10,0.025706940874036
CDMX NORPONIENTE,2023-12-17,327,320,7,0.0214067278287462
CDMX NORPONIENTE,2023-12-18,361,351,10,0.0277008310249307
CDMX NORPONIENTE,2023-12-19,416,408,8,0.0192307692307692
CDMX NORPONIENTE,2023-12-20,418,404,14,0.0334928229665072
CDMX NORPONIENTE,2023-12-21,398,387,11,0.0276381909547739
CDMX NORPONIENTE,2023-12-22,390,379,11,0.0282051282051282
CDMX NORPONIENTE,2023-12-23,438,422,16,0.0365296803652968
CDMX NORPONIENTE,2023-12-24,226,221,5,0.0221238938053097
CDMX NORPONIENTE,2023-12-25,106,99,7,0.0660377358490566
CDMX NORPONIENTE,2023-12-26,308,303,5,0.0162337662337662
CDMX NORPONIENTE,2023-12-27,437,425,12,0.0274599542334096
CDMX NORPONIENTE,2023-12-28,476,465,11,0.023109243697479
CDMX NORPONIENTE,2023-12-29,419,412,7,0.0167064439140811
CDMX NORPONIENTE,2023-12-30,383,374,9,0.0234986945169713
CDMX NORPONIENTE,2023-12-31,197,195,2,0.0101522842639594
CDMX NORPONIENTE,2024-01-01,65,64,1,0.0153846153846154
CDMX NORPONIENTE,2024-01-02,322,316,6,0.0186335403726708
CDMX NORPONIENTE,2024-01-03,445,434,11,0.0247191011235955
CDMX NORPONIENTE,2024-01-04,411,395,16,0.0389294403892944
CDMX NORPONIENTE,2024-01-05,371,358,13,0.0350404312668464
CDMX NORPONIENTE,2024-01-06,390,384,6,0.0153846153846154
CDMX NORPONIENTE,2024-01-07,312,308,4,0.0128205128205128
CDMX NORPONIENTE,2024-01-08,365,357,8,0.0219178082191781
CDMX NORPONIENTE,2024-01-09,345,336,9,0.0260869565217391
CDMX NORPONIENTE,2024-01-10,410,400,10,0.024390243902439
CDMX NORPONIENTE,2024-01-11,369,361,8,0.021680216802168
CDMX NORPONIENTE,2024-01-12,350,338,12,0.0342857142857143
CDMX NORPONIENTE,2024-01-13,469,458,11,0.023454157782516
CDMX NORPONIENTE,2024-01-14,369,364,5,0.013550135501355
CDMX PONIENTE CONDESA,2023-01-02,88,52,36,0.409090909090909
CDMX PONIENTE CONDESA,2023-01-03,88,53,35,0.397727272727273
CDMX PONIENTE CONDESA,2023-01-04,100,65,35,0.35
CDMX PONIENTE CONDESA,2023-01-05,102,65,37,0.362745098039216
CDMX PONIENTE CONDESA,2023-01-06,77,55,22,0.285714285714286
CDMX PONIENTE CONDESA,2023-01-07,121,82,39,0.322314049586777
CDMX PONIENTE CONDESA,2023-01-08,69,52,17,0.246376811594203
CDMX PONIENTE CONDESA,2023-01-09,110,75,35,0.318181818181818
CDMX PONIENTE CONDESA,2023-01-10,90,63,27,0.3
CDMX PONIENTE CONDESA,2023-01-11,101,73,28,0.277227722772277
CDMX PONIENTE CONDESA,2023-01-12,111,67,44,0.396396396396396
CDMX PONIENTE CONDESA,2023-01-13,101,72,29,0.287128712871287
CDMX PONIENTE CONDESA,2023-01-14,112,69,43,0.383928571428571
CDMX PONIENTE CONDESA,2023-01-15,85,54,31,0.364705882352941
CDMX PONIENTE CONDESA,2023-01-16,101,44,57,0.564356435643564
CDMX PONIENTE CONDESA,2023-01-17,92,28,64,0.695652173913043
CDMX PONIENTE CONDESA,2023-01-18,105,34,71,0.676190476190476
CDMX PONIENTE CONDESA,2023-01-19,98,50,48,0.489795918367347
CDMX PONIENTE CONDESA,2023-01-20,112,66,46,0.410714285714286
CDMX PONIENTE CONDESA,2023-01-21,97,50,47,0.484536082474227
CDMX PONIENTE CONDESA,2023-01-22,55,30,25,0.454545454545455
CDMX PONIENTE CONDESA,2023-01-23,92,44,48,0.521739130434783
CDMX PONIENTE CONDESA,2023-01-24,98,47,51,0.520408163265306
CDMX PONIENTE CONDESA,2023-01-25,88,34,54,0.613636363636364
CDMX PONIENTE CONDESA,2023-01-26,96,42,54,0.5625
CDMX PONIENTE CONDESA,2023-01-27,91,43,48,0.527472527472527
CDMX PONIENTE CONDESA,2023-01-28,106,43,63,0.594339622641509
CDMX PONIENTE CONDESA,2023-01-29,78,37,41,0.525641025641026
CDMX PONIENTE CONDESA,2023-01-30,107,50,57,0.532710280373832
CDMX PONIENTE CONDESA,2023-01-31,106,44,62,0.584905660377358
CDMX PONIENTE CONDESA,2023-02-01,109,54,55,0.504587155963303
CDMX PONIENTE CONDESA,2023-02-02,111,60,51,0.459459459459459
CDMX PONIENTE CONDESA,2023-02-03,108,47,61,0.564814814814815
CDMX PONIENTE CONDESA,2023-02-04,133,68,65,0.488721804511278
CDMX PONIENTE CONDESA,2023-02-05,89,41,48,0.539325842696629
CDMX PONIENTE CONDESA,2023-02-06,99,36,63,0.636363636363636
CDMX PONIENTE CONDESA,2023-02-07,113,57,56,0.495575221238938
CDMX PONIENTE CONDESA,2023-02-08,98,45,55,0.561224489795918
CDMX PONIENTE CONDESA,2023-02-09,101,52,49,0.485148514851485
CDMX PONIENTE CONDESA,2023-02-10,117,44,74,0.632478632478632
CDMX PONIENTE CONDESA,2023-02-11,107,49,58,0.542056074766355
CDMX PONIENTE CONDESA,2023-02-12,68,25,43,0.632352941176471
CDMX PONIENTE CONDESA,2023-02-13,100,43,57,0.57
CDMX PONIENTE CONDESA,2023-02-14,103,48,55,0.533980582524272
CDMX PONIENTE CONDESA,2023-02-15,106,46,60,0.566037735849057
CDMX PONIENTE CONDESA,2023-02-16,93,39,54,0.580645161290323
CDMX PONIENTE CONDESA,2023-02-17,98,51,47,0.479591836734694
CDMX PONIENTE CONDESA,2023-02-18,119,49,70,0.588235294117647
CDMX PONIENTE CONDESA,2023-02-19,75,37,38,0.506666666666667
CDMX PONIENTE CONDESA,2023-02-20,116,57,59,0.508620689655172
CDMX PONIENTE CONDESA,2023-02-21,99,47,52,0.525252525252525
CDMX PONIENTE CONDESA,2023-02-22,98,57,41,0.418367346938776
CDMX PONIENTE CONDESA,2023-02-23,92,58,34,0.369565217391304
CDMX PONIENTE CONDESA,2023-02-24,100,48,52,0.52
CDMX PONIENTE CONDESA,2023-02-25,98,55,43,0.438775510204082
CDMX PONIENTE CONDESA,2023-02-26,68,38,30,0.441176470588235
CDMX PONIENTE CONDESA,2023-02-27,106,43,63,0.594339622641509
CDMX PONIENTE CONDESA,2023-02-28,101,54,47,0.465346534653465
CDMX PONIENTE CONDESA,2023-03-01,109,70,39,0.357798165137615
CDMX PONIENTE CONDESA,2023-03-02,111,58,53,0.477477477477477
CDMX PONIENTE CONDESA,2023-03-03,115,70,45,0.391304347826087
CDMX PONIENTE CONDESA,2023-03-04,139,73,66,0.474820143884892
CDMX PONIENTE CONDESA,2023-03-05,95,51,44,0.463157894736842
CDMX PONIENTE CONDESA,2023-03-06,101,47,54,0.534653465346535
CDMX PONIENTE CONDESA,2023-03-07,124,67,57,0.459677419354839
CDMX PONIENTE CONDESA,2023-03-08,129,88,41,0.317829457364341
CDMX PONIENTE CONDESA,2023-03-09,115,77,38,0.330434782608696
CDMX PONIENTE CONDESA,2023-03-10,94,72,22,0.234042553191489
CDMX PONIENTE CONDESA,2023-03-11,99,70,29,0.292929292929293
CDMX PONIENTE CONDESA,2023-03-12,67,54,13,0.194029850746269
CDMX PONIENTE CONDESA,2023-03-13,96,56,40,0.416666666666667
CDMX PONIENTE CONDESA,2023-03-14,101,70,31,0.306930693069307
CDMX PONIENTE CONDESA,2023-03-15,113,89,24,0.212389380530973
CDMX PONIENTE CONDESA,2023-03-16,111,93,18,0.162162162162162
CDMX PONIENTE CONDESA,2023-03-17,134,119,15,0.111940298507463
CDMX PONIENTE CONDESA,2023-03-18,134,119,15,0.111940298507463
CDMX PONIENTE CONDESA,2023-03-19,79,70,9,0.113924050632911
CDMX PONIENTE CONDESA,2023-03-20,94,86,8,0.0851063829787234
CDMX PONIENTE CONDESA,2023-03-21,108,104,4,0.037037037037037
CDMX PONIENTE CONDESA,2023-03-22,122,115,7,0.0573770491803279
CDMX PONIENTE CONDESA,2023-03-23,105,102,3,0.0285714285714286
CDMX PONIENTE CONDESA,2023-03-24,104,96,8,0.0769230769230769
CDMX PONIENTE CONDESA,2023-03-25,117,110,7,0.0598290598290598
CDMX PONIENTE CONDESA,2023-03-26,76,76,0,0
CDMX PONIENTE CONDESA,2023-03-27,98,92,6,0.0612244897959184
CDMX PONIENTE CONDESA,2023-03-28,103,99,4,0.0388349514563107
CDMX PONIENTE CONDESA,2023-03-29,92,90,2,0.0217391304347826
CDMX PONIENTE CONDESA,2023-03-30,106,103,3,0.0283018867924528
CDMX PONIENTE CONDESA,2023-03-31,163,155,8,0.049079754601227
CDMX PONIENTE CONDESA,2023-04-01,152,144,8,0.0526315789473684
CDMX PONIENTE CONDESA,2023-04-02,69,68,1,0.0144927536231884
CDMX PONIENTE CONDESA,2023-04-03,118,116,2,0.0169491525423729
CDMX PONIENTE CONDESA,2023-04-04,124,123,1,0.00806451612903226
CDMX PONIENTE CONDESA,2023-04-05,101,95,6,0.0594059405940594
CDMX PONIENTE CONDESA,2023-04-06,105,104,1,0.00952380952380952
CDMX PONIENTE CONDESA,2023-04-07,86,85,1,0.0116279069767442
CDMX PONIENTE CONDESA,2023-04-08,58,58,0,0
CDMX PONIENTE CONDESA,2023-04-09,46,45,1,0.0217391304347826
CDMX PONIENTE CONDESA,2023-04-10,96,93,3,0.03125
CDMX PONIENTE CONDESA,2023-04-11,90,84,6,0.0666666666666667
CDMX PONIENTE CONDESA,2023-04-12,103,96,7,0.0679611650485437
CDMX PONIENTE CONDESA,2023-04-13,94,88,6,0.0638297872340425
CDMX PONIENTE CONDESA,2023-04-14,114,112,2,0.0175438596491228
CDMX PONIENTE CONDESA,2023-04-15,141,137,4,0.0283687943262411
CDMX PONIENTE CONDESA,2023-04-16,111,107,4,0.036036036036036
CDMX PONIENTE CONDESA,2023-04-17,109,102,7,0.0642201834862385
CDMX PONIENTE CONDESA,2023-04-18,103,96,7,0.0679611650485437
CDMX PONIENTE CONDESA,2023-04-19,113,109,4,0.0353982300884956
CDMX PONIENTE CONDESA,2023-04-20,98,93,5,0.0510204081632653
CDMX PONIENTE CONDESA,2023-04-21,120,115,5,0.0416666666666667
CDMX PONIENTE CONDESA,2023-04-22,106,101,5,0.0471698113207547
CDMX PONIENTE CONDESA,2023-04-23,95,91,4,0.0421052631578947
CDMX PONIENTE CONDESA,2023-04-24,101,90,11,0.108910891089109
CDMX PONIENTE CONDESA,2023-04-25,133,124,9,0.0676691729323308
CDMX PONIENTE CONDESA,2023-04-26,108,100,8,0.0740740740740741
CDMX PONIENTE CONDESA,2023-04-27,106,101,5,0.0471698113207547
CDMX PONIENTE CONDESA,2023-04-28,109,100,9,0.0825688073394495
CDMX PONIENTE CONDESA,2023-04-29,157,150,7,0.0445859872611465
CDMX PONIENTE CONDESA,2023-04-30,110,100,10,0.0909090909090909
CDMX PONIENTE CONDESA,2023-05-01,111,101,10,0.0900900900900901
CDMX PONIENTE CONDESA,2023-05-02,126,117,9,0.0714285714285714
CDMX PONIENTE CONDESA,2023-05-03,85,79,6,0.0705882352941176
CDMX PONIENTE CONDESA,2023-05-04,117,111,6,0.0512820512820513
CDMX PONIENTE CONDESA,2023-05-05,133,124,9,0.0676691729323308
CDMX PONIENTE CONDESA,2023-05-06,108,99,9,0.0833333333333333
CDMX PONIENTE CONDESA,2023-05-07,92,92,0,0
CDMX PONIENTE CONDESA,2023-05-08,103,95,8,0.0776699029126214
CDMX PONIENTE CONDESA,2023-05-09,113,103,10,0.0884955752212389
CDMX PONIENTE CONDESA,2023-05-10,116,106,10,0.0862068965517241
CDMX PONIENTE CONDESA,2023-05-11,113,103,10,0.0884955752212389
CDMX PONIENTE CONDESA,2023-05-12,120,110,10,0.0833333333333333
CDMX PONIENTE CONDESA,2023-05-13,146,138,8,0.0547945205479452
CDMX PONIENTE CONDESA,2023-05-14,108,102,6,0.0555555555555556
CDMX PONIENTE CONDESA,2023-05-15,144,133,11,0.0763888888888889
CDMX PONIENTE CONDESA,2023-05-16,148,133,15,0.101351351351351
CDMX PONIENTE CONDESA,2023-05-17,160,150,10,0.0625
CDMX PONIENTE CONDESA,2023-05-18,110,103,7,0.0636363636363636
CDMX PONIENTE CONDESA,2023-05-19,104,100,4,0.0384615384615385
CDMX PONIENTE CONDESA,2023-05-20,110,102,8,0.0727272727272727
CDMX PONIENTE CONDESA,2023-05-21,89,86,3,0.0337078651685393
CDMX PONIENTE CONDESA,2023-05-22,142,130,12,0.0845070422535211
CDMX PONIENTE CONDESA,2023-05-23,102,95,7,0.0686274509803922
CDMX PONIENTE CONDESA,2023-05-24,92,83,9,0.0978260869565217
CDMX PONIENTE CONDESA,2023-05-25,123,113,10,0.0813008130081301
CDMX PONIENTE CONDESA,2023-05-26,106,97,9,0.0849056603773585
CDMX PONIENTE CONDESA,2023-05-27,124,117,7,0.0564516129032258
CDMX PONIENTE CONDESA,2023-05-28,80,77,3,0.0375
CDMX PONIENTE CONDESA,2023-05-29,123,111,12,0.0975609756097561
CDMX PONIENTE CONDESA,2023-05-30,131,115,16,0.122137404580153
CDMX PONIENTE CONDESA,2023-05-31,122,109,13,0.10655737704918
CDMX PONIENTE CONDESA,2023-06-01,208,198,10,0.0480769230769231
CDMX PONIENTE CONDESA,2023-06-02,164,149,15,0.0914634146341463
CDMX PONIENTE CONDESA,2023-06-03,209,191,18,0.0861244019138756
CDMX PONIENTE CONDESA,2023-06-04,105,105,0,0
CDMX PONIENTE CONDESA,2023-06-05,103,86,17,0.16504854368932
CDMX PONIENTE CONDESA,2023-06-06,97,90,7,0.0721649484536082
CDMX PONIENTE CONDESA,2023-06-07,106,93,13,0.122641509433962
CDMX PONIENTE CONDESA,2023-06-08,108,100,8,0.0740740740740741
CDMX PONIENTE CONDESA,2023-06-09,125,112,13,0.104
CDMX PONIENTE CONDESA,2023-06-10,124,113,11,0.0887096774193548
CDMX PONIENTE CONDESA,2023-06-11,69,65,4,0.0579710144927536
CDMX PONIENTE CONDESA,2023-06-12,120,108,12,0.1
CDMX PONIENTE CONDESA,2023-06-13,96,87,9,0.09375
CDMX PONIENTE CONDESA,2023-06-14,105,98,7,0.0666666666666667
CDMX PONIENTE CONDESA,2023-06-15,114,105,9,0.0789473684210526
CDMX PONIENTE CONDESA,2023-06-16,101,93,8,0.0792079207920792
CDMX PONIENTE CONDESA,2023-06-17,96,90,6,0.0625
CDMX PONIENTE CONDESA,2023-06-18,101,96,5,0.0495049504950495
CDMX PONIENTE CONDESA,2023-06-19,120,111,9,0.075
CDMX PONIENTE CONDESA,2023-06-20,110,103,7,0.0636363636363636
CDMX PONIENTE CONDESA,2023-06-21,97,86,11,0.11340206185567
CDMX PONIENTE CONDESA,2023-06-22,98,94,4,0.0408163265306122
CDMX PONIENTE CONDESA,2023-06-23,84,79,5,0.0595238095238095
CDMX PONIENTE CONDESA,2023-06-24,112,103,9,0.0803571428571429
CDMX PONIENTE CONDESA,2023-06-25,90,85,5,0.0555555555555556
CDMX PONIENTE CONDESA,2023-06-26,101,98,3,0.0297029702970297
CDMX PONIENTE CONDESA,2023-06-27,113,108,5,0.0442477876106195
CDMX PONIENTE CONDESA,2023-06-28,88,84,4,0.0454545454545455
CDMX PONIENTE CONDESA,2023-06-29,96,86,10,0.104166666666667
CDMX PONIENTE CONDESA,2023-06-30,87,77,10,0.114942528735632
CDMX PONIENTE CONDESA,2023-07-01,122,113,9,0.0737704918032787
CDMX PONIENTE CONDESA,2023-07-02,59,56,3,0.0508474576271186
CDMX PONIENTE CONDESA,2023-07-03,113,109,4,0.0353982300884956
CDMX PONIENTE CONDESA,2023-07-04,104,98,6,0.0576923076923077
CDMX PONIENTE CONDESA,2023-07-05,99,91,8,0.0808080808080808
CDMX PONIENTE CONDESA,2023-07-06,108,106,2,0.0185185185185185
CDMX PONIENTE CONDESA,2023-07-07,146,143,3,0.0205479452054795
CDMX PONIENTE CONDESA,2023-07-08,142,137,5,0.0352112676056338
CDMX PONIENTE CONDESA,2023-07-09,111,111,0,0
CDMX PONIENTE CONDESA,2023-07-10,145,138,7,0.0482758620689655
CDMX PONIENTE CONDESA,2023-07-11,138,128,10,0.072463768115942
CDMX PONIENTE CONDESA,2023-07-12,135,122,13,0.0962962962962963
CDMX PONIENTE CONDESA,2023-07-13,111,99,12,0.108108108108108
CDMX PONIENTE CONDESA,2023-07-14,119,113,6,0.0504201680672269
CDMX PONIENTE CONDESA,2023-07-15,149,142,7,0.0469798657718121
CDMX PONIENTE CONDESA,2023-07-16,125,123,2,0.016
CDMX PONIENTE CONDESA,2023-07-17,145,137,8,0.0551724137931034
CDMX PONIENTE CONDESA,2023-07-18,126,120,6,0.0476190476190476
CDMX PONIENTE CONDESA,2023-07-19,138,136,2,0.0144927536231884
CDMX PONIENTE CONDESA,2023-07-20,146,136,10,0.0684931506849315
CDMX PONIENTE CONDESA,2023-07-21,106,95,11,0.10377358490566
CDMX PONIENTE CONDESA,2023-07-22,138,134,4,0.0289855072463768
CDMX PONIENTE CONDESA,2023-07-23,102,98,4,0.0392156862745098
CDMX PONIENTE CONDESA,2023-07-24,146,137,9,0.0616438356164384
CDMX PONIENTE CONDESA,2023-07-25,151,145,6,0.0397350993377483
CDMX PONIENTE CONDESA,2023-07-26,113,106,7,0.0619469026548673
CDMX PONIENTE CONDESA,2023-07-27,164,155,9,0.0548780487804878
CDMX PONIENTE CONDESA,2023-07-28,184,178,6,0.0326086956521739
CDMX PONIENTE CONDESA,2023-07-29,155,145,10,0.0645161290322581
CDMX PONIENTE CONDESA,2023-07-30,117,109,8,0.0683760683760684
CDMX PONIENTE CONDESA,2023-07-31,143,133,10,0.0699300699300699
CDMX PONIENTE CONDESA,2023-08-01,175,166,9,0.0514285714285714
CDMX PONIENTE CONDESA,2023-08-02,173,167,6,0.0346820809248555
CDMX PONIENTE CONDESA,2023-08-03,153,123,30,0.196078431372549
CDMX PONIENTE CONDESA,2023-08-04,133,126,7,0.0526315789473684
CDMX PONIENTE CONDESA,2023-08-05,156,145,11,0.0705128205128205
CDMX PONIENTE CONDESA,2023-08-06,121,118,3,0.0247933884297521
CDMX PONIENTE CONDESA,2023-08-07,139,134,5,0.0359712230215827
CDMX PONIENTE CONDESA,2023-08-08,155,144,11,0.0709677419354839
CDMX PONIENTE CONDESA,2023-08-09,176,163,13,0.0738636363636364
CDMX PONIENTE CONDESA,2023-08-10,142,136,6,0.0422535211267606
CDMX PONIENTE CONDESA,2023-08-11,156,146,10,0.0641025641025641
CDMX PONIENTE CONDESA,2023-08-12,153,151,2,0.0130718954248366
CDMX PONIENTE CONDESA,2023-08-13,117,111,6,0.0512820512820513
CDMX PONIENTE CONDESA,2023-08-14,144,135,9,0.0625
CDMX PONIENTE CONDESA,2023-08-15,189,180,9,0.0476190476190476
CDMX PONIENTE CONDESA,2023-08-16,155,149,6,0.0387096774193548
CDMX PONIENTE CONDESA,2023-08-17,183,172,11,0.0601092896174863
CDMX PONIENTE CONDESA,2023-08-18,154,145,9,0.0584415584415584
CDMX PONIENTE CONDESA,2023-08-19,147,140,7,0.0476190476190476
CDMX PONIENTE CONDESA,2023-08-20,122,117,5,0.040983606557377
CDMX PONIENTE CONDESA,2023-08-21,144,143,1,0.00694444444444444
CDMX PONIENTE CONDESA,2023-08-22,140,140,0,0
CDMX PONIENTE CONDESA,2023-08-23,150,148,2,0.0133333333333333
CDMX PONIENTE CONDESA,2023-08-24,165,160,5,0.0303030303030303
CDMX PONIENTE CONDESA,2023-08-25,153,148,5,0.0326797385620915
CDMX PONIENTE CONDESA,2023-08-26,170,168,2,0.0117647058823529
CDMX PONIENTE CONDESA,2023-08-27,126,124,2,0.0158730158730159
CDMX PONIENTE CONDESA,2023-08-28,153,150,3,0.0196078431372549
CDMX PONIENTE CONDESA,2023-08-29,154,152,2,0.012987012987013
CDMX PONIENTE CONDESA,2023-08-30,138,135,3,0.0217391304347826
CDMX PONIENTE CONDESA,2023-08-31,157,155,2,0.0127388535031847
CDMX PONIENTE CONDESA,2023-09-01,141,140,1,0.00709219858156028
CDMX PONIENTE CONDESA,2023-09-02,187,186,1,0.0053475935828877
CDMX PONIENTE CONDESA,2023-09-03,143,143,0,0
CDMX PONIENTE CONDESA,2023-09-04,142,141,1,0.00704225352112676
CDMX PONIENTE CONDESA,2023-09-05,160,160,0,0
CDMX PONIENTE CONDESA,2023-09-06,136,134,2,0.0147058823529412
CDMX PONIENTE CONDESA,2023-09-07,103,102,1,0.00970873786407767
CDMX PONIENTE CONDESA,2023-09-08,113,113,0,0
CDMX PONIENTE CONDESA,2023-09-09,171,171,0,0
CDMX PONIENTE CONDESA,2023-09-10,129,128,1,0.00775193798449612
CDMX PONIENTE CONDESA,2023-09-11,128,125,3,0.0234375
CDMX PONIENTE CONDESA,2023-09-12,158,158,0,0
CDMX PONIENTE CONDESA,2023-09-13,135,131,4,0.0296296296296296
CDMX PONIENTE CONDESA,2023-09-14,116,109,7,0.0603448275862069
CDMX PONIENTE CONDESA,2023-09-15,84,80,4,0.0476190476190476
CDMX PONIENTE CONDESA,2023-09-16,123,120,3,0.024390243902439
CDMX PONIENTE CONDESA,2023-09-17,107,106,1,0.00934579439252336
CDMX PONIENTE CONDESA,2023-09-18,119,118,1,0.00840336134453781
CDMX PONIENTE CONDESA,2023-09-19,147,144,3,0.0204081632653061
CDMX PONIENTE CONDESA,2023-09-20,141,136,5,0.0354609929078014
CDMX PONIENTE CONDESA,2023-09-21,146,140,6,0.0410958904109589
CDMX PONIENTE CONDESA,2023-09-22,169,163,6,0.0355029585798817
CDMX PONIENTE CONDESA,2023-09-23,164,164,0,0
CDMX PONIENTE CONDESA,2023-09-24,116,113,3,0.0258620689655172
CDMX PONIENTE CONDESA,2023-09-25,137,136,1,0.0072992700729927
CDMX PONIENTE CONDESA,2023-09-26,147,146,1,0.00680272108843537
CDMX PONIENTE CONDESA,2023-09-27,139,138,1,0.00719424460431655
CDMX PONIENTE CONDESA,2023-09-28,142,141,1,0.00704225352112676
CDMX PONIENTE CONDESA,2023-09-29,179,178,1,0.00558659217877095
CDMX PONIENTE CONDESA,2023-09-30,196,192,4,0.0204081632653061
CDMX PONIENTE CONDESA,2023-10-01,122,119,3,0.0245901639344262
CDMX PONIENTE CONDESA,2023-10-02,145,141,4,0.0275862068965517
CDMX PONIENTE CONDESA,2023-10-03,157,147,10,0.0636942675159236
CDMX PONIENTE CONDESA,2023-10-04,132,125,7,0.053030303030303
CDMX PONIENTE CONDESA,2023-10-05,119,111,8,0.0672268907563025
CDMX PONIENTE CONDESA,2023-10-06,134,125,9,0.0671641791044776
CDMX PONIENTE CONDESA,2023-10-07,117,114,3,0.0256410256410256
CDMX PONIENTE CONDESA,2023-10-08,89,85,4,0.0449438202247191
CDMX PONIENTE CONDESA,2023-10-09,131,121,10,0.0763358778625954
CDMX PONIENTE CONDESA,2023-10-10,133,128,5,0.037593984962406
CDMX PONIENTE CONDESA,2023-10-11,136,121,15,0.110294117647059
CDMX PONIENTE CONDESA,2023-10-12,119,114,5,0.0420168067226891
CDMX PONIENTE CONDESA,2023-10-13,114,106,8,0.0701754385964912
CDMX PONIENTE CONDESA,2023-10-14,134,129,5,0.0373134328358209
CDMX PONIENTE CONDESA,2023-10-15,91,91,0,0
CDMX PONIENTE CONDESA,2023-10-16,148,142,6,0.0405405405405405
CDMX PONIENTE CONDESA,2023-10-17,121,117,4,0.0330578512396694
CDMX PONIENTE CONDESA,2023-10-18,134,127,7,0.0522388059701493
CDMX PONIENTE CONDESA,2023-10-19,132,124,8,0.0606060606060606
CDMX PONIENTE CONDESA,2023-10-20,131,124,7,0.0534351145038168
CDMX PONIENTE CONDESA,2023-10-21,124,120,4,0.032258064516129
CDMX PONIENTE CONDESA,2023-10-22,93,91,2,0.021505376344086
CDMX PONIENTE CONDESA,2023-10-23,132,121,11,0.0833333333333333
CDMX PONIENTE CONDESA,2023-10-24,132,127,5,0.0378787878787879
CDMX PONIENTE CONDESA,2023-10-25,112,108,4,0.0357142857142857
CDMX PONIENTE CONDESA,2023-10-26,132,130,2,0.0151515151515152
CDMX PONIENTE CONDESA,2023-10-27,121,118,3,0.0247933884297521
CDMX PONIENTE CONDESA,2023-10-28,131,128,3,0.0229007633587786
CDMX PONIENTE CONDESA,2023-10-29,101,97,4,0.0396039603960396
CDMX PONIENTE CONDESA,2023-10-30,131,125,6,0.0458015267175573
CDMX PONIENTE CONDESA,2023-10-31,157,149,8,0.0509554140127389
CDMX PONIENTE CONDESA,2023-11-01,121,119,2,0.0165289256198347
CDMX PONIENTE CONDESA,2023-11-02,122,116,6,0.0491803278688525
CDMX PONIENTE CONDESA,2023-11-03,129,126,3,0.0232558139534884
CDMX PONIENTE CONDESA,2023-11-04,133,126,7,0.0526315789473684
CDMX PONIENTE CONDESA,2023-11-05,109,106,3,0.0275229357798165
CDMX PONIENTE CONDESA,2023-11-06,133,128,5,0.037593984962406
CDMX PONIENTE CONDESA,2023-11-07,132,121,11,0.0833333333333333
CDMX PONIENTE CONDESA,2023-11-08,149,143,6,0.0402684563758389
CDMX PONIENTE CONDESA,2023-11-09,118,114,4,0.0338983050847458
CDMX PONIENTE CONDESA,2023-11-10,131,124,7,0.0534351145038168
CDMX PONIENTE CONDESA,2023-11-11,148,142,6,0.0405405405405405
CDMX PONIENTE CONDESA,2023-11-12,95,92,3,0.0315789473684211
CDMX PONIENTE CONDESA,2023-11-13,145,136,9,0.0620689655172414
CDMX PONIENTE CONDESA,2023-11-14,149,145,4,0.0268456375838926
CDMX PONIENTE CONDESA,2023-11-15,165,157,8,0.0484848484848485
CDMX PONIENTE CONDESA,2023-11-16,156,148,8,0.0512820512820513
CDMX PONIENTE CONDESA,2023-11-17,164,160,4,0.024390243902439
CDMX PONIENTE CONDESA,2023-11-18,192,185,7,0.0364583333333333
CDMX PONIENTE CONDESA,2023-11-19,119,117,2,0.0168067226890756
CDMX PONIENTE CONDESA,2023-11-20,184,180,4,0.0217391304347826
CDMX PONIENTE CONDESA,2023-11-21,189,179,10,0.0529100529100529
CDMX PONIENTE CONDESA,2023-11-22,161,160,1,0.0062111801242236
CDMX PONIENTE CONDESA,2023-11-23,156,152,4,0.0256410256410256
CDMX PONIENTE CONDESA,2023-11-24,141,130,11,0.0780141843971631
CDMX PONIENTE CONDESA,2023-11-25,157,156,1,0.00636942675159236
CDMX PONIENTE CONDESA,2023-11-26,94,91,3,0.0319148936170213
CDMX PONIENTE CONDESA,2023-11-27,149,144,5,0.0335570469798658
CDMX PONIENTE CONDESA,2023-11-28,150,142,8,0.0533333333333333
CDMX PONIENTE CONDESA,2023-11-29,155,142,13,0.0838709677419355
CDMX PONIENTE CONDESA,2023-11-30,180,166,14,0.0777777777777778
CDMX PONIENTE CONDESA,2023-12-01,183,178,5,0.0273224043715847
CDMX PONIENTE CONDESA,2023-12-02,123,116,7,0.0569105691056911
CDMX PONIENTE CONDESA,2023-12-03,128,125,3,0.0234375
CDMX PONIENTE CONDESA,2023-12-04,169,158,11,0.0650887573964497
CDMX PONIENTE CONDESA,2023-12-05,174,169,5,0.028735632183908
CDMX PONIENTE CONDESA,2023-12-06,135,124,11,0.0814814814814815
CDMX PONIENTE CONDESA,2023-12-07,137,133,4,0.0291970802919708
CDMX PONIENTE CONDESA,2023-12-08,139,129,10,0.0719424460431655
CDMX PONIENTE CONDESA,2023-12-09,141,137,4,0.0283687943262411
CDMX PONIENTE CONDESA,2023-12-10,97,96,1,0.0103092783505155
CDMX PONIENTE CONDESA,2023-12-11,141,134,7,0.049645390070922
CDMX PONIENTE CONDESA,2023-12-12,166,154,12,0.072289156626506
CDMX PONIENTE CONDESA,2023-12-13,107,101,6,0.0560747663551402
CDMX PONIENTE CONDESA,2023-12-14,123,117,6,0.0487804878048781
CDMX PONIENTE CONDESA,2023-12-15,144,142,2,0.0138888888888889
CDMX PONIENTE CONDESA,2023-12-16,154,151,3,0.0194805194805195
CDMX PONIENTE CONDESA,2023-12-17,108,107,1,0.00925925925925926
CDMX PONIENTE CONDESA,2023-12-18,135,131,4,0.0296296296296296
CDMX PONIENTE CONDESA,2023-12-19,149,141,8,0.0536912751677852
CDMX PONIENTE CONDESA,2023-12-20,156,150,6,0.0384615384615385
CDMX PONIENTE CONDESA,2023-12-21,136,132,4,0.0294117647058824
CDMX PONIENTE CONDESA,2023-12-22,133,131,2,0.0150375939849624
CDMX PONIENTE CONDESA,2023-12-23,139,133,6,0.0431654676258993
CDMX PONIENTE CONDESA,2023-12-24,63,61,2,0.0317460317460317
CDMX PONIENTE CONDESA,2023-12-25,29,29,0,0
CDMX PONIENTE CONDESA,2023-12-26,127,119,8,0.062992125984252
CDMX PONIENTE CONDESA,2023-12-27,158,151,7,0.0443037974683544
CDMX PONIENTE CONDESA,2023-12-28,137,132,5,0.0364963503649635
CDMX PONIENTE CONDESA,2023-12-29,130,123,7,0.0538461538461538
CDMX PONIENTE CONDESA,2023-12-30,139,137,2,0.0143884892086331
CDMX PONIENTE CONDESA,2023-12-31,44,44,0,0
CDMX PONIENTE CONDESA,2024-01-01,35,34,1,0.0285714285714286
CDMX PONIENTE CONDESA,2024-01-02,126,118,8,0.0634920634920635
CDMX PONIENTE CONDESA,2024-01-03,179,176,3,0.0167597765363128
CDMX PONIENTE CONDESA,2024-01-04,151,151,0,0
CDMX PONIENTE CONDESA,2024-01-05,146,141,5,0.0342465753424658
CDMX PONIENTE CONDESA,2024-01-06,156,149,7,0.0448717948717949
CDMX PONIENTE CONDESA,2024-01-07,85,82,3,0.0352941176470588
CDMX PONIENTE CONDESA,2024-01-08,148,141,7,0.0472972972972973
CDMX PONIENTE CONDESA,2024-01-09,151,142,9,0.0596026490066225
CDMX PONIENTE CONDESA,2024-01-10,143,141,2,0.013986013986014
CDMX PONIENTE CONDESA,2024-01-11,136,132,4,0.0294117647058824
CDMX PONIENTE CONDESA,2024-01-12,164,157,7,0.0426829268292683
CDMX PONIENTE CONDESA,2024-01-13,164,158,6,0.0365853658536585
CDMX PONIENTE CONDESA,2024-01-14,137,132,5,0.0364963503649635
CDMX PONIENTE PEDREGAL,2023-01-02,97,50,47,0.484536082474227
CDMX PONIENTE PEDREGAL,2023-01-03,129,69,60,0.465116279069767
CDMX PONIENTE PEDREGAL,2023-01-04,122,70,52,0.426229508196721
CDMX PONIENTE PEDREGAL,2023-01-05,114,64,50,0.43859649122807
CDMX PONIENTE PEDREGAL,2023-01-06,104,53,51,0.490384615384615
CDMX PONIENTE PEDREGAL,2023-01-07,131,72,59,0.450381679389313
CDMX PONIENTE PEDREGAL,2023-01-08,105,67,38,0.361904761904762
CDMX PONIENTE PEDREGAL,2023-01-09,129,74,55,0.426356589147287
CDMX PONIENTE PEDREGAL,2023-01-10,119,60,59,0.495798319327731
CDMX PONIENTE PEDREGAL,2023-01-11,112,45,67,0.598214285714286
CDMX PONIENTE PEDREGAL,2023-01-12,119,56,63,0.529411764705882
CDMX PONIENTE PEDREGAL,2023-01-13,118,59,59,0.5
CDMX PONIENTE PEDREGAL,2023-01-14,141,58,83,0.588652482269504
CDMX PONIENTE PEDREGAL,2023-01-15,130,56,74,0.569230769230769
CDMX PONIENTE PEDREGAL,2023-01-16,124,41,83,0.669354838709677
CDMX PONIENTE PEDREGAL,2023-01-17,113,25,88,0.778761061946903
CDMX PONIENTE PEDREGAL,2023-01-18,105,34,71,0.676190476190476
CDMX PONIENTE PEDREGAL,2023-01-19,113,54,59,0.52212389380531
CDMX PONIENTE PEDREGAL,2023-01-20,117,52,65,0.555555555555556
CDMX PONIENTE PEDREGAL,2023-01-21,130,59,71,0.546153846153846
CDMX PONIENTE PEDREGAL,2023-01-22,108,46,62,0.574074074074074
CDMX PONIENTE PEDREGAL,2023-01-23,93,43,50,0.537634408602151
CDMX PONIENTE PEDREGAL,2023-01-24,118,47,71,0.601694915254237
CDMX PONIENTE PEDREGAL,2023-01-25,112,53,59,0.526785714285714
CDMX PONIENTE PEDREGAL,2023-01-26,118,45,73,0.61864406779661
CDMX PONIENTE PEDREGAL,2023-01-27,121,53,68,0.56198347107438
CDMX PONIENTE PEDREGAL,2023-01-28,135,58,77,0.57037037037037
CDMX PONIENTE PEDREGAL,2023-01-29,112,51,61,0.544642857142857
CDMX PONIENTE PEDREGAL,2023-01-30,125,39,86,0.688
CDMX PONIENTE PEDREGAL,2023-01-31,148,57,91,0.614864864864865
CDMX PONIENTE PEDREGAL,2023-02-01,132,41,91,0.689393939393939
CDMX PONIENTE PEDREGAL,2023-02-02,121,51,70,0.578512396694215
CDMX PONIENTE PEDREGAL,2023-02-03,130,51,79,0.607692307692308
CDMX PONIENTE PEDREGAL,2023-02-04,149,61,88,0.590604026845638
CDMX PONIENTE PEDREGAL,2023-02-05,120,51,69,0.575
CDMX PONIENTE PEDREGAL,2023-02-06,126,62,64,0.507936507936508
CDMX PONIENTE PEDREGAL,2023-02-07,110,49,61,0.554545454545455
CDMX PONIENTE PEDREGAL,2023-02-08,126,46,80,0.634920634920635
CDMX PONIENTE PEDREGAL,2023-02-09,110,50,60,0.545454545454545
CDMX PONIENTE PEDREGAL,2023-02-10,115,48,67,0.582608695652174
CDMX PONIENTE PEDREGAL,2023-02-11,123,43,80,0.650406504065041
CDMX PONIENTE PEDREGAL,2023-02-12,79,27,52,0.658227848101266
CDMX PONIENTE PEDREGAL,2023-02-13,120,50,70,0.583333333333333
CDMX PONIENTE PEDREGAL,2023-02-14,96,47,49,0.510416666666667
CDMX PONIENTE PEDREGAL,2023-02-15,93,56,37,0.397849462365591
CDMX PONIENTE PEDREGAL,2023-02-16,119,59,60,0.504201680672269
CDMX PONIENTE PEDREGAL,2023-02-17,111,45,66,0.594594594594595
CDMX PONIENTE PEDREGAL,2023-02-18,162,63,99,0.611111111111111
CDMX PONIENTE PEDREGAL,2023-02-19,93,39,54,0.580645161290323
CDMX PONIENTE PEDREGAL,2023-02-20,95,42,53,0.557894736842105
CDMX PONIENTE PEDREGAL,2023-02-21,90,47,43,0.477777777777778
CDMX PONIENTE PEDREGAL,2023-02-22,116,63,53,0.456896551724138
CDMX PONIENTE PEDREGAL,2023-02-23,100,47,53,0.53
CDMX PONIENTE PEDREGAL,2023-02-24,110,58,52,0.472727272727273
CDMX PONIENTE PEDREGAL,2023-02-25,147,66,81,0.551020408163265
CDMX PONIENTE PEDREGAL,2023-02-26,104,59,45,0.432692307692308
CDMX PONIENTE PEDREGAL,2023-02-27,102,43,59,0.57843137254902
CDMX PONIENTE PEDREGAL,2023-02-28,130,67,63,0.484615384615385
CDMX PONIENTE PEDREGAL,2023-03-01,142,57,85,0.598591549295775
CDMX PONIENTE PEDREGAL,2023-03-02,102,47,55,0.53921568627451
CDMX PONIENTE PEDREGAL,2023-03-03,130,64,66,0.507692307692308
CDMX PONIENTE PEDREGAL,2023-03-04,154,79,75,0.487012987012987
CDMX PONIENTE PEDREGAL,2023-03-05,137,58,79,0.576642335766423
CDMX PONIENTE PEDREGAL,2023-03-06,103,52,51,0.495145631067961
CDMX PONIENTE PEDREGAL,2023-03-07,120,58,62,0.516666666666667
CDMX PONIENTE PEDREGAL,2023-03-08,115,61,54,0.469565217391304
CDMX PONIENTE PEDREGAL,2023-03-09,113,66,47,0.415929203539823
CDMX PONIENTE PEDREGAL,2023-03-10,104,70,34,0.326923076923077
CDMX PONIENTE PEDREGAL,2023-03-11,117,72,45,0.384615384615385
CDMX PONIENTE PEDREGAL,2023-03-12,95,63,32,0.336842105263158
CDMX PONIENTE PEDREGAL,2023-03-13,119,81,38,0.319327731092437
CDMX PONIENTE PEDREGAL,2023-03-14,99,66,33,0.333333333333333
CDMX PONIENTE PEDREGAL,2023-03-15,103,84,19,0.184466019417476
CDMX PONIENTE PEDREGAL,2023-03-16,138,106,32,0.231884057971014
CDMX PONIENTE PEDREGAL,2023-03-17,157,115,42,0.267515923566879
CDMX PONIENTE PEDREGAL,2023-03-18,216,164,52,0.240740740740741
CDMX PONIENTE PEDREGAL,2023-03-19,153,130,23,0.150326797385621
CDMX PONIENTE PEDREGAL,2023-03-20,181,138,43,0.237569060773481
CDMX PONIENTE PEDREGAL,2023-03-21,134,110,24,0.17910447761194
CDMX PONIENTE PEDREGAL,2023-03-22,119,102,17,0.142857142857143
CDMX PONIENTE PEDREGAL,2023-03-23,127,110,17,0.133858267716535
CDMX PONIENTE PEDREGAL,2023-03-24,105,91,14,0.133333333333333
CDMX PONIENTE PEDREGAL,2023-03-25,150,129,21,0.14
CDMX PONIENTE PEDREGAL,2023-03-26,131,117,14,0.106870229007634
CDMX PONIENTE PEDREGAL,2023-03-27,113,102,11,0.0973451327433628
CDMX PONIENTE PEDREGAL,2023-03-28,101,94,7,0.0693069306930693
CDMX PONIENTE PEDREGAL,2023-03-29,105,99,6,0.0571428571428571
CDMX PONIENTE PEDREGAL,2023-03-30,156,140,16,0.102564102564103
CDMX PONIENTE PEDREGAL,2023-03-31,180,162,18,0.1
CDMX PONIENTE PEDREGAL,2023-04-01,150,146,4,0.0266666666666667
CDMX PONIENTE PEDREGAL,2023-04-02,102,93,9,0.0882352941176471
CDMX PONIENTE PEDREGAL,2023-04-03,128,116,12,0.09375
CDMX PONIENTE PEDREGAL,2023-04-04,145,134,11,0.0758620689655172
CDMX PONIENTE PEDREGAL,2023-04-05,114,89,25,0.219298245614035
CDMX PONIENTE PEDREGAL,2023-04-06,134,123,11,0.082089552238806
CDMX PONIENTE PEDREGAL,2023-04-07,100,97,3,0.03
CDMX PONIENTE PEDREGAL,2023-04-08,79,72,7,0.0886075949367089
CDMX PONIENTE PEDREGAL,2023-04-09,84,79,5,0.0595238095238095
CDMX PONIENTE PEDREGAL,2023-04-10,90,82,8,0.0888888888888889
CDMX PONIENTE PEDREGAL,2023-04-11,105,90,15,0.142857142857143
CDMX PONIENTE PEDREGAL,2023-04-12,102,91,11,0.107843137254902
CDMX PONIENTE PEDREGAL,2023-04-13,116,106,10,0.0862068965517241
CDMX PONIENTE PEDREGAL,2023-04-14,134,120,14,0.104477611940299
CDMX PONIENTE PEDREGAL,2023-04-15,177,145,32,0.180790960451977
CDMX PONIENTE PEDREGAL,2023-04-16,157,148,9,0.0573248407643312
CDMX PONIENTE PEDREGAL,2023-04-17,129,120,9,0.0697674418604651
CDMX PONIENTE PEDREGAL,2023-04-18,135,114,21,0.155555555555556
CDMX PONIENTE PEDREGAL,2023-04-19,116,107,9,0.0775862068965517
CDMX PONIENTE PEDREGAL,2023-04-20,97,86,11,0.11340206185567
CDMX PONIENTE PEDREGAL,2023-04-21,131,118,13,0.099236641221374
CDMX PONIENTE PEDREGAL,2023-04-22,133,126,7,0.0526315789473684
CDMX PONIENTE PEDREGAL,2023-04-23,124,112,12,0.0967741935483871
CDMX PONIENTE PEDREGAL,2023-04-24,145,129,16,0.110344827586207
CDMX PONIENTE PEDREGAL,2023-04-25,146,131,15,0.102739726027397
CDMX PONIENTE PEDREGAL,2023-04-26,134,122,12,0.0895522388059701
CDMX PONIENTE PEDREGAL,2023-04-27,120,105,15,0.125
CDMX PONIENTE PEDREGAL,2023-04-28,152,136,16,0.105263157894737
CDMX PONIENTE PEDREGAL,2023-04-29,179,162,17,0.0949720670391061
CDMX PONIENTE PEDREGAL,2023-04-30,122,103,19,0.155737704918033
CDMX PONIENTE PEDREGAL,2023-05-01,108,85,23,0.212962962962963
CDMX PONIENTE PEDREGAL,2023-05-02,138,121,17,0.123188405797101
CDMX PONIENTE PEDREGAL,2023-05-03,103,89,14,0.135922330097087
CDMX PONIENTE PEDREGAL,2023-05-04,126,116,10,0.0793650793650794
CDMX PONIENTE PEDREGAL,2023-05-05,148,134,14,0.0945945945945946
CDMX PONIENTE PEDREGAL,2023-05-06,115,106,9,0.0782608695652174
CDMX PONIENTE PEDREGAL,2023-05-07,104,95,9,0.0865384615384615
CDMX PONIENTE PEDREGAL,2023-05-08,94,88,6,0.0638297872340425
CDMX PONIENTE PEDREGAL,2023-05-09,103,93,10,0.0970873786407767
CDMX PONIENTE PEDREGAL,2023-05-10,106,96,10,0.0943396226415094
CDMX PONIENTE PEDREGAL,2023-05-11,101,92,9,0.0891089108910891
CDMX PONIENTE PEDREGAL,2023-05-12,134,115,19,0.141791044776119
CDMX PONIENTE PEDREGAL,2023-05-13,143,135,8,0.0559440559440559
CDMX PONIENTE PEDREGAL,2023-05-14,149,138,11,0.0738255033557047
CDMX PONIENTE PEDREGAL,2023-05-15,178,164,14,0.0786516853932584
CDMX PONIENTE PEDREGAL,2023-05-16,179,164,15,0.0837988826815642
CDMX PONIENTE PEDREGAL,2023-05-17,181,158,23,0.12707182320442
CDMX PONIENTE PEDREGAL,2023-05-18,139,130,9,0.0647482014388489
CDMX PONIENTE PEDREGAL,2023-05-19,96,87,9,0.09375
CDMX PONIENTE PEDREGAL,2023-05-20,152,141,11,0.0723684210526316
CDMX PONIENTE PEDREGAL,2023-05-21,120,104,16,0.133333333333333
CDMX PONIENTE PEDREGAL,2023-05-22,155,144,11,0.0709677419354839
CDMX PONIENTE PEDREGAL,2023-05-23,119,110,9,0.0756302521008403
CDMX PONIENTE PEDREGAL,2023-05-24,119,114,5,0.0420168067226891
CDMX PONIENTE PEDREGAL,2023-05-25,106,94,12,0.113207547169811
CDMX PONIENTE PEDREGAL,2023-05-26,114,102,12,0.105263157894737
CDMX PONIENTE PEDREGAL,2023-05-27,143,134,9,0.0629370629370629
CDMX PONIENTE PEDREGAL,2023-05-28,114,107,7,0.0614035087719298
CDMX PONIENTE PEDREGAL,2023-05-29,146,129,17,0.116438356164384
CDMX PONIENTE PEDREGAL,2023-05-30,154,128,26,0.168831168831169
CDMX PONIENTE PEDREGAL,2023-05-31,165,139,26,0.157575757575758
CDMX PONIENTE PEDREGAL,2023-06-01,215,205,10,0.0465116279069767
CDMX PONIENTE PEDREGAL,2023-06-02,225,209,16,0.0711111111111111
CDMX PONIENTE PEDREGAL,2023-06-03,200,166,34,0.17
CDMX PONIENTE PEDREGAL,2023-06-04,231,201,30,0.12987012987013
CDMX PONIENTE PEDREGAL,2023-06-05,126,109,17,0.134920634920635
CDMX PONIENTE PEDREGAL,2023-06-06,128,119,9,0.0703125
CDMX PONIENTE PEDREGAL,2023-06-07,111,98,13,0.117117117117117
CDMX PONIENTE PEDREGAL,2023-06-08,128,109,19,0.1484375
CDMX PONIENTE PEDREGAL,2023-06-09,116,101,15,0.129310344827586
CDMX PONIENTE PEDREGAL,2023-06-10,132,113,19,0.143939393939394
CDMX PONIENTE PEDREGAL,2023-06-11,122,111,11,0.0901639344262295
CDMX PONIENTE PEDREGAL,2023-06-12,157,142,15,0.0955414012738854
CDMX PONIENTE PEDREGAL,2023-06-13,118,101,17,0.144067796610169
CDMX PONIENTE PEDREGAL,2023-06-14,153,137,16,0.104575163398693
CDMX PONIENTE PEDREGAL,2023-06-15,139,133,6,0.0431654676258993
CDMX PONIENTE PEDREGAL,2023-06-16,128,112,16,0.125
CDMX PONIENTE PEDREGAL,2023-06-17,161,142,19,0.118012422360248
CDMX PONIENTE PEDREGAL,2023-06-18,97,90,7,0.0721649484536082
CDMX PONIENTE PEDREGAL,2023-06-19,132,118,14,0.106060606060606
CDMX PONIENTE PEDREGAL,2023-06-20,116,102,14,0.120689655172414
CDMX PONIENTE PEDREGAL,2023-06-21,109,97,12,0.110091743119266
CDMX PONIENTE PEDREGAL,2023-06-22,120,108,12,0.1
CDMX PONIENTE PEDREGAL,2023-06-23,140,123,17,0.121428571428571
CDMX PONIENTE PEDREGAL,2023-06-24,135,129,6,0.0444444444444444
CDMX PONIENTE PEDREGAL,2023-06-25,96,92,4,0.0416666666666667
CDMX PONIENTE PEDREGAL,2023-06-26,113,105,8,0.0707964601769911
CDMX PONIENTE PEDREGAL,2023-06-27,102,95,7,0.0686274509803922
CDMX PONIENTE PEDREGAL,2023-06-28,101,97,4,0.0396039603960396
CDMX PONIENTE PEDREGAL,2023-06-29,111,107,4,0.036036036036036
CDMX PONIENTE PEDREGAL,2023-06-30,121,102,19,0.15702479338843
CDMX PONIENTE PEDREGAL,2023-07-01,136,129,7,0.0514705882352941
CDMX PONIENTE PEDREGAL,2023-07-02,92,92,0,0
CDMX PONIENTE PEDREGAL,2023-07-03,88,82,6,0.0681818181818182
CDMX PONIENTE PEDREGAL,2023-07-04,116,109,7,0.0603448275862069
CDMX PONIENTE PEDREGAL,2023-07-05,94,87,7,0.074468085106383
CDMX PONIENTE PEDREGAL,2023-07-06,126,120,6,0.0476190476190476
CDMX PONIENTE PEDREGAL,2023-07-07,142,135,7,0.0492957746478873
CDMX PONIENTE PEDREGAL,2023-07-08,169,158,11,0.0650887573964497
CDMX PONIENTE PEDREGAL,2023-07-09,131,123,8,0.0610687022900763
CDMX PONIENTE PEDREGAL,2023-07-10,121,117,4,0.0330578512396694
CDMX PONIENTE PEDREGAL,2023-07-11,143,139,4,0.027972027972028
CDMX PONIENTE PEDREGAL,2023-07-12,120,115,5,0.0416666666666667
CDMX PONIENTE PEDREGAL,2023-07-13,140,135,5,0.0357142857142857
CDMX PONIENTE PEDREGAL,2023-07-14,105,101,4,0.0380952380952381
CDMX PONIENTE PEDREGAL,2023-07-15,133,128,5,0.037593984962406
CDMX PONIENTE PEDREGAL,2023-07-16,125,123,2,0.016
CDMX PONIENTE PEDREGAL,2023-07-17,147,141,6,0.0408163265306122
CDMX PONIENTE PEDREGAL,2023-07-18,128,124,4,0.03125
CDMX PONIENTE PEDREGAL,2023-07-19,141,133,8,0.0567375886524823
CDMX PONIENTE PEDREGAL,2023-07-20,145,138,7,0.0482758620689655
CDMX PONIENTE PEDREGAL,2023-07-21,140,138,2,0.0142857142857143
CDMX PONIENTE PEDREGAL,2023-07-22,151,147,4,0.0264900662251656
CDMX PONIENTE PEDREGAL,2023-07-23,138,134,4,0.0289855072463768
CDMX PONIENTE PEDREGAL,2023-07-24,143,136,7,0.048951048951049
CDMX PONIENTE PEDREGAL,2023-07-25,132,127,5,0.0378787878787879
CDMX PONIENTE PEDREGAL,2023-07-26,121,117,4,0.0330578512396694
CDMX PONIENTE PEDREGAL,2023-07-27,137,136,1,0.0072992700729927
CDMX PONIENTE PEDREGAL,2023-07-28,167,162,5,0.029940119760479
CDMX PONIENTE PEDREGAL,2023-07-29,153,148,5,0.0326797385620915
CDMX PONIENTE PEDREGAL,2023-07-30,127,126,1,0.0078740157480315
CDMX PONIENTE PEDREGAL,2023-07-31,153,148,5,0.0326797385620915
CDMX PONIENTE PEDREGAL,2023-08-01,169,164,5,0.029585798816568
CDMX PONIENTE PEDREGAL,2023-08-02,169,160,9,0.0532544378698225
CDMX PONIENTE PEDREGAL,2023-08-03,179,161,18,0.100558659217877
CDMX PONIENTE PEDREGAL,2023-08-04,159,151,8,0.050314465408805
CDMX PONIENTE PEDREGAL,2023-08-05,156,149,7,0.0448717948717949
CDMX PONIENTE PEDREGAL,2023-08-06,137,134,3,0.0218978102189781
CDMX PONIENTE PEDREGAL,2023-08-07,143,136,7,0.048951048951049
CDMX PONIENTE PEDREGAL,2023-08-08,141,140,1,0.00709219858156028
CDMX PONIENTE PEDREGAL,2023-08-09,152,147,5,0.0328947368421053
CDMX PONIENTE PEDREGAL,2023-08-10,134,127,7,0.0522388059701493
CDMX PONIENTE PEDREGAL,2023-08-11,161,157,4,0.0248447204968944
CDMX PONIENTE PEDREGAL,2023-08-12,148,143,5,0.0337837837837838
CDMX PONIENTE PEDREGAL,2023-08-13,130,128,2,0.0153846153846154
CDMX PONIENTE PEDREGAL,2023-08-14,122,118,4,0.0327868852459016
CDMX PONIENTE PEDREGAL,2023-08-15,184,179,5,0.0271739130434783
CDMX PONIENTE PEDREGAL,2023-08-16,151,147,4,0.0264900662251656
CDMX PONIENTE PEDREGAL,2023-08-17,131,125,6,0.0458015267175573
CDMX PONIENTE PEDREGAL,2023-08-18,180,169,11,0.0611111111111111
CDMX PONIENTE PEDREGAL,2023-08-19,150,142,8,0.0533333333333333
CDMX PONIENTE PEDREGAL,2023-08-20,142,136,6,0.0422535211267606
CDMX PONIENTE PEDREGAL,2023-08-21,121,120,1,0.00826446280991736
CDMX PONIENTE PEDREGAL,2023-08-22,130,128,2,0.0153846153846154
CDMX PONIENTE PEDREGAL,2023-08-23,135,132,3,0.0222222222222222
CDMX PONIENTE PEDREGAL,2023-08-24,159,157,2,0.0125786163522013
CDMX PONIENTE PEDREGAL,2023-08-25,138,137,1,0.0072463768115942
CDMX PONIENTE PEDREGAL,2023-08-26,161,159,2,0.0124223602484472
CDMX PONIENTE PEDREGAL,2023-08-27,180,179,1,0.00555555555555556
CDMX PONIENTE PEDREGAL,2023-08-28,123,121,2,0.016260162601626
CDMX PONIENTE PEDREGAL,2023-08-29,137,136,1,0.0072992700729927
CDMX PONIENTE PEDREGAL,2023-08-30,153,151,2,0.0130718954248366
CDMX PONIENTE PEDREGAL,2023-08-31,147,145,2,0.0136054421768707
CDMX PONIENTE PEDREGAL,2023-09-01,153,151,2,0.0130718954248366
CDMX PONIENTE PEDREGAL,2023-09-02,155,153,2,0.0129032258064516
CDMX PONIENTE PEDREGAL,2023-09-03,128,126,2,0.015625
CDMX PONIENTE PEDREGAL,2023-09-04,121,121,0,0
CDMX PONIENTE PEDREGAL,2023-09-05,137,135,2,0.0145985401459854
CDMX PONIENTE PEDREGAL,2023-09-06,120,119,1,0.00833333333333333
CDMX PONIENTE PEDREGAL,2023-09-07,121,120,1,0.00826446280991736
CDMX PONIENTE PEDREGAL,2023-09-08,108,107,1,0.00925925925925926
CDMX PONIENTE PEDREGAL,2023-09-09,147,145,2,0.0136054421768707
CDMX PONIENTE PEDREGAL,2023-09-10,107,107,0,0
CDMX PONIENTE PEDREGAL,2023-09-11,138,135,3,0.0217391304347826
CDMX PONIENTE PEDREGAL,2023-09-12,138,136,2,0.0144927536231884
CDMX PONIENTE PEDREGAL,2023-09-13,107,106,1,0.00934579439252336
CDMX PONIENTE PEDREGAL,2023-09-14,124,122,2,0.0161290322580645
CDMX PONIENTE PEDREGAL,2023-09-15,153,151,2,0.0130718954248366
CDMX PONIENTE PEDREGAL,2023-09-16,98,96,2,0.0204081632653061
CDMX PONIENTE PEDREGAL,2023-09-17,106,103,3,0.0283018867924528
CDMX PONIENTE PEDREGAL,2023-09-18,138,136,2,0.0144927536231884
CDMX PONIENTE PEDREGAL,2023-09-19,136,135,1,0.00735294117647059
CDMX PONIENTE PEDREGAL,2023-09-20,124,123,1,0.00806451612903226
CDMX PONIENTE PEDREGAL,2023-09-21,144,141,3,0.0208333333333333
CDMX PONIENTE PEDREGAL,2023-09-22,128,124,4,0.03125
CDMX PONIENTE PEDREGAL,2023-09-23,148,145,3,0.0202702702702703
CDMX PONIENTE PEDREGAL,2023-09-24,117,115,2,0.0170940170940171
CDMX PONIENTE PEDREGAL,2023-09-25,128,125,3,0.0234375
CDMX PONIENTE PEDREGAL,2023-09-26,138,137,1,0.0072463768115942
CDMX PONIENTE PEDREGAL,2023-09-27,129,128,1,0.00775193798449612
CDMX PONIENTE PEDREGAL,2023-09-28,131,129,2,0.0152671755725191
CDMX PONIENTE PEDREGAL,2023-09-29,147,139,8,0.054421768707483
CDMX PONIENTE PEDREGAL,2023-09-30,168,161,7,0.0416666666666667
CDMX PONIENTE PEDREGAL,2023-10-01,119,117,2,0.0168067226890756
CDMX PONIENTE PEDREGAL,2023-10-02,125,125,0,0
CDMX PONIENTE PEDREGAL,2023-10-03,126,122,4,0.0317460317460317
CDMX PONIENTE PEDREGAL,2023-10-04,111,109,2,0.018018018018018
CDMX PONIENTE PEDREGAL,2023-10-05,112,110,2,0.0178571428571429
CDMX PONIENTE PEDREGAL,2023-10-06,122,119,3,0.0245901639344262
CDMX PONIENTE PEDREGAL,2023-10-07,141,140,1,0.00709219858156028
CDMX PONIENTE PEDREGAL,2023-10-08,95,88,7,0.0736842105263158
CDMX PONIENTE PEDREGAL,2023-10-09,111,109,2,0.018018018018018
CDMX PONIENTE PEDREGAL,2023-10-10,129,125,4,0.0310077519379845
CDMX PONIENTE PEDREGAL,2023-10-11,115,111,4,0.0347826086956522
CDMX PONIENTE PEDREGAL,2023-10-12,93,89,4,0.043010752688172
CDMX PONIENTE PEDREGAL,2023-10-13,109,105,4,0.036697247706422
CDMX PONIENTE PEDREGAL,2023-10-14,119,115,4,0.0336134453781513
CDMX PONIENTE PEDREGAL,2023-10-15,126,124,2,0.0158730158730159
CDMX PONIENTE PEDREGAL,2023-10-16,141,138,3,0.0212765957446809
CDMX PONIENTE PEDREGAL,2023-10-17,124,122,2,0.0161290322580645
CDMX PONIENTE PEDREGAL,2023-10-18,110,106,4,0.0363636363636364
CDMX PONIENTE PEDREGAL,2023-10-19,142,136,6,0.0422535211267606
CDMX PONIENTE PEDREGAL,2023-10-20,125,121,4,0.032
CDMX PONIENTE PEDREGAL,2023-10-21,115,112,3,0.0260869565217391
CDMX PONIENTE PEDREGAL,2023-10-22,122,120,2,0.0163934426229508
CDMX PONIENTE PEDREGAL,2023-10-23,93,90,3,0.032258064516129
CDMX PONIENTE PEDREGAL,2023-10-24,106,101,5,0.0471698113207547
CDMX PONIENTE PEDREGAL,2023-10-25,119,115,4,0.0336134453781513
CDMX PONIENTE PEDREGAL,2023-10-26,110,107,3,0.0272727272727273
CDMX PONIENTE PEDREGAL,2023-10-27,115,114,1,0.00869565217391304
CDMX PONIENTE PEDREGAL,2023-10-28,149,146,3,0.0201342281879195
CDMX PONIENTE PEDREGAL,2023-10-29,120,118,2,0.0166666666666667
CDMX PONIENTE PEDREGAL,2023-10-30,126,125,1,0.00793650793650794
CDMX PONIENTE PEDREGAL,2023-10-31,157,153,4,0.0254777070063694
CDMX PONIENTE PEDREGAL,2023-11-01,138,136,2,0.0144927536231884
CDMX PONIENTE PEDREGAL,2023-11-02,107,107,0,0
CDMX PONIENTE PEDREGAL,2023-11-03,113,111,2,0.0176991150442478
CDMX PONIENTE PEDREGAL,2023-11-04,142,142,0,0
CDMX PONIENTE PEDREGAL,2023-11-05,123,122,1,0.00813008130081301
CDMX PONIENTE PEDREGAL,2023-11-06,130,130,0,0
CDMX PONIENTE PEDREGAL,2023-11-07,132,131,1,0.00757575757575758
CDMX PONIENTE PEDREGAL,2023-11-08,133,130,3,0.0225563909774436
CDMX PONIENTE PEDREGAL,2023-11-09,119,116,3,0.0252100840336134
CDMX PONIENTE PEDREGAL,2023-11-10,133,131,2,0.0150375939849624
CDMX PONIENTE PEDREGAL,2023-11-11,170,166,4,0.0235294117647059
CDMX PONIENTE PEDREGAL,2023-11-12,130,128,2,0.0153846153846154
CDMX PONIENTE PEDREGAL,2023-11-13,140,136,4,0.0285714285714286
CDMX PONIENTE PEDREGAL,2023-11-14,159,155,4,0.0251572327044025
CDMX PONIENTE PEDREGAL,2023-11-15,152,150,2,0.0131578947368421
CDMX PONIENTE PEDREGAL,2023-11-16,142,139,3,0.0211267605633803
CDMX PONIENTE PEDREGAL,2023-11-17,174,168,6,0.0344827586206897
CDMX PONIENTE PEDREGAL,2023-11-18,221,218,3,0.0135746606334842
CDMX PONIENTE PEDREGAL,2023-11-19,163,158,5,0.0306748466257669
CDMX PONIENTE PEDREGAL,2023-11-20,162,156,6,0.037037037037037
CDMX PONIENTE PEDREGAL,2023-11-21,162,159,3,0.0185185185185185
CDMX PONIENTE PEDREGAL,2023-11-22,147,144,3,0.0204081632653061
CDMX PONIENTE PEDREGAL,2023-11-23,163,158,5,0.0306748466257669
CDMX PONIENTE PEDREGAL,2023-11-24,156,153,3,0.0192307692307692
CDMX PONIENTE PEDREGAL,2023-11-25,166,165,1,0.00602409638554217
CDMX PONIENTE PEDREGAL,2023-11-26,156,152,4,0.0256410256410256
CDMX PONIENTE PEDREGAL,2023-11-27,170,166,4,0.0235294117647059
CDMX PONIENTE PEDREGAL,2023-11-28,163,161,2,0.0122699386503067
CDMX PONIENTE PEDREGAL,2023-11-29,164,155,9,0.0548780487804878
CDMX PONIENTE PEDREGAL,2023-11-30,186,172,14,0.0752688172043011
CDMX PONIENTE PEDREGAL,2023-12-01,151,144,7,0.0463576158940397
CDMX PONIENTE PEDREGAL,2023-12-02,161,154,7,0.0434782608695652
CDMX PONIENTE PEDREGAL,2023-12-03,164,156,8,0.0487804878048781
CDMX PONIENTE PEDREGAL,2023-12-04,147,143,4,0.0272108843537415
CDMX PONIENTE PEDREGAL,2023-12-05,141,131,10,0.0709219858156028
CDMX PONIENTE PEDREGAL,2023-12-06,136,130,6,0.0441176470588235
CDMX PONIENTE PEDREGAL,2023-12-07,127,120,7,0.0551181102362205
CDMX PONIENTE PEDREGAL,2023-12-08,122,118,4,0.0327868852459016
CDMX PONIENTE PEDREGAL,2023-12-09,146,143,3,0.0205479452054795
CDMX PONIENTE PEDREGAL,2023-12-10,120,118,2,0.0166666666666667
CDMX PONIENTE PEDREGAL,2023-12-11,137,134,3,0.0218978102189781
CDMX PONIENTE PEDREGAL,2023-12-12,140,136,4,0.0285714285714286
CDMX PONIENTE PEDREGAL,2023-12-13,136,135,1,0.00735294117647059
CDMX PONIENTE PEDREGAL,2023-12-14,122,119,3,0.0245901639344262
CDMX PONIENTE PEDREGAL,2023-12-15,129,129,0,0
CDMX PONIENTE PEDREGAL,2023-12-16,150,149,1,0.00666666666666667
CDMX PONIENTE PEDREGAL,2023-12-17,109,106,3,0.0275229357798165
CDMX PONIENTE PEDREGAL,2023-12-18,174,172,2,0.0114942528735632
CDMX PONIENTE PEDREGAL,2023-12-19,152,149,3,0.0197368421052632
CDMX PONIENTE PEDREGAL,2023-12-20,150,144,6,0.04
CDMX PONIENTE PEDREGAL,2023-12-21,148,145,3,0.0202702702702703
CDMX PONIENTE PEDREGAL,2023-12-22,125,122,3,0.024
CDMX PONIENTE PEDREGAL,2023-12-23,128,125,3,0.0234375
CDMX PONIENTE PEDREGAL,2023-12-24,91,89,2,0.021978021978022
CDMX PONIENTE PEDREGAL,2023-12-25,39,39,0,0
CDMX PONIENTE PEDREGAL,2023-12-26,132,126,6,0.0454545454545455
CDMX PONIENTE PEDREGAL,2023-12-27,158,157,1,0.00632911392405063
CDMX PONIENTE PEDREGAL,2023-12-28,137,132,5,0.0364963503649635
CDMX PONIENTE PEDREGAL,2023-12-29,154,151,3,0.0194805194805195
CDMX PONIENTE PEDREGAL,2023-12-30,177,172,5,0.0282485875706215
CDMX PONIENTE PEDREGAL,2023-12-31,93,88,5,0.0537634408602151
CDMX PONIENTE PEDREGAL,2024-01-01,34,34,0,0
CDMX PONIENTE PEDREGAL,2024-01-02,139,138,1,0.00719424460431655
CDMX PONIENTE PEDREGAL,2024-01-03,149,147,2,0.0134228187919463
CDMX PONIENTE PEDREGAL,2024-01-04,145,143,2,0.0137931034482759
CDMX PONIENTE PEDREGAL,2024-01-05,132,128,4,0.0303030303030303
CDMX PONIENTE PEDREGAL,2024-01-06,143,140,3,0.020979020979021
CDMX PONIENTE PEDREGAL,2024-01-07,128,125,3,0.0234375
CDMX PONIENTE PEDREGAL,2024-01-08,152,148,4,0.0263157894736842
CDMX PONIENTE PEDREGAL,2024-01-09,149,148,1,0.00671140939597315
CDMX PONIENTE PEDREGAL,2024-01-10,120,116,4,0.0333333333333333
CDMX PONIENTE PEDREGAL,2024-01-11,137,132,5,0.0364963503649635
CDMX PONIENTE PEDREGAL,2024-01-12,157,154,3,0.0191082802547771
CDMX PONIENTE PEDREGAL,2024-01-13,166,159,7,0.0421686746987952
CDMX PONIENTE PEDREGAL,2024-01-14,153,148,5,0.0326797385620915
CDMX SUR ORIENTE,2023-01-02,135,95,40,0.296296296296296
CDMX SUR ORIENTE,2023-01-03,164,125,39,0.23780487804878
CDMX SUR ORIENTE,2023-01-04,187,139,48,0.25668449197861
CDMX SUR ORIENTE,2023-01-05,156,106,50,0.320512820512821
CDMX SUR ORIENTE,2023-01-06,160,122,38,0.2375
CDMX SUR ORIENTE,2023-01-07,212,159,53,0.25
CDMX SUR ORIENTE,2023-01-08,195,151,44,0.225641025641026
CDMX SUR ORIENTE,2023-01-09,175,132,43,0.245714285714286
CDMX SUR ORIENTE,2023-01-10,208,158,50,0.240384615384615
CDMX SUR ORIENTE,2023-01-11,205,142,63,0.307317073170732
CDMX SUR ORIENTE,2023-01-12,199,135,64,0.321608040201005
CDMX SUR ORIENTE,2023-01-13,184,134,50,0.271739130434783
CDMX SUR ORIENTE,2023-01-14,212,154,58,0.273584905660377
CDMX SUR ORIENTE,2023-01-15,193,140,53,0.274611398963731
CDMX SUR ORIENTE,2023-01-16,186,127,59,0.317204301075269
CDMX SUR ORIENTE,2023-01-17,176,118,58,0.329545454545455
CDMX SUR ORIENTE,2023-01-18,216,130,86,0.398148148148148
CDMX SUR ORIENTE,2023-01-19,205,128,77,0.375609756097561
CDMX SUR ORIENTE,2023-01-20,188,121,67,0.356382978723404
CDMX SUR ORIENTE,2023-01-21,214,135,79,0.369158878504673
CDMX SUR ORIENTE,2023-01-22,193,124,69,0.357512953367876
CDMX SUR ORIENTE,2023-01-23,185,123,62,0.335135135135135
CDMX SUR ORIENTE,2023-01-24,194,125,69,0.355670103092784
CDMX SUR ORIENTE,2023-01-25,204,134,70,0.343137254901961
CDMX SUR ORIENTE,2023-01-26,214,123,91,0.425233644859813
CDMX SUR ORIENTE,2023-01-27,197,117,80,0.406091370558376
CDMX SUR ORIENTE,2023-01-28,233,134,99,0.424892703862661
CDMX SUR ORIENTE,2023-01-29,222,139,83,0.373873873873874
CDMX SUR ORIENTE,2023-01-30,229,149,80,0.349344978165939
CDMX SUR ORIENTE,2023-01-31,227,142,85,0.374449339207048
CDMX SUR ORIENTE,2023-02-01,197,133,64,0.3248730964467
CDMX SUR ORIENTE,2023-02-02,211,133,78,0.369668246445498
CDMX SUR ORIENTE,2023-02-03,182,123,59,0.324175824175824
CDMX SUR ORIENTE,2023-02-04,239,148,91,0.380753138075314
CDMX SUR ORIENTE,2023-02-05,200,118,82,0.41
CDMX SUR ORIENTE,2023-02-06,214,134,80,0.373831775700935
CDMX SUR ORIENTE,2023-02-07,177,79,98,0.553672316384181
CDMX SUR ORIENTE,2023-02-08,148,76,72,0.486486486486487
CDMX SUR ORIENTE,2023-02-09,168,80,88,0.523809523809524
CDMX SUR ORIENTE,2023-02-10,173,88,85,0.491329479768786
CDMX SUR ORIENTE,2023-02-11,229,118,111,0.48471615720524
CDMX SUR ORIENTE,2023-02-12,209,101,108,0.516746411483254
CDMX SUR ORIENTE,2023-02-13,176,74,102,0.579545454545455
CDMX SUR ORIENTE,2023-02-14,165,79,86,0.521212121212121
CDMX SUR ORIENTE,2023-02-15,216,97,119,0.550925925925926
CDMX SUR ORIENTE,2023-02-16,184,83,101,0.548913043478261
CDMX SUR ORIENTE,2023-02-17,187,92,95,0.508021390374332
CDMX SUR ORIENTE,2023-02-18,239,126,113,0.472803347280335
CDMX SUR ORIENTE,2023-02-19,244,115,129,0.528688524590164
CDMX SUR ORIENTE,2023-02-20,212,113,99,0.466981132075472
CDMX SUR ORIENTE,2023-02-21,200,129,71,0.355
CDMX SUR ORIENTE,2023-02-22,184,143,41,0.222826086956522
CDMX SUR ORIENTE,2023-02-23,192,161,31,0.161458333333333
CDMX SUR ORIENTE,2023-02-24,165,137,28,0.16969696969697
CDMX SUR ORIENTE,2023-02-25,253,204,49,0.193675889328063
CDMX SUR ORIENTE,2023-02-26,214,175,39,0.182242990654206
CDMX SUR ORIENTE,2023-02-27,206,153,53,0.257281553398058
CDMX SUR ORIENTE,2023-02-28,217,180,37,0.170506912442396
CDMX SUR ORIENTE,2023-03-01,148,122,26,0.175675675675676
CDMX SUR ORIENTE,2023-03-02,201,174,27,0.134328358208955
CDMX SUR ORIENTE,2023-03-03,200,180,20,0.1
CDMX SUR ORIENTE,2023-03-04,232,192,40,0.172413793103448
CDMX SUR ORIENTE,2023-03-05,222,169,53,0.238738738738739
CDMX SUR ORIENTE,2023-03-06,184,159,25,0.135869565217391
CDMX SUR ORIENTE,2023-03-07,217,188,29,0.133640552995392
CDMX SUR ORIENTE,2023-03-08,224,205,19,0.0848214285714286
CDMX SUR ORIENTE,2023-03-09,226,211,15,0.0663716814159292
CDMX SUR ORIENTE,2023-03-10,177,165,12,0.0677966101694915
CDMX SUR ORIENTE,2023-03-11,243,228,15,0.0617283950617284
CDMX SUR ORIENTE,2023-03-12,202,184,18,0.0891089108910891
CDMX SUR ORIENTE,2023-03-13,230,207,23,0.1
CDMX SUR ORIENTE,2023-03-14,239,213,26,0.108786610878661
CDMX SUR ORIENTE,2023-03-15,206,195,11,0.0533980582524272
CDMX SUR ORIENTE,2023-03-16,240,231,9,0.0375
CDMX SUR ORIENTE,2023-03-17,292,281,11,0.0376712328767123
CDMX SUR ORIENTE,2023-03-18,345,330,15,0.0434782608695652
CDMX SUR ORIENTE,2023-03-19,321,309,12,0.0373831775700935
CDMX SUR ORIENTE,2023-03-20,375,369,6,0.016
CDMX SUR ORIENTE,2023-03-21,291,286,5,0.0171821305841924
CDMX SUR ORIENTE,2023-03-22,233,224,9,0.0386266094420601
CDMX SUR ORIENTE,2023-03-23,216,213,3,0.0138888888888889
CDMX SUR ORIENTE,2023-03-24,245,244,1,0.00408163265306122
CDMX SUR ORIENTE,2023-03-25,274,273,1,0.00364963503649635
CDMX SUR ORIENTE,2023-03-26,274,273,1,0.00364963503649635
CDMX SUR ORIENTE,2023-03-27,222,221,1,0.0045045045045045
CDMX SUR ORIENTE,2023-03-28,189,188,1,0.00529100529100529
CDMX SUR ORIENTE,2023-03-29,211,208,3,0.014218009478673
CDMX SUR ORIENTE,2023-03-30,294,291,3,0.0102040816326531
CDMX SUR ORIENTE,2023-03-31,328,322,6,0.0182926829268293
CDMX SUR ORIENTE,2023-04-01,291,286,5,0.0171821305841924
CDMX SUR ORIENTE,2023-04-02,270,268,2,0.00740740740740741
CDMX SUR ORIENTE,2023-04-03,297,292,5,0.0168350168350168
CDMX SUR ORIENTE,2023-04-04,153,153,0,0
CDMX SUR ORIENTE,2023-04-05,217,217,0,0
CDMX SUR ORIENTE,2023-04-06,190,190,0,0
CDMX SUR ORIENTE,2023-04-07,185,185,0,0
CDMX SUR ORIENTE,2023-04-08,182,182,0,0
CDMX SUR ORIENTE,2023-04-09,163,163,0,0
CDMX SUR ORIENTE,2023-04-10,165,165,0,0
CDMX SUR ORIENTE,2023-04-11,197,197,0,0
CDMX SUR ORIENTE,2023-04-12,195,195,0,0
CDMX SUR ORIENTE,2023-04-13,180,180,0,0
CDMX SUR ORIENTE,2023-04-14,245,245,0,0
CDMX SUR ORIENTE,2023-04-15,259,259,0,0
CDMX SUR ORIENTE,2023-04-16,330,330,0,0
CDMX SUR ORIENTE,2023-04-17,290,290,0,0
CDMX SUR ORIENTE,2023-04-18,233,233,0,0
CDMX SUR ORIENTE,2023-04-19,227,227,0,0
CDMX SUR ORIENTE,2023-04-20,207,207,0,0
CDMX SUR ORIENTE,2023-04-21,218,218,0,0
CDMX SUR ORIENTE,2023-04-22,235,235,0,0
CDMX SUR ORIENTE,2023-04-23,222,222,0,0
CDMX SUR ORIENTE,2023-04-24,223,223,0,0
CDMX SUR ORIENTE,2023-04-25,294,294,0,0
CDMX SUR ORIENTE,2023-04-26,251,251,0,0
CDMX SUR ORIENTE,2023-04-27,200,200,0,0
CDMX SUR ORIENTE,2023-04-28,265,265,0,0
CDMX SUR ORIENTE,2023-04-29,311,311,0,0
CDMX SUR ORIENTE,2023-04-30,261,261,0,0
CDMX SUR ORIENTE,2023-05-01,255,255,0,0
CDMX SUR ORIENTE,2023-05-02,277,277,0,0
CDMX SUR ORIENTE,2023-05-03,206,206,0,0
CDMX SUR ORIENTE,2023-05-04,188,188,0,0
CDMX SUR ORIENTE,2023-05-05,232,232,0,0
CDMX SUR ORIENTE,2023-05-06,242,242,0,0
CDMX SUR ORIENTE,2023-05-07,184,184,0,0
CDMX SUR ORIENTE,2023-05-08,205,205,0,0
CDMX SUR ORIENTE,2023-05-09,199,199,0,0
CDMX SUR ORIENTE,2023-05-10,207,207,0,0
CDMX SUR ORIENTE,2023-05-11,176,176,0,0
CDMX SUR ORIENTE,2023-05-12,189,189,0,0
CDMX SUR ORIENTE,2023-05-13,299,299,0,0
CDMX SUR ORIENTE,2023-05-14,333,333,0,0
CDMX SUR ORIENTE,2023-05-15,390,390,0,0
CDMX SUR ORIENTE,2023-05-16,409,409,0,0
CDMX SUR ORIENTE,2023-05-17,332,332,0,0
CDMX SUR ORIENTE,2023-05-18,246,246,0,0
CDMX SUR ORIENTE,2023-05-19,245,245,0,0
CDMX SUR ORIENTE,2023-05-20,277,277,0,0
CDMX SUR ORIENTE,2023-05-21,243,243,0,0
CDMX SUR ORIENTE,2023-05-22,267,267,0,0
CDMX SUR ORIENTE,2023-05-23,239,239,0,0
CDMX SUR ORIENTE,2023-05-24,239,239,0,0
CDMX SUR ORIENTE,2023-05-25,243,243,0,0
CDMX SUR ORIENTE,2023-05-26,295,291,4,0.0135593220338983
CDMX SUR ORIENTE,2023-05-27,234,227,7,0.0299145299145299
CDMX SUR ORIENTE,2023-05-28,273,272,1,0.00366300366300366
CDMX SUR ORIENTE,2023-05-29,258,254,4,0.0155038759689922
CDMX SUR ORIENTE,2023-05-30,281,271,10,0.0355871886120996
CDMX SUR ORIENTE,2023-05-31,302,300,2,0.00662251655629139
CDMX SUR ORIENTE,2023-06-01,617,605,12,0.0194489465153971
CDMX SUR ORIENTE,2023-06-02,226,224,2,0.00884955752212389
CDMX SUR ORIENTE,2023-06-03,410,404,6,0.0146341463414634
CDMX SUR ORIENTE,2023-06-04,537,526,11,0.0204841713221601
CDMX SUR ORIENTE,2023-06-05,268,264,4,0.0149253731343284
CDMX SUR ORIENTE,2023-06-06,243,242,1,0.00411522633744856
CDMX SUR ORIENTE,2023-06-07,228,222,6,0.0263157894736842
CDMX SUR ORIENTE,2023-06-08,220,216,4,0.0181818181818182
CDMX SUR ORIENTE,2023-06-09,208,206,2,0.00961538461538462
CDMX SUR ORIENTE,2023-06-10,295,290,5,0.0169491525423729
CDMX SUR ORIENTE,2023-06-11,278,275,3,0.0107913669064748
CDMX SUR ORIENTE,2023-06-12,287,280,7,0.024390243902439
CDMX SUR ORIENTE,2023-06-13,261,258,3,0.0114942528735632
CDMX SUR ORIENTE,2023-06-14,272,268,4,0.0147058823529412
CDMX SUR ORIENTE,2023-06-15,258,253,5,0.0193798449612403
CDMX SUR ORIENTE,2023-06-16,289,285,4,0.013840830449827
CDMX SUR ORIENTE,2023-06-17,313,304,9,0.0287539936102236
CDMX SUR ORIENTE,2023-06-18,258,253,5,0.0193798449612403
CDMX SUR ORIENTE,2023-06-19,301,299,2,0.00664451827242525
CDMX SUR ORIENTE,2023-06-20,304,300,4,0.0131578947368421
CDMX SUR ORIENTE,2023-06-21,273,264,9,0.032967032967033
CDMX SUR ORIENTE,2023-06-22,209,203,6,0.0287081339712919
CDMX SUR ORIENTE,2023-06-23,291,285,6,0.0206185567010309
CDMX SUR ORIENTE,2023-06-24,318,313,5,0.0157232704402516
CDMX SUR ORIENTE,2023-06-25,219,213,6,0.0273972602739726
CDMX SUR ORIENTE,2023-06-26,254,251,3,0.0118110236220472
CDMX SUR ORIENTE,2023-06-27,223,220,3,0.0134529147982063
CDMX SUR ORIENTE,2023-06-28,252,247,5,0.0198412698412698
CDMX SUR ORIENTE,2023-06-29,283,275,8,0.0282685512367491
CDMX SUR ORIENTE,2023-06-30,194,183,11,0.0567010309278351
CDMX SUR ORIENTE,2023-07-01,316,312,4,0.0126582278481013
CDMX SUR ORIENTE,2023-07-02,252,248,4,0.0158730158730159
CDMX SUR ORIENTE,2023-07-03,235,231,4,0.0170212765957447
CDMX SUR ORIENTE,2023-07-04,321,314,7,0.0218068535825545
CDMX SUR ORIENTE,2023-07-05,300,294,6,0.02
CDMX SUR ORIENTE,2023-07-06,268,263,5,0.0186567164179104
CDMX SUR ORIENTE,2023-07-07,288,281,7,0.0243055555555556
CDMX SUR ORIENTE,2023-07-08,373,365,8,0.0214477211796247
CDMX SUR ORIENTE,2023-07-09,297,295,2,0.00673400673400673
CDMX SUR ORIENTE,2023-07-10,345,336,9,0.0260869565217391
CDMX SUR ORIENTE,2023-07-11,321,312,9,0.0280373831775701
CDMX SUR ORIENTE,2023-07-12,297,289,8,0.0269360269360269
CDMX SUR ORIENTE,2023-07-13,282,271,11,0.0390070921985816
CDMX SUR ORIENTE,2023-07-14,296,288,8,0.027027027027027
CDMX SUR ORIENTE,2023-07-15,378,374,4,0.0105820105820106
CDMX SUR ORIENTE,2023-07-16,323,320,3,0.00928792569659443
CDMX SUR ORIENTE,2023-07-17,349,343,6,0.0171919770773639
CDMX SUR ORIENTE,2023-07-18,312,306,6,0.0192307692307692
CDMX SUR ORIENTE,2023-07-19,315,303,12,0.0380952380952381
CDMX SUR ORIENTE,2023-07-20,353,347,6,0.0169971671388102
CDMX SUR ORIENTE,2023-07-21,274,270,4,0.0145985401459854
CDMX SUR ORIENTE,2023-07-22,339,330,9,0.0265486725663717
CDMX SUR ORIENTE,2023-07-23,322,313,9,0.0279503105590062
CDMX SUR ORIENTE,2023-07-24,313,309,4,0.012779552715655
CDMX SUR ORIENTE,2023-07-25,330,322,8,0.0242424242424242
CDMX SUR ORIENTE,2023-07-26,381,379,2,0.005249343832021
CDMX SUR ORIENTE,2023-07-27,366,362,4,0.0109289617486339
CDMX SUR ORIENTE,2023-07-28,362,355,7,0.0193370165745856
CDMX SUR ORIENTE,2023-07-29,392,388,4,0.0102040816326531
CDMX SUR ORIENTE,2023-07-30,438,430,8,0.0182648401826484
CDMX SUR ORIENTE,2023-07-31,472,468,4,0.00847457627118644
CDMX SUR ORIENTE,2023-08-01,363,355,8,0.0220385674931129
CDMX SUR ORIENTE,2023-08-02,303,293,10,0.033003300330033
CDMX SUR ORIENTE,2023-08-03,328,314,14,0.0426829268292683
CDMX SUR ORIENTE,2023-08-04,333,325,8,0.024024024024024
CDMX SUR ORIENTE,2023-08-05,377,362,15,0.0397877984084881
CDMX SUR ORIENTE,2023-08-06,354,343,11,0.0310734463276836
CDMX SUR ORIENTE,2023-08-07,311,305,6,0.0192926045016077
CDMX SUR ORIENTE,2023-08-08,329,321,8,0.0243161094224924
CDMX SUR ORIENTE,2023-08-09,370,358,12,0.0324324324324324
CDMX SUR ORIENTE,2023-08-10,295,287,8,0.0271186440677966
CDMX SUR ORIENTE,2023-08-11,317,312,5,0.0157728706624606
CDMX SUR ORIENTE,2023-08-12,370,361,9,0.0243243243243243
CDMX SUR ORIENTE,2023-08-13,368,353,15,0.0407608695652174
CDMX SUR ORIENTE,2023-08-14,347,338,9,0.0259365994236311
CDMX SUR ORIENTE,2023-08-15,391,385,6,0.0153452685421995
CDMX SUR ORIENTE,2023-08-16,387,375,12,0.0310077519379845
CDMX SUR ORIENTE,2023-08-17,346,337,9,0.0260115606936416
CDMX SUR ORIENTE,2023-08-18,338,332,6,0.0177514792899408
CDMX SUR ORIENTE,2023-08-19,355,349,6,0.0169014084507042
CDMX SUR ORIENTE,2023-08-20,342,334,8,0.0233918128654971
CDMX SUR ORIENTE,2023-08-21,300,300,0,0
CDMX SUR ORIENTE,2023-08-22,313,313,0,0
CDMX SUR ORIENTE,2023-08-23,319,319,0,0
CDMX SUR ORIENTE,2023-08-24,306,306,0,0
CDMX SUR ORIENTE,2023-08-25,374,374,0,0
CDMX SUR ORIENTE,2023-08-26,460,459,1,0.00217391304347826
CDMX SUR ORIENTE,2023-08-27,461,461,0,0
CDMX SUR ORIENTE,2023-08-28,392,392,0,0
CDMX SUR ORIENTE,2023-08-29,428,428,0,0
CDMX SUR ORIENTE,2023-08-30,401,401,0,0
CDMX SUR ORIENTE,2023-08-31,338,337,1,0.0029585798816568
CDMX SUR ORIENTE,2023-09-01,319,318,1,0.00313479623824451
CDMX SUR ORIENTE,2023-09-02,348,348,0,0
CDMX SUR ORIENTE,2023-09-03,307,307,0,0
CDMX SUR ORIENTE,2023-09-04,315,314,1,0.00317460317460317
CDMX SUR ORIENTE,2023-09-05,299,298,1,0.00334448160535117
CDMX SUR ORIENTE,2023-09-06,313,313,0,0
CDMX SUR ORIENTE,2023-09-07,319,318,1,0.00313479623824451
CDMX SUR ORIENTE,2023-09-08,278,278,0,0
CDMX SUR ORIENTE,2023-09-09,343,343,0,0
CDMX SUR ORIENTE,2023-09-10,362,362,0,0
CDMX SUR ORIENTE,2023-09-11,255,255,0,0
CDMX SUR ORIENTE,2023-09-12,214,213,1,0.00467289719626168
CDMX SUR ORIENTE,2023-09-13,290,290,0,0
CDMX SUR ORIENTE,2023-09-14,216,215,1,0.00462962962962963
CDMX SUR ORIENTE,2023-09-15,169,169,0,0
CDMX SUR ORIENTE,2023-09-16,301,300,1,0.00332225913621262
CDMX SUR ORIENTE,2023-09-17,355,354,1,0.0028169014084507
CDMX SUR ORIENTE,2023-09-18,255,255,0,0
CDMX SUR ORIENTE,2023-09-19,278,277,1,0.00359712230215827
CDMX SUR ORIENTE,2023-09-20,180,179,1,0.00555555555555556
CDMX SUR ORIENTE,2023-09-21,358,356,2,0.00558659217877095
CDMX SUR ORIENTE,2023-09-22,390,389,1,0.00256410256410256
CDMX SUR ORIENTE,2023-09-23,405,405,0,0
CDMX SUR ORIENTE,2023-09-24,417,417,0,0
CDMX SUR ORIENTE,2023-09-25,355,355,0,0
CDMX SUR ORIENTE,2023-09-26,314,314,0,0
CDMX SUR ORIENTE,2023-09-27,289,289,0,0
CDMX SUR ORIENTE,2023-09-28,346,345,1,0.00289017341040462
CDMX SUR ORIENTE,2023-09-29,415,414,1,0.00240963855421687
CDMX SUR ORIENTE,2023-09-30,463,461,2,0.00431965442764579
CDMX SUR ORIENTE,2023-10-01,333,332,1,0.003003003003003
CDMX SUR ORIENTE,2023-10-02,290,290,0,0
CDMX SUR ORIENTE,2023-10-03,293,283,10,0.0341296928327645
CDMX SUR ORIENTE,2023-10-04,297,289,8,0.0269360269360269
CDMX SUR ORIENTE,2023-10-05,281,273,8,0.0284697508896797
CDMX SUR ORIENTE,2023-10-06,299,289,10,0.0334448160535117
CDMX SUR ORIENTE,2023-10-07,327,318,9,0.0275229357798165
CDMX SUR ORIENTE,2023-10-08,338,326,12,0.0355029585798817
CDMX SUR ORIENTE,2023-10-09,311,304,7,0.022508038585209
CDMX SUR ORIENTE,2023-10-10,252,245,7,0.0277777777777778
CDMX SUR ORIENTE,2023-10-11,262,256,6,0.0229007633587786
CDMX SUR ORIENTE,2023-10-12,254,249,5,0.0196850393700787
CDMX SUR ORIENTE,2023-10-13,299,295,4,0.0133779264214047
CDMX SUR ORIENTE,2023-10-14,381,376,5,0.0131233595800525
CDMX SUR ORIENTE,2023-10-15,381,370,11,0.0288713910761155
CDMX SUR ORIENTE,2023-10-16,363,354,9,0.0247933884297521
CDMX SUR ORIENTE,2023-10-17,351,338,13,0.037037037037037
CDMX SUR ORIENTE,2023-10-18,291,286,5,0.0171821305841924
CDMX SUR ORIENTE,2023-10-19,313,303,10,0.0319488817891374
CDMX SUR ORIENTE,2023-10-20,309,302,7,0.0226537216828479
CDMX SUR ORIENTE,2023-10-21,402,395,7,0.0174129353233831
CDMX SUR ORIENTE,2023-10-22,383,373,10,0.0261096605744125
CDMX SUR ORIENTE,2023-10-23,347,342,5,0.0144092219020173
CDMX SUR ORIENTE,2023-10-24,309,302,7,0.0226537216828479
CDMX SUR ORIENTE,2023-10-25,285,277,8,0.0280701754385965
CDMX SUR ORIENTE,2023-10-26,261,255,6,0.0229885057471264
CDMX SUR ORIENTE,2023-10-27,273,269,4,0.0146520146520147
CDMX SUR ORIENTE,2023-10-28,357,351,6,0.0168067226890756
CDMX SUR ORIENTE,2023-10-29,336,328,8,0.0238095238095238
CDMX SUR ORIENTE,2023-10-30,314,303,11,0.035031847133758
CDMX SUR ORIENTE,2023-10-31,440,431,9,0.0204545454545455
CDMX SUR ORIENTE,2023-11-01,303,293,10,0.033003300330033
CDMX SUR ORIENTE,2023-11-02,282,277,5,0.0177304964539007
CDMX SUR ORIENTE,2023-11-03,261,258,3,0.0114942528735632
CDMX SUR ORIENTE,2023-11-04,380,369,11,0.0289473684210526
CDMX SUR ORIENTE,2023-11-05,412,399,13,0.0315533980582524
CDMX SUR ORIENTE,2023-11-06,376,366,10,0.0265957446808511
CDMX SUR ORIENTE,2023-11-07,390,381,9,0.0230769230769231
CDMX SUR ORIENTE,2023-11-08,369,358,11,0.029810298102981
CDMX SUR ORIENTE,2023-11-09,325,318,7,0.0215384615384615
CDMX SUR ORIENTE,2023-11-10,335,328,7,0.0208955223880597
CDMX SUR ORIENTE,2023-11-11,425,414,11,0.0258823529411765
CDMX SUR ORIENTE,2023-11-12,396,389,7,0.0176767676767677
CDMX SUR ORIENTE,2023-11-13,400,380,20,0.05
CDMX SUR ORIENTE,2023-11-14,434,420,14,0.032258064516129
CDMX SUR ORIENTE,2023-11-15,447,438,9,0.0201342281879195
CDMX SUR ORIENTE,2023-11-16,488,476,12,0.0245901639344262
CDMX SUR ORIENTE,2023-11-17,516,511,5,0.00968992248062015
CDMX SUR ORIENTE,2023-11-18,587,570,17,0.0289608177172061
CDMX SUR ORIENTE,2023-11-19,611,597,14,0.0229132569558101
CDMX SUR ORIENTE,2023-11-20,623,614,9,0.014446227929374
CDMX SUR ORIENTE,2023-11-21,458,444,14,0.0305676855895196
CDMX SUR ORIENTE,2023-11-22,412,402,10,0.0242718446601942
CDMX SUR ORIENTE,2023-11-23,379,369,10,0.0263852242744063
CDMX SUR ORIENTE,2023-11-24,401,393,8,0.0199501246882793
CDMX SUR ORIENTE,2023-11-25,445,437,8,0.0179775280898876
CDMX SUR ORIENTE,2023-11-26,434,421,13,0.0299539170506912
CDMX SUR ORIENTE,2023-11-27,430,415,15,0.0348837209302326
CDMX SUR ORIENTE,2023-11-28,447,438,9,0.0201342281879195
CDMX SUR ORIENTE,2023-11-29,455,435,20,0.043956043956044
CDMX SUR ORIENTE,2023-11-30,537,520,17,0.031657355679702
CDMX SUR ORIENTE,2023-12-01,376,364,12,0.0319148936170213
CDMX SUR ORIENTE,2023-12-02,462,441,21,0.0454545454545455
CDMX SUR ORIENTE,2023-12-03,461,445,16,0.03470715835141
CDMX SUR ORIENTE,2023-12-04,413,402,11,0.026634382566586
CDMX SUR ORIENTE,2023-12-05,341,328,13,0.0381231671554252
CDMX SUR ORIENTE,2023-12-06,365,353,12,0.0328767123287671
CDMX SUR ORIENTE,2023-12-07,399,392,7,0.0175438596491228
CDMX SUR ORIENTE,2023-12-08,284,276,8,0.028169014084507
CDMX SUR ORIENTE,2023-12-09,440,428,12,0.0272727272727273
CDMX SUR ORIENTE,2023-12-10,447,437,10,0.0223713646532438
CDMX SUR ORIENTE,2023-12-11,377,366,11,0.0291777188328912
CDMX SUR ORIENTE,2023-12-12,386,375,11,0.0284974093264249
CDMX SUR ORIENTE,2023-12-13,336,323,13,0.0386904761904762
CDMX SUR ORIENTE,2023-12-14,258,252,6,0.0232558139534884
CDMX SUR ORIENTE,2023-12-15,474,463,11,0.0232067510548523
CDMX SUR ORIENTE,2023-12-16,512,503,9,0.017578125
CDMX SUR ORIENTE,2023-12-17,425,414,11,0.0258823529411765
CDMX SUR ORIENTE,2023-12-18,452,442,10,0.0221238938053097
CDMX SUR ORIENTE,2023-12-19,408,399,9,0.0220588235294118
CDMX SUR ORIENTE,2023-12-20,398,389,9,0.0226130653266332
CDMX SUR ORIENTE,2023-12-21,386,380,6,0.0155440414507772
CDMX SUR ORIENTE,2023-12-22,377,369,8,0.0212201591511936
CDMX SUR ORIENTE,2023-12-23,377,368,9,0.0238726790450928
CDMX SUR ORIENTE,2023-12-24,284,277,7,0.0246478873239437
CDMX SUR ORIENTE,2023-12-25,110,109,1,0.00909090909090909
CDMX SUR ORIENTE,2023-12-26,346,336,10,0.0289017341040462
CDMX SUR ORIENTE,2023-12-27,419,409,10,0.0238663484486874
CDMX SUR ORIENTE,2023-12-28,406,399,7,0.0172413793103448
CDMX SUR ORIENTE,2023-12-29,411,394,17,0.0413625304136253
CDMX SUR ORIENTE,2023-12-30,430,421,9,0.0209302325581395
CDMX SUR ORIENTE,2023-12-31,251,244,7,0.0278884462151394
CDMX SUR ORIENTE,2024-01-01,79,76,3,0.0379746835443038
CDMX SUR ORIENTE,2024-01-02,318,312,6,0.0188679245283019
CDMX SUR ORIENTE,2024-01-03,373,368,5,0.0134048257372654
CDMX SUR ORIENTE,2024-01-04,327,318,9,0.0275229357798165
CDMX SUR ORIENTE,2024-01-05,377,369,8,0.0212201591511936
CDMX SUR ORIENTE,2024-01-06,338,331,7,0.0207100591715976
CDMX SUR ORIENTE,2024-01-07,374,369,5,0.0133689839572193
CDMX SUR ORIENTE,2024-01-08,378,367,11,0.0291005291005291
CDMX SUR ORIENTE,2024-01-09,419,412,7,0.0167064439140811
CDMX SUR ORIENTE,2024-01-10,362,354,8,0.0220994475138122
CDMX SUR ORIENTE,2024-01-11,388,384,4,0.0103092783505155
CDMX SUR ORIENTE,2024-01-12,374,367,7,0.018716577540107
CDMX SUR ORIENTE,2024-01-13,473,460,13,0.0274841437632135
CDMX SUR ORIENTE,2024-01-14,467,451,16,0.0342612419700214
FRONTERA,2023-01-02,211,195,16,0.0758293838862559
FRONTERA,2023-01-03,221,205,16,0.0723981900452489
FRONTERA,2023-01-04,236,220,16,0.0677966101694915
FRONTERA,2023-01-05,242,230,12,0.0495867768595041
FRONTERA,2023-01-06,249,228,21,0.0843373493975904
FRONTERA,2023-01-07,263,244,19,0.0722433460076046
FRONTERA,2023-01-08,172,159,13,0.0755813953488372
FRONTERA,2023-01-09,231,218,13,0.0562770562770563
FRONTERA,2023-01-10,242,223,19,0.0785123966942149
FRONTERA,2023-01-11,232,220,12,0.0517241379310345
FRONTERA,2023-01-12,221,208,13,0.0588235294117647
FRONTERA,2023-01-13,260,235,25,0.0961538461538462
FRONTERA,2023-01-14,274,258,16,0.0583941605839416
FRONTERA,2023-01-15,176,163,13,0.0738636363636364
FRONTERA,2023-01-16,245,219,26,0.106122448979592
FRONTERA,2023-01-17,234,218,16,0.0683760683760684
FRONTERA,2023-01-18,232,214,18,0.0775862068965517
FRONTERA,2023-01-19,231,220,11,0.0476190476190476
FRONTERA,2023-01-20,250,236,14,0.056
FRONTERA,2023-01-21,250,235,15,0.06
FRONTERA,2023-01-22,139,130,9,0.0647482014388489
FRONTERA,2023-01-23,190,180,10,0.0526315789473684
FRONTERA,2023-01-24,217,210,7,0.032258064516129
FRONTERA,2023-01-25,206,195,11,0.0533980582524272
FRONTERA,2023-01-26,189,179,10,0.0529100529100529
FRONTERA,2023-01-27,214,210,4,0.0186915887850467
FRONTERA,2023-01-28,240,228,12,0.05
FRONTERA,2023-01-29,161,155,6,0.0372670807453416
FRONTERA,2023-01-30,212,205,7,0.0330188679245283
FRONTERA,2023-01-31,226,218,8,0.0353982300884956
FRONTERA,2023-02-01,206,197,9,0.0436893203883495
FRONTERA,2023-02-02,196,192,4,0.0204081632653061
FRONTERA,2023-02-03,224,216,8,0.0357142857142857
FRONTERA,2023-02-04,294,284,10,0.0340136054421769
FRONTERA,2023-02-05,200,195,5,0.025
FRONTERA,2023-02-06,221,213,8,0.0361990950226244
FRONTERA,2023-02-07,240,235,5,0.0208333333333333
FRONTERA,2023-02-08,221,215,6,0.0271493212669683
FRONTERA,2023-02-09,239,227,12,0.0502092050209205
FRONTERA,2023-02-10,232,226,6,0.0258620689655172
FRONTERA,2023-02-11,240,228,12,0.05
FRONTERA,2023-02-12,211,202,9,0.042654028436019
FRONTERA,2023-02-13,227,220,7,0.0308370044052863
FRONTERA,2023-02-14,224,216,8,0.0357142857142857
FRONTERA,2023-02-15,252,246,6,0.0238095238095238
FRONTERA,2023-02-16,240,229,11,0.0458333333333333
FRONTERA,2023-02-17,261,249,12,0.0459770114942529
FRONTERA,2023-02-18,292,286,6,0.0205479452054795
FRONTERA,2023-02-19,212,201,11,0.0518867924528302
FRONTERA,2023-02-20,217,211,6,0.0276497695852535
FRONTERA,2023-02-21,215,207,8,0.0372093023255814
FRONTERA,2023-02-22,220,219,1,0.00454545454545455
FRONTERA,2023-02-23,232,226,6,0.0258620689655172
FRONTERA,2023-02-24,241,232,9,0.037344398340249
FRONTERA,2023-02-25,269,256,13,0.0483271375464684
FRONTERA,2023-02-26,209,202,7,0.0334928229665072
FRONTERA,2023-02-27,224,219,5,0.0223214285714286
FRONTERA,2023-02-28,283,272,11,0.03886925795053
FRONTERA,2023-03-01,287,278,9,0.0313588850174216
FRONTERA,2023-03-02,290,282,8,0.0275862068965517
FRONTERA,2023-03-03,301,289,12,0.0398671096345515
FRONTERA,2023-03-04,336,310,26,0.0773809523809524
FRONTERA,2023-03-05,179,165,14,0.0782122905027933
FRONTERA,2023-03-06,236,222,14,0.0593220338983051
FRONTERA,2023-03-07,270,259,11,0.0407407407407407
FRONTERA,2023-03-08,265,255,10,0.0377358490566038
FRONTERA,2023-03-09,240,239,1,0.00416666666666667
FRONTERA,2023-03-10,279,277,2,0.00716845878136201
FRONTERA,2023-03-11,338,331,7,0.0207100591715976
FRONTERA,2023-03-12,236,231,5,0.0211864406779661
FRONTERA,2023-03-13,273,273,0,0
FRONTERA,2023-03-14,314,303,11,0.035031847133758
FRONTERA,2023-03-15,279,279,0,0
FRONTERA,2023-03-16,312,311,1,0.00320512820512821
FRONTERA,2023-03-17,380,379,1,0.00263157894736842
FRONTERA,2023-03-18,456,456,0,0
FRONTERA,2023-03-19,324,324,0,0
FRONTERA,2023-03-20,359,358,1,0.00278551532033426
FRONTERA,2023-03-21,329,328,1,0.00303951367781155
FRONTERA,2023-03-22,321,321,0,0
FRONTERA,2023-03-23,311,310,1,0.00321543408360129
FRONTERA,2023-03-24,309,309,0,0
FRONTERA,2023-03-25,378,377,1,0.00264550264550265
FRONTERA,2023-03-26,257,254,3,0.0116731517509728
FRONTERA,2023-03-27,274,274,0,0
FRONTERA,2023-03-28,236,235,1,0.00423728813559322
FRONTERA,2023-03-29,272,271,1,0.00367647058823529
FRONTERA,2023-03-30,324,321,3,0.00925925925925926
FRONTERA,2023-03-31,431,431,0,0
FRONTERA,2023-04-01,378,378,0,0
FRONTERA,2023-04-02,217,215,2,0.00921658986175115
FRONTERA,2023-04-03,368,366,2,0.00543478260869565
FRONTERA,2023-04-04,312,308,4,0.0128205128205128
FRONTERA,2023-04-05,253,253,0,0
FRONTERA,2023-04-06,278,275,3,0.0107913669064748
FRONTERA,2023-04-07,249,249,0,0
FRONTERA,2023-04-08,235,235,0,0
FRONTERA,2023-04-09,145,145,0,0
FRONTERA,2023-04-10,231,228,3,0.012987012987013
FRONTERA,2023-04-11,260,260,0,0
FRONTERA,2023-04-12,254,251,3,0.0118110236220472
FRONTERA,2023-04-13,275,272,3,0.0109090909090909
FRONTERA,2023-04-14,299,296,3,0.0100334448160535
FRONTERA,2023-04-15,364,356,8,0.021978021978022
FRONTERA,2023-04-16,242,241,1,0.00413223140495868
FRONTERA,2023-04-17,297,294,3,0.0101010101010101
FRONTERA,2023-04-18,291,284,7,0.0240549828178694
FRONTERA,2023-04-19,257,253,4,0.0155642023346304
FRONTERA,2023-04-20,257,249,8,0.0311284046692607
FRONTERA,2023-04-21,299,293,6,0.020066889632107
FRONTERA,2023-04-22,312,306,6,0.0192307692307692
FRONTERA,2023-04-23,239,235,4,0.0167364016736402
FRONTERA,2023-04-24,270,263,7,0.0259259259259259
FRONTERA,2023-04-25,326,320,6,0.0184049079754601
FRONTERA,2023-04-26,306,299,7,0.0228758169934641
FRONTERA,2023-04-27,280,272,8,0.0285714285714286
FRONTERA,2023-04-28,326,315,11,0.0337423312883436
FRONTERA,2023-04-29,313,303,10,0.0319488817891374
FRONTERA,2023-04-30,243,237,6,0.0246913580246914
FRONTERA,2023-05-01,230,224,6,0.0260869565217391
FRONTERA,2023-05-02,249,243,6,0.0240963855421687
FRONTERA,2023-05-03,225,217,8,0.0355555555555556
FRONTERA,2023-05-04,252,246,6,0.0238095238095238
FRONTERA,2023-05-05,298,292,6,0.0201342281879195
FRONTERA,2023-05-06,271,262,9,0.033210332103321
FRONTERA,2023-05-07,286,280,6,0.020979020979021
FRONTERA,2023-05-08,292,280,12,0.0410958904109589
FRONTERA,2023-05-09,292,279,13,0.0445205479452055
FRONTERA,2023-05-10,252,239,13,0.0515873015873016
FRONTERA,2023-05-11,299,284,15,0.0501672240802676
FRONTERA,2023-05-12,297,280,17,0.0572390572390572
FRONTERA,2023-05-13,325,310,15,0.0461538461538462
FRONTERA,2023-05-14,344,335,9,0.0261627906976744
FRONTERA,2023-05-15,352,338,14,0.0397727272727273
FRONTERA,2023-05-16,416,400,16,0.0384615384615385
FRONTERA,2023-05-17,427,405,22,0.0515222482435597
FRONTERA,2023-05-18,247,243,4,0.0161943319838057
FRONTERA,2023-05-19,376,357,19,0.050531914893617
FRONTERA,2023-05-20,401,386,15,0.0374064837905237
FRONTERA,2023-05-21,320,302,18,0.05625
FRONTERA,2023-05-22,333,313,20,0.0600600600600601
FRONTERA,2023-05-23,315,308,7,0.0222222222222222
FRONTERA,2023-05-24,279,265,14,0.0501792114695341
FRONTERA,2023-05-25,312,291,21,0.0673076923076923
FRONTERA,2023-05-26,281,268,13,0.0462633451957295
FRONTERA,2023-05-27,330,310,20,0.0606060606060606
FRONTERA,2023-05-28,250,228,22,0.088
FRONTERA,2023-05-29,307,291,16,0.0521172638436482
FRONTERA,2023-05-30,306,284,22,0.0718954248366013
FRONTERA,2023-05-31,294,277,17,0.0578231292517007
FRONTERA,2023-06-01,511,492,19,0.0371819960861057
FRONTERA,2023-06-02,401,373,28,0.0698254364089776
FRONTERA,2023-06-03,559,533,26,0.0465116279069767
FRONTERA,2023-06-04,391,373,18,0.0460358056265985
FRONTERA,2023-06-05,259,246,13,0.0501930501930502
FRONTERA,2023-06-06,241,230,11,0.045643153526971
FRONTERA,2023-06-07,270,261,9,0.0333333333333333
FRONTERA,2023-06-08,267,256,11,0.0411985018726592
FRONTERA,2023-06-09,287,275,12,0.0418118466898955
FRONTERA,2023-06-10,354,339,15,0.0423728813559322
FRONTERA,2023-06-11,265,252,13,0.0490566037735849
FRONTERA,2023-06-12,291,277,14,0.0481099656357388
FRONTERA,2023-06-13,297,286,11,0.037037037037037
FRONTERA,2023-06-14,290,278,12,0.0413793103448276
FRONTERA,2023-06-15,288,273,15,0.0520833333333333
FRONTERA,2023-06-16,275,262,13,0.0472727272727273
FRONTERA,2023-06-17,282,279,3,0.0106382978723404
FRONTERA,2023-06-18,188,177,11,0.0585106382978723
FRONTERA,2023-06-19,261,250,11,0.0421455938697318
FRONTERA,2023-06-20,239,230,9,0.0376569037656904
FRONTERA,2023-06-21,269,253,16,0.0594795539033457
FRONTERA,2023-06-22,261,251,10,0.0383141762452107
FRONTERA,2023-06-23,269,253,16,0.0594795539033457
FRONTERA,2023-06-24,295,280,15,0.0508474576271186
FRONTERA,2023-06-25,232,225,7,0.0301724137931034
FRONTERA,2023-06-26,292,283,9,0.0308219178082192
FRONTERA,2023-06-27,308,289,19,0.0616883116883117
FRONTERA,2023-06-28,267,260,7,0.0262172284644195
FRONTERA,2023-06-29,280,274,6,0.0214285714285714
FRONTERA,2023-06-30,172,165,7,0.0406976744186047
FRONTERA,2023-07-01,283,282,1,0.00353356890459364
FRONTERA,2023-07-02,203,197,6,0.0295566502463054
FRONTERA,2023-07-03,254,248,6,0.0236220472440945
FRONTERA,2023-07-04,314,305,9,0.0286624203821656
FRONTERA,2023-07-05,249,242,7,0.0281124497991968
FRONTERA,2023-07-06,236,232,4,0.0169491525423729
FRONTERA,2023-07-07,292,288,4,0.0136986301369863
FRONTERA,2023-07-08,247,240,7,0.0283400809716599
FRONTERA,2023-07-09,211,210,1,0.004739336492891
FRONTERA,2023-07-10,249,242,7,0.0281124497991968
FRONTERA,2023-07-11,264,258,6,0.0227272727272727
FRONTERA,2023-07-12,267,261,6,0.0224719101123595
FRONTERA,2023-07-13,262,258,4,0.0152671755725191
FRONTERA,2023-07-14,260,257,3,0.0115384615384615
FRONTERA,2023-07-15,288,280,8,0.0277777777777778
FRONTERA,2023-07-16,192,192,0,0
FRONTERA,2023-07-17,274,269,5,0.0182481751824818
FRONTERA,2023-07-18,259,257,2,0.00772200772200772
FRONTERA,2023-07-19,263,259,4,0.0152091254752852
FRONTERA,2023-07-20,260,257,3,0.0115384615384615
FRONTERA,2023-07-21,291,288,3,0.0103092783505155
FRONTERA,2023-07-22,287,284,3,0.0104529616724739
FRONTERA,2023-07-23,189,189,0,0
FRONTERA,2023-07-24,244,240,4,0.0163934426229508
FRONTERA,2023-07-25,259,254,5,0.0193050193050193
FRONTERA,2023-07-26,270,264,6,0.0222222222222222
FRONTERA,2023-07-27,257,253,4,0.0155642023346304
FRONTERA,2023-07-28,282,279,3,0.0106382978723404
FRONTERA,2023-07-29,286,283,3,0.0104895104895105
FRONTERA,2023-07-30,219,217,2,0.0091324200913242
FRONTERA,2023-07-31,241,237,4,0.016597510373444
FRONTERA,2023-08-01,239,234,5,0.0209205020920502
FRONTERA,2023-08-02,307,302,5,0.0162866449511401
FRONTERA,2023-08-03,221,185,36,0.16289592760181
FRONTERA,2023-08-04,248,242,6,0.0241935483870968
FRONTERA,2023-08-05,212,210,2,0.00943396226415094
FRONTERA,2023-08-06,186,182,4,0.021505376344086
FRONTERA,2023-08-07,262,255,7,0.0267175572519084
FRONTERA,2023-08-08,258,254,4,0.0155038759689922
FRONTERA,2023-08-09,240,237,3,0.0125
FRONTERA,2023-08-10,216,211,5,0.0231481481481481
FRONTERA,2023-08-11,250,249,1,0.004
FRONTERA,2023-08-12,257,250,7,0.0272373540856031
FRONTERA,2023-08-13,186,185,1,0.00537634408602151
FRONTERA,2023-08-14,220,219,1,0.00454545454545455
FRONTERA,2023-08-15,224,220,4,0.0178571428571429
FRONTERA,2023-08-16,249,246,3,0.0120481927710843
FRONTERA,2023-08-17,248,239,9,0.0362903225806452
FRONTERA,2023-08-18,255,253,2,0.00784313725490196
FRONTERA,2023-08-19,311,286,25,0.0803858520900322
FRONTERA,2023-08-20,240,225,15,0.0625
FRONTERA,2023-08-21,233,220,13,0.055793991416309
FRONTERA,2023-08-22,192,179,13,0.0677083333333333
FRONTERA,2023-08-23,255,226,29,0.113725490196078
FRONTERA,2023-08-24,249,228,21,0.0843373493975904
FRONTERA,2023-08-25,304,271,33,0.108552631578947
FRONTERA,2023-08-26,329,307,22,0.0668693009118541
FRONTERA,2023-08-27,276,256,20,0.072463768115942
FRONTERA,2023-08-28,241,227,14,0.0580912863070539
FRONTERA,2023-08-29,238,229,9,0.0378151260504202
FRONTERA,2023-08-30,223,218,5,0.0224215246636771
FRONTERA,2023-08-31,224,221,3,0.0133928571428571
FRONTERA,2023-09-01,221,217,4,0.0180995475113122
FRONTERA,2023-09-02,229,226,3,0.0131004366812227
FRONTERA,2023-09-03,236,231,5,0.0211864406779661
FRONTERA,2023-09-04,242,241,1,0.00413223140495868
FRONTERA,2023-09-05,257,256,1,0.00389105058365759
FRONTERA,2023-09-06,271,269,2,0.00738007380073801
FRONTERA,2023-09-07,221,221,0,0
FRONTERA,2023-09-08,226,224,2,0.00884955752212389
FRONTERA,2023-09-09,248,242,6,0.0241935483870968
FRONTERA,2023-09-10,219,218,1,0.0045662100456621
FRONTERA,2023-09-11,222,221,1,0.0045045045045045
FRONTERA,2023-09-12,243,240,3,0.0123456790123457
FRONTERA,2023-09-13,263,261,2,0.00760456273764259
FRONTERA,2023-09-14,240,237,3,0.0125
FRONTERA,2023-09-15,244,242,2,0.00819672131147541
FRONTERA,2023-09-16,178,177,1,0.00561797752808989
FRONTERA,2023-09-17,200,197,3,0.015
FRONTERA,2023-09-18,234,233,1,0.00427350427350427
FRONTERA,2023-09-19,190,188,2,0.0105263157894737
FRONTERA,2023-09-20,155,155,0,0
FRONTERA,2023-09-21,175,169,6,0.0342857142857143
FRONTERA,2023-09-22,177,174,3,0.0169491525423729
FRONTERA,2023-09-23,226,223,3,0.0132743362831858
FRONTERA,2023-09-24,203,200,3,0.0147783251231527
FRONTERA,2023-09-25,198,195,3,0.0151515151515152
FRONTERA,2023-09-26,194,191,3,0.0154639175257732
FRONTERA,2023-09-27,232,227,5,0.021551724137931
FRONTERA,2023-09-28,258,255,3,0.0116279069767442
FRONTERA,2023-09-29,237,235,2,0.00843881856540084
FRONTERA,2023-09-30,241,240,1,0.004149377593361
FRONTERA,2023-10-01,169,168,1,0.00591715976331361
FRONTERA,2023-10-02,202,201,1,0.00495049504950495
FRONTERA,2023-10-03,209,208,1,0.00478468899521531
FRONTERA,2023-10-04,209,204,5,0.0239234449760766
FRONTERA,2023-10-05,168,166,2,0.0119047619047619
FRONTERA,2023-10-06,194,192,2,0.0103092783505155
FRONTERA,2023-10-07,247,241,6,0.0242914979757085
FRONTERA,2023-10-08,193,189,4,0.0207253886010363
FRONTERA,2023-10-09,186,185,1,0.00537634408602151
FRONTERA,2023-10-10,209,209,0,0
FRONTERA,2023-10-11,243,236,7,0.0288065843621399
FRONTERA,2023-10-12,198,192,6,0.0303030303030303
FRONTERA,2023-10-13,174,170,4,0.0229885057471264
FRONTERA,2023-10-14,255,250,5,0.0196078431372549
FRONTERA,2023-10-15,197,191,6,0.0304568527918782
FRONTERA,2023-10-16,205,202,3,0.0146341463414634
FRONTERA,2023-10-17,231,227,4,0.0173160173160173
FRONTERA,2023-10-18,215,211,4,0.0186046511627907
FRONTERA,2023-10-19,227,224,3,0.013215859030837
FRONTERA,2023-10-20,208,204,4,0.0192307692307692
FRONTERA,2023-10-21,236,234,2,0.00847457627118644
FRONTERA,2023-10-22,188,186,2,0.0106382978723404
FRONTERA,2023-10-23,189,184,5,0.0264550264550265
FRONTERA,2023-10-24,221,217,4,0.0180995475113122
FRONTERA,2023-10-25,225,219,6,0.0266666666666667
FRONTERA,2023-10-26,225,219,6,0.0266666666666667
FRONTERA,2023-10-27,208,203,5,0.0240384615384615
FRONTERA,2023-10-28,233,230,3,0.0128755364806867
FRONTERA,2023-10-29,155,152,3,0.0193548387096774
FRONTERA,2023-10-30,187,184,3,0.0160427807486631
FRONTERA,2023-10-31,190,189,1,0.00526315789473684
FRONTERA,2023-11-01,247,244,3,0.0121457489878543
FRONTERA,2023-11-02,207,205,2,0.00966183574879227
FRONTERA,2023-11-03,248,245,3,0.0120967741935484
FRONTERA,2023-11-04,259,255,4,0.0154440154440154
FRONTERA,2023-11-05,190,188,2,0.0105263157894737
FRONTERA,2023-11-06,258,256,2,0.00775193798449612
FRONTERA,2023-11-07,270,268,2,0.00740740740740741
FRONTERA,2023-11-08,223,221,2,0.00896860986547085
FRONTERA,2023-11-09,244,241,3,0.0122950819672131
FRONTERA,2023-11-10,245,242,3,0.0122448979591837
FRONTERA,2023-11-11,247,242,5,0.0202429149797571
FRONTERA,2023-11-12,175,172,3,0.0171428571428571
FRONTERA,2023-11-13,249,245,4,0.0160642570281124
FRONTERA,2023-11-14,306,301,5,0.0163398692810458
FRONTERA,2023-11-15,250,245,5,0.02
FRONTERA,2023-11-16,231,223,8,0.0346320346320346
FRONTERA,2023-11-17,287,284,3,0.0104529616724739
FRONTERA,2023-11-18,330,326,4,0.0121212121212121
FRONTERA,2023-11-19,278,273,5,0.0179856115107914
FRONTERA,2023-11-20,242,237,5,0.0206611570247934
FRONTERA,2023-11-21,297,293,4,0.0134680134680135
FRONTERA,2023-11-22,285,282,3,0.0105263157894737
FRONTERA,2023-11-23,298,295,3,0.0100671140939597
FRONTERA,2023-11-24,286,286,0,0
FRONTERA,2023-11-25,296,291,5,0.0168918918918919
FRONTERA,2023-11-26,264,262,2,0.00757575757575758
FRONTERA,2023-11-27,289,288,1,0.00346020761245675
FRONTERA,2023-11-28,320,319,1,0.003125
FRONTERA,2023-11-29,315,307,8,0.0253968253968254
FRONTERA,2023-11-30,320,318,2,0.00625
FRONTERA,2023-12-01,286,283,3,0.0104895104895105
FRONTERA,2023-12-02,309,304,5,0.0161812297734628
FRONTERA,2023-12-03,257,253,4,0.0155642023346304
FRONTERA,2023-12-04,300,295,5,0.0166666666666667
FRONTERA,2023-12-05,292,287,5,0.0171232876712329
FRONTERA,2023-12-06,311,305,6,0.0192926045016077
FRONTERA,2023-12-07,299,295,4,0.0133779264214047
FRONTERA,2023-12-08,361,354,7,0.0193905817174515
FRONTERA,2023-12-09,314,311,3,0.00955414012738853
FRONTERA,2023-12-10,267,260,7,0.0262172284644195
FRONTERA,2023-12-11,248,247,1,0.00403225806451613
FRONTERA,2023-12-12,259,250,9,0.0347490347490347
FRONTERA,2023-12-13,260,260,0,0
FRONTERA,2023-12-14,241,239,2,0.00829875518672199
FRONTERA,2023-12-15,225,220,5,0.0222222222222222
FRONTERA,2023-12-16,282,279,3,0.0106382978723404
FRONTERA,2023-12-17,230,226,4,0.0173913043478261
FRONTERA,2023-12-18,287,283,4,0.0139372822299652
FRONTERA,2023-12-19,317,311,6,0.0189274447949527
FRONTERA,2023-12-20,347,338,9,0.0259365994236311
FRONTERA,2023-12-21,296,289,7,0.0236486486486486
FRONTERA,2023-12-22,324,317,7,0.0216049382716049
FRONTERA,2023-12-23,299,295,4,0.0133779264214047
FRONTERA,2023-12-24,182,182,0,0
FRONTERA,2023-12-25,70,70,0,0
FRONTERA,2023-12-26,267,265,2,0.00749063670411985
FRONTERA,2023-12-27,324,318,6,0.0185185185185185
FRONTERA,2023-12-28,317,313,4,0.0126182965299685
FRONTERA,2023-12-29,328,323,5,0.0152439024390244
FRONTERA,2023-12-30,323,318,5,0.0154798761609907
FRONTERA,2023-12-31,156,152,4,0.0256410256410256
FRONTERA,2024-01-01,32,32,0,0
FRONTERA,2024-01-02,226,222,4,0.0176991150442478
FRONTERA,2024-01-03,338,333,5,0.014792899408284
FRONTERA,2024-01-04,295,292,3,0.0101694915254237
FRONTERA,2024-01-05,310,307,3,0.00967741935483871
FRONTERA,2024-01-06,325,317,8,0.0246153846153846
FRONTERA,2024-01-07,251,246,5,0.0199203187250996
FRONTERA,2024-01-08,273,268,5,0.0183150183150183
FRONTERA,2024-01-09,276,272,4,0.0144927536231884
FRONTERA,2024-01-10,263,259,4,0.0152091254752852
FRONTERA,2024-01-11,229,227,2,0.00873362445414847
FRONTERA,2024-01-12,281,276,5,0.0177935943060498
FRONTERA,2024-01-13,277,275,2,0.0072202166064982
FRONTERA,2024-01-14,223,222,1,0.00448430493273543
NORESTE 1,2023-01-02,33,17,16,0.484848484848485
NORESTE 1,2023-01-03,54,19,35,0.648148148148148
NORESTE 1,2023-01-04,63,22,41,0.650793650793651
NORESTE 1,2023-01-05,55,26,29,0.527272727272727
NORESTE 1,2023-01-06,76,33,43,0.565789473684211
NORESTE 1,2023-01-07,65,37,28,0.430769230769231
NORESTE 1,2023-01-08,26,13,13,0.5
NORESTE 1,2023-01-09,51,22,29,0.568627450980392
NORESTE 1,2023-01-10,54,24,30,0.555555555555556
NORESTE 1,2023-01-11,50,25,25,0.5
NORESTE 1,2023-01-12,53,26,27,0.509433962264151
NORESTE 1,2023-01-13,58,32,26,0.448275862068966
NORESTE 1,2023-01-14,49,26,23,0.469387755102041
NORESTE 1,2023-01-15,36,17,19,0.527777777777778
NORESTE 1,2023-01-16,52,24,28,0.538461538461538
NORESTE 1,2023-01-17,45,17,28,0.622222222222222
NORESTE 1,2023-01-18,46,26,20,0.434782608695652
NORESTE 1,2023-01-19,53,22,31,0.584905660377358
NORESTE 1,2023-01-20,40,19,21,0.525
NORESTE 1,2023-01-21,64,35,29,0.453125
NORESTE 1,2023-01-22,32,16,16,0.5
NORESTE 1,2023-01-23,54,21,33,0.611111111111111
NORESTE 1,2023-01-24,65,34,31,0.476923076923077
NORESTE 1,2023-01-25,47,29,18,0.382978723404255
NORESTE 1,2023-01-26,47,20,27,0.574468085106383
NORESTE 1,2023-01-27,58,28,30,0.517241379310345
NORESTE 1,2023-01-28,83,31,52,0.626506024096386
NORESTE 1,2023-01-29,43,18,25,0.581395348837209
NORESTE 1,2023-01-30,58,26,32,0.551724137931034
NORESTE 1,2023-01-31,51,24,27,0.529411764705882
NORESTE 1,2023-02-01,41,17,24,0.585365853658537
NORESTE 1,2023-02-02,70,37,33,0.471428571428571
NORESTE 1,2023-02-03,53,28,25,0.471698113207547
NORESTE 1,2023-02-04,64,31,33,0.515625
NORESTE 1,2023-02-05,35,19,16,0.457142857142857
NORESTE 1,2023-02-06,18,13,5,0.277777777777778
NORESTE 1,2023-02-07,46,25,21,0.456521739130435
NORESTE 1,2023-02-08,54,22,32,0.592592592592593
NORESTE 1,2023-02-09,56,26,30,0.535714285714286
NORESTE 1,2023-02-10,46,27,19,0.41304347826087
NORESTE 1,2023-02-11,68,33,35,0.514705882352941
NORESTE 1,2023-02-12,33,19,14,0.424242424242424
NORESTE 1,2023-02-13,38,16,22,0.578947368421053
NORESTE 1,2023-02-14,48,22,26,0.541666666666667
NORESTE 1,2023-02-15,59,27,32,0.542372881355932
NORESTE 1,2023-02-16,54,30,24,0.444444444444444
NORESTE 1,2023-02-17,56,29,27,0.482142857142857
NORESTE 1,2023-02-18,73,37,36,0.493150684931507
NORESTE 1,2023-02-19,31,13,18,0.580645161290323
NORESTE 1,2023-02-20,47,23,24,0.51063829787234
NORESTE 1,2023-02-21,50,24,26,0.52
NORESTE 1,2023-02-22,54,29,25,0.462962962962963
NORESTE 1,2023-02-23,51,26,25,0.490196078431373
NORESTE 1,2023-02-24,41,16,25,0.609756097560976
NORESTE 1,2023-02-25,65,25,40,0.615384615384615
NORESTE 1,2023-02-26,30,17,13,0.433333333333333
NORESTE 1,2023-02-27,55,28,27,0.490909090909091
NORESTE 1,2023-02-28,55,27,28,0.509090909090909
NORESTE 1,2023-03-01,44,23,21,0.477272727272727
NORESTE 1,2023-03-02,65,36,29,0.446153846153846
NORESTE 1,2023-03-03,68,38,30,0.441176470588235
NORESTE 1,2023-03-04,84,50,34,0.404761904761905
NORESTE 1,2023-03-05,28,17,11,0.392857142857143
NORESTE 1,2023-03-06,51,32,19,0.372549019607843
NORESTE 1,2023-03-07,47,29,18,0.382978723404255
NORESTE 1,2023-03-08,52,33,19,0.365384615384615
NORESTE 1,2023-03-09,48,34,14,0.291666666666667
NORESTE 1,2023-03-10,46,31,15,0.326086956521739
NORESTE 1,2023-03-11,75,59,16,0.213333333333333
NORESTE 1,2023-03-12,29,20,9,0.310344827586207
NORESTE 1,2023-03-13,38,28,10,0.263157894736842
NORESTE 1,2023-03-14,51,36,15,0.294117647058824
NORESTE 1,2023-03-15,49,48,1,0.0204081632653061
NORESTE 1,2023-03-16,60,60,0,0
NORESTE 1,2023-03-17,60,51,9,0.15
NORESTE 1,2023-03-18,77,71,6,0.0779220779220779
NORESTE 1,2023-03-19,39,36,3,0.0769230769230769
NORESTE 1,2023-03-20,45,39,6,0.133333333333333
NORESTE 1,2023-03-21,55,51,4,0.0727272727272727
NORESTE 1,2023-03-22,61,56,5,0.0819672131147541
NORESTE 1,2023-03-23,69,67,2,0.0289855072463768
NORESTE 1,2023-03-24,53,49,4,0.0754716981132075
NORESTE 1,2023-03-25,80,70,10,0.125
NORESTE 1,2023-03-26,44,40,4,0.0909090909090909
NORESTE 1,2023-03-27,80,76,4,0.05
NORESTE 1,2023-03-28,52,48,4,0.0769230769230769
NORESTE 1,2023-03-29,54,52,2,0.037037037037037
NORESTE 1,2023-03-30,47,45,2,0.0425531914893617
NORESTE 1,2023-03-31,90,88,2,0.0222222222222222
NORESTE 1,2023-04-01,72,66,6,0.0833333333333333
NORESTE 1,2023-04-02,36,35,1,0.0277777777777778
NORESTE 1,2023-04-03,57,54,3,0.0526315789473684
NORESTE 1,2023-04-04,31,31,0,0
NORESTE 1,2023-04-05,37,37,0,0
NORESTE 1,2023-04-06,62,62,0,0
NORESTE 1,2023-04-07,65,65,0,0
NORESTE 1,2023-04-08,58,58,0,0
NORESTE 1,2023-04-09,33,33,0,0
NORESTE 1,2023-04-10,47,47,0,0
NORESTE 1,2023-04-11,52,52,0,0
NORESTE 1,2023-04-12,52,52,0,0
NORESTE 1,2023-04-13,41,41,0,0
NORESTE 1,2023-04-14,61,61,0,0
NORESTE 1,2023-04-15,91,91,0,0
NORESTE 1,2023-04-16,45,45,0,0
NORESTE 1,2023-04-17,54,54,0,0
NORESTE 1,2023-04-18,61,61,0,0
NORESTE 1,2023-04-19,58,58,0,0
NORESTE 1,2023-04-20,53,53,0,0
NORESTE 1,2023-04-21,59,59,0,0
NORESTE 1,2023-04-22,70,70,0,0
NORESTE 1,2023-04-23,48,48,0,0
NORESTE 1,2023-04-24,63,63,0,0
NORESTE 1,2023-04-25,57,57,0,0
NORESTE 1,2023-04-26,62,62,0,0
NORESTE 1,2023-04-27,46,46,0,0
NORESTE 1,2023-04-28,56,56,0,0
NORESTE 1,2023-04-29,83,83,0,0
NORESTE 1,2023-04-30,69,69,0,0
NORESTE 1,2023-05-01,14,14,0,0
NORESTE 1,2023-05-02,68,68,0,0
NORESTE 1,2023-05-03,56,56,0,0
NORESTE 1,2023-05-04,63,63,0,0
NORESTE 1,2023-05-05,66,66,0,0
NORESTE 1,2023-05-06,78,78,0,0
NORESTE 1,2023-05-07,47,47,0,0
NORESTE 1,2023-05-08,50,50,0,0
NORESTE 1,2023-05-09,52,52,0,0
NORESTE 1,2023-05-10,48,48,0,0
NORESTE 1,2023-05-11,48,48,0,0
NORESTE 1,2023-05-12,42,42,0,0
NORESTE 1,2023-05-13,82,82,0,0
NORESTE 1,2023-05-14,54,54,0,0
NORESTE 1,2023-05-15,81,81,0,0
NORESTE 1,2023-05-16,71,71,0,0
NORESTE 1,2023-05-17,77,77,0,0
NORESTE 1,2023-05-18,58,58,0,0
NORESTE 1,2023-05-19,36,36,0,0
NORESTE 1,2023-05-20,50,50,0,0
NORESTE 1,2023-05-21,44,44,0,0
NORESTE 1,2023-05-22,55,55,0,0
NORESTE 1,2023-05-23,56,56,0,0
NORESTE 1,2023-05-24,54,54,0,0
NORESTE 1,2023-05-25,55,55,0,0
NORESTE 1,2023-05-26,58,57,1,0.0172413793103448
NORESTE 1,2023-05-27,78,76,2,0.0256410256410256
NORESTE 1,2023-05-28,48,48,0,0
NORESTE 1,2023-05-29,85,84,1,0.0117647058823529
NORESTE 1,2023-05-30,50,50,0,0
NORESTE 1,2023-05-31,83,81,2,0.0240963855421687
NORESTE 1,2023-06-01,39,39,0,0
NORESTE 1,2023-06-02,95,91,4,0.0421052631578947
NORESTE 1,2023-06-03,78,76,2,0.0256410256410256
NORESTE 1,2023-06-04,100,96,4,0.04
NORESTE 1,2023-06-05,70,67,3,0.0428571428571429
NORESTE 1,2023-06-06,76,74,2,0.0263157894736842
NORESTE 1,2023-06-07,88,87,1,0.0113636363636364
NORESTE 1,2023-06-08,54,52,2,0.037037037037037
NORESTE 1,2023-06-09,93,92,1,0.010752688172043
NORESTE 1,2023-06-10,61,60,1,0.0163934426229508
NORESTE 1,2023-06-11,66,65,1,0.0151515151515152
NORESTE 1,2023-06-12,72,69,3,0.0416666666666667
NORESTE 1,2023-06-13,65,64,1,0.0153846153846154
NORESTE 1,2023-06-14,61,60,1,0.0163934426229508
NORESTE 1,2023-06-15,78,75,3,0.0384615384615385
NORESTE 1,2023-06-16,70,68,2,0.0285714285714286
NORESTE 1,2023-06-17,61,59,2,0.0327868852459016
NORESTE 1,2023-06-18,39,39,0,0
NORESTE 1,2023-06-19,76,74,2,0.0263157894736842
NORESTE 1,2023-06-20,42,40,2,0.0476190476190476
NORESTE 1,2023-06-21,49,48,1,0.0204081632653061
NORESTE 1,2023-06-22,74,74,0,0
NORESTE 1,2023-06-23,78,77,1,0.0128205128205128
NORESTE 1,2023-06-24,94,92,2,0.0212765957446809
NORESTE 1,2023-06-25,71,70,1,0.0140845070422535
NORESTE 1,2023-06-26,89,87,2,0.0224719101123595
NORESTE 1,2023-06-27,80,80,0,0
NORESTE 1,2023-06-28,49,47,2,0.0408163265306122
NORESTE 1,2023-06-29,70,66,4,0.0571428571428571
NORESTE 1,2023-06-30,34,34,0,0
NORESTE 1,2023-07-01,84,84,0,0
NORESTE 1,2023-07-02,40,39,1,0.025
NORESTE 1,2023-07-03,75,73,2,0.0266666666666667
NORESTE 1,2023-07-04,111,107,4,0.036036036036036
NORESTE 1,2023-07-05,73,72,1,0.0136986301369863
NORESTE 1,2023-07-06,104,98,6,0.0576923076923077
NORESTE 1,2023-07-07,132,131,1,0.00757575757575758
NORESTE 1,2023-07-08,170,170,0,0
NORESTE 1,2023-07-09,143,142,1,0.00699300699300699
NORESTE 1,2023-07-10,116,116,0,0
NORESTE 1,2023-07-11,101,100,1,0.0099009900990099
NORESTE 1,2023-07-12,121,120,1,0.00826446280991736
NORESTE 1,2023-07-13,131,126,5,0.0381679389312977
NORESTE 1,2023-07-14,135,134,1,0.00740740740740741
NORESTE 1,2023-07-15,160,155,5,0.03125
NORESTE 1,2023-07-16,91,91,0,0
NORESTE 1,2023-07-17,110,107,3,0.0272727272727273
NORESTE 1,2023-07-18,126,124,2,0.0158730158730159
NORESTE 1,2023-07-19,103,101,2,0.0194174757281553
NORESTE 1,2023-07-20,150,144,6,0.04
NORESTE 1,2023-07-21,181,177,4,0.0220994475138122
NORESTE 1,2023-07-22,175,173,2,0.0114285714285714
NORESTE 1,2023-07-23,92,92,0,0
NORESTE 1,2023-07-24,109,107,2,0.018348623853211
NORESTE 1,2023-07-25,141,140,1,0.00709219858156028
NORESTE 1,2023-07-26,149,148,1,0.00671140939597315
NORESTE 1,2023-07-27,167,165,2,0.0119760479041916
NORESTE 1,2023-07-28,194,191,3,0.0154639175257732
NORESTE 1,2023-07-29,206,203,3,0.0145631067961165
NORESTE 1,2023-07-30,70,69,1,0.0142857142857143
NORESTE 1,2023-07-31,150,147,3,0.02
NORESTE 1,2023-08-01,128,124,4,0.03125
NORESTE 1,2023-08-02,139,133,6,0.0431654676258993
NORESTE 1,2023-08-03,157,140,17,0.10828025477707
NORESTE 1,2023-08-04,151,149,2,0.0132450331125828
NORESTE 1,2023-08-05,178,176,2,0.0112359550561798
NORESTE 1,2023-08-06,119,117,2,0.0168067226890756
NORESTE 1,2023-08-07,107,102,5,0.0467289719626168
NORESTE 1,2023-08-08,130,125,5,0.0384615384615385
NORESTE 1,2023-08-09,115,112,3,0.0260869565217391
NORESTE 1,2023-08-10,135,127,8,0.0592592592592593
NORESTE 1,2023-08-11,153,146,7,0.0457516339869281
NORESTE 1,2023-08-12,144,140,4,0.0277777777777778
NORESTE 1,2023-08-13,74,74,0,0
NORESTE 1,2023-08-14,123,119,4,0.032520325203252
NORESTE 1,2023-08-15,179,176,3,0.0167597765363128
NORESTE 1,2023-08-16,150,147,3,0.02
NORESTE 1,2023-08-17,173,167,6,0.0346820809248555
NORESTE 1,2023-08-18,189,184,5,0.0264550264550265
NORESTE 1,2023-08-19,204,194,10,0.0490196078431373
NORESTE 1,2023-08-20,113,110,3,0.0265486725663717
NORESTE 1,2023-08-21,126,125,1,0.00793650793650794
NORESTE 1,2023-08-22,148,147,1,0.00675675675675676
NORESTE 1,2023-08-23,158,158,0,0
NORESTE 1,2023-08-24,157,156,1,0.00636942675159236
NORESTE 1,2023-08-25,180,178,2,0.0111111111111111
NORESTE 1,2023-08-26,233,231,2,0.00858369098712446
NORESTE 1,2023-08-27,123,121,2,0.016260162601626
NORESTE 1,2023-08-28,141,140,1,0.00709219858156028
NORESTE 1,2023-08-29,141,140,1,0.00709219858156028
NORESTE 1,2023-08-30,138,138,0,0
NORESTE 1,2023-08-31,153,151,2,0.0130718954248366
NORESTE 1,2023-09-01,143,143,0,0
NORESTE 1,2023-09-02,156,156,0,0
NORESTE 1,2023-09-03,136,136,0,0
NORESTE 1,2023-09-04,127,127,0,0
NORESTE 1,2023-09-05,163,161,2,0.0122699386503067
NORESTE 1,2023-09-06,158,158,0,0
NORESTE 1,2023-09-07,136,136,0,0
NORESTE 1,2023-09-08,131,131,0,0
NORESTE 1,2023-09-09,181,181,0,0
NORESTE 1,2023-09-10,115,114,1,0.00869565217391304
NORESTE 1,2023-09-11,129,129,0,0
NORESTE 1,2023-09-12,154,154,0,0
NORESTE 1,2023-09-13,138,138,0,0
NORESTE 1,2023-09-14,109,109,0,0
NORESTE 1,2023-09-15,175,173,2,0.0114285714285714
NORESTE 1,2023-09-16,138,136,2,0.0144927536231884
NORESTE 1,2023-09-17,131,130,1,0.00763358778625954
NORESTE 1,2023-09-18,142,141,1,0.00704225352112676
NORESTE 1,2023-09-19,138,138,0,0
NORESTE 1,2023-09-20,102,101,1,0.00980392156862745
NORESTE 1,2023-09-21,109,106,3,0.0275229357798165
NORESTE 1,2023-09-22,198,191,7,0.0353535353535354
NORESTE 1,2023-09-23,220,219,1,0.00454545454545455
NORESTE 1,2023-09-24,136,136,0,0
NORESTE 1,2023-09-25,178,175,3,0.0168539325842697
NORESTE 1,2023-09-26,172,166,6,0.0348837209302326
NORESTE 1,2023-09-27,178,175,3,0.0168539325842697
NORESTE 1,2023-09-28,174,170,4,0.0229885057471264
NORESTE 1,2023-09-29,204,196,8,0.0392156862745098
NORESTE 1,2023-09-30,230,225,5,0.0217391304347826
NORESTE 1,2023-10-01,152,150,2,0.0131578947368421
NORESTE 1,2023-10-02,149,146,3,0.0201342281879195
NORESTE 1,2023-10-03,126,120,6,0.0476190476190476
NORESTE 1,2023-10-04,199,189,10,0.050251256281407
NORESTE 1,2023-10-05,155,146,9,0.0580645161290323
NORESTE 1,2023-10-06,187,179,8,0.0427807486631016
NORESTE 1,2023-10-07,191,183,8,0.0418848167539267
NORESTE 1,2023-10-08,128,124,4,0.03125
NORESTE 1,2023-10-09,179,170,9,0.0502793296089385
NORESTE 1,2023-10-10,128,126,2,0.015625
NORESTE 1,2023-10-11,150,146,4,0.0266666666666667
NORESTE 1,2023-10-12,119,115,4,0.0336134453781513
NORESTE 1,2023-10-13,125,120,5,0.04
NORESTE 1,2023-10-14,146,138,8,0.0547945205479452
NORESTE 1,2023-10-15,122,122,0,0
NORESTE 1,2023-10-16,169,163,6,0.0355029585798817
NORESTE 1,2023-10-17,159,157,2,0.0125786163522013
NORESTE 1,2023-10-18,196,190,6,0.0306122448979592
NORESTE 1,2023-10-19,150,148,2,0.0133333333333333
NORESTE 1,2023-10-20,180,172,8,0.0444444444444444
NORESTE 1,2023-10-21,177,174,3,0.0169491525423729
NORESTE 1,2023-10-22,130,127,3,0.0230769230769231
NORESTE 1,2023-10-23,141,133,8,0.0567375886524823
NORESTE 1,2023-10-24,150,143,7,0.0466666666666667
NORESTE 1,2023-10-25,144,138,6,0.0416666666666667
NORESTE 1,2023-10-26,174,167,7,0.0402298850574713
NORESTE 1,2023-10-27,154,149,5,0.0324675324675325
NORESTE 1,2023-10-28,191,186,5,0.0261780104712042
NORESTE 1,2023-10-29,112,110,2,0.0178571428571429
NORESTE 1,2023-10-30,115,113,2,0.0173913043478261
NORESTE 1,2023-10-31,110,107,3,0.0272727272727273
NORESTE 1,2023-11-01,153,145,8,0.0522875816993464
NORESTE 1,2023-11-02,179,172,7,0.0391061452513966
NORESTE 1,2023-11-03,200,192,8,0.04
NORESTE 1,2023-11-04,171,161,10,0.0584795321637427
NORESTE 1,2023-11-05,148,145,3,0.0202702702702703
NORESTE 1,2023-11-06,166,162,4,0.0240963855421687
NORESTE 1,2023-11-07,176,174,2,0.0113636363636364
NORESTE 1,2023-11-08,196,194,2,0.0102040816326531
NORESTE 1,2023-11-09,192,187,5,0.0260416666666667
NORESTE 1,2023-11-10,169,168,1,0.00591715976331361
NORESTE 1,2023-11-11,226,221,5,0.0221238938053097
NORESTE 1,2023-11-12,138,136,2,0.0144927536231884
NORESTE 1,2023-11-13,172,167,5,0.0290697674418605
NORESTE 1,2023-11-14,183,176,7,0.0382513661202186
NORESTE 1,2023-11-15,169,166,3,0.0177514792899408
NORESTE 1,2023-11-16,174,167,7,0.0402298850574713
NORESTE 1,2023-11-17,228,223,5,0.0219298245614035
NORESTE 1,2023-11-18,236,231,5,0.0211864406779661
NORESTE 1,2023-11-19,155,153,2,0.0129032258064516
NORESTE 1,2023-11-20,163,156,7,0.0429447852760736
NORESTE 1,2023-11-21,164,160,4,0.024390243902439
NORESTE 1,2023-11-22,149,145,4,0.0268456375838926
NORESTE 1,2023-11-23,194,187,7,0.0360824742268041
NORESTE 1,2023-11-24,196,189,7,0.0357142857142857
NORESTE 1,2023-11-25,231,226,5,0.0216450216450216
NORESTE 1,2023-11-26,227,220,7,0.0308370044052863
NORESTE 1,2023-11-27,145,141,4,0.0275862068965517
NORESTE 1,2023-11-28,163,162,1,0.00613496932515337
NORESTE 1,2023-11-29,212,196,16,0.0754716981132075
NORESTE 1,2023-11-30,208,193,15,0.0721153846153846
NORESTE 1,2023-12-01,159,150,9,0.0566037735849057
NORESTE 1,2023-12-02,229,213,16,0.0698689956331878
NORESTE 1,2023-12-03,240,230,10,0.0416666666666667
NORESTE 1,2023-12-04,172,165,7,0.0406976744186047
NORESTE 1,2023-12-05,205,195,10,0.0487804878048781
NORESTE 1,2023-12-06,190,178,12,0.0631578947368421
NORESTE 1,2023-12-07,206,196,10,0.0485436893203883
NORESTE 1,2023-12-08,232,224,8,0.0344827586206897
NORESTE 1,2023-12-09,236,225,11,0.0466101694915254
NORESTE 1,2023-12-10,184,176,8,0.0434782608695652
NORESTE 1,2023-12-11,162,152,10,0.0617283950617284
NORESTE 1,2023-12-12,193,184,9,0.0466321243523316
NORESTE 1,2023-12-13,184,176,8,0.0434782608695652
NORESTE 1,2023-12-14,165,157,8,0.0484848484848485
NORESTE 1,2023-12-15,176,166,10,0.0568181818181818
NORESTE 1,2023-12-16,214,204,10,0.0467289719626168
NORESTE 1,2023-12-17,164,159,5,0.0304878048780488
NORESTE 1,2023-12-18,166,159,7,0.0421686746987952
NORESTE 1,2023-12-19,191,185,6,0.031413612565445
NORESTE 1,2023-12-20,189,181,8,0.0423280423280423
NORESTE 1,2023-12-21,199,189,10,0.050251256281407
NORESTE 1,2023-12-22,205,201,4,0.0195121951219512
NORESTE 1,2023-12-23,240,234,6,0.025
NORESTE 1,2023-12-24,146,144,2,0.0136986301369863
NORESTE 1,2023-12-25,52,52,0,0
NORESTE 1,2023-12-26,153,149,4,0.0261437908496732
NORESTE 1,2023-12-27,218,213,5,0.0229357798165138
NORESTE 1,2023-12-28,213,205,8,0.0375586854460094
NORESTE 1,2023-12-29,232,226,6,0.0258620689655172
NORESTE 1,2023-12-30,199,196,3,0.0150753768844221
NORESTE 1,2023-12-31,116,116,0,0
NORESTE 1,2024-01-01,21,21,0,0
NORESTE 1,2024-01-02,130,128,2,0.0153846153846154
NORESTE 1,2024-01-03,215,211,4,0.0186046511627907
NORESTE 1,2024-01-04,208,202,6,0.0288461538461538
NORESTE 1,2024-01-05,232,227,5,0.021551724137931
NORESTE 1,2024-01-06,268,263,5,0.0186567164179104
NORESTE 1,2024-01-07,168,166,2,0.0119047619047619
NORESTE 1,2024-01-08,162,161,1,0.00617283950617284
NORESTE 1,2024-01-09,174,168,6,0.0344827586206897
NORESTE 1,2024-01-10,219,216,3,0.0136986301369863
NORESTE 1,2024-01-11,210,207,3,0.0142857142857143
NORESTE 1,2024-01-12,235,230,5,0.0212765957446809
NORESTE 1,2024-01-13,254,247,7,0.0275590551181102
NORESTE 1,2024-01-14,188,183,5,0.0265957446808511
NORESTE 2,2023-01-02,100,59,41,0.41
NORESTE 2,2023-01-03,125,85,40,0.32
NORESTE 2,2023-01-04,127,79,48,0.377952755905512
NORESTE 2,2023-01-05,129,95,34,0.263565891472868
NORESTE 2,2023-01-06,129,89,40,0.310077519379845
NORESTE 2,2023-01-07,185,123,62,0.335135135135135
NORESTE 2,2023-01-08,95,57,38,0.4
NORESTE 2,2023-01-09,128,83,45,0.3515625
NORESTE 2,2023-01-10,126,88,38,0.301587301587302
NORESTE 2,2023-01-11,131,94,37,0.282442748091603
NORESTE 2,2023-01-12,104,70,34,0.326923076923077
NORESTE 2,2023-01-13,140,108,32,0.228571428571429
NORESTE 2,2023-01-14,159,109,50,0.314465408805031
NORESTE 2,2023-01-15,93,69,24,0.258064516129032
NORESTE 2,2023-01-16,111,76,35,0.315315315315315
NORESTE 2,2023-01-17,132,98,34,0.257575757575758
NORESTE 2,2023-01-18,100,68,32,0.32
NORESTE 2,2023-01-19,98,67,31,0.316326530612245
NORESTE 2,2023-01-20,140,106,34,0.242857142857143
NORESTE 2,2023-01-21,181,133,48,0.265193370165746
NORESTE 2,2023-01-22,88,62,26,0.295454545454545
NORESTE 2,2023-01-23,114,86,28,0.245614035087719
NORESTE 2,2023-01-24,104,84,20,0.192307692307692
NORESTE 2,2023-01-25,126,81,45,0.357142857142857
NORESTE 2,2023-01-26,123,82,41,0.333333333333333
NORESTE 2,2023-01-27,124,88,36,0.290322580645161
NORESTE 2,2023-01-28,215,114,101,0.469767441860465
NORESTE 2,2023-01-29,109,60,49,0.44954128440367
NORESTE 2,2023-01-30,125,86,39,0.312
NORESTE 2,2023-01-31,122,92,30,0.245901639344262
NORESTE 2,2023-02-01,97,73,24,0.247422680412371
NORESTE 2,2023-02-02,134,89,45,0.335820895522388
NORESTE 2,2023-02-03,141,92,49,0.347517730496454
NORESTE 2,2023-02-04,189,132,57,0.301587301587302
NORESTE 2,2023-02-05,103,67,36,0.349514563106796
NORESTE 2,2023-02-06,104,70,34,0.326923076923077
NORESTE 2,2023-02-07,116,83,33,0.28448275862069
NORESTE 2,2023-02-08,127,98,29,0.228346456692913
NORESTE 2,2023-02-09,127,102,25,0.196850393700787
NORESTE 2,2023-02-10,126,85,41,0.325396825396825
NORESTE 2,2023-02-11,171,105,66,0.385964912280702
NORESTE 2,2023-02-12,120,75,45,0.375
NORESTE 2,2023-02-13,110,69,41,0.372727272727273
NORESTE 2,2023-02-14,116,83,33,0.28448275862069
NORESTE 2,2023-02-15,115,80,35,0.304347826086957
NORESTE 2,2023-02-16,124,92,32,0.258064516129032
NORESTE 2,2023-02-17,138,88,50,0.36231884057971
NORESTE 2,2023-02-18,197,134,63,0.319796954314721
NORESTE 2,2023-02-19,100,62,38,0.38
NORESTE 2,2023-02-20,111,72,39,0.351351351351351
NORESTE 2,2023-02-21,111,77,34,0.306306306306306
NORESTE 2,2023-02-22,126,73,53,0.420634920634921
NORESTE 2,2023-02-23,111,68,43,0.387387387387387
NORESTE 2,2023-02-24,112,70,42,0.375
NORESTE 2,2023-02-25,195,105,90,0.461538461538462
NORESTE 2,2023-02-26,98,61,37,0.377551020408163
NORESTE 2,2023-02-27,127,71,56,0.440944881889764
NORESTE 2,2023-02-28,146,89,57,0.39041095890411
NORESTE 2,2023-03-01,133,80,53,0.398496240601504
NORESTE 2,2023-03-02,131,79,52,0.396946564885496
NORESTE 2,2023-03-03,145,90,55,0.379310344827586
NORESTE 2,2023-03-04,166,96,70,0.421686746987952
NORESTE 2,2023-03-05,83,50,33,0.397590361445783
NORESTE 2,2023-03-06,103,59,44,0.427184466019417
NORESTE 2,2023-03-07,137,76,61,0.445255474452555
NORESTE 2,2023-03-08,145,81,64,0.441379310344828
NORESTE 2,2023-03-09,146,120,26,0.178082191780822
NORESTE 2,2023-03-10,165,117,48,0.290909090909091
NORESTE 2,2023-03-11,215,151,64,0.297674418604651
NORESTE 2,2023-03-12,146,104,42,0.287671232876712
NORESTE 2,2023-03-13,103,72,31,0.300970873786408
NORESTE 2,2023-03-14,136,107,29,0.213235294117647
NORESTE 2,2023-03-15,134,114,20,0.149253731343284
NORESTE 2,2023-03-16,151,133,18,0.119205298013245
NORESTE 2,2023-03-17,151,132,19,0.125827814569536
NORESTE 2,2023-03-18,220,197,23,0.104545454545455
NORESTE 2,2023-03-19,108,93,15,0.138888888888889
NORESTE 2,2023-03-20,121,102,19,0.15702479338843
NORESTE 2,2023-03-21,163,149,14,0.0858895705521472
NORESTE 2,2023-03-22,156,141,15,0.0961538461538462
NORESTE 2,2023-03-23,154,138,16,0.103896103896104
NORESTE 2,2023-03-24,199,180,19,0.0954773869346734
NORESTE 2,2023-03-25,177,159,18,0.101694915254237
NORESTE 2,2023-03-26,98,80,18,0.183673469387755
NORESTE 2,2023-03-27,153,138,15,0.0980392156862745
NORESTE 2,2023-03-28,105,98,7,0.0666666666666667
NORESTE 2,2023-03-29,173,148,25,0.144508670520231
NORESTE 2,2023-03-30,168,146,22,0.130952380952381
NORESTE 2,2023-03-31,243,223,20,0.0823045267489712
NORESTE 2,2023-04-01,162,148,14,0.0864197530864197
NORESTE 2,2023-04-02,97,87,10,0.103092783505155
NORESTE 2,2023-04-03,132,127,5,0.0378787878787879
NORESTE 2,2023-04-04,139,139,0,0
NORESTE 2,2023-04-05,141,135,6,0.0425531914893617
NORESTE 2,2023-04-06,147,145,2,0.0136054421768707
NORESTE 2,2023-04-07,145,145,0,0
NORESTE 2,2023-04-08,151,151,0,0
NORESTE 2,2023-04-09,92,92,0,0
NORESTE 2,2023-04-10,105,105,0,0
NORESTE 2,2023-04-11,137,137,0,0
NORESTE 2,2023-04-12,124,124,0,0
NORESTE 2,2023-04-13,119,116,3,0.0252100840336134
NORESTE 2,2023-04-14,190,190,0,0
NORESTE 2,2023-04-15,198,195,3,0.0151515151515152
NORESTE 2,2023-04-16,123,121,2,0.016260162601626
NORESTE 2,2023-04-17,151,151,0,0
NORESTE 2,2023-04-18,144,144,0,0
NORESTE 2,2023-04-19,131,129,2,0.0152671755725191
NORESTE 2,2023-04-20,130,129,1,0.00769230769230769
NORESTE 2,2023-04-21,168,163,5,0.0297619047619048
NORESTE 2,2023-04-22,189,187,2,0.0105820105820106
NORESTE 2,2023-04-23,141,140,1,0.00709219858156028
NORESTE 2,2023-04-24,148,146,2,0.0135135135135135
NORESTE 2,2023-04-25,185,185,0,0
NORESTE 2,2023-04-26,168,168,0,0
NORESTE 2,2023-04-27,130,130,0,0
NORESTE 2,2023-04-28,158,158,0,0
NORESTE 2,2023-04-29,190,189,1,0.00526315789473684
NORESTE 2,2023-04-30,149,149,0,0
NORESTE 2,2023-05-01,124,124,0,0
NORESTE 2,2023-05-02,130,130,0,0
NORESTE 2,2023-05-03,146,146,0,0
NORESTE 2,2023-05-04,148,147,1,0.00675675675675676
NORESTE 2,2023-05-05,171,171,0,0
NORESTE 2,2023-05-06,185,184,1,0.00540540540540541
NORESTE 2,2023-05-07,102,102,0,0
NORESTE 2,2023-05-08,115,114,1,0.00869565217391304
NORESTE 2,2023-05-09,122,122,0,0
NORESTE 2,2023-05-10,129,128,1,0.00775193798449612
NORESTE 2,2023-05-11,119,118,1,0.00840336134453781
NORESTE 2,2023-05-12,132,132,0,0
NORESTE 2,2023-05-13,204,203,1,0.00490196078431373
NORESTE 2,2023-05-14,174,174,0,0
NORESTE 2,2023-05-15,181,181,0,0
NORESTE 2,2023-05-16,216,215,1,0.00462962962962963
NORESTE 2,2023-05-17,154,154,0,0
NORESTE 2,2023-05-18,129,129,0,0
NORESTE 2,2023-05-19,153,152,1,0.0065359477124183
NORESTE 2,2023-05-20,145,144,1,0.00689655172413793
NORESTE 2,2023-05-21,155,155,0,0
NORESTE 2,2023-05-22,140,140,0,0
NORESTE 2,2023-05-23,144,144,0,0
NORESTE 2,2023-05-24,147,147,0,0
NORESTE 2,2023-05-25,128,128,0,0
NORESTE 2,2023-05-26,110,107,3,0.0272727272727273
NORESTE 2,2023-05-27,137,126,11,0.0802919708029197
NORESTE 2,2023-05-28,131,127,4,0.0305343511450382
NORESTE 2,2023-05-29,112,110,2,0.0178571428571429
NORESTE 2,2023-05-30,103,103,0,0
NORESTE 2,2023-05-31,122,119,3,0.0245901639344262
NORESTE 2,2023-06-01,123,114,9,0.0731707317073171
NORESTE 2,2023-06-02,243,237,6,0.0246913580246914
NORESTE 2,2023-06-03,204,200,4,0.0196078431372549
NORESTE 2,2023-06-04,107,106,1,0.00934579439252336
NORESTE 2,2023-06-05,110,106,4,0.0363636363636364
NORESTE 2,2023-06-06,158,156,2,0.0126582278481013
NORESTE 2,2023-06-07,150,146,4,0.0266666666666667
NORESTE 2,2023-06-08,134,128,6,0.0447761194029851
NORESTE 2,2023-06-09,121,118,3,0.0247933884297521
NORESTE 2,2023-06-10,130,127,3,0.0230769230769231
NORESTE 2,2023-06-11,113,112,1,0.00884955752212389
NORESTE 2,2023-06-12,140,136,4,0.0285714285714286
NORESTE 2,2023-06-13,116,112,4,0.0344827586206897
NORESTE 2,2023-06-14,146,144,2,0.0136986301369863
NORESTE 2,2023-06-15,124,121,3,0.0241935483870968
NORESTE 2,2023-06-16,117,116,1,0.00854700854700855
NORESTE 2,2023-06-17,174,170,4,0.0229885057471264
NORESTE 2,2023-06-18,94,92,2,0.0212765957446809
NORESTE 2,2023-06-19,112,111,1,0.00892857142857143
NORESTE 2,2023-06-20,132,127,5,0.0378787878787879
NORESTE 2,2023-06-21,120,119,1,0.00833333333333333
NORESTE 2,2023-06-22,142,138,4,0.028169014084507
NORESTE 2,2023-06-23,145,139,6,0.0413793103448276
NORESTE 2,2023-06-24,139,138,1,0.00719424460431655
NORESTE 2,2023-06-25,117,112,5,0.0427350427350427
NORESTE 2,2023-06-26,103,100,3,0.029126213592233
NORESTE 2,2023-06-27,148,145,3,0.0202702702702703
NORESTE 2,2023-06-28,109,102,7,0.0642201834862385
NORESTE 2,2023-06-29,140,134,6,0.0428571428571429
NORESTE 2,2023-06-30,82,77,5,0.0609756097560976
NORESTE 2,2023-07-01,122,118,4,0.0327868852459016
NORESTE 2,2023-07-02,108,105,3,0.0277777777777778
NORESTE 2,2023-07-03,115,112,3,0.0260869565217391
NORESTE 2,2023-07-04,171,165,6,0.0350877192982456
NORESTE 2,2023-07-05,66,64,2,0.0303030303030303
NORESTE 2,2023-07-06,138,134,4,0.0289855072463768
NORESTE 2,2023-07-07,152,146,6,0.0394736842105263
NORESTE 2,2023-07-08,190,184,6,0.0315789473684211
NORESTE 2,2023-07-09,169,169,0,0
NORESTE 2,2023-07-10,148,142,6,0.0405405405405405
NORESTE 2,2023-07-11,209,201,8,0.0382775119617225
NORESTE 2,2023-07-12,202,195,7,0.0346534653465347
NORESTE 2,2023-07-13,221,216,5,0.0226244343891403
NORESTE 2,2023-07-14,200,191,9,0.045
NORESTE 2,2023-07-15,241,234,7,0.029045643153527
NORESTE 2,2023-07-16,154,152,2,0.012987012987013
NORESTE 2,2023-07-17,194,189,5,0.0257731958762887
NORESTE 2,2023-07-18,207,204,3,0.0144927536231884
NORESTE 2,2023-07-19,175,172,3,0.0171428571428571
NORESTE 2,2023-07-20,188,184,4,0.0212765957446809
NORESTE 2,2023-07-21,216,207,9,0.0416666666666667
NORESTE 2,2023-07-22,274,266,8,0.0291970802919708
NORESTE 2,2023-07-23,197,194,3,0.0152284263959391
NORESTE 2,2023-07-24,185,176,9,0.0486486486486487
NORESTE 2,2023-07-25,208,202,6,0.0288461538461538
NORESTE 2,2023-07-26,221,215,6,0.0271493212669683
NORESTE 2,2023-07-27,218,215,3,0.0137614678899083
NORESTE 2,2023-07-28,212,204,8,0.0377358490566038
NORESTE 2,2023-07-29,208,201,7,0.0336538461538462
NORESTE 2,2023-07-30,196,193,3,0.0153061224489796
NORESTE 2,2023-07-31,177,167,10,0.0564971751412429
NORESTE 2,2023-08-01,196,185,11,0.0561224489795918
NORESTE 2,2023-08-02,238,229,9,0.0378151260504202
NORESTE 2,2023-08-03,228,194,34,0.149122807017544
NORESTE 2,2023-08-04,208,195,13,0.0625
NORESTE 2,2023-08-05,279,260,19,0.0681003584229391
NORESTE 2,2023-08-06,144,134,10,0.0694444444444444
NORESTE 2,2023-08-07,179,172,7,0.0391061452513966
NORESTE 2,2023-08-08,170,160,10,0.0588235294117647
NORESTE 2,2023-08-09,205,194,11,0.0536585365853659
NORESTE 2,2023-08-10,185,179,6,0.0324324324324324
NORESTE 2,2023-08-11,240,230,10,0.0416666666666667
NORESTE 2,2023-08-12,185,172,13,0.0702702702702703
NORESTE 2,2023-08-13,136,126,10,0.0735294117647059
NORESTE 2,2023-08-14,172,162,10,0.0581395348837209
NORESTE 2,2023-08-15,217,210,7,0.032258064516129
NORESTE 2,2023-08-16,208,202,6,0.0288461538461538
NORESTE 2,2023-08-17,241,231,10,0.04149377593361
NORESTE 2,2023-08-18,301,294,7,0.0232558139534884
NORESTE 2,2023-08-19,329,313,16,0.0486322188449848
NORESTE 2,2023-08-20,203,199,4,0.0197044334975369
NORESTE 2,2023-08-21,180,175,5,0.0277777777777778
NORESTE 2,2023-08-22,208,203,5,0.0240384615384615
NORESTE 2,2023-08-23,222,213,9,0.0405405405405405
NORESTE 2,2023-08-24,198,186,12,0.0606060606060606
NORESTE 2,2023-08-25,265,260,5,0.0188679245283019
NORESTE 2,2023-08-26,294,285,9,0.0306122448979592
NORESTE 2,2023-08-27,245,235,10,0.0408163265306122
NORESTE 2,2023-08-28,228,216,12,0.0526315789473684
NORESTE 2,2023-08-29,212,199,13,0.0613207547169811
NORESTE 2,2023-08-30,177,171,6,0.0338983050847458
NORESTE 2,2023-08-31,210,205,5,0.0238095238095238
NORESTE 2,2023-09-01,191,187,4,0.0209424083769634
NORESTE 2,2023-09-02,222,218,4,0.018018018018018
NORESTE 2,2023-09-03,159,156,3,0.0188679245283019
NORESTE 2,2023-09-04,190,186,4,0.0210526315789474
NORESTE 2,2023-09-05,218,212,6,0.0275229357798165
NORESTE 2,2023-09-06,200,199,1,0.005
NORESTE 2,2023-09-07,183,179,4,0.0218579234972678
NORESTE 2,2023-09-08,216,213,3,0.0138888888888889
NORESTE 2,2023-09-09,231,223,8,0.0346320346320346
NORESTE 2,2023-09-10,151,150,1,0.00662251655629139
NORESTE 2,2023-09-11,173,170,3,0.0173410404624277
NORESTE 2,2023-09-12,193,187,6,0.0310880829015544
NORESTE 2,2023-09-13,179,173,6,0.0335195530726257
NORESTE 2,2023-09-14,128,127,1,0.0078125
NORESTE 2,2023-09-15,215,206,9,0.0418604651162791
NORESTE 2,2023-09-16,141,139,2,0.0141843971631206
NORESTE 2,2023-09-17,144,141,3,0.0208333333333333
NORESTE 2,2023-09-18,165,160,5,0.0303030303030303
NORESTE 2,2023-09-19,94,94,0,0
NORESTE 2,2023-09-20,93,91,2,0.021505376344086
NORESTE 2,2023-09-21,75,70,5,0.0666666666666667
NORESTE 2,2023-09-22,249,248,1,0.00401606425702811
NORESTE 2,2023-09-23,247,239,8,0.0323886639676113
NORESTE 2,2023-09-24,183,179,4,0.0218579234972678
NORESTE 2,2023-09-25,194,190,4,0.0206185567010309
NORESTE 2,2023-09-26,215,209,6,0.027906976744186
NORESTE 2,2023-09-27,170,165,5,0.0294117647058824
NORESTE 2,2023-09-28,206,197,9,0.0436893203883495
NORESTE 2,2023-09-29,200,184,16,0.08
NORESTE 2,2023-09-30,246,232,14,0.0569105691056911
NORESTE 2,2023-10-01,159,144,15,0.0943396226415094
NORESTE 2,2023-10-02,179,171,8,0.0446927374301676
NORESTE 2,2023-10-03,90,84,6,0.0666666666666667
NORESTE 2,2023-10-04,226,213,13,0.0575221238938053
NORESTE 2,2023-10-05,173,166,7,0.0404624277456647
NORESTE 2,2023-10-06,189,182,7,0.037037037037037
NORESTE 2,2023-10-07,213,202,11,0.0516431924882629
NORESTE 2,2023-10-08,152,141,11,0.0723684210526316
NORESTE 2,2023-10-09,173,162,11,0.0635838150289017
NORESTE 2,2023-10-10,136,130,6,0.0441176470588235
NORESTE 2,2023-10-11,142,138,4,0.028169014084507
NORESTE 2,2023-10-12,131,125,6,0.0458015267175573
NORESTE 2,2023-10-13,122,120,2,0.0163934426229508
NORESTE 2,2023-10-14,170,167,3,0.0176470588235294
NORESTE 2,2023-10-15,157,151,6,0.0382165605095541
NORESTE 2,2023-10-16,193,188,5,0.0259067357512953
NORESTE 2,2023-10-17,192,187,5,0.0260416666666667
NORESTE 2,2023-10-18,229,222,7,0.0305676855895196
NORESTE 2,2023-10-19,211,205,6,0.028436018957346
NORESTE 2,2023-10-20,193,188,5,0.0259067357512953
NORESTE 2,2023-10-21,269,259,10,0.0371747211895911
NORESTE 2,2023-10-22,160,157,3,0.01875
NORESTE 2,2023-10-23,214,206,8,0.0373831775700935
NORESTE 2,2023-10-24,169,163,6,0.0355029585798817
NORESTE 2,2023-10-25,194,193,1,0.00515463917525773
NORESTE 2,2023-10-26,201,196,5,0.0248756218905473
NORESTE 2,2023-10-27,209,204,5,0.0239234449760766
NORESTE 2,2023-10-28,262,258,4,0.0152671755725191
NORESTE 2,2023-10-29,191,184,7,0.0366492146596859
NORESTE 2,2023-10-30,157,153,4,0.0254777070063694
NORESTE 2,2023-10-31,188,183,5,0.0265957446808511
NORESTE 2,2023-11-01,155,152,3,0.0193548387096774
NORESTE 2,2023-11-02,188,185,3,0.0159574468085106
NORESTE 2,2023-11-03,193,190,3,0.0155440414507772
NORESTE 2,2023-11-04,264,259,5,0.0189393939393939
NORESTE 2,2023-11-05,184,178,6,0.0326086956521739
NORESTE 2,2023-11-06,168,162,6,0.0357142857142857
NORESTE 2,2023-11-07,188,178,10,0.0531914893617021
NORESTE 2,2023-11-08,222,216,6,0.027027027027027
NORESTE 2,2023-11-09,218,213,5,0.0229357798165138
NORESTE 2,2023-11-10,201,199,2,0.00995024875621891
NORESTE 2,2023-11-11,293,285,8,0.0273037542662116
NORESTE 2,2023-11-12,101,96,5,0.0495049504950495
NORESTE 2,2023-11-13,200,191,9,0.045
NORESTE 2,2023-11-14,190,188,2,0.0105263157894737
NORESTE 2,2023-11-15,188,182,6,0.0319148936170213
NORESTE 2,2023-11-16,193,186,7,0.0362694300518135
NORESTE 2,2023-11-17,253,245,8,0.0316205533596838
NORESTE 2,2023-11-18,312,307,5,0.016025641025641
NORESTE 2,2023-11-19,190,186,4,0.0210526315789474
NORESTE 2,2023-11-20,200,198,2,0.01
NORESTE 2,2023-11-21,169,163,6,0.0355029585798817
NORESTE 2,2023-11-22,180,171,9,0.05
NORESTE 2,2023-11-23,235,229,6,0.025531914893617
NORESTE 2,2023-11-24,267,255,12,0.0449438202247191
NORESTE 2,2023-11-25,269,263,6,0.0223048327137546
NORESTE 2,2023-11-26,254,245,9,0.0354330708661417
NORESTE 2,2023-11-27,171,167,4,0.0233918128654971
NORESTE 2,2023-11-28,231,225,6,0.025974025974026
NORESTE 2,2023-11-29,202,187,15,0.0742574257425743
NORESTE 2,2023-11-30,224,208,16,0.0714285714285714
NORESTE 2,2023-12-01,186,179,7,0.0376344086021505
NORESTE 2,2023-12-02,292,285,7,0.023972602739726
NORESTE 2,2023-12-03,194,190,4,0.0206185567010309
NORESTE 2,2023-12-04,190,174,16,0.0842105263157895
NORESTE 2,2023-12-05,199,189,10,0.050251256281407
NORESTE 2,2023-12-06,177,168,9,0.0508474576271186
NORESTE 2,2023-12-07,219,211,8,0.0365296803652968
NORESTE 2,2023-12-08,207,201,6,0.0289855072463768
NORESTE 2,2023-12-09,276,265,11,0.0398550724637681
NORESTE 2,2023-12-10,224,213,11,0.0491071428571429
NORESTE 2,2023-12-11,121,115,6,0.0495867768595041
NORESTE 2,2023-12-12,222,213,9,0.0405405405405405
NORESTE 2,2023-12-13,158,153,5,0.0316455696202532
NORESTE 2,2023-12-14,194,186,8,0.0412371134020619
NORESTE 2,2023-12-15,206,200,6,0.029126213592233
NORESTE 2,2023-12-16,219,210,9,0.0410958904109589
NORESTE 2,2023-12-17,158,152,6,0.0379746835443038
NORESTE 2,2023-12-18,168,161,7,0.0416666666666667
NORESTE 2,2023-12-19,212,206,6,0.0283018867924528
NORESTE 2,2023-12-20,243,237,6,0.0246913580246914
NORESTE 2,2023-12-21,196,185,11,0.0561224489795918
NORESTE 2,2023-12-22,219,213,6,0.0273972602739726
NORESTE 2,2023-12-23,244,235,9,0.0368852459016393
NORESTE 2,2023-12-24,134,132,2,0.0149253731343284
NORESTE 2,2023-12-25,48,48,0,0
NORESTE 2,2023-12-26,168,163,5,0.0297619047619048
NORESTE 2,2023-12-27,218,208,10,0.0458715596330275
NORESTE 2,2023-12-28,219,213,6,0.0273972602739726
NORESTE 2,2023-12-29,263,253,10,0.0380228136882129
NORESTE 2,2023-12-30,249,246,3,0.0120481927710843
NORESTE 2,2023-12-31,124,119,5,0.0403225806451613
NORESTE 2,2024-01-01,30,29,1,0.0333333333333333
NORESTE 2,2024-01-02,143,137,6,0.041958041958042
NORESTE 2,2024-01-03,217,209,8,0.0368663594470046
NORESTE 2,2024-01-04,199,193,6,0.0301507537688442
NORESTE 2,2024-01-05,227,214,13,0.0572687224669604
NORESTE 2,2024-01-06,301,285,16,0.053156146179402
NORESTE 2,2024-01-07,167,164,3,0.0179640718562874
NORESTE 2,2024-01-08,153,148,5,0.0326797385620915
NORESTE 2,2024-01-09,189,179,10,0.0529100529100529
NORESTE 2,2024-01-10,189,179,10,0.0529100529100529
NORESTE 2,2024-01-11,216,213,3,0.0138888888888889
NORESTE 2,2024-01-12,260,253,7,0.0269230769230769
NORESTE 2,2024-01-13,275,273,2,0.00727272727272727
NORESTE 2,2024-01-14,216,214,2,0.00925925925925926
NORTE BARRANCA,2023-07-04,139,134,5,0.0359712230215827
NORTE BARRANCA,2023-07-05,120,114,6,0.05
NORTE BARRANCA,2023-07-06,77,76,1,0.012987012987013
NORTE BARRANCA,2023-07-07,52,52,0,0
NORTE BARRANCA,2023-07-08,127,127,0,0
NORTE BARRANCA,2023-07-09,88,87,1,0.0113636363636364
NORTE BARRANCA,2023-07-10,123,117,6,0.0487804878048781
NORTE BARRANCA,2023-07-11,84,80,4,0.0476190476190476
NORTE BARRANCA,2023-07-12,116,115,1,0.00862068965517241
NORTE BARRANCA,2023-07-13,74,73,1,0.0135135135135135
NORTE BARRANCA,2023-07-14,138,134,4,0.0289855072463768
NORTE BARRANCA,2023-07-15,108,103,5,0.0462962962962963
NORTE BARRANCA,2023-07-16,53,51,2,0.0377358490566038
NORTE BARRANCA,2023-07-17,118,113,5,0.0423728813559322
NORTE BARRANCA,2023-07-18,115,115,0,0
NORTE BARRANCA,2023-07-19,116,114,2,0.0172413793103448
NORTE BARRANCA,2023-07-20,168,167,1,0.00595238095238095
NORTE BARRANCA,2023-07-21,159,158,1,0.00628930817610063
NORTE BARRANCA,2023-07-22,181,178,3,0.0165745856353591
NORTE BARRANCA,2023-07-23,73,72,1,0.0136986301369863
NORTE BARRANCA,2023-07-24,139,137,2,0.0143884892086331
NORTE BARRANCA,2023-07-25,161,159,2,0.0124223602484472
NORTE BARRANCA,2023-07-26,133,131,2,0.0150375939849624
NORTE BARRANCA,2023-07-27,150,147,3,0.02
NORTE BARRANCA,2023-07-28,181,179,2,0.0110497237569061
NORTE BARRANCA,2023-07-29,154,150,4,0.025974025974026
NORTE BARRANCA,2023-07-30,92,91,1,0.0108695652173913
NORTE BARRANCA,2023-07-31,126,126,0,0
NORTE BARRANCA,2023-08-01,147,145,2,0.0136054421768707
NORTE BARRANCA,2023-08-02,151,145,6,0.0397350993377483
NORTE BARRANCA,2023-08-03,134,116,18,0.134328358208955
NORTE BARRANCA,2023-08-04,188,182,6,0.0319148936170213
NORTE BARRANCA,2023-08-05,169,167,2,0.0118343195266272
NORTE BARRANCA,2023-08-06,99,96,3,0.0303030303030303
NORTE BARRANCA,2023-08-07,126,124,2,0.0158730158730159
NORTE BARRANCA,2023-08-08,112,107,5,0.0446428571428571
NORTE BARRANCA,2023-08-09,137,136,1,0.0072992700729927
NORTE BARRANCA,2023-08-10,140,138,2,0.0142857142857143
NORTE BARRANCA,2023-08-11,162,159,3,0.0185185185185185
NORTE BARRANCA,2023-08-12,144,141,3,0.0208333333333333
NORTE BARRANCA,2023-08-13,114,113,1,0.0087719298245614
NORTE BARRANCA,2023-08-14,112,110,2,0.0178571428571429
NORTE BARRANCA,2023-08-15,122,119,3,0.0245901639344262
NORTE BARRANCA,2023-08-16,77,75,2,0.025974025974026
NORTE BARRANCA,2023-08-17,112,109,3,0.0267857142857143
NORTE BARRANCA,2023-08-18,106,102,4,0.0377358490566038
NORTE BARRANCA,2023-08-19,121,120,1,0.00826446280991736
NORTE BARRANCA,2023-08-20,58,58,0,0
NORTE BARRANCA,2023-08-21,154,154,0,0
NORTE BARRANCA,2023-08-22,126,126,0,0
NORTE BARRANCA,2023-08-23,146,144,2,0.0136986301369863
NORTE BARRANCA,2023-08-24,116,116,0,0
NORTE BARRANCA,2023-08-25,148,147,1,0.00675675675675676
NORTE BARRANCA,2023-08-26,204,203,1,0.00490196078431373
NORTE BARRANCA,2023-08-27,122,122,0,0
NORTE BARRANCA,2023-08-28,150,150,0,0
NORTE BARRANCA,2023-08-29,145,145,0,0
NORTE BARRANCA,2023-08-30,142,142,0,0
NORTE BARRANCA,2023-08-31,146,146,0,0
NORTE BARRANCA,2023-09-01,133,133,0,0
NORTE BARRANCA,2023-09-02,153,153,0,0
NORTE BARRANCA,2023-09-03,102,102,0,0
NORTE BARRANCA,2023-09-04,154,154,0,0
NORTE BARRANCA,2023-09-05,154,153,1,0.00649350649350649
NORTE BARRANCA,2023-09-06,146,146,0,0
NORTE BARRANCA,2023-09-07,131,131,0,0
NORTE BARRANCA,2023-09-08,176,175,1,0.00568181818181818
NORTE BARRANCA,2023-09-09,159,159,0,0
NORTE BARRANCA,2023-09-10,88,87,1,0.0113636363636364
NORTE BARRANCA,2023-09-11,141,141,0,0
NORTE BARRANCA,2023-09-12,132,132,0,0
NORTE BARRANCA,2023-09-13,139,138,1,0.00719424460431655
NORTE BARRANCA,2023-09-14,111,111,0,0
NORTE BARRANCA,2023-09-15,137,137,0,0
NORTE BARRANCA,2023-09-16,93,93,0,0
NORTE BARRANCA,2023-09-17,100,100,0,0
NORTE BARRANCA,2023-09-18,182,182,0,0
NORTE BARRANCA,2023-09-19,159,159,0,0
NORTE BARRANCA,2023-09-20,143,143,0,0
NORTE BARRANCA,2023-09-21,129,128,1,0.00775193798449612
NORTE BARRANCA,2023-09-22,165,164,1,0.00606060606060606
NORTE BARRANCA,2023-09-23,198,197,1,0.00505050505050505
NORTE BARRANCA,2023-09-24,95,94,1,0.0105263157894737
NORTE BARRANCA,2023-09-25,137,137,0,0
NORTE BARRANCA,2023-09-26,145,145,0,0
NORTE BARRANCA,2023-09-27,124,124,0,0
NORTE BARRANCA,2023-09-28,147,147,0,0
NORTE BARRANCA,2023-09-29,116,115,1,0.00862068965517241
NORTE BARRANCA,2023-09-30,172,171,1,0.00581395348837209
NORTE BARRANCA,2023-10-01,90,89,1,0.0111111111111111
NORTE BARRANCA,2023-10-02,120,119,1,0.00833333333333333
NORTE BARRANCA,2023-10-03,133,130,3,0.0225563909774436
NORTE BARRANCA,2023-10-04,141,138,3,0.0212765957446809
NORTE BARRANCA,2023-10-05,132,129,3,0.0227272727272727
NORTE BARRANCA,2023-10-06,163,159,4,0.0245398773006135
NORTE BARRANCA,2023-10-07,184,182,2,0.0108695652173913
NORTE BARRANCA,2023-10-08,105,104,1,0.00952380952380952
NORTE BARRANCA,2023-10-09,136,134,2,0.0147058823529412
NORTE BARRANCA,2023-10-10,134,130,4,0.0298507462686567
NORTE BARRANCA,2023-10-11,126,125,1,0.00793650793650794
NORTE BARRANCA,2023-10-12,121,119,2,0.0165289256198347
NORTE BARRANCA,2023-10-13,134,128,6,0.0447761194029851
NORTE BARRANCA,2023-10-14,153,151,2,0.0130718954248366
NORTE BARRANCA,2023-10-15,117,117,0,0
NORTE BARRANCA,2023-10-16,144,142,2,0.0138888888888889
NORTE BARRANCA,2023-10-17,126,124,2,0.0158730158730159
NORTE BARRANCA,2023-10-18,125,122,3,0.024
NORTE BARRANCA,2023-10-19,134,130,4,0.0298507462686567
NORTE BARRANCA,2023-10-20,145,143,2,0.0137931034482759
NORTE BARRANCA,2023-10-21,204,200,4,0.0196078431372549
NORTE BARRANCA,2023-10-22,103,99,4,0.0388349514563107
NORTE BARRANCA,2023-10-23,141,137,4,0.0283687943262411
NORTE BARRANCA,2023-10-24,131,128,3,0.0229007633587786
NORTE BARRANCA,2023-10-25,131,124,7,0.0534351145038168
NORTE BARRANCA,2023-10-26,159,155,4,0.0251572327044025
NORTE BARRANCA,2023-10-27,150,149,1,0.00666666666666667
NORTE BARRANCA,2023-10-28,159,158,1,0.00628930817610063
NORTE BARRANCA,2023-10-29,90,89,1,0.0111111111111111
NORTE BARRANCA,2023-10-30,123,120,3,0.024390243902439
NORTE BARRANCA,2023-10-31,110,108,2,0.0181818181818182
NORTE BARRANCA,2023-11-01,134,132,2,0.0149253731343284
NORTE BARRANCA,2023-11-02,165,162,3,0.0181818181818182
NORTE BARRANCA,2023-11-03,122,119,3,0.0245901639344262
NORTE BARRANCA,2023-11-04,173,172,1,0.00578034682080925
NORTE BARRANCA,2023-11-05,130,129,1,0.00769230769230769
NORTE BARRANCA,2023-11-06,134,132,2,0.0149253731343284
NORTE BARRANCA,2023-11-07,163,159,4,0.0245398773006135
NORTE BARRANCA,2023-11-08,164,161,3,0.0182926829268293
NORTE BARRANCA,2023-11-09,173,170,3,0.0173410404624277
NORTE BARRANCA,2023-11-10,156,152,4,0.0256410256410256
NORTE BARRANCA,2023-11-11,212,209,3,0.0141509433962264
NORTE BARRANCA,2023-11-12,117,115,2,0.0170940170940171
NORTE BARRANCA,2023-11-13,147,144,3,0.0204081632653061
NORTE BARRANCA,2023-11-14,161,159,2,0.0124223602484472
NORTE BARRANCA,2023-11-15,176,176,0,0
NORTE BARRANCA,2023-11-16,151,145,6,0.0397350993377483
NORTE BARRANCA,2023-11-17,178,175,3,0.0168539325842697
NORTE BARRANCA,2023-11-18,212,209,3,0.0141509433962264
NORTE BARRANCA,2023-11-19,146,143,3,0.0205479452054795
NORTE BARRANCA,2023-11-20,154,152,2,0.012987012987013
NORTE BARRANCA,2023-11-21,178,172,6,0.0337078651685393
NORTE BARRANCA,2023-11-22,176,174,2,0.0113636363636364
NORTE BARRANCA,2023-11-23,179,175,4,0.0223463687150838
NORTE BARRANCA,2023-11-24,198,193,5,0.0252525252525253
NORTE BARRANCA,2023-11-25,202,200,2,0.0099009900990099
NORTE BARRANCA,2023-11-26,117,117,0,0
NORTE BARRANCA,2023-11-27,165,164,1,0.00606060606060606
NORTE BARRANCA,2023-11-28,157,151,6,0.0382165605095541
NORTE BARRANCA,2023-11-29,157,151,6,0.0382165605095541
NORTE BARRANCA,2023-11-30,159,158,1,0.00628930817610063
NORTE BARRANCA,2023-12-01,166,161,5,0.0301204819277108
NORTE BARRANCA,2023-12-02,215,209,6,0.027906976744186
NORTE BARRANCA,2023-12-03,156,153,3,0.0192307692307692
NORTE BARRANCA,2023-12-04,171,161,10,0.0584795321637427
NORTE BARRANCA,2023-12-05,171,165,6,0.0350877192982456
NORTE BARRANCA,2023-12-06,174,172,2,0.0114942528735632
NORTE BARRANCA,2023-12-07,185,180,5,0.027027027027027
NORTE BARRANCA,2023-12-08,180,176,4,0.0222222222222222
NORTE BARRANCA,2023-12-09,197,195,2,0.0101522842639594
NORTE BARRANCA,2023-12-10,140,135,5,0.0357142857142857
NORTE BARRANCA,2023-12-11,159,157,2,0.0125786163522013
NORTE BARRANCA,2023-12-12,166,164,2,0.0120481927710843
NORTE BARRANCA,2023-12-13,159,155,4,0.0251572327044025
NORTE BARRANCA,2023-12-14,157,155,2,0.0127388535031847
NORTE BARRANCA,2023-12-15,162,158,4,0.0246913580246914
NORTE BARRANCA,2023-12-16,177,175,2,0.0112994350282486
NORTE BARRANCA,2023-12-17,135,133,2,0.0148148148148148
NORTE BARRANCA,2023-12-18,142,139,3,0.0211267605633803
NORTE BARRANCA,2023-12-19,198,191,7,0.0353535353535354
NORTE BARRANCA,2023-12-20,160,152,8,0.05
NORTE BARRANCA,2023-12-21,168,165,3,0.0178571428571429
NORTE BARRANCA,2023-12-22,147,145,2,0.0136054421768707
NORTE BARRANCA,2023-12-23,157,157,0,0
NORTE BARRANCA,2023-12-24,72,70,2,0.0277777777777778
NORTE BARRANCA,2023-12-25,8,7,1,0.125
NORTE BARRANCA,2023-12-26,161,158,3,0.0186335403726708
NORTE BARRANCA,2023-12-27,172,168,4,0.0232558139534884
NORTE BARRANCA,2023-12-28,181,177,4,0.0220994475138122
NORTE BARRANCA,2023-12-29,174,172,2,0.0114942528735632
NORTE BARRANCA,2023-12-30,177,173,4,0.0225988700564972
NORTE BARRANCA,2023-12-31,67,65,2,0.0298507462686567
NORTE BARRANCA,2024-01-01,5,5,0,0
NORTE BARRANCA,2024-01-02,131,130,1,0.00763358778625954
NORTE BARRANCA,2024-01-03,184,182,2,0.0108695652173913
NORTE BARRANCA,2024-01-04,178,175,3,0.0168539325842697
NORTE BARRANCA,2024-01-05,186,182,4,0.021505376344086
NORTE BARRANCA,2024-01-06,215,213,2,0.00930232558139535
NORTE BARRANCA,2024-01-07,127,127,0,0
NORTE BARRANCA,2024-01-08,109,104,5,0.0458715596330275
NORTE BARRANCA,2024-01-09,205,202,3,0.0146341463414634
NORTE BARRANCA,2024-01-10,199,195,4,0.0201005025125628
NORTE BARRANCA,2024-01-11,89,85,4,0.0449438202247191
NORTE BARRANCA,2024-01-12,182,179,3,0.0164835164835165
NORTE BARRANCA,2024-01-13,219,216,3,0.0136986301369863
NORTE BARRANCA,2024-01-14,133,132,1,0.0075187969924812
NORTE LA BAJA,2023-01-02,38,26,12,0.315789473684211
NORTE LA BAJA,2023-01-03,39,28,11,0.282051282051282
NORTE LA BAJA,2023-01-04,44,27,17,0.386363636363636
NORTE LA BAJA,2023-01-05,26,16,10,0.384615384615385
NORTE LA BAJA,2023-01-06,30,16,14,0.466666666666667
NORTE LA BAJA,2023-01-07,43,33,10,0.232558139534884
NORTE LA BAJA,2023-01-08,31,22,9,0.290322580645161
NORTE LA BAJA,2023-01-09,26,17,9,0.346153846153846
NORTE LA BAJA,2023-01-10,51,31,20,0.392156862745098
NORTE LA BAJA,2023-01-11,34,28,6,0.176470588235294
NORTE LA BAJA,2023-01-12,37,27,10,0.27027027027027
NORTE LA BAJA,2023-01-13,50,35,15,0.3
NORTE LA BAJA,2023-01-14,35,29,6,0.171428571428571
NORTE LA BAJA,2023-01-15,35,26,9,0.257142857142857
NORTE LA BAJA,2023-01-16,24,17,7,0.291666666666667
NORTE LA BAJA,2023-01-17,35,25,10,0.285714285714286
NORTE LA BAJA,2023-01-18,24,2,22,0.916666666666667
NORTE LA BAJA,2023-01-19,43,7,36,0.837209302325581
NORTE LA BAJA,2023-01-20,43,7,36,0.837209302325581
NORTE LA BAJA,2023-01-21,46,13,33,0.717391304347826
NORTE LA BAJA,2023-01-22,25,2,23,0.92
NORTE LA BAJA,2023-01-23,36,6,30,0.833333333333333
NORTE LA BAJA,2023-01-24,31,7,24,0.774193548387097
NORTE LA BAJA,2023-01-25,23,7,16,0.695652173913043
NORTE LA BAJA,2023-01-26,40,4,36,0.9
NORTE LA BAJA,2023-01-27,34,5,29,0.852941176470588
NORTE LA BAJA,2023-01-28,44,7,37,0.840909090909091
NORTE LA BAJA,2023-01-29,32,5,27,0.84375
NORTE LA BAJA,2023-01-30,33,3,30,0.909090909090909
NORTE LA BAJA,2023-01-31,34,4,30,0.882352941176471
NORTE LA BAJA,2023-02-01,35,1,34,0.971428571428571
NORTE LA BAJA,2023-02-02,30,7,23,0.766666666666667
NORTE LA BAJA,2023-02-03,41,1,40,0.975609756097561
NORTE LA BAJA,2023-02-04,47,2,45,0.957446808510638
NORTE LA BAJA,2023-02-05,36,4,32,0.888888888888889
NORTE LA BAJA,2023-02-06,39,8,31,0.794871794871795
NORTE LA BAJA,2023-02-07,40,2,38,0.95
NORTE LA BAJA,2023-02-08,38,3,35,0.921052631578947
NORTE LA BAJA,2023-02-09,43,5,38,0.883720930232558
NORTE LA BAJA,2023-02-10,42,5,37,0.880952380952381
NORTE LA BAJA,2023-02-11,53,8,45,0.849056603773585
NORTE LA BAJA,2023-02-12,34,2,32,0.941176470588235
NORTE LA BAJA,2023-02-13,36,5,31,0.861111111111111
NORTE LA BAJA,2023-02-14,35,3,32,0.914285714285714
NORTE LA BAJA,2023-02-15,28,5,23,0.821428571428571
NORTE LA BAJA,2023-02-16,35,2,33,0.942857142857143
NORTE LA BAJA,2023-02-17,48,7,41,0.854166666666667
NORTE LA BAJA,2023-02-18,57,7,50,0.87719298245614
NORTE LA BAJA,2023-02-19,35,4,31,0.885714285714286
NORTE LA BAJA,2023-02-20,38,4,34,0.894736842105263
NORTE LA BAJA,2023-02-21,45,4,41,0.911111111111111
NORTE LA BAJA,2023-02-22,38,2,36,0.947368421052632
NORTE LA BAJA,2023-02-23,23,4,19,0.826086956521739
NORTE LA BAJA,2023-02-24,31,7,24,0.774193548387097
NORTE LA BAJA,2023-02-25,58,6,52,0.896551724137931
NORTE LA BAJA,2023-02-26,36,5,31,0.861111111111111
NORTE LA BAJA,2023-02-27,33,3,30,0.909090909090909
NORTE LA BAJA,2023-02-28,43,5,38,0.883720930232558
NORTE LA BAJA,2023-03-01,32,6,26,0.8125
NORTE LA BAJA,2023-03-02,29,5,24,0.827586206896552
NORTE LA BAJA,2023-03-03,44,7,37,0.840909090909091
NORTE LA BAJA,2023-03-04,54,5,49,0.907407407407407
NORTE LA BAJA,2023-03-05,30,5,25,0.833333333333333
NORTE LA BAJA,2023-03-06,37,6,31,0.837837837837838
NORTE LA BAJA,2023-03-07,52,6,46,0.884615384615385
NORTE LA BAJA,2023-03-08,43,6,37,0.86046511627907
NORTE LA BAJA,2023-03-09,45,11,34,0.755555555555556
NORTE LA BAJA,2023-03-10,46,5,41,0.891304347826087
NORTE LA BAJA,2023-03-11,45,12,33,0.733333333333333
NORTE LA BAJA,2023-03-12,43,16,27,0.627906976744186
NORTE LA BAJA,2023-03-13,44,11,33,0.75
NORTE LA BAJA,2023-03-14,44,17,27,0.613636363636364
NORTE LA BAJA,2023-03-15,47,44,3,0.0638297872340425
NORTE LA BAJA,2023-03-16,30,27,3,0.1
NORTE LA BAJA,2023-03-17,67,57,10,0.149253731343284
NORTE LA BAJA,2023-03-18,69,61,8,0.115942028985507
NORTE LA BAJA,2023-03-19,43,37,6,0.13953488372093
NORTE LA BAJA,2023-03-20,29,24,5,0.172413793103448
NORTE LA BAJA,2023-03-21,40,37,3,0.075
NORTE LA BAJA,2023-03-22,44,41,3,0.0681818181818182
NORTE LA BAJA,2023-03-23,45,43,2,0.0444444444444444
NORTE LA BAJA,2023-03-24,54,47,7,0.12962962962963
NORTE LA BAJA,2023-03-25,54,47,7,0.12962962962963
NORTE LA BAJA,2023-03-26,30,28,2,0.0666666666666667
NORTE LA BAJA,2023-03-27,29,28,1,0.0344827586206897
NORTE LA BAJA,2023-03-28,35,34,1,0.0285714285714286
NORTE LA BAJA,2023-03-29,41,40,1,0.024390243902439
NORTE LA BAJA,2023-03-30,42,35,7,0.166666666666667
NORTE LA BAJA,2023-03-31,56,52,4,0.0714285714285714
NORTE LA BAJA,2023-04-01,50,47,3,0.06
NORTE LA BAJA,2023-04-02,32,29,3,0.09375
NORTE LA BAJA,2023-04-03,39,37,2,0.0512820512820513
NORTE LA BAJA,2023-04-04,48,44,4,0.0833333333333333
NORTE LA BAJA,2023-04-05,39,36,3,0.0769230769230769
NORTE LA BAJA,2023-04-06,39,37,2,0.0512820512820513
NORTE LA BAJA,2023-04-07,30,29,1,0.0333333333333333
NORTE LA BAJA,2023-04-08,36,32,4,0.111111111111111
NORTE LA BAJA,2023-04-09,21,17,4,0.19047619047619
NORTE LA BAJA,2023-04-10,24,19,5,0.208333333333333
NORTE LA BAJA,2023-04-11,55,47,8,0.145454545454545
NORTE LA BAJA,2023-04-12,38,33,5,0.131578947368421
NORTE LA BAJA,2023-04-13,46,45,1,0.0217391304347826
NORTE LA BAJA,2023-04-14,40,36,4,0.1
NORTE LA BAJA,2023-04-15,53,50,3,0.0566037735849057
NORTE LA BAJA,2023-04-16,34,31,3,0.0882352941176471
NORTE LA BAJA,2023-04-17,42,38,4,0.0952380952380952
NORTE LA BAJA,2023-04-18,41,37,4,0.0975609756097561
NORTE LA BAJA,2023-04-19,39,32,7,0.179487179487179
NORTE LA BAJA,2023-04-20,36,32,4,0.111111111111111
NORTE LA BAJA,2023-04-21,50,38,12,0.24
NORTE LA BAJA,2023-04-22,55,47,8,0.145454545454545
NORTE LA BAJA,2023-04-23,38,32,6,0.157894736842105
NORTE LA BAJA,2023-04-24,41,37,4,0.0975609756097561
NORTE LA BAJA,2023-04-25,57,50,7,0.12280701754386
NORTE LA BAJA,2023-04-26,40,38,2,0.05
NORTE LA BAJA,2023-04-27,38,33,5,0.131578947368421
NORTE LA BAJA,2023-04-28,45,38,7,0.155555555555556
NORTE LA BAJA,2023-04-29,51,42,9,0.176470588235294
NORTE LA BAJA,2023-04-30,37,36,1,0.027027027027027
NORTE LA BAJA,2023-05-01,23,23,0,0
NORTE LA BAJA,2023-05-02,40,38,2,0.05
NORTE LA BAJA,2023-05-03,39,39,0,0
NORTE LA BAJA,2023-05-04,38,33,5,0.131578947368421
NORTE LA BAJA,2023-05-05,48,45,3,0.0625
NORTE LA BAJA,2023-05-06,44,37,7,0.159090909090909
NORTE LA BAJA,2023-05-07,35,34,1,0.0285714285714286
NORTE LA BAJA,2023-05-08,47,42,5,0.106382978723404
NORTE LA BAJA,2023-05-09,34,34,0,0
NORTE LA BAJA,2023-05-10,40,37,3,0.075
NORTE LA BAJA,2023-05-11,38,33,5,0.131578947368421
NORTE LA BAJA,2023-05-12,41,39,2,0.0487804878048781
NORTE LA BAJA,2023-05-13,63,56,7,0.111111111111111
NORTE LA BAJA,2023-05-14,47,42,5,0.106382978723404
NORTE LA BAJA,2023-05-15,53,47,6,0.113207547169811
NORTE LA BAJA,2023-05-16,51,47,4,0.0784313725490196
NORTE LA BAJA,2023-05-17,44,38,6,0.136363636363636
NORTE LA BAJA,2023-05-18,35,34,1,0.0285714285714286
NORTE LA BAJA,2023-05-19,40,36,4,0.1
NORTE LA BAJA,2023-05-20,51,46,5,0.0980392156862745
NORTE LA BAJA,2023-05-21,41,37,4,0.0975609756097561
NORTE LA BAJA,2023-05-22,47,42,5,0.106382978723404
NORTE LA BAJA,2023-05-23,43,40,3,0.0697674418604651
NORTE LA BAJA,2023-05-24,33,32,1,0.0303030303030303
NORTE LA BAJA,2023-05-25,52,41,11,0.211538461538462
NORTE LA BAJA,2023-05-26,78,56,22,0.282051282051282
NORTE LA BAJA,2023-05-27,76,60,16,0.210526315789474
NORTE LA BAJA,2023-05-28,35,29,6,0.171428571428571
NORTE LA BAJA,2023-05-29,43,37,6,0.13953488372093
NORTE LA BAJA,2023-05-30,40,35,5,0.125
NORTE LA BAJA,2023-05-31,47,38,9,0.191489361702128
NORTE LA BAJA,2023-06-01,72,68,4,0.0555555555555556
NORTE LA BAJA,2023-06-02,32,28,4,0.125
NORTE LA BAJA,2023-06-03,47,43,4,0.0851063829787234
NORTE LA BAJA,2023-06-04,84,68,16,0.19047619047619
NORTE LA BAJA,2023-06-05,39,35,4,0.102564102564103
NORTE LA BAJA,2023-06-06,50,44,6,0.12
NORTE LA BAJA,2023-06-07,35,32,3,0.0857142857142857
NORTE LA BAJA,2023-06-08,39,35,4,0.102564102564103
NORTE LA BAJA,2023-06-09,53,46,7,0.132075471698113
NORTE LA BAJA,2023-06-10,56,52,4,0.0714285714285714
NORTE LA BAJA,2023-06-11,44,41,3,0.0681818181818182
NORTE LA BAJA,2023-06-12,35,32,3,0.0857142857142857
NORTE LA BAJA,2023-06-13,56,46,10,0.178571428571429
NORTE LA BAJA,2023-06-14,53,50,3,0.0566037735849057
NORTE LA BAJA,2023-06-15,57,51,6,0.105263157894737
NORTE LA BAJA,2023-06-16,54,46,8,0.148148148148148
NORTE LA BAJA,2023-06-17,69,64,5,0.072463768115942
NORTE LA BAJA,2023-06-18,43,40,3,0.0697674418604651
NORTE LA BAJA,2023-06-19,57,54,3,0.0526315789473684
NORTE LA BAJA,2023-06-20,41,37,4,0.0975609756097561
NORTE LA BAJA,2023-06-21,65,60,5,0.0769230769230769
NORTE LA BAJA,2023-06-22,49,43,6,0.122448979591837
NORTE LA BAJA,2023-06-23,51,48,3,0.0588235294117647
NORTE LA BAJA,2023-06-24,54,46,8,0.148148148148148
NORTE LA BAJA,2023-06-25,45,39,6,0.133333333333333
NORTE LA BAJA,2023-06-26,50,44,6,0.12
NORTE LA BAJA,2023-06-27,61,52,9,0.147540983606557
NORTE LA BAJA,2023-06-28,37,36,1,0.027027027027027
NORTE LA BAJA,2023-06-29,47,45,2,0.0425531914893617
NORTE LA BAJA,2023-06-30,32,25,7,0.21875
NORTE LA BAJA,2023-07-01,70,62,8,0.114285714285714
NORTE LA BAJA,2023-07-02,44,44,0,0
NORTE LA BAJA,2023-07-03,32,29,3,0.09375
NORTE LA BAJA,2023-07-04,181,178,3,0.0165745856353591
NORTE LA BAJA,2023-07-05,103,101,2,0.0194174757281553
NORTE LA BAJA,2023-07-06,111,104,7,0.0630630630630631
NORTE LA BAJA,2023-07-07,135,134,1,0.00740740740740741
NORTE LA BAJA,2023-07-08,188,186,2,0.0106382978723404
NORTE LA BAJA,2023-07-09,189,189,0,0
NORTE LA BAJA,2023-07-10,201,189,12,0.0597014925373134
NORTE LA BAJA,2023-07-11,160,156,4,0.025
NORTE LA BAJA,2023-07-12,192,182,10,0.0520833333333333
NORTE LA BAJA,2023-07-13,191,184,7,0.0366492146596859
NORTE LA BAJA,2023-07-14,153,149,4,0.0261437908496732
NORTE LA BAJA,2023-07-15,182,176,6,0.032967032967033
NORTE LA BAJA,2023-07-16,146,139,7,0.0479452054794521
NORTE LA BAJA,2023-07-17,185,181,4,0.0216216216216216
NORTE LA BAJA,2023-07-18,185,178,7,0.0378378378378378
NORTE LA BAJA,2023-07-19,177,169,8,0.0451977401129944
NORTE LA BAJA,2023-07-20,189,186,3,0.0158730158730159
NORTE LA BAJA,2023-07-21,180,176,4,0.0222222222222222
NORTE LA BAJA,2023-07-22,204,198,6,0.0294117647058824
NORTE LA BAJA,2023-07-23,159,154,5,0.0314465408805031
NORTE LA BAJA,2023-07-24,174,171,3,0.0172413793103448
NORTE LA BAJA,2023-07-25,170,165,5,0.0294117647058824
NORTE LA BAJA,2023-07-26,189,181,8,0.0423280423280423
NORTE LA BAJA,2023-07-27,151,150,1,0.00662251655629139
NORTE LA BAJA,2023-07-28,191,185,6,0.031413612565445
NORTE LA BAJA,2023-07-29,219,213,6,0.0273972602739726
NORTE LA BAJA,2023-07-30,159,154,5,0.0314465408805031
NORTE LA BAJA,2023-07-31,176,171,5,0.0284090909090909
NORTE LA BAJA,2023-08-01,193,180,13,0.0673575129533679
NORTE LA BAJA,2023-08-02,166,158,8,0.0481927710843374
NORTE LA BAJA,2023-08-03,200,169,31,0.155
NORTE LA BAJA,2023-08-04,155,142,13,0.0838709677419355
NORTE LA BAJA,2023-08-05,172,159,13,0.0755813953488372
NORTE LA BAJA,2023-08-06,174,160,14,0.0804597701149425
NORTE LA BAJA,2023-08-07,153,147,6,0.0392156862745098
NORTE LA BAJA,2023-08-08,191,185,6,0.031413612565445
NORTE LA BAJA,2023-08-09,170,163,7,0.0411764705882353
NORTE LA BAJA,2023-08-10,174,154,20,0.114942528735632
NORTE LA BAJA,2023-08-11,224,213,11,0.0491071428571429
NORTE LA BAJA,2023-08-12,217,188,29,0.133640552995392
NORTE LA BAJA,2023-08-13,177,157,20,0.112994350282486
NORTE LA BAJA,2023-08-14,171,158,13,0.0760233918128655
NORTE LA BAJA,2023-08-15,184,176,8,0.0434782608695652
NORTE LA BAJA,2023-08-16,148,138,10,0.0675675675675676
NORTE LA BAJA,2023-08-17,161,155,6,0.0372670807453416
NORTE LA BAJA,2023-08-18,213,204,9,0.0422535211267606
NORTE LA BAJA,2023-08-19,240,231,9,0.0375
NORTE LA BAJA,2023-08-20,7,7,0,0
NORTE LA BAJA,2023-08-21,35,31,4,0.114285714285714
NORTE LA BAJA,2023-08-22,167,158,9,0.0538922155688623
NORTE LA BAJA,2023-08-23,148,141,7,0.0472972972972973
NORTE LA BAJA,2023-08-24,184,181,3,0.016304347826087
NORTE LA BAJA,2023-08-25,161,150,11,0.0683229813664596
NORTE LA BAJA,2023-08-26,168,159,9,0.0535714285714286
NORTE LA BAJA,2023-08-27,179,175,4,0.0223463687150838
NORTE LA BAJA,2023-08-28,211,202,9,0.042654028436019
NORTE LA BAJA,2023-08-29,187,187,0,0
NORTE LA BAJA,2023-08-30,217,217,0,0
NORTE LA BAJA,2023-08-31,218,217,1,0.00458715596330275
NORTE LA BAJA,2023-09-01,167,164,3,0.0179640718562874
NORTE LA BAJA,2023-09-02,220,217,3,0.0136363636363636
NORTE LA BAJA,2023-09-03,178,176,2,0.0112359550561798
NORTE LA BAJA,2023-09-04,165,164,1,0.00606060606060606
NORTE LA BAJA,2023-09-05,172,171,1,0.00581395348837209
NORTE LA BAJA,2023-09-06,161,158,3,0.0186335403726708
NORTE LA BAJA,2023-09-07,173,173,0,0
NORTE LA BAJA,2023-09-08,199,198,1,0.0050251256281407
NORTE LA BAJA,2023-09-09,245,240,5,0.0204081632653061
NORTE LA BAJA,2023-09-10,204,202,2,0.00980392156862745
NORTE LA BAJA,2023-09-11,178,173,5,0.0280898876404494
NORTE LA BAJA,2023-09-12,177,177,0,0
NORTE LA BAJA,2023-09-13,166,165,1,0.00602409638554217
NORTE LA BAJA,2023-09-14,169,168,1,0.00591715976331361
NORTE LA BAJA,2023-09-15,184,183,1,0.00543478260869565
NORTE LA BAJA,2023-09-16,148,146,2,0.0135135135135135
NORTE LA BAJA,2023-09-17,202,201,1,0.00495049504950495
NORTE LA BAJA,2023-09-18,206,206,0,0
NORTE LA BAJA,2023-09-19,206,203,3,0.0145631067961165
NORTE LA BAJA,2023-09-20,173,170,3,0.0173410404624277
NORTE LA BAJA,2023-09-21,216,212,4,0.0185185185185185
NORTE LA BAJA,2023-09-22,199,192,7,0.0351758793969849
NORTE LA BAJA,2023-09-23,226,218,8,0.0353982300884956
NORTE LA BAJA,2023-09-24,207,205,2,0.00966183574879227
NORTE LA BAJA,2023-09-25,158,156,2,0.0126582278481013
NORTE LA BAJA,2023-09-26,199,194,5,0.0251256281407035
NORTE LA BAJA,2023-09-27,198,195,3,0.0151515151515152
NORTE LA BAJA,2023-09-28,184,183,1,0.00543478260869565
NORTE LA BAJA,2023-09-29,232,228,4,0.0172413793103448
NORTE LA BAJA,2023-09-30,224,222,2,0.00892857142857143
NORTE LA BAJA,2023-10-01,184,182,2,0.0108695652173913
NORTE LA BAJA,2023-10-02,152,151,1,0.00657894736842105
NORTE LA BAJA,2023-10-03,196,191,5,0.0255102040816327
NORTE LA BAJA,2023-10-04,170,166,4,0.0235294117647059
NORTE LA BAJA,2023-10-05,206,205,1,0.00485436893203883
NORTE LA BAJA,2023-10-06,212,201,11,0.0518867924528302
NORTE LA BAJA,2023-10-07,203,198,5,0.0246305418719212
NORTE LA BAJA,2023-10-08,207,202,5,0.0241545893719807
NORTE LA BAJA,2023-10-09,170,165,5,0.0294117647058824
NORTE LA BAJA,2023-10-10,188,184,4,0.0212765957446809
NORTE LA BAJA,2023-10-11,149,147,2,0.0134228187919463
NORTE LA BAJA,2023-10-12,198,194,4,0.0202020202020202
NORTE LA BAJA,2023-10-13,177,170,7,0.0395480225988701
NORTE LA BAJA,2023-10-14,205,199,6,0.0292682926829268
NORTE LA BAJA,2023-10-15,195,190,5,0.0256410256410256
NORTE LA BAJA,2023-10-16,189,185,4,0.0211640211640212
NORTE LA BAJA,2023-10-17,188,186,2,0.0106382978723404
NORTE LA BAJA,2023-10-18,159,152,7,0.0440251572327044
NORTE LA BAJA,2023-10-19,185,183,2,0.0108108108108108
NORTE LA BAJA,2023-10-20,211,207,4,0.018957345971564
NORTE LA BAJA,2023-10-21,257,251,6,0.0233463035019455
NORTE LA BAJA,2023-10-22,187,182,5,0.0267379679144385
NORTE LA BAJA,2023-10-23,171,168,3,0.0175438596491228
NORTE LA BAJA,2023-10-24,187,181,6,0.0320855614973262
NORTE LA BAJA,2023-10-25,189,184,5,0.0264550264550265
NORTE LA BAJA,2023-10-26,160,158,2,0.0125
NORTE LA BAJA,2023-10-27,200,194,6,0.03
NORTE LA BAJA,2023-10-28,201,200,1,0.00497512437810945
NORTE LA BAJA,2023-10-29,175,170,5,0.0285714285714286
NORTE LA BAJA,2023-10-30,160,154,6,0.0375
NORTE LA BAJA,2023-10-31,164,161,3,0.0182926829268293
NORTE LA BAJA,2023-11-01,180,176,4,0.0222222222222222
NORTE LA BAJA,2023-11-02,194,190,4,0.0206185567010309
NORTE LA BAJA,2023-11-03,192,186,6,0.03125
NORTE LA BAJA,2023-11-04,255,245,10,0.0392156862745098
NORTE LA BAJA,2023-11-05,197,194,3,0.0152284263959391
NORTE LA BAJA,2023-11-06,203,197,6,0.0295566502463054
NORTE LA BAJA,2023-11-07,195,192,3,0.0153846153846154
NORTE LA BAJA,2023-11-08,213,206,7,0.0328638497652582
NORTE LA BAJA,2023-11-09,189,185,4,0.0211640211640212
NORTE LA BAJA,2023-11-10,231,228,3,0.012987012987013
NORTE LA BAJA,2023-11-11,245,240,5,0.0204081632653061
NORTE LA BAJA,2023-11-12,237,227,10,0.0421940928270042
NORTE LA BAJA,2023-11-13,171,167,4,0.0233918128654971
NORTE LA BAJA,2023-11-14,216,207,9,0.0416666666666667
NORTE LA BAJA,2023-11-15,150,146,4,0.0266666666666667
NORTE LA BAJA,2023-11-16,208,205,3,0.0144230769230769
NORTE LA BAJA,2023-11-17,202,200,2,0.0099009900990099
NORTE LA BAJA,2023-11-18,285,277,8,0.0280701754385965
NORTE LA BAJA,2023-11-19,231,225,6,0.025974025974026
NORTE LA BAJA,2023-11-20,142,136,6,0.0422535211267606
NORTE LA BAJA,2023-11-21,247,241,6,0.0242914979757085
NORTE LA BAJA,2023-11-22,174,169,5,0.028735632183908
NORTE LA BAJA,2023-11-23,223,216,7,0.031390134529148
NORTE LA BAJA,2023-11-24,228,226,2,0.0087719298245614
NORTE LA BAJA,2023-11-25,258,251,7,0.0271317829457364
NORTE LA BAJA,2023-11-26,227,225,2,0.00881057268722467
NORTE LA BAJA,2023-11-27,183,178,5,0.0273224043715847
NORTE LA BAJA,2023-11-28,237,237,0,0
NORTE LA BAJA,2023-11-29,192,184,8,0.0416666666666667
NORTE LA BAJA,2023-11-30,161,158,3,0.0186335403726708
NORTE LA BAJA,2023-12-01,210,202,8,0.0380952380952381
NORTE LA BAJA,2023-12-02,246,243,3,0.0121951219512195
NORTE LA BAJA,2023-12-03,198,194,4,0.0202020202020202
NORTE LA BAJA,2023-12-04,211,206,5,0.023696682464455
NORTE LA BAJA,2023-12-05,216,210,6,0.0277777777777778
NORTE LA BAJA,2023-12-06,197,191,6,0.0304568527918782
NORTE LA BAJA,2023-12-07,181,173,8,0.0441988950276243
NORTE LA BAJA,2023-12-08,209,207,2,0.00956937799043062
NORTE LA BAJA,2023-12-09,210,206,4,0.019047619047619
NORTE LA BAJA,2023-12-10,209,205,4,0.0191387559808612
NORTE LA BAJA,2023-12-11,183,180,3,0.0163934426229508
NORTE LA BAJA,2023-12-12,194,191,3,0.0154639175257732
NORTE LA BAJA,2023-12-13,201,195,6,0.0298507462686567
NORTE LA BAJA,2023-12-14,183,176,7,0.0382513661202186
NORTE LA BAJA,2023-12-15,178,174,4,0.0224719101123595
NORTE LA BAJA,2023-12-16,220,216,4,0.0181818181818182
NORTE LA BAJA,2023-12-17,206,203,3,0.0145631067961165
NORTE LA BAJA,2023-12-18,191,188,3,0.0157068062827225
NORTE LA BAJA,2023-12-19,206,205,1,0.00485436893203883
NORTE LA BAJA,2023-12-20,232,223,9,0.0387931034482759
NORTE LA BAJA,2023-12-21,239,233,6,0.0251046025104603
NORTE LA BAJA,2023-12-22,213,207,6,0.028169014084507
NORTE LA BAJA,2023-12-23,245,240,5,0.0204081632653061
NORTE LA BAJA,2023-12-24,83,80,3,0.036144578313253
NORTE LA BAJA,2023-12-25,8,8,0,0
NORTE LA BAJA,2023-12-26,223,218,5,0.0224215246636771
NORTE LA BAJA,2023-12-27,204,197,7,0.0343137254901961
NORTE LA BAJA,2023-12-28,232,224,8,0.0344827586206897
NORTE LA BAJA,2023-12-29,232,230,2,0.00862068965517241
NORTE LA BAJA,2023-12-30,208,203,5,0.0240384615384615
NORTE LA BAJA,2023-12-31,93,92,1,0.010752688172043
NORTE LA BAJA,2024-01-01,6,6,0,0
NORTE LA BAJA,2024-01-02,206,201,5,0.0242718446601942
NORTE LA BAJA,2024-01-03,152,147,5,0.0328947368421053
NORTE LA BAJA,2024-01-04,224,218,6,0.0267857142857143
NORTE LA BAJA,2024-01-05,248,242,6,0.0241935483870968
NORTE LA BAJA,2024-01-06,249,243,6,0.0240963855421687
NORTE LA BAJA,2024-01-07,241,236,5,0.020746887966805
NORTE LA BAJA,2024-01-08,184,180,4,0.0217391304347826
NORTE LA BAJA,2024-01-09,227,220,7,0.0308370044052863
NORTE LA BAJA,2024-01-10,226,221,5,0.0221238938053097
NORTE LA BAJA,2024-01-11,230,224,6,0.0260869565217391
NORTE LA BAJA,2024-01-12,225,219,6,0.0266666666666667
NORTE LA BAJA,2024-01-13,269,263,6,0.0223048327137546
NORTE LA BAJA,2024-01-14,234,232,2,0.00854700854700855
OCCIDENTE 1,2023-01-02,86,45,41,0.476744186046512
OCCIDENTE 1,2023-01-03,175,117,58,0.331428571428571
OCCIDENTE 1,2023-01-04,138,77,61,0.442028985507246
OCCIDENTE 1,2023-01-05,149,101,48,0.322147651006711
OCCIDENTE 1,2023-01-06,134,80,54,0.402985074626866
OCCIDENTE 1,2023-01-07,161,97,64,0.397515527950311
OCCIDENTE 1,2023-01-08,94,61,33,0.351063829787234
OCCIDENTE 1,2023-01-09,149,99,50,0.335570469798658
OCCIDENTE 1,2023-01-10,170,105,65,0.382352941176471
OCCIDENTE 1,2023-01-11,153,95,58,0.379084967320261
OCCIDENTE 1,2023-01-12,147,103,44,0.299319727891156
OCCIDENTE 1,2023-01-13,137,81,56,0.408759124087591
OCCIDENTE 1,2023-01-14,162,111,51,0.314814814814815
OCCIDENTE 1,2023-01-15,102,71,31,0.303921568627451
OCCIDENTE 1,2023-01-16,158,104,54,0.341772151898734
OCCIDENTE 1,2023-01-17,126,93,33,0.261904761904762
OCCIDENTE 1,2023-01-18,131,90,41,0.312977099236641
OCCIDENTE 1,2023-01-19,152,110,42,0.276315789473684
OCCIDENTE 1,2023-01-20,137,84,53,0.386861313868613
OCCIDENTE 1,2023-01-21,170,46,124,0.729411764705882
OCCIDENTE 1,2023-01-22,102,34,68,0.666666666666667
OCCIDENTE 1,2023-01-23,129,33,96,0.744186046511628
OCCIDENTE 1,2023-01-24,138,42,96,0.695652173913043
OCCIDENTE 1,2023-01-25,116,33,83,0.71551724137931
OCCIDENTE 1,2023-01-26,144,38,106,0.736111111111111
OCCIDENTE 1,2023-01-27,128,36,92,0.71875
OCCIDENTE 1,2023-01-28,135,39,96,0.711111111111111
OCCIDENTE 1,2023-01-29,107,35,72,0.672897196261682
OCCIDENTE 1,2023-01-30,153,40,113,0.738562091503268
OCCIDENTE 1,2023-01-31,183,66,117,0.639344262295082
OCCIDENTE 1,2023-02-01,168,54,114,0.678571428571429
OCCIDENTE 1,2023-02-02,165,47,118,0.715151515151515
OCCIDENTE 1,2023-02-03,124,40,84,0.67741935483871
OCCIDENTE 1,2023-02-04,165,49,116,0.703030303030303
OCCIDENTE 1,2023-02-05,97,33,64,0.65979381443299
OCCIDENTE 1,2023-02-06,122,33,89,0.729508196721312
OCCIDENTE 1,2023-02-07,156,55,101,0.647435897435897
OCCIDENTE 1,2023-02-08,124,37,87,0.701612903225806
OCCIDENTE 1,2023-02-09,133,45,88,0.661654135338346
OCCIDENTE 1,2023-02-10,135,56,79,0.585185185185185
OCCIDENTE 1,2023-02-11,133,56,77,0.578947368421053
OCCIDENTE 1,2023-02-12,92,35,57,0.619565217391304
OCCIDENTE 1,2023-02-13,113,30,83,0.734513274336283
OCCIDENTE 1,2023-02-14,134,42,92,0.686567164179104
OCCIDENTE 1,2023-02-15,116,45,71,0.612068965517241
OCCIDENTE 1,2023-02-16,144,37,107,0.743055555555556
OCCIDENTE 1,2023-02-17,130,40,90,0.692307692307692
OCCIDENTE 1,2023-02-18,177,70,107,0.604519774011299
OCCIDENTE 1,2023-02-19,107,41,66,0.616822429906542
OCCIDENTE 1,2023-02-20,118,46,72,0.610169491525424
OCCIDENTE 1,2023-02-21,156,63,93,0.596153846153846
OCCIDENTE 1,2023-02-22,110,49,61,0.554545454545455
OCCIDENTE 1,2023-02-23,127,70,57,0.448818897637795
OCCIDENTE 1,2023-02-24,115,53,62,0.539130434782609
OCCIDENTE 1,2023-02-25,164,84,80,0.48780487804878
OCCIDENTE 1,2023-02-26,91,43,48,0.527472527472527
OCCIDENTE 1,2023-02-27,115,62,53,0.460869565217391
OCCIDENTE 1,2023-02-28,155,91,64,0.412903225806452
OCCIDENTE 1,2023-03-01,136,77,59,0.433823529411765
OCCIDENTE 1,2023-03-02,130,75,55,0.423076923076923
OCCIDENTE 1,2023-03-03,127,93,34,0.267716535433071
OCCIDENTE 1,2023-03-04,147,83,64,0.435374149659864
OCCIDENTE 1,2023-03-05,99,55,44,0.444444444444444
OCCIDENTE 1,2023-03-06,114,69,45,0.394736842105263
OCCIDENTE 1,2023-03-07,138,77,61,0.442028985507246
OCCIDENTE 1,2023-03-08,144,91,53,0.368055555555556
OCCIDENTE 1,2023-03-09,132,121,11,0.0833333333333333
OCCIDENTE 1,2023-03-10,116,103,13,0.112068965517241
OCCIDENTE 1,2023-03-11,148,134,14,0.0945945945945946
OCCIDENTE 1,2023-03-12,116,107,9,0.0775862068965517
OCCIDENTE 1,2023-03-13,116,102,14,0.120689655172414
OCCIDENTE 1,2023-03-14,122,101,21,0.172131147540984
OCCIDENTE 1,2023-03-15,149,138,11,0.0738255033557047
OCCIDENTE 1,2023-03-16,162,151,11,0.0679012345679012
OCCIDENTE 1,2023-03-17,176,163,13,0.0738636363636364
OCCIDENTE 1,2023-03-18,196,171,25,0.127551020408163
OCCIDENTE 1,2023-03-19,153,138,15,0.0980392156862745
OCCIDENTE 1,2023-03-20,182,169,13,0.0714285714285714
OCCIDENTE 1,2023-03-21,152,142,10,0.0657894736842105
OCCIDENTE 1,2023-03-22,114,110,4,0.0350877192982456
OCCIDENTE 1,2023-03-23,134,126,8,0.0597014925373134
OCCIDENTE 1,2023-03-24,146,143,3,0.0205479452054795
OCCIDENTE 1,2023-03-25,172,163,9,0.0523255813953488
OCCIDENTE 1,2023-03-26,127,124,3,0.0236220472440945
OCCIDENTE 1,2023-03-27,106,99,7,0.0660377358490566
OCCIDENTE 1,2023-03-28,125,122,3,0.024
OCCIDENTE 1,2023-03-29,128,114,14,0.109375
OCCIDENTE 1,2023-03-30,160,146,14,0.0875
OCCIDENTE 1,2023-03-31,197,187,10,0.050761421319797
OCCIDENTE 1,2023-04-01,168,159,9,0.0535714285714286
OCCIDENTE 1,2023-04-02,80,78,2,0.025
OCCIDENTE 1,2023-04-03,146,140,6,0.0410958904109589
OCCIDENTE 1,2023-04-04,169,157,12,0.0710059171597633
OCCIDENTE 1,2023-04-05,144,136,8,0.0555555555555556
OCCIDENTE 1,2023-04-06,125,119,6,0.048
OCCIDENTE 1,2023-04-07,82,80,2,0.024390243902439
OCCIDENTE 1,2023-04-08,78,73,5,0.0641025641025641
OCCIDENTE 1,2023-04-09,49,49,0,0
OCCIDENTE 1,2023-04-10,110,98,12,0.109090909090909
OCCIDENTE 1,2023-04-11,135,120,15,0.111111111111111
OCCIDENTE 1,2023-04-12,119,106,13,0.109243697478992
OCCIDENTE 1,2023-04-13,116,105,11,0.0948275862068965
OCCIDENTE 1,2023-04-14,144,129,15,0.104166666666667
OCCIDENTE 1,2023-04-15,178,161,17,0.0955056179775281
OCCIDENTE 1,2023-04-16,114,101,13,0.114035087719298
OCCIDENTE 1,2023-04-17,123,115,8,0.0650406504065041
OCCIDENTE 1,2023-04-18,125,107,18,0.144
OCCIDENTE 1,2023-04-19,133,120,13,0.0977443609022556
OCCIDENTE 1,2023-04-20,129,122,7,0.0542635658914729
OCCIDENTE 1,2023-04-21,128,114,14,0.109375
OCCIDENTE 1,2023-04-22,149,139,10,0.0671140939597315
OCCIDENTE 1,2023-04-23,92,84,8,0.0869565217391304
OCCIDENTE 1,2023-04-24,149,139,10,0.0671140939597315
OCCIDENTE 1,2023-04-25,168,145,23,0.136904761904762
OCCIDENTE 1,2023-04-26,150,134,16,0.106666666666667
OCCIDENTE 1,2023-04-27,134,124,10,0.0746268656716418
OCCIDENTE 1,2023-04-28,153,135,18,0.117647058823529
OCCIDENTE 1,2023-04-29,175,158,17,0.0971428571428571
OCCIDENTE 1,2023-04-30,106,96,10,0.0943396226415094
OCCIDENTE 1,2023-05-01,114,105,9,0.0789473684210526
OCCIDENTE 1,2023-05-02,147,134,13,0.0884353741496599
OCCIDENTE 1,2023-05-03,138,132,6,0.0434782608695652
OCCIDENTE 1,2023-05-04,121,103,18,0.148760330578512
OCCIDENTE 1,2023-05-05,133,121,12,0.0902255639097744
OCCIDENTE 1,2023-05-06,117,111,6,0.0512820512820513
OCCIDENTE 1,2023-05-07,93,90,3,0.032258064516129
OCCIDENTE 1,2023-05-08,128,117,11,0.0859375
OCCIDENTE 1,2023-05-09,129,117,12,0.0930232558139535
OCCIDENTE 1,2023-05-10,119,111,8,0.0672268907563025
OCCIDENTE 1,2023-05-11,114,105,9,0.0789473684210526
OCCIDENTE 1,2023-05-12,95,90,5,0.0526315789473684
OCCIDENTE 1,2023-05-13,171,149,22,0.128654970760234
OCCIDENTE 1,2023-05-14,136,124,12,0.0882352941176471
OCCIDENTE 1,2023-05-15,146,135,11,0.0753424657534247
OCCIDENTE 1,2023-05-16,219,186,33,0.150684931506849
OCCIDENTE 1,2023-05-17,133,123,10,0.075187969924812
OCCIDENTE 1,2023-05-18,114,105,9,0.0789473684210526
OCCIDENTE 1,2023-05-19,136,118,18,0.132352941176471
OCCIDENTE 1,2023-05-20,156,134,22,0.141025641025641
OCCIDENTE 1,2023-05-21,125,107,18,0.144
OCCIDENTE 1,2023-05-22,130,108,22,0.169230769230769
OCCIDENTE 1,2023-05-23,137,124,13,0.0948905109489051
OCCIDENTE 1,2023-05-24,136,122,14,0.102941176470588
OCCIDENTE 1,2023-05-25,153,131,22,0.143790849673203
OCCIDENTE 1,2023-05-26,134,119,15,0.111940298507463
OCCIDENTE 1,2023-05-27,162,142,20,0.123456790123457
OCCIDENTE 1,2023-05-28,109,91,18,0.165137614678899
OCCIDENTE 1,2023-05-29,122,104,18,0.147540983606557
OCCIDENTE 1,2023-05-30,153,129,24,0.156862745098039
OCCIDENTE 1,2023-05-31,212,180,32,0.150943396226415
OCCIDENTE 1,2023-06-01,295,276,19,0.0644067796610169
OCCIDENTE 1,2023-06-02,250,225,25,0.1
OCCIDENTE 1,2023-06-03,298,268,30,0.100671140939597
OCCIDENTE 1,2023-06-04,190,166,24,0.126315789473684
OCCIDENTE 1,2023-06-05,132,118,14,0.106060606060606
OCCIDENTE 1,2023-06-06,134,124,10,0.0746268656716418
OCCIDENTE 1,2023-06-07,133,115,18,0.135338345864662
OCCIDENTE 1,2023-06-08,149,130,19,0.12751677852349
OCCIDENTE 1,2023-06-09,119,107,12,0.100840336134454
OCCIDENTE 1,2023-06-10,169,148,21,0.124260355029586
OCCIDENTE 1,2023-06-11,108,95,13,0.12037037037037
OCCIDENTE 1,2023-06-12,138,115,23,0.166666666666667
OCCIDENTE 1,2023-06-13,151,132,19,0.125827814569536
OCCIDENTE 1,2023-06-14,148,132,16,0.108108108108108
OCCIDENTE 1,2023-06-15,130,120,10,0.0769230769230769
OCCIDENTE 1,2023-06-16,125,113,12,0.096
OCCIDENTE 1,2023-06-17,143,129,14,0.0979020979020979
OCCIDENTE 1,2023-06-18,90,85,5,0.0555555555555556
OCCIDENTE 1,2023-06-19,116,104,12,0.103448275862069
OCCIDENTE 1,2023-06-20,136,126,10,0.0735294117647059
OCCIDENTE 1,2023-06-21,153,136,17,0.111111111111111
OCCIDENTE 1,2023-06-22,139,122,17,0.122302158273381
OCCIDENTE 1,2023-06-23,97,93,4,0.0412371134020619
OCCIDENTE 1,2023-06-24,147,135,12,0.0816326530612245
OCCIDENTE 1,2023-06-25,102,95,7,0.0686274509803922
OCCIDENTE 1,2023-06-26,128,122,6,0.046875
OCCIDENTE 1,2023-06-27,142,129,13,0.0915492957746479
OCCIDENTE 1,2023-06-28,135,126,9,0.0666666666666667
OCCIDENTE 1,2023-06-29,124,116,8,0.0645161290322581
OCCIDENTE 1,2023-06-30,76,60,16,0.210526315789474
OCCIDENTE 1,2023-07-01,198,193,5,0.0252525252525253
OCCIDENTE 1,2023-07-02,107,104,3,0.0280373831775701
OCCIDENTE 1,2023-07-03,131,127,4,0.0305343511450382
OCCIDENTE 1,2023-07-04,173,169,4,0.023121387283237
OCCIDENTE 1,2023-07-05,114,107,7,0.0614035087719298
OCCIDENTE 1,2023-07-06,106,100,6,0.0566037735849057
OCCIDENTE 1,2023-07-07,125,121,4,0.032
OCCIDENTE 1,2023-07-08,222,216,6,0.027027027027027
OCCIDENTE 1,2023-07-09,142,135,7,0.0492957746478873
OCCIDENTE 1,2023-07-10,130,122,8,0.0615384615384615
OCCIDENTE 1,2023-07-11,156,140,16,0.102564102564103
OCCIDENTE 1,2023-07-12,157,147,10,0.0636942675159236
OCCIDENTE 1,2023-07-13,156,148,8,0.0512820512820513
OCCIDENTE 1,2023-07-14,134,125,9,0.0671641791044776
OCCIDENTE 1,2023-07-15,241,224,17,0.0705394190871369
OCCIDENTE 1,2023-07-16,107,105,2,0.0186915887850467
OCCIDENTE 1,2023-07-17,132,123,9,0.0681818181818182
OCCIDENTE 1,2023-07-18,141,136,5,0.0354609929078014
OCCIDENTE 1,2023-07-19,139,129,10,0.0719424460431655
OCCIDENTE 1,2023-07-20,169,162,7,0.0414201183431953
OCCIDENTE 1,2023-07-21,138,134,4,0.0289855072463768
OCCIDENTE 1,2023-07-22,205,195,10,0.0487804878048781
OCCIDENTE 1,2023-07-23,108,104,4,0.037037037037037
OCCIDENTE 1,2023-07-24,116,113,3,0.0258620689655172
OCCIDENTE 1,2023-07-25,159,147,12,0.0754716981132075
OCCIDENTE 1,2023-07-26,175,159,16,0.0914285714285714
OCCIDENTE 1,2023-07-27,166,160,6,0.036144578313253
OCCIDENTE 1,2023-07-28,159,145,14,0.0880503144654088
OCCIDENTE 1,2023-07-29,205,189,16,0.0780487804878049
OCCIDENTE 1,2023-07-30,138,124,14,0.101449275362319
OCCIDENTE 1,2023-07-31,164,155,9,0.0548780487804878
OCCIDENTE 1,2023-08-01,180,159,21,0.116666666666667
OCCIDENTE 1,2023-08-02,170,160,10,0.0588235294117647
OCCIDENTE 1,2023-08-03,131,106,25,0.190839694656489
OCCIDENTE 1,2023-08-04,140,121,19,0.135714285714286
OCCIDENTE 1,2023-08-05,188,174,14,0.074468085106383
OCCIDENTE 1,2023-08-06,115,106,9,0.0782608695652174
OCCIDENTE 1,2023-08-07,137,133,4,0.0291970802919708
OCCIDENTE 1,2023-08-08,180,175,5,0.0277777777777778
OCCIDENTE 1,2023-08-09,155,140,15,0.0967741935483871
OCCIDENTE 1,2023-08-10,172,157,15,0.0872093023255814
OCCIDENTE 1,2023-08-11,190,180,10,0.0526315789473684
OCCIDENTE 1,2023-08-12,183,176,7,0.0382513661202186
OCCIDENTE 1,2023-08-13,127,117,10,0.078740157480315
OCCIDENTE 1,2023-08-14,158,149,9,0.0569620253164557
OCCIDENTE 1,2023-08-15,184,176,8,0.0434782608695652
OCCIDENTE 1,2023-08-16,183,176,7,0.0382513661202186
OCCIDENTE 1,2023-08-17,185,176,9,0.0486486486486487
OCCIDENTE 1,2023-08-18,157,151,6,0.0382165605095541
OCCIDENTE 1,2023-08-19,201,189,12,0.0597014925373134
OCCIDENTE 1,2023-08-20,131,128,3,0.0229007633587786
OCCIDENTE 1,2023-08-21,157,153,4,0.0254777070063694
OCCIDENTE 1,2023-08-22,152,150,2,0.0131578947368421
OCCIDENTE 1,2023-08-23,149,138,11,0.0738255033557047
OCCIDENTE 1,2023-08-24,166,159,7,0.0421686746987952
OCCIDENTE 1,2023-08-25,159,155,4,0.0251572327044025
OCCIDENTE 1,2023-08-26,197,191,6,0.0304568527918782
OCCIDENTE 1,2023-08-27,137,129,8,0.0583941605839416
OCCIDENTE 1,2023-08-28,140,137,3,0.0214285714285714
OCCIDENTE 1,2023-08-29,162,159,3,0.0185185185185185
OCCIDENTE 1,2023-08-30,147,146,1,0.00680272108843537
OCCIDENTE 1,2023-08-31,161,155,6,0.0372670807453416
OCCIDENTE 1,2023-09-01,148,145,3,0.0202702702702703
OCCIDENTE 1,2023-09-02,161,155,6,0.0372670807453416
OCCIDENTE 1,2023-09-03,112,110,2,0.0178571428571429
OCCIDENTE 1,2023-09-04,136,133,3,0.0220588235294118
OCCIDENTE 1,2023-09-05,173,170,3,0.0173410404624277
OCCIDENTE 1,2023-09-06,146,140,6,0.0410958904109589
OCCIDENTE 1,2023-09-07,183,177,6,0.0327868852459016
OCCIDENTE 1,2023-09-08,141,141,0,0
OCCIDENTE 1,2023-09-09,178,176,2,0.0112359550561798
OCCIDENTE 1,2023-09-10,89,89,0,0
OCCIDENTE 1,2023-09-11,131,129,2,0.0152671755725191
OCCIDENTE 1,2023-09-12,136,134,2,0.0147058823529412
OCCIDENTE 1,2023-09-13,150,149,1,0.00666666666666667
OCCIDENTE 1,2023-09-14,147,146,1,0.00680272108843537
OCCIDENTE 1,2023-09-15,168,163,5,0.0297619047619048
OCCIDENTE 1,2023-09-16,144,142,2,0.0138888888888889
OCCIDENTE 1,2023-09-17,120,119,1,0.00833333333333333
OCCIDENTE 1,2023-09-18,143,143,0,0
OCCIDENTE 1,2023-09-19,160,156,4,0.025
OCCIDENTE 1,2023-09-20,125,125,0,0
OCCIDENTE 1,2023-09-21,130,128,2,0.0153846153846154
OCCIDENTE 1,2023-09-22,164,160,4,0.024390243902439
OCCIDENTE 1,2023-09-23,164,161,3,0.0182926829268293
OCCIDENTE 1,2023-09-24,103,102,1,0.00970873786407767
OCCIDENTE 1,2023-09-25,116,114,2,0.0172413793103448
OCCIDENTE 1,2023-09-26,143,137,6,0.041958041958042
OCCIDENTE 1,2023-09-27,139,136,3,0.0215827338129496
OCCIDENTE 1,2023-09-28,146,145,1,0.00684931506849315
OCCIDENTE 1,2023-09-29,173,172,1,0.00578034682080925
OCCIDENTE 1,2023-09-30,194,191,3,0.0154639175257732
OCCIDENTE 1,2023-10-01,122,119,3,0.0245901639344262
OCCIDENTE 1,2023-10-02,138,134,4,0.0289855072463768
OCCIDENTE 1,2023-10-03,139,137,2,0.0143884892086331
OCCIDENTE 1,2023-10-04,133,128,5,0.037593984962406
OCCIDENTE 1,2023-10-05,146,142,4,0.0273972602739726
OCCIDENTE 1,2023-10-06,124,118,6,0.0483870967741935
OCCIDENTE 1,2023-10-07,138,131,7,0.0507246376811594
OCCIDENTE 1,2023-10-08,109,106,3,0.0275229357798165
OCCIDENTE 1,2023-10-09,147,143,4,0.0272108843537415
OCCIDENTE 1,2023-10-10,119,113,6,0.0504201680672269
OCCIDENTE 1,2023-10-11,123,115,8,0.0650406504065041
OCCIDENTE 1,2023-10-12,115,113,2,0.0173913043478261
OCCIDENTE 1,2023-10-13,112,106,6,0.0535714285714286
OCCIDENTE 1,2023-10-14,165,159,6,0.0363636363636364
OCCIDENTE 1,2023-10-15,109,104,5,0.0458715596330275
OCCIDENTE 1,2023-10-16,143,138,5,0.034965034965035
OCCIDENTE 1,2023-10-17,115,113,2,0.0173913043478261
OCCIDENTE 1,2023-10-18,131,128,3,0.0229007633587786
OCCIDENTE 1,2023-10-19,118,110,8,0.0677966101694915
OCCIDENTE 1,2023-10-20,137,132,5,0.0364963503649635
OCCIDENTE 1,2023-10-21,155,149,6,0.0387096774193548
OCCIDENTE 1,2023-10-22,104,103,1,0.00961538461538462
OCCIDENTE 1,2023-10-23,135,131,4,0.0296296296296296
OCCIDENTE 1,2023-10-24,133,130,3,0.0225563909774436
OCCIDENTE 1,2023-10-25,140,137,3,0.0214285714285714
OCCIDENTE 1,2023-10-26,115,110,5,0.0434782608695652
OCCIDENTE 1,2023-10-27,132,129,3,0.0227272727272727
OCCIDENTE 1,2023-10-28,143,142,1,0.00699300699300699
OCCIDENTE 1,2023-10-29,79,78,1,0.0126582278481013
OCCIDENTE 1,2023-10-30,111,109,2,0.018018018018018
OCCIDENTE 1,2023-10-31,143,139,4,0.027972027972028
OCCIDENTE 1,2023-11-01,148,143,5,0.0337837837837838
OCCIDENTE 1,2023-11-02,167,161,6,0.0359281437125748
OCCIDENTE 1,2023-11-03,117,115,2,0.0170940170940171
OCCIDENTE 1,2023-11-04,152,149,3,0.0197368421052632
OCCIDENTE 1,2023-11-05,102,100,2,0.0196078431372549
OCCIDENTE 1,2023-11-06,138,135,3,0.0217391304347826
OCCIDENTE 1,2023-11-07,151,150,1,0.00662251655629139
OCCIDENTE 1,2023-11-08,149,140,9,0.0604026845637584
OCCIDENTE 1,2023-11-09,153,149,4,0.0261437908496732
OCCIDENTE 1,2023-11-10,132,125,7,0.053030303030303
OCCIDENTE 1,2023-11-11,173,163,10,0.0578034682080925
OCCIDENTE 1,2023-11-12,103,103,0,0
OCCIDENTE 1,2023-11-13,123,118,5,0.040650406504065
OCCIDENTE 1,2023-11-14,145,144,1,0.00689655172413793
OCCIDENTE 1,2023-11-15,145,144,1,0.00689655172413793
OCCIDENTE 1,2023-11-16,135,130,5,0.037037037037037
OCCIDENTE 1,2023-11-17,140,133,7,0.05
OCCIDENTE 1,2023-11-18,177,171,6,0.0338983050847458
OCCIDENTE 1,2023-11-19,141,138,3,0.0212765957446809
OCCIDENTE 1,2023-11-20,144,143,1,0.00694444444444444
OCCIDENTE 1,2023-11-21,157,147,10,0.0636942675159236
OCCIDENTE 1,2023-11-22,130,125,5,0.0384615384615385
OCCIDENTE 1,2023-11-23,146,139,7,0.0479452054794521
OCCIDENTE 1,2023-11-24,169,164,5,0.029585798816568
OCCIDENTE 1,2023-11-25,168,165,3,0.0178571428571429
OCCIDENTE 1,2023-11-26,101,97,4,0.0396039603960396
OCCIDENTE 1,2023-11-27,144,138,6,0.0416666666666667
OCCIDENTE 1,2023-11-28,170,161,9,0.0529411764705882
OCCIDENTE 1,2023-11-29,160,151,9,0.05625
OCCIDENTE 1,2023-11-30,156,151,5,0.032051282051282
OCCIDENTE 1,2023-12-01,133,125,8,0.0601503759398496
OCCIDENTE 1,2023-12-02,151,147,4,0.0264900662251656
OCCIDENTE 1,2023-12-03,116,113,3,0.0258620689655172
OCCIDENTE 1,2023-12-04,128,124,4,0.03125
OCCIDENTE 1,2023-12-05,144,137,7,0.0486111111111111
OCCIDENTE 1,2023-12-06,152,147,5,0.0328947368421053
OCCIDENTE 1,2023-12-07,148,147,1,0.00675675675675676
OCCIDENTE 1,2023-12-08,130,125,5,0.0384615384615385
OCCIDENTE 1,2023-12-09,172,164,8,0.0465116279069767
OCCIDENTE 1,2023-12-10,88,88,0,0
OCCIDENTE 1,2023-12-11,122,119,3,0.0245901639344262
OCCIDENTE 1,2023-12-12,155,151,4,0.0258064516129032
OCCIDENTE 1,2023-12-13,131,128,3,0.0229007633587786
OCCIDENTE 1,2023-12-14,130,125,5,0.0384615384615385
OCCIDENTE 1,2023-12-15,132,127,5,0.0378787878787879
OCCIDENTE 1,2023-12-16,154,153,1,0.00649350649350649
OCCIDENTE 1,2023-12-17,106,103,3,0.0283018867924528
OCCIDENTE 1,2023-12-18,161,160,1,0.0062111801242236
OCCIDENTE 1,2023-12-19,150,144,6,0.04
OCCIDENTE 1,2023-12-20,134,127,7,0.0522388059701493
OCCIDENTE 1,2023-12-21,141,131,10,0.0709219858156028
OCCIDENTE 1,2023-12-22,147,144,3,0.0204081632653061
OCCIDENTE 1,2023-12-23,139,136,3,0.0215827338129496
OCCIDENTE 1,2023-12-24,73,71,2,0.0273972602739726
OCCIDENTE 1,2023-12-25,33,33,0,0
OCCIDENTE 1,2023-12-26,124,121,3,0.0241935483870968
OCCIDENTE 1,2023-12-27,151,149,2,0.0132450331125828
OCCIDENTE 1,2023-12-28,170,163,7,0.0411764705882353
OCCIDENTE 1,2023-12-29,155,148,7,0.0451612903225806
OCCIDENTE 1,2023-12-30,207,203,4,0.0193236714975845
OCCIDENTE 1,2023-12-31,88,88,0,0
OCCIDENTE 1,2024-01-01,29,29,0,0
OCCIDENTE 1,2024-01-02,132,131,1,0.00757575757575758
OCCIDENTE 1,2024-01-03,179,176,3,0.0167597765363128
OCCIDENTE 1,2024-01-04,122,119,3,0.0245901639344262
OCCIDENTE 1,2024-01-05,119,115,4,0.0336134453781513
OCCIDENTE 1,2024-01-06,118,118,0,0
OCCIDENTE 1,2024-01-07,81,81,0,0
OCCIDENTE 1,2024-01-08,143,139,4,0.027972027972028
OCCIDENTE 1,2024-01-09,134,133,1,0.00746268656716418
OCCIDENTE 1,2024-01-10,112,111,1,0.00892857142857143
OCCIDENTE 1,2024-01-11,135,135,0,0
OCCIDENTE 1,2024-01-12,150,149,1,0.00666666666666667
OCCIDENTE 1,2024-01-13,119,117,2,0.0168067226890756
OCCIDENTE 1,2024-01-14,78,77,1,0.0128205128205128
OCCIDENTE 2,2023-01-02,169,114,55,0.325443786982249
OCCIDENTE 2,2023-01-03,208,127,81,0.389423076923077
OCCIDENTE 2,2023-01-04,192,120,72,0.375
OCCIDENTE 2,2023-01-05,194,112,82,0.422680412371134
OCCIDENTE 2,2023-01-06,212,141,71,0.334905660377358
OCCIDENTE 2,2023-01-07,221,148,73,0.330316742081448
OCCIDENTE 2,2023-01-08,130,91,39,0.3
OCCIDENTE 2,2023-01-09,188,105,83,0.441489361702128
OCCIDENTE 2,2023-01-10,207,141,66,0.318840579710145
OCCIDENTE 2,2023-01-11,235,150,85,0.361702127659574
OCCIDENTE 2,2023-01-12,184,129,55,0.298913043478261
OCCIDENTE 2,2023-01-13,205,127,78,0.380487804878049
OCCIDENTE 2,2023-01-14,247,171,76,0.307692307692308
OCCIDENTE 2,2023-01-15,143,100,43,0.300699300699301
OCCIDENTE 2,2023-01-16,214,132,82,0.383177570093458
OCCIDENTE 2,2023-01-17,237,158,79,0.333333333333333
OCCIDENTE 2,2023-01-18,197,129,68,0.345177664974619
OCCIDENTE 2,2023-01-19,202,133,69,0.341584158415842
OCCIDENTE 2,2023-01-20,196,119,77,0.392857142857143
OCCIDENTE 2,2023-01-21,202,63,139,0.688118811881188
OCCIDENTE 2,2023-01-22,129,40,89,0.689922480620155
OCCIDENTE 2,2023-01-23,178,71,107,0.601123595505618
OCCIDENTE 2,2023-01-24,201,61,140,0.696517412935323
OCCIDENTE 2,2023-01-25,212,92,120,0.566037735849057
OCCIDENTE 2,2023-01-26,217,78,139,0.640552995391705
OCCIDENTE 2,2023-01-27,192,72,120,0.625
OCCIDENTE 2,2023-01-28,243,92,151,0.621399176954732
OCCIDENTE 2,2023-01-29,141,46,95,0.673758865248227
OCCIDENTE 2,2023-01-30,203,73,130,0.640394088669951
OCCIDENTE 2,2023-01-31,245,97,148,0.604081632653061
OCCIDENTE 2,2023-02-01,179,75,104,0.581005586592179
OCCIDENTE 2,2023-02-02,223,58,165,0.739910313901345
OCCIDENTE 2,2023-02-03,216,73,143,0.662037037037037
OCCIDENTE 2,2023-02-04,229,77,152,0.663755458515284
OCCIDENTE 2,2023-02-05,129,51,78,0.604651162790698
OCCIDENTE 2,2023-02-06,203,71,132,0.650246305418719
OCCIDENTE 2,2023-02-07,252,97,155,0.615079365079365
OCCIDENTE 2,2023-02-08,197,64,133,0.6751269035533
OCCIDENTE 2,2023-02-09,200,85,115,0.575
OCCIDENTE 2,2023-02-10,185,69,116,0.627027027027027
OCCIDENTE 2,2023-02-11,226,87,139,0.615044247787611
OCCIDENTE 2,2023-02-12,124,47,77,0.620967741935484
OCCIDENTE 2,2023-02-13,178,68,110,0.617977528089888
OCCIDENTE 2,2023-02-14,183,74,109,0.595628415300546
OCCIDENTE 2,2023-02-15,171,79,92,0.538011695906433
OCCIDENTE 2,2023-02-16,206,81,126,0.611650485436893
OCCIDENTE 2,2023-02-17,215,75,140,0.651162790697674
OCCIDENTE 2,2023-02-18,257,114,143,0.556420233463035
OCCIDENTE 2,2023-02-19,135,55,80,0.592592592592593
OCCIDENTE 2,2023-02-20,177,74,103,0.581920903954802
OCCIDENTE 2,2023-02-21,207,96,111,0.536231884057971
OCCIDENTE 2,2023-02-22,224,118,106,0.473214285714286
OCCIDENTE 2,2023-02-23,169,97,72,0.42603550295858
OCCIDENTE 2,2023-02-24,191,132,59,0.308900523560209
OCCIDENTE 2,2023-02-25,216,150,66,0.305555555555556
OCCIDENTE 2,2023-02-26,87,47,40,0.459770114942529
OCCIDENTE 2,2023-02-27,167,112,55,0.329341317365269
OCCIDENTE 2,2023-02-28,197,133,64,0.3248730964467
OCCIDENTE 2,2023-03-01,195,131,64,0.328205128205128
OCCIDENTE 2,2023-03-02,226,150,76,0.336283185840708
OCCIDENTE 2,2023-03-03,184,110,74,0.402173913043478
OCCIDENTE 2,2023-03-04,244,159,85,0.348360655737705
OCCIDENTE 2,2023-03-05,104,67,37,0.355769230769231
OCCIDENTE 2,2023-03-06,165,103,62,0.375757575757576
OCCIDENTE 2,2023-03-07,188,132,56,0.297872340425532
OCCIDENTE 2,2023-03-08,180,132,48,0.266666666666667
OCCIDENTE 2,2023-03-09,149,130,19,0.12751677852349
OCCIDENTE 2,2023-03-10,167,142,25,0.149700598802395
OCCIDENTE 2,2023-03-11,209,168,41,0.196172248803828
OCCIDENTE 2,2023-03-12,108,90,18,0.166666666666667
OCCIDENTE 2,2023-03-13,151,129,22,0.145695364238411
OCCIDENTE 2,2023-03-14,227,192,35,0.154185022026432
OCCIDENTE 2,2023-03-15,198,171,27,0.136363636363636
OCCIDENTE 2,2023-03-16,211,191,20,0.0947867298578199
OCCIDENTE 2,2023-03-17,227,204,23,0.101321585903084
OCCIDENTE 2,2023-03-18,273,244,29,0.106227106227106
OCCIDENTE 2,2023-03-19,166,157,9,0.0542168674698795
OCCIDENTE 2,2023-03-20,202,183,19,0.0940594059405941
OCCIDENTE 2,2023-03-21,219,199,20,0.091324200913242
OCCIDENTE 2,2023-03-22,221,201,20,0.0904977375565611
OCCIDENTE 2,2023-03-23,182,170,12,0.0659340659340659
OCCIDENTE 2,2023-03-24,198,180,18,0.0909090909090909
OCCIDENTE 2,2023-03-25,249,232,17,0.0682730923694779
OCCIDENTE 2,2023-03-26,172,161,11,0.063953488372093
OCCIDENTE 2,2023-03-27,179,167,12,0.0670391061452514
OCCIDENTE 2,2023-03-28,152,142,10,0.0657894736842105
OCCIDENTE 2,2023-03-29,207,197,10,0.0483091787439614
OCCIDENTE 2,2023-03-30,212,195,17,0.080188679245283
OCCIDENTE 2,2023-03-31,268,246,22,0.082089552238806
OCCIDENTE 2,2023-04-01,263,253,10,0.0380228136882129
OCCIDENTE 2,2023-04-02,117,111,6,0.0512820512820513
OCCIDENTE 2,2023-04-03,203,196,7,0.0344827586206897
OCCIDENTE 2,2023-04-04,238,222,16,0.0672268907563025
OCCIDENTE 2,2023-04-05,178,160,18,0.101123595505618
OCCIDENTE 2,2023-04-06,181,174,7,0.0386740331491713
OCCIDENTE 2,2023-04-07,146,137,9,0.0616438356164384
OCCIDENTE 2,2023-04-08,97,94,3,0.0309278350515464
OCCIDENTE 2,2023-04-09,83,80,3,0.036144578313253
OCCIDENTE 2,2023-04-10,145,137,8,0.0551724137931034
OCCIDENTE 2,2023-04-11,186,171,15,0.0806451612903226
OCCIDENTE 2,2023-04-12,185,165,20,0.108108108108108
OCCIDENTE 2,2023-04-13,154,138,16,0.103896103896104
OCCIDENTE 2,2023-04-14,191,181,10,0.0523560209424084
OCCIDENTE 2,2023-04-15,246,229,17,0.0691056910569106
OCCIDENTE 2,2023-04-16,142,139,3,0.0211267605633803
OCCIDENTE 2,2023-04-17,174,164,10,0.0574712643678161
OCCIDENTE 2,2023-04-18,188,163,25,0.132978723404255
OCCIDENTE 2,2023-04-19,181,158,23,0.12707182320442
OCCIDENTE 2,2023-04-20,181,171,10,0.0552486187845304
OCCIDENTE 2,2023-04-21,173,156,17,0.0982658959537572
OCCIDENTE 2,2023-04-22,208,187,21,0.100961538461538
OCCIDENTE 2,2023-04-23,108,98,10,0.0925925925925926
OCCIDENTE 2,2023-04-24,202,187,15,0.0742574257425743
OCCIDENTE 2,2023-04-25,227,213,14,0.0616740088105727
OCCIDENTE 2,2023-04-26,193,181,12,0.0621761658031088
OCCIDENTE 2,2023-04-27,158,150,8,0.0506329113924051
OCCIDENTE 2,2023-04-28,200,188,12,0.06
OCCIDENTE 2,2023-04-29,231,208,23,0.0995670995670996
OCCIDENTE 2,2023-04-30,149,139,10,0.0671140939597315
OCCIDENTE 2,2023-05-01,139,128,11,0.079136690647482
OCCIDENTE 2,2023-05-02,169,159,10,0.0591715976331361
OCCIDENTE 2,2023-05-03,169,150,19,0.112426035502959
OCCIDENTE 2,2023-05-04,173,160,13,0.0751445086705202
OCCIDENTE 2,2023-05-05,189,174,15,0.0793650793650794
OCCIDENTE 2,2023-05-06,204,180,24,0.117647058823529
OCCIDENTE 2,2023-05-07,98,95,3,0.0306122448979592
OCCIDENTE 2,2023-05-08,149,135,14,0.0939597315436242
OCCIDENTE 2,2023-05-09,181,172,9,0.0497237569060773
OCCIDENTE 2,2023-05-10,152,135,17,0.111842105263158
OCCIDENTE 2,2023-05-11,160,150,10,0.0625
OCCIDENTE 2,2023-05-12,175,165,10,0.0571428571428571
OCCIDENTE 2,2023-05-13,231,210,21,0.0909090909090909
OCCIDENTE 2,2023-05-14,169,151,18,0.106508875739645
OCCIDENTE 2,2023-05-15,231,198,33,0.142857142857143
OCCIDENTE 2,2023-05-16,277,232,45,0.162454873646209
OCCIDENTE 2,2023-05-17,271,236,35,0.129151291512915
OCCIDENTE 2,2023-05-18,209,192,17,0.0813397129186603
OCCIDENTE 2,2023-05-19,195,173,22,0.112820512820513
OCCIDENTE 2,2023-05-20,263,243,20,0.0760456273764259
OCCIDENTE 2,2023-05-21,173,160,13,0.0751445086705202
OCCIDENTE 2,2023-05-22,207,188,19,0.0917874396135266
OCCIDENTE 2,2023-05-23,202,180,22,0.108910891089109
OCCIDENTE 2,2023-05-24,199,170,29,0.14572864321608
OCCIDENTE 2,2023-05-25,197,173,24,0.121827411167513
OCCIDENTE 2,2023-05-26,229,195,34,0.148471615720524
OCCIDENTE 2,2023-05-27,277,231,46,0.166064981949458
OCCIDENTE 2,2023-05-28,176,142,34,0.193181818181818
OCCIDENTE 2,2023-05-29,226,180,46,0.20353982300885
OCCIDENTE 2,2023-05-30,298,237,61,0.204697986577181
OCCIDENTE 2,2023-05-31,284,239,45,0.158450704225352
OCCIDENTE 2,2023-06-01,492,444,48,0.0975609756097561
OCCIDENTE 2,2023-06-02,332,275,57,0.171686746987952
OCCIDENTE 2,2023-06-03,442,384,58,0.131221719457014
OCCIDENTE 2,2023-06-04,324,277,47,0.145061728395062
OCCIDENTE 2,2023-06-05,255,214,41,0.16078431372549
OCCIDENTE 2,2023-06-06,260,235,25,0.0961538461538462
OCCIDENTE 2,2023-06-07,227,198,29,0.127753303964758
OCCIDENTE 2,2023-06-08,223,194,29,0.130044843049327
OCCIDENTE 2,2023-06-09,226,205,21,0.0929203539823009
OCCIDENTE 2,2023-06-10,253,224,29,0.114624505928854
OCCIDENTE 2,2023-06-11,154,140,14,0.0909090909090909
OCCIDENTE 2,2023-06-12,219,194,25,0.114155251141553
OCCIDENTE 2,2023-06-13,232,196,36,0.155172413793103
OCCIDENTE 2,2023-06-14,262,245,17,0.0648854961832061
OCCIDENTE 2,2023-06-15,257,230,27,0.105058365758755
OCCIDENTE 2,2023-06-16,241,219,22,0.0912863070539419
OCCIDENTE 2,2023-06-17,247,217,30,0.121457489878543
OCCIDENTE 2,2023-06-18,170,147,23,0.135294117647059
OCCIDENTE 2,2023-06-19,217,192,25,0.115207373271889
OCCIDENTE 2,2023-06-20,218,193,25,0.114678899082569
OCCIDENTE 2,2023-06-21,196,178,18,0.0918367346938776
OCCIDENTE 2,2023-06-22,208,193,15,0.0721153846153846
OCCIDENTE 2,2023-06-23,194,176,18,0.0927835051546392
OCCIDENTE 2,2023-06-24,225,211,14,0.0622222222222222
OCCIDENTE 2,2023-06-25,151,143,8,0.0529801324503311
OCCIDENTE 2,2023-06-26,226,212,14,0.0619469026548673
OCCIDENTE 2,2023-06-27,226,215,11,0.0486725663716814
OCCIDENTE 2,2023-06-28,239,223,16,0.0669456066945607
OCCIDENTE 2,2023-06-29,207,192,15,0.072463768115942
OCCIDENTE 2,2023-06-30,149,104,45,0.302013422818792
OCCIDENTE 2,2023-07-01,240,217,23,0.0958333333333333
OCCIDENTE 2,2023-07-02,140,128,12,0.0857142857142857
OCCIDENTE 2,2023-07-03,217,206,11,0.0506912442396313
OCCIDENTE 2,2023-07-04,249,225,24,0.0963855421686747
OCCIDENTE 2,2023-07-05,164,144,20,0.121951219512195
OCCIDENTE 2,2023-07-06,96,83,13,0.135416666666667
OCCIDENTE 2,2023-07-07,209,190,19,0.0909090909090909
OCCIDENTE 2,2023-07-08,384,354,30,0.078125
OCCIDENTE 2,2023-07-09,160,150,10,0.0625
OCCIDENTE 2,2023-07-10,236,222,14,0.0593220338983051
OCCIDENTE 2,2023-07-11,256,238,18,0.0703125
OCCIDENTE 2,2023-07-12,266,243,23,0.0864661654135338
OCCIDENTE 2,2023-07-13,230,206,24,0.104347826086957
OCCIDENTE 2,2023-07-14,212,197,15,0.0707547169811321
OCCIDENTE 2,2023-07-15,341,322,19,0.0557184750733138
OCCIDENTE 2,2023-07-16,143,134,9,0.0629370629370629
OCCIDENTE 2,2023-07-17,241,222,19,0.0788381742738589
OCCIDENTE 2,2023-07-18,209,193,16,0.076555023923445
OCCIDENTE 2,2023-07-19,187,176,11,0.0588235294117647
OCCIDENTE 2,2023-07-20,280,263,17,0.0607142857142857
OCCIDENTE 2,2023-07-21,246,227,19,0.0772357723577236
OCCIDENTE 2,2023-07-22,367,343,24,0.0653950953678474
OCCIDENTE 2,2023-07-23,164,155,9,0.0548780487804878
OCCIDENTE 2,2023-07-24,185,173,12,0.0648648648648649
OCCIDENTE 2,2023-07-25,251,231,20,0.0796812749003984
OCCIDENTE 2,2023-07-26,255,228,27,0.105882352941176
OCCIDENTE 2,2023-07-27,226,217,9,0.0398230088495575
OCCIDENTE 2,2023-07-28,273,252,21,0.0769230769230769
OCCIDENTE 2,2023-07-29,284,265,19,0.0669014084507042
OCCIDENTE 2,2023-07-30,187,168,19,0.101604278074866
OCCIDENTE 2,2023-07-31,275,260,15,0.0545454545454545
OCCIDENTE 2,2023-08-01,270,248,22,0.0814814814814815
OCCIDENTE 2,2023-08-02,291,269,22,0.0756013745704467
OCCIDENTE 2,2023-08-03,245,173,72,0.293877551020408
OCCIDENTE 2,2023-08-04,264,239,25,0.0946969696969697
OCCIDENTE 2,2023-08-05,283,265,18,0.0636042402826855
OCCIDENTE 2,2023-08-06,185,175,10,0.0540540540540541
OCCIDENTE 2,2023-08-07,250,238,12,0.048
OCCIDENTE 2,2023-08-08,236,228,8,0.0338983050847458
OCCIDENTE 2,2023-08-09,258,245,13,0.0503875968992248
OCCIDENTE 2,2023-08-10,268,257,11,0.041044776119403
OCCIDENTE 2,2023-08-11,269,249,20,0.0743494423791822
OCCIDENTE 2,2023-08-12,305,278,27,0.0885245901639344
OCCIDENTE 2,2023-08-13,193,179,14,0.0725388601036269
OCCIDENTE 2,2023-08-14,241,227,14,0.0580912863070539
OCCIDENTE 2,2023-08-15,288,263,25,0.0868055555555556
OCCIDENTE 2,2023-08-16,256,239,17,0.06640625
OCCIDENTE 2,2023-08-17,245,222,23,0.0938775510204082
OCCIDENTE 2,2023-08-18,267,250,17,0.0636704119850187
OCCIDENTE 2,2023-08-19,303,279,24,0.0792079207920792
OCCIDENTE 2,2023-08-20,183,169,14,0.0765027322404372
OCCIDENTE 2,2023-08-21,253,241,12,0.0474308300395257
OCCIDENTE 2,2023-08-22,270,259,11,0.0407407407407407
OCCIDENTE 2,2023-08-23,255,245,10,0.0392156862745098
OCCIDENTE 2,2023-08-24,273,257,16,0.0586080586080586
OCCIDENTE 2,2023-08-25,281,272,9,0.0320284697508897
OCCIDENTE 2,2023-08-26,310,295,15,0.0483870967741935
OCCIDENTE 2,2023-08-27,194,186,8,0.0412371134020619
OCCIDENTE 2,2023-08-28,259,244,15,0.0579150579150579
OCCIDENTE 2,2023-08-29,281,267,14,0.0498220640569395
OCCIDENTE 2,2023-08-30,241,234,7,0.029045643153527
OCCIDENTE 2,2023-08-31,263,253,10,0.0380228136882129
OCCIDENTE 2,2023-09-01,226,217,9,0.0398230088495575
OCCIDENTE 2,2023-09-02,275,271,4,0.0145454545454545
OCCIDENTE 2,2023-09-03,187,182,5,0.0267379679144385
OCCIDENTE 2,2023-09-04,222,215,7,0.0315315315315315
OCCIDENTE 2,2023-09-05,248,244,4,0.0161290322580645
OCCIDENTE 2,2023-09-06,259,252,7,0.027027027027027
OCCIDENTE 2,2023-09-07,232,222,10,0.0431034482758621
OCCIDENTE 2,2023-09-08,230,224,6,0.0260869565217391
OCCIDENTE 2,2023-09-09,233,223,10,0.0429184549356223
OCCIDENTE 2,2023-09-10,168,163,5,0.0297619047619048
OCCIDENTE 2,2023-09-11,229,220,9,0.0393013100436681
OCCIDENTE 2,2023-09-12,231,227,4,0.0173160173160173
OCCIDENTE 2,2023-09-13,228,218,10,0.043859649122807
OCCIDENTE 2,2023-09-14,238,227,11,0.046218487394958
OCCIDENTE 2,2023-09-15,265,261,4,0.0150943396226415
OCCIDENTE 2,2023-09-16,246,241,5,0.0203252032520325
OCCIDENTE 2,2023-09-17,170,166,4,0.0235294117647059
OCCIDENTE 2,2023-09-18,249,239,10,0.0401606425702811
OCCIDENTE 2,2023-09-19,245,238,7,0.0285714285714286
OCCIDENTE 2,2023-09-20,205,197,8,0.0390243902439024
OCCIDENTE 2,2023-09-21,225,216,9,0.04
OCCIDENTE 2,2023-09-22,242,233,9,0.0371900826446281
OCCIDENTE 2,2023-09-23,276,266,10,0.036231884057971
OCCIDENTE 2,2023-09-24,172,168,4,0.0232558139534884
OCCIDENTE 2,2023-09-25,209,201,8,0.0382775119617225
OCCIDENTE 2,2023-09-26,245,239,6,0.0244897959183673
OCCIDENTE 2,2023-09-27,229,221,8,0.0349344978165939
OCCIDENTE 2,2023-09-28,249,232,17,0.0682730923694779
OCCIDENTE 2,2023-09-29,285,268,17,0.0596491228070175
OCCIDENTE 2,2023-09-30,314,294,20,0.0636942675159236
OCCIDENTE 2,2023-10-01,196,188,8,0.0408163265306122
OCCIDENTE 2,2023-10-02,230,220,10,0.0434782608695652
OCCIDENTE 2,2023-10-03,228,215,13,0.0570175438596491
OCCIDENTE 2,2023-10-04,202,187,15,0.0742574257425743
OCCIDENTE 2,2023-10-05,199,180,19,0.0954773869346734
OCCIDENTE 2,2023-10-06,199,182,17,0.085427135678392
OCCIDENTE 2,2023-10-07,269,258,11,0.0408921933085502
OCCIDENTE 2,2023-10-08,162,156,6,0.037037037037037
OCCIDENTE 2,2023-10-09,226,213,13,0.0575221238938053
OCCIDENTE 2,2023-10-10,189,178,11,0.0582010582010582
OCCIDENTE 2,2023-10-11,182,167,15,0.0824175824175824
OCCIDENTE 2,2023-10-12,197,178,19,0.0964467005076142
OCCIDENTE 2,2023-10-13,189,174,15,0.0793650793650794
OCCIDENTE 2,2023-10-14,205,193,12,0.0585365853658537
OCCIDENTE 2,2023-10-15,174,166,8,0.0459770114942529
OCCIDENTE 2,2023-10-16,218,209,9,0.0412844036697248
OCCIDENTE 2,2023-10-17,194,187,7,0.0360824742268041
OCCIDENTE 2,2023-10-18,215,200,15,0.0697674418604651
OCCIDENTE 2,2023-10-19,197,190,7,0.0355329949238579
OCCIDENTE 2,2023-10-20,233,222,11,0.0472103004291846
OCCIDENTE 2,2023-10-21,226,221,5,0.0221238938053097
OCCIDENTE 2,2023-10-22,161,158,3,0.0186335403726708
OCCIDENTE 2,2023-10-23,179,175,4,0.0223463687150838
OCCIDENTE 2,2023-10-24,204,196,8,0.0392156862745098
OCCIDENTE 2,2023-10-25,205,198,7,0.0341463414634146
OCCIDENTE 2,2023-10-26,205,189,16,0.0780487804878049
OCCIDENTE 2,2023-10-27,201,194,7,0.0348258706467662
OCCIDENTE 2,2023-10-28,215,209,6,0.027906976744186
OCCIDENTE 2,2023-10-29,129,127,2,0.0155038759689922
OCCIDENTE 2,2023-10-30,197,188,9,0.0456852791878173
OCCIDENTE 2,2023-10-31,259,248,11,0.0424710424710425
OCCIDENTE 2,2023-11-01,239,231,8,0.0334728033472803
OCCIDENTE 2,2023-11-02,228,222,6,0.0263157894736842
OCCIDENTE 2,2023-11-03,232,221,11,0.0474137931034483
OCCIDENTE 2,2023-11-04,263,254,9,0.0342205323193916
OCCIDENTE 2,2023-11-05,201,197,4,0.0199004975124378
OCCIDENTE 2,2023-11-06,220,206,14,0.0636363636363636
OCCIDENTE 2,2023-11-07,244,238,6,0.0245901639344262
OCCIDENTE 2,2023-11-08,234,225,9,0.0384615384615385
OCCIDENTE 2,2023-11-09,217,206,11,0.0506912442396313
OCCIDENTE 2,2023-11-10,230,222,8,0.0347826086956522
OCCIDENTE 2,2023-11-11,298,290,8,0.0268456375838926
OCCIDENTE 2,2023-11-12,177,170,7,0.0395480225988701
OCCIDENTE 2,2023-11-13,245,241,4,0.0163265306122449
OCCIDENTE 2,2023-11-14,255,240,15,0.0588235294117647
OCCIDENTE 2,2023-11-15,260,250,10,0.0384615384615385
OCCIDENTE 2,2023-11-16,233,217,16,0.0686695278969957
OCCIDENTE 2,2023-11-17,257,248,9,0.0350194552529183
OCCIDENTE 2,2023-11-18,291,286,5,0.0171821305841924
OCCIDENTE 2,2023-11-19,196,191,5,0.0255102040816327
OCCIDENTE 2,2023-11-20,270,257,13,0.0481481481481481
OCCIDENTE 2,2023-11-21,270,264,6,0.0222222222222222
OCCIDENTE 2,2023-11-22,237,229,8,0.0337552742616034
OCCIDENTE 2,2023-11-23,243,235,8,0.0329218106995885
OCCIDENTE 2,2023-11-24,274,264,10,0.0364963503649635
OCCIDENTE 2,2023-11-25,265,259,6,0.0226415094339623
OCCIDENTE 2,2023-11-26,181,178,3,0.0165745856353591
OCCIDENTE 2,2023-11-27,222,215,7,0.0315315315315315
OCCIDENTE 2,2023-11-28,254,242,12,0.047244094488189
OCCIDENTE 2,2023-11-29,260,237,23,0.0884615384615385
OCCIDENTE 2,2023-11-30,262,252,10,0.0381679389312977
OCCIDENTE 2,2023-12-01,250,234,16,0.064
OCCIDENTE 2,2023-12-02,288,269,19,0.0659722222222222
OCCIDENTE 2,2023-12-03,179,167,12,0.0670391061452514
OCCIDENTE 2,2023-12-04,249,234,15,0.0602409638554217
OCCIDENTE 2,2023-12-05,253,236,17,0.0671936758893281
OCCIDENTE 2,2023-12-06,260,246,14,0.0538461538461538
OCCIDENTE 2,2023-12-07,240,226,14,0.0583333333333333
OCCIDENTE 2,2023-12-08,249,237,12,0.0481927710843374
OCCIDENTE 2,2023-12-09,260,243,17,0.0653846153846154
OCCIDENTE 2,2023-12-10,195,187,8,0.041025641025641
OCCIDENTE 2,2023-12-11,210,196,14,0.0666666666666667
OCCIDENTE 2,2023-12-12,244,227,17,0.069672131147541
OCCIDENTE 2,2023-12-13,235,224,11,0.0468085106382979
OCCIDENTE 2,2023-12-14,225,212,13,0.0577777777777778
OCCIDENTE 2,2023-12-15,225,212,13,0.0577777777777778
OCCIDENTE 2,2023-12-16,254,243,11,0.0433070866141732
OCCIDENTE 2,2023-12-17,187,182,5,0.0267379679144385
OCCIDENTE 2,2023-12-18,237,223,14,0.0590717299578059
OCCIDENTE 2,2023-12-19,261,246,15,0.0574712643678161
OCCIDENTE 2,2023-12-20,276,264,12,0.0434782608695652
OCCIDENTE 2,2023-12-21,244,234,10,0.040983606557377
OCCIDENTE 2,2023-12-22,256,248,8,0.03125
OCCIDENTE 2,2023-12-23,271,263,8,0.029520295202952
OCCIDENTE 2,2023-12-24,142,136,6,0.0422535211267606
OCCIDENTE 2,2023-12-25,36,35,1,0.0277777777777778
OCCIDENTE 2,2023-12-26,192,184,8,0.0416666666666667
OCCIDENTE 2,2023-12-27,251,241,10,0.0398406374501992
OCCIDENTE 2,2023-12-28,280,272,8,0.0285714285714286
OCCIDENTE 2,2023-12-29,276,267,9,0.0326086956521739
OCCIDENTE 2,2023-12-30,263,254,9,0.0342205323193916
OCCIDENTE 2,2023-12-31,165,163,2,0.0121212121212121
OCCIDENTE 2,2024-01-01,44,40,4,0.0909090909090909
OCCIDENTE 2,2024-01-02,213,207,6,0.028169014084507
OCCIDENTE 2,2024-01-03,294,288,6,0.0204081632653061
OCCIDENTE 2,2024-01-04,284,272,12,0.0422535211267606
OCCIDENTE 2,2024-01-05,304,295,9,0.0296052631578947
OCCIDENTE 2,2024-01-06,330,318,12,0.0363636363636364
OCCIDENTE 2,2024-01-07,199,191,8,0.0402010050251256
OCCIDENTE 2,2024-01-08,294,283,11,0.0374149659863946
OCCIDENTE 2,2024-01-09,335,321,14,0.0417910447761194
OCCIDENTE 2,2024-01-10,318,307,11,0.0345911949685535
OCCIDENTE 2,2024-01-11,306,297,9,0.0294117647058824
OCCIDENTE 2,2024-01-12,290,282,8,0.0275862068965517
OCCIDENTE 2,2024-01-13,341,323,18,0.0527859237536657
OCCIDENTE 2,2024-01-14,222,210,12,0.0540540540540541
ORIENTE GOLFO,2023-01-02,106,73,33,0.311320754716981
ORIENTE GOLFO,2023-01-03,160,104,56,0.35
ORIENTE GOLFO,2023-01-04,182,109,73,0.401098901098901
ORIENTE GOLFO,2023-01-05,177,119,58,0.327683615819209
ORIENTE GOLFO,2023-01-06,167,112,55,0.329341317365269
ORIENTE GOLFO,2023-01-07,154,112,42,0.272727272727273
ORIENTE GOLFO,2023-01-08,124,83,41,0.330645161290323
ORIENTE GOLFO,2023-01-09,146,101,45,0.308219178082192
ORIENTE GOLFO,2023-01-10,161,99,62,0.385093167701863
ORIENTE GOLFO,2023-01-11,171,110,61,0.35672514619883
ORIENTE GOLFO,2023-01-12,146,84,62,0.424657534246575
ORIENTE GOLFO,2023-01-13,132,82,50,0.378787878787879
ORIENTE GOLFO,2023-01-14,172,109,63,0.366279069767442
ORIENTE GOLFO,2023-01-15,139,90,49,0.352517985611511
ORIENTE GOLFO,2023-01-16,166,63,103,0.620481927710843
ORIENTE GOLFO,2023-01-17,162,66,96,0.592592592592593
ORIENTE GOLFO,2023-01-18,157,75,82,0.522292993630573
ORIENTE GOLFO,2023-01-19,156,83,73,0.467948717948718
ORIENTE GOLFO,2023-01-20,170,87,83,0.488235294117647
ORIENTE GOLFO,2023-01-21,175,84,91,0.52
ORIENTE GOLFO,2023-01-22,115,62,53,0.460869565217391
ORIENTE GOLFO,2023-01-23,132,63,69,0.522727272727273
ORIENTE GOLFO,2023-01-24,152,68,84,0.552631578947368
ORIENTE GOLFO,2023-01-25,158,85,73,0.462025316455696
ORIENTE GOLFO,2023-01-26,144,60,84,0.583333333333333
ORIENTE GOLFO,2023-01-27,144,81,63,0.4375
ORIENTE GOLFO,2023-01-28,139,66,73,0.525179856115108
ORIENTE GOLFO,2023-01-29,112,46,66,0.589285714285714
ORIENTE GOLFO,2023-01-30,135,63,72,0.533333333333333
ORIENTE GOLFO,2023-01-31,167,81,86,0.514970059880239
ORIENTE GOLFO,2023-02-01,169,68,101,0.597633136094675
ORIENTE GOLFO,2023-02-02,162,74,88,0.54320987654321
ORIENTE GOLFO,2023-02-03,153,63,90,0.588235294117647
ORIENTE GOLFO,2023-02-04,205,90,115,0.560975609756098
ORIENTE GOLFO,2023-02-05,124,50,74,0.596774193548387
ORIENTE GOLFO,2023-02-06,166,64,102,0.614457831325301
ORIENTE GOLFO,2023-02-07,152,68,84,0.552631578947368
ORIENTE GOLFO,2023-02-08,159,80,79,0.49685534591195
ORIENTE GOLFO,2023-02-09,147,68,79,0.537414965986395
ORIENTE GOLFO,2023-02-10,131,56,75,0.572519083969466
ORIENTE GOLFO,2023-02-11,171,67,104,0.608187134502924
ORIENTE GOLFO,2023-02-12,107,46,61,0.570093457943925
ORIENTE GOLFO,2023-02-13,142,66,76,0.535211267605634
ORIENTE GOLFO,2023-02-14,147,57,90,0.612244897959184
ORIENTE GOLFO,2023-02-15,168,61,107,0.636904761904762
ORIENTE GOLFO,2023-02-16,177,70,107,0.604519774011299
ORIENTE GOLFO,2023-02-17,134,58,76,0.567164179104478
ORIENTE GOLFO,2023-02-18,153,70,83,0.542483660130719
ORIENTE GOLFO,2023-02-19,113,40,73,0.646017699115044
ORIENTE GOLFO,2023-02-20,159,66,93,0.584905660377358
ORIENTE GOLFO,2023-02-21,144,65,79,0.548611111111111
ORIENTE GOLFO,2023-02-22,153,61,92,0.601307189542484
ORIENTE GOLFO,2023-02-23,168,82,86,0.511904761904762
ORIENTE GOLFO,2023-02-24,180,88,92,0.511111111111111
ORIENTE GOLFO,2023-02-25,169,78,91,0.538461538461538
ORIENTE GOLFO,2023-02-26,112,57,55,0.491071428571429
ORIENTE GOLFO,2023-02-27,170,68,102,0.6
ORIENTE GOLFO,2023-02-28,189,80,109,0.576719576719577
ORIENTE GOLFO,2023-03-01,183,73,110,0.601092896174863
ORIENTE GOLFO,2023-03-02,117,43,74,0.632478632478632
ORIENTE GOLFO,2023-03-03,136,64,72,0.529411764705882
ORIENTE GOLFO,2023-03-04,168,70,98,0.583333333333333
ORIENTE GOLFO,2023-03-05,74,34,40,0.540540540540541
ORIENTE GOLFO,2023-03-06,163,78,85,0.521472392638037
ORIENTE GOLFO,2023-03-07,153,79,74,0.483660130718954
ORIENTE GOLFO,2023-03-08,154,98,56,0.363636363636364
ORIENTE GOLFO,2023-03-09,149,121,28,0.187919463087248
ORIENTE GOLFO,2023-03-10,143,126,17,0.118881118881119
ORIENTE GOLFO,2023-03-11,170,150,20,0.117647058823529
ORIENTE GOLFO,2023-03-12,102,94,8,0.0784313725490196
ORIENTE GOLFO,2023-03-13,150,135,15,0.1
ORIENTE GOLFO,2023-03-14,145,134,11,0.0758620689655172
ORIENTE GOLFO,2023-03-15,162,142,20,0.123456790123457
ORIENTE GOLFO,2023-03-16,206,197,9,0.0436893203883495
ORIENTE GOLFO,2023-03-17,203,194,9,0.0443349753694581
ORIENTE GOLFO,2023-03-18,213,202,11,0.0516431924882629
ORIENTE GOLFO,2023-03-19,142,133,9,0.0633802816901408
ORIENTE GOLFO,2023-03-20,203,192,11,0.0541871921182266
ORIENTE GOLFO,2023-03-21,181,176,5,0.0276243093922652
ORIENTE GOLFO,2023-03-22,164,160,4,0.024390243902439
ORIENTE GOLFO,2023-03-23,168,166,2,0.0119047619047619
ORIENTE GOLFO,2023-03-24,179,176,3,0.0167597765363128
ORIENTE GOLFO,2023-03-25,190,184,6,0.0315789473684211
ORIENTE GOLFO,2023-03-26,150,147,3,0.02
ORIENTE GOLFO,2023-03-27,112,110,2,0.0178571428571429
ORIENTE GOLFO,2023-03-28,123,118,5,0.040650406504065
ORIENTE GOLFO,2023-03-29,142,141,1,0.00704225352112676
ORIENTE GOLFO,2023-03-30,173,166,7,0.0404624277456647
ORIENTE GOLFO,2023-03-31,263,253,10,0.0380228136882129
ORIENTE GOLFO,2023-04-01,188,180,8,0.0425531914893617
ORIENTE GOLFO,2023-04-02,107,102,5,0.0467289719626168
ORIENTE GOLFO,2023-04-03,185,180,5,0.027027027027027
ORIENTE GOLFO,2023-04-04,165,160,5,0.0303030303030303
ORIENTE GOLFO,2023-04-05,128,118,10,0.078125
ORIENTE GOLFO,2023-04-06,138,130,8,0.0579710144927536
ORIENTE GOLFO,2023-04-07,88,86,2,0.0227272727272727
ORIENTE GOLFO,2023-04-08,106,104,2,0.0188679245283019
ORIENTE GOLFO,2023-04-09,80,77,3,0.0375
ORIENTE GOLFO,2023-04-10,122,114,8,0.0655737704918033
ORIENTE GOLFO,2023-04-11,132,123,9,0.0681818181818182
ORIENTE GOLFO,2023-04-12,151,138,13,0.0860927152317881
ORIENTE GOLFO,2023-04-13,134,127,7,0.0522388059701493
ORIENTE GOLFO,2023-04-14,176,160,16,0.0909090909090909
ORIENTE GOLFO,2023-04-15,257,228,29,0.11284046692607
ORIENTE GOLFO,2023-04-16,178,165,13,0.0730337078651685
ORIENTE GOLFO,2023-04-17,152,143,9,0.0592105263157895
ORIENTE GOLFO,2023-04-18,138,124,14,0.101449275362319
ORIENTE GOLFO,2023-04-19,132,122,10,0.0757575757575758
ORIENTE GOLFO,2023-04-20,145,131,14,0.096551724137931
ORIENTE GOLFO,2023-04-21,148,136,12,0.0810810810810811
ORIENTE GOLFO,2023-04-22,193,180,13,0.0673575129533679
ORIENTE GOLFO,2023-04-23,125,112,13,0.104
ORIENTE GOLFO,2023-04-24,162,156,6,0.037037037037037
ORIENTE GOLFO,2023-04-25,227,200,27,0.118942731277533
ORIENTE GOLFO,2023-04-26,168,161,7,0.0416666666666667
ORIENTE GOLFO,2023-04-27,124,108,16,0.129032258064516
ORIENTE GOLFO,2023-04-28,195,171,24,0.123076923076923
ORIENTE GOLFO,2023-04-29,217,201,16,0.0737327188940092
ORIENTE GOLFO,2023-04-30,172,161,11,0.063953488372093
ORIENTE GOLFO,2023-05-01,161,153,8,0.0496894409937888
ORIENTE GOLFO,2023-05-02,138,130,8,0.0579710144927536
ORIENTE GOLFO,2023-05-03,154,146,8,0.051948051948052
ORIENTE GOLFO,2023-05-04,151,140,11,0.0728476821192053
ORIENTE GOLFO,2023-05-05,173,164,9,0.0520231213872832
ORIENTE GOLFO,2023-05-06,173,163,10,0.0578034682080925
ORIENTE GOLFO,2023-05-07,94,85,9,0.0957446808510638
ORIENTE GOLFO,2023-05-08,130,119,11,0.0846153846153846
ORIENTE GOLFO,2023-05-09,172,162,10,0.0581395348837209
ORIENTE GOLFO,2023-05-10,118,110,8,0.0677966101694915
ORIENTE GOLFO,2023-05-11,141,126,15,0.106382978723404
ORIENTE GOLFO,2023-05-12,125,120,5,0.04
ORIENTE GOLFO,2023-05-13,192,179,13,0.0677083333333333
ORIENTE GOLFO,2023-05-14,193,181,12,0.0621761658031088
ORIENTE GOLFO,2023-05-15,271,259,12,0.044280442804428
ORIENTE GOLFO,2023-05-16,279,266,13,0.046594982078853
ORIENTE GOLFO,2023-05-17,188,169,19,0.101063829787234
ORIENTE GOLFO,2023-05-18,140,131,9,0.0642857142857143
ORIENTE GOLFO,2023-05-19,141,128,13,0.0921985815602837
ORIENTE GOLFO,2023-05-20,195,178,17,0.0871794871794872
ORIENTE GOLFO,2023-05-21,173,162,11,0.0635838150289017
ORIENTE GOLFO,2023-05-22,143,127,16,0.111888111888112
ORIENTE GOLFO,2023-05-23,134,124,10,0.0746268656716418
ORIENTE GOLFO,2023-05-24,163,155,8,0.049079754601227
ORIENTE GOLFO,2023-05-25,162,155,7,0.0432098765432099
ORIENTE GOLFO,2023-05-26,171,156,15,0.087719298245614
ORIENTE GOLFO,2023-05-27,170,154,16,0.0941176470588235
ORIENTE GOLFO,2023-05-28,102,91,11,0.107843137254902
ORIENTE GOLFO,2023-05-29,160,149,11,0.06875
ORIENTE GOLFO,2023-05-30,195,182,13,0.0666666666666667
ORIENTE GOLFO,2023-05-31,233,223,10,0.0429184549356223
ORIENTE GOLFO,2023-06-01,383,361,22,0.0574412532637076
ORIENTE GOLFO,2023-06-02,216,195,21,0.0972222222222222
ORIENTE GOLFO,2023-06-03,230,216,14,0.0608695652173913
ORIENTE GOLFO,2023-06-04,304,280,24,0.0789473684210526
ORIENTE GOLFO,2023-06-05,143,136,7,0.048951048951049
ORIENTE GOLFO,2023-06-06,143,134,9,0.0629370629370629
ORIENTE GOLFO,2023-06-07,134,123,11,0.082089552238806
ORIENTE GOLFO,2023-06-08,133,124,9,0.0676691729323308
ORIENTE GOLFO,2023-06-09,148,139,9,0.0608108108108108
ORIENTE GOLFO,2023-06-10,186,177,9,0.0483870967741935
ORIENTE GOLFO,2023-06-11,141,131,10,0.0709219858156028
ORIENTE GOLFO,2023-06-12,137,130,7,0.0510948905109489
ORIENTE GOLFO,2023-06-13,143,138,5,0.034965034965035
ORIENTE GOLFO,2023-06-14,169,160,9,0.0532544378698225
ORIENTE GOLFO,2023-06-15,190,182,8,0.0421052631578947
ORIENTE GOLFO,2023-06-16,179,172,7,0.0391061452513966
ORIENTE GOLFO,2023-06-17,187,180,7,0.0374331550802139
ORIENTE GOLFO,2023-06-18,136,130,6,0.0441176470588235
ORIENTE GOLFO,2023-06-19,182,179,3,0.0164835164835165
ORIENTE GOLFO,2023-06-20,202,197,5,0.0247524752475248
ORIENTE GOLFO,2023-06-21,164,157,7,0.0426829268292683
ORIENTE GOLFO,2023-06-22,129,120,9,0.0697674418604651
ORIENTE GOLFO,2023-06-23,147,140,7,0.0476190476190476
ORIENTE GOLFO,2023-06-24,163,162,1,0.00613496932515337
ORIENTE GOLFO,2023-06-25,162,158,4,0.0246913580246914
ORIENTE GOLFO,2023-06-26,154,146,8,0.051948051948052
ORIENTE GOLFO,2023-06-27,179,175,4,0.0223463687150838
ORIENTE GOLFO,2023-06-28,139,132,7,0.0503597122302158
ORIENTE GOLFO,2023-06-29,168,160,8,0.0476190476190476
ORIENTE GOLFO,2023-06-30,169,150,19,0.112426035502959
ORIENTE GOLFO,2023-07-01,204,193,11,0.053921568627451
ORIENTE GOLFO,2023-07-02,125,118,7,0.056
ORIENTE GOLFO,2023-07-03,164,160,4,0.024390243902439
ORIENTE GOLFO,2023-07-04,146,140,6,0.0410958904109589
ORIENTE GOLFO,2023-07-05,124,119,5,0.0403225806451613
ORIENTE GOLFO,2023-07-06,164,151,13,0.0792682926829268
ORIENTE GOLFO,2023-07-07,159,146,13,0.0817610062893082
ORIENTE GOLFO,2023-07-08,187,182,5,0.0267379679144385
ORIENTE GOLFO,2023-07-09,143,140,3,0.020979020979021
ORIENTE GOLFO,2023-07-10,151,147,4,0.0264900662251656
ORIENTE GOLFO,2023-07-11,174,166,8,0.0459770114942529
ORIENTE GOLFO,2023-07-12,143,140,3,0.020979020979021
ORIENTE GOLFO,2023-07-13,160,153,7,0.04375
ORIENTE GOLFO,2023-07-14,156,150,6,0.0384615384615385
ORIENTE GOLFO,2023-07-15,195,189,6,0.0307692307692308
ORIENTE GOLFO,2023-07-16,142,139,3,0.0211267605633803
ORIENTE GOLFO,2023-07-17,145,138,7,0.0482758620689655
ORIENTE GOLFO,2023-07-18,154,148,6,0.038961038961039
ORIENTE GOLFO,2023-07-19,145,142,3,0.0206896551724138
ORIENTE GOLFO,2023-07-20,165,161,4,0.0242424242424242
ORIENTE GOLFO,2023-07-21,157,153,4,0.0254777070063694
ORIENTE GOLFO,2023-07-22,147,144,3,0.0204081632653061
ORIENTE GOLFO,2023-07-23,118,113,5,0.0423728813559322
ORIENTE GOLFO,2023-07-24,154,149,5,0.0324675324675325
ORIENTE GOLFO,2023-07-25,154,147,7,0.0454545454545455
ORIENTE GOLFO,2023-07-26,158,150,8,0.0506329113924051
ORIENTE GOLFO,2023-07-27,148,143,5,0.0337837837837838
ORIENTE GOLFO,2023-07-28,175,170,5,0.0285714285714286
ORIENTE GOLFO,2023-07-29,213,203,10,0.0469483568075117
ORIENTE GOLFO,2023-07-30,161,157,4,0.0248447204968944
ORIENTE GOLFO,2023-07-31,228,222,6,0.0263157894736842
ORIENTE GOLFO,2023-08-01,200,182,18,0.09
ORIENTE GOLFO,2023-08-02,157,148,9,0.0573248407643312
ORIENTE GOLFO,2023-08-03,175,148,27,0.154285714285714
ORIENTE GOLFO,2023-08-04,148,144,4,0.027027027027027
ORIENTE GOLFO,2023-08-05,165,163,2,0.0121212121212121
ORIENTE GOLFO,2023-08-06,112,109,3,0.0267857142857143
ORIENTE GOLFO,2023-08-07,163,163,0,0
ORIENTE GOLFO,2023-08-08,173,165,8,0.046242774566474
ORIENTE GOLFO,2023-08-09,168,164,4,0.0238095238095238
ORIENTE GOLFO,2023-08-10,183,181,2,0.0109289617486339
ORIENTE GOLFO,2023-08-11,159,156,3,0.0188679245283019
ORIENTE GOLFO,2023-08-12,185,175,10,0.0540540540540541
ORIENTE GOLFO,2023-08-13,124,120,4,0.032258064516129
ORIENTE GOLFO,2023-08-14,171,170,1,0.00584795321637427
ORIENTE GOLFO,2023-08-15,167,164,3,0.0179640718562874
ORIENTE GOLFO,2023-08-16,201,194,7,0.0348258706467662
ORIENTE GOLFO,2023-08-17,190,175,15,0.0789473684210526
ORIENTE GOLFO,2023-08-18,190,182,8,0.0421052631578947
ORIENTE GOLFO,2023-08-19,196,187,9,0.0459183673469388
ORIENTE GOLFO,2023-08-20,138,132,6,0.0434782608695652
ORIENTE GOLFO,2023-08-21,150,148,2,0.0133333333333333
ORIENTE GOLFO,2023-08-22,174,173,1,0.00574712643678161
ORIENTE GOLFO,2023-08-23,167,164,3,0.0179640718562874
ORIENTE GOLFO,2023-08-24,182,177,5,0.0274725274725275
ORIENTE GOLFO,2023-08-25,196,190,6,0.0306122448979592
ORIENTE GOLFO,2023-08-26,193,190,3,0.0155440414507772
ORIENTE GOLFO,2023-08-27,118,115,3,0.0254237288135593
ORIENTE GOLFO,2023-08-28,155,153,2,0.0129032258064516
ORIENTE GOLFO,2023-08-29,156,155,1,0.00641025641025641
ORIENTE GOLFO,2023-08-30,164,162,2,0.0121951219512195
ORIENTE GOLFO,2023-08-31,182,182,0,0
ORIENTE GOLFO,2023-09-01,158,151,7,0.0443037974683544
ORIENTE GOLFO,2023-09-02,152,152,0,0
ORIENTE GOLFO,2023-09-03,126,125,1,0.00793650793650794
ORIENTE GOLFO,2023-09-04,162,161,1,0.00617283950617284
ORIENTE GOLFO,2023-09-05,199,198,1,0.0050251256281407
ORIENTE GOLFO,2023-09-06,163,162,1,0.00613496932515337
ORIENTE GOLFO,2023-09-07,144,141,3,0.0208333333333333
ORIENTE GOLFO,2023-09-08,157,155,2,0.0127388535031847
ORIENTE GOLFO,2023-09-09,166,164,2,0.0120481927710843
ORIENTE GOLFO,2023-09-10,106,105,1,0.00943396226415094
ORIENTE GOLFO,2023-09-11,110,109,1,0.00909090909090909
ORIENTE GOLFO,2023-09-12,184,181,3,0.016304347826087
ORIENTE GOLFO,2023-09-13,143,140,3,0.020979020979021
ORIENTE GOLFO,2023-09-14,161,159,2,0.0124223602484472
ORIENTE GOLFO,2023-09-15,199,195,4,0.0201005025125628
ORIENTE GOLFO,2023-09-16,157,154,3,0.0191082802547771
ORIENTE GOLFO,2023-09-17,122,121,1,0.00819672131147541
ORIENTE GOLFO,2023-09-18,165,165,0,0
ORIENTE GOLFO,2023-09-19,157,155,2,0.0127388535031847
ORIENTE GOLFO,2023-09-20,125,125,0,0
ORIENTE GOLFO,2023-09-21,143,141,2,0.013986013986014
ORIENTE GOLFO,2023-09-22,146,145,1,0.00684931506849315
ORIENTE GOLFO,2023-09-23,145,144,1,0.00689655172413793
ORIENTE GOLFO,2023-09-24,128,126,2,0.015625
ORIENTE GOLFO,2023-09-25,148,148,0,0
ORIENTE GOLFO,2023-09-26,159,156,3,0.0188679245283019
ORIENTE GOLFO,2023-09-27,138,137,1,0.0072463768115942
ORIENTE GOLFO,2023-09-28,157,157,0,0
ORIENTE GOLFO,2023-09-29,195,192,3,0.0153846153846154
ORIENTE GOLFO,2023-09-30,213,211,2,0.00938967136150235
ORIENTE GOLFO,2023-10-01,132,131,1,0.00757575757575758
ORIENTE GOLFO,2023-10-02,149,146,3,0.0201342281879195
ORIENTE GOLFO,2023-10-03,151,147,4,0.0264900662251656
ORIENTE GOLFO,2023-10-04,130,126,4,0.0307692307692308
ORIENTE GOLFO,2023-10-05,146,144,2,0.0136986301369863
ORIENTE GOLFO,2023-10-06,155,147,8,0.0516129032258065
ORIENTE GOLFO,2023-10-07,161,157,4,0.0248447204968944
ORIENTE GOLFO,2023-10-08,122,119,3,0.0245901639344262
ORIENTE GOLFO,2023-10-09,129,123,6,0.0465116279069767
ORIENTE GOLFO,2023-10-10,112,106,6,0.0535714285714286
ORIENTE GOLFO,2023-10-11,132,126,6,0.0454545454545455
ORIENTE GOLFO,2023-10-12,137,135,2,0.0145985401459854
ORIENTE GOLFO,2023-10-13,170,165,5,0.0294117647058824
ORIENTE GOLFO,2023-10-14,183,175,8,0.0437158469945355
ORIENTE GOLFO,2023-10-15,131,128,3,0.0229007633587786
ORIENTE GOLFO,2023-10-16,156,154,2,0.0128205128205128
ORIENTE GOLFO,2023-10-17,129,125,4,0.0310077519379845
ORIENTE GOLFO,2023-10-18,138,136,2,0.0144927536231884
ORIENTE GOLFO,2023-10-19,144,142,2,0.0138888888888889
ORIENTE GOLFO,2023-10-20,147,143,4,0.0272108843537415
ORIENTE GOLFO,2023-10-21,191,190,1,0.00523560209424084
ORIENTE GOLFO,2023-10-22,144,140,4,0.0277777777777778
ORIENTE GOLFO,2023-10-23,164,160,4,0.024390243902439
ORIENTE GOLFO,2023-10-24,132,130,2,0.0151515151515152
ORIENTE GOLFO,2023-10-25,146,140,6,0.0410958904109589
ORIENTE GOLFO,2023-10-26,173,167,6,0.0346820809248555
ORIENTE GOLFO,2023-10-27,143,138,5,0.034965034965035
ORIENTE GOLFO,2023-10-28,184,177,7,0.0380434782608696
ORIENTE GOLFO,2023-10-29,130,127,3,0.0230769230769231
ORIENTE GOLFO,2023-10-30,159,157,2,0.0125786163522013
ORIENTE GOLFO,2023-10-31,202,198,4,0.0198019801980198
ORIENTE GOLFO,2023-11-01,157,152,5,0.0318471337579618
ORIENTE GOLFO,2023-11-02,128,127,1,0.0078125
ORIENTE GOLFO,2023-11-03,135,131,4,0.0296296296296296
ORIENTE GOLFO,2023-11-04,144,141,3,0.0208333333333333
ORIENTE GOLFO,2023-11-05,135,133,2,0.0148148148148148
ORIENTE GOLFO,2023-11-06,170,160,10,0.0588235294117647
ORIENTE GOLFO,2023-11-07,163,159,4,0.0245398773006135
ORIENTE GOLFO,2023-11-08,166,161,5,0.0301204819277108
ORIENTE GOLFO,2023-11-09,175,168,7,0.04
ORIENTE GOLFO,2023-11-10,175,169,6,0.0342857142857143
ORIENTE GOLFO,2023-11-11,173,169,4,0.023121387283237
ORIENTE GOLFO,2023-11-12,136,131,5,0.0367647058823529
ORIENTE GOLFO,2023-11-13,164,159,5,0.0304878048780488
ORIENTE GOLFO,2023-11-14,195,191,4,0.0205128205128205
ORIENTE GOLFO,2023-11-15,208,201,7,0.0336538461538462
ORIENTE GOLFO,2023-11-16,194,191,3,0.0154639175257732
ORIENTE GOLFO,2023-11-17,200,193,7,0.035
ORIENTE GOLFO,2023-11-18,218,216,2,0.00917431192660551
ORIENTE GOLFO,2023-11-19,169,160,9,0.0532544378698225
ORIENTE GOLFO,2023-11-20,180,175,5,0.0277777777777778
ORIENTE GOLFO,2023-11-21,157,153,4,0.0254777070063694
ORIENTE GOLFO,2023-11-22,159,156,3,0.0188679245283019
ORIENTE GOLFO,2023-11-23,173,169,4,0.023121387283237
ORIENTE GOLFO,2023-11-24,171,165,6,0.0350877192982456
ORIENTE GOLFO,2023-11-25,186,184,2,0.010752688172043
ORIENTE GOLFO,2023-11-26,136,132,4,0.0294117647058824
ORIENTE GOLFO,2023-11-27,160,157,3,0.01875
ORIENTE GOLFO,2023-11-28,182,179,3,0.0164835164835165
ORIENTE GOLFO,2023-11-29,183,169,14,0.0765027322404372
ORIENTE GOLFO,2023-11-30,235,222,13,0.0553191489361702
ORIENTE GOLFO,2023-12-01,206,198,8,0.0388349514563107
ORIENTE GOLFO,2023-12-02,193,189,4,0.0207253886010363
ORIENTE GOLFO,2023-12-03,170,164,6,0.0352941176470588
ORIENTE GOLFO,2023-12-04,153,149,4,0.0261437908496732
ORIENTE GOLFO,2023-12-05,162,157,5,0.0308641975308642
ORIENTE GOLFO,2023-12-06,186,181,5,0.0268817204301075
ORIENTE GOLFO,2023-12-07,198,189,9,0.0454545454545455
ORIENTE GOLFO,2023-12-08,215,211,4,0.0186046511627907
ORIENTE GOLFO,2023-12-09,197,190,7,0.0355329949238579
ORIENTE GOLFO,2023-12-10,112,107,5,0.0446428571428571
ORIENTE GOLFO,2023-12-11,156,155,1,0.00641025641025641
ORIENTE GOLFO,2023-12-12,148,146,2,0.0135135135135135
ORIENTE GOLFO,2023-12-13,160,156,4,0.025
ORIENTE GOLFO,2023-12-14,156,148,8,0.0512820512820513
ORIENTE GOLFO,2023-12-15,170,163,7,0.0411764705882353
ORIENTE GOLFO,2023-12-16,171,167,4,0.0233918128654971
ORIENTE GOLFO,2023-12-17,150,144,6,0.04
ORIENTE GOLFO,2023-12-18,191,186,5,0.0261780104712042
ORIENTE GOLFO,2023-12-19,206,197,9,0.0436893203883495
ORIENTE GOLFO,2023-12-20,159,154,5,0.0314465408805031
ORIENTE GOLFO,2023-12-21,203,198,5,0.0246305418719212
ORIENTE GOLFO,2023-12-22,193,188,5,0.0259067357512953
ORIENTE GOLFO,2023-12-23,215,207,8,0.0372093023255814
ORIENTE GOLFO,2023-12-24,107,103,4,0.0373831775700935
ORIENTE GOLFO,2023-12-25,42,42,0,0
ORIENTE GOLFO,2023-12-26,158,155,3,0.0189873417721519
ORIENTE GOLFO,2023-12-27,190,186,4,0.0210526315789474
ORIENTE GOLFO,2023-12-28,203,198,5,0.0246305418719212
ORIENTE GOLFO,2023-12-29,174,168,6,0.0344827586206897
ORIENTE GOLFO,2023-12-30,184,179,5,0.0271739130434783
ORIENTE GOLFO,2023-12-31,77,73,4,0.051948051948052
ORIENTE GOLFO,2024-01-01,37,36,1,0.027027027027027
ORIENTE GOLFO,2024-01-02,145,140,5,0.0344827586206897
ORIENTE GOLFO,2024-01-03,178,176,2,0.0112359550561798
ORIENTE GOLFO,2024-01-04,160,158,2,0.0125
ORIENTE GOLFO,2024-01-05,170,165,5,0.0294117647058824
ORIENTE GOLFO,2024-01-06,163,158,5,0.0306748466257669
ORIENTE GOLFO,2024-01-07,114,111,3,0.0263157894736842
ORIENTE GOLFO,2024-01-08,163,155,8,0.049079754601227
ORIENTE GOLFO,2024-01-09,188,180,8,0.0425531914893617
ORIENTE GOLFO,2024-01-10,190,186,4,0.0210526315789474
ORIENTE GOLFO,2024-01-11,170,165,5,0.0294117647058824
ORIENTE GOLFO,2024-01-12,176,172,4,0.0227272727272727
ORIENTE GOLFO,2024-01-13,173,167,6,0.0346820809248555
ORIENTE GOLFO,2024-01-14,163,160,3,0.0184049079754601
ORIENTE PACIFICO,2023-01-02,42,39,3,0.0714285714285714
ORIENTE PACIFICO,2023-01-03,58,48,10,0.172413793103448
ORIENTE PACIFICO,2023-01-04,75,66,9,0.12
ORIENTE PACIFICO,2023-01-05,59,50,9,0.152542372881356
ORIENTE PACIFICO,2023-01-06,80,74,6,0.075
ORIENTE PACIFICO,2023-01-07,81,74,7,0.0864197530864197
ORIENTE PACIFICO,2023-01-08,52,46,6,0.115384615384615
ORIENTE PACIFICO,2023-01-09,75,67,8,0.106666666666667
ORIENTE PACIFICO,2023-01-10,77,67,10,0.12987012987013
ORIENTE PACIFICO,2023-01-11,78,67,11,0.141025641025641
ORIENTE PACIFICO,2023-01-12,73,65,8,0.10958904109589
ORIENTE PACIFICO,2023-01-13,79,65,14,0.177215189873418
ORIENTE PACIFICO,2023-01-14,79,66,13,0.164556962025316
ORIENTE PACIFICO,2023-01-15,70,58,12,0.171428571428571
ORIENTE PACIFICO,2023-01-16,65,38,27,0.415384615384615
ORIENTE PACIFICO,2023-01-17,73,43,30,0.410958904109589
ORIENTE PACIFICO,2023-01-18,70,41,29,0.414285714285714
ORIENTE PACIFICO,2023-01-19,65,39,26,0.4
ORIENTE PACIFICO,2023-01-20,80,50,30,0.375
ORIENTE PACIFICO,2023-01-21,88,55,33,0.375
ORIENTE PACIFICO,2023-01-22,85,51,34,0.4
ORIENTE PACIFICO,2023-01-23,86,58,28,0.325581395348837
ORIENTE PACIFICO,2023-01-24,63,38,25,0.396825396825397
ORIENTE PACIFICO,2023-01-25,71,46,25,0.352112676056338
ORIENTE PACIFICO,2023-01-26,75,51,24,0.32
ORIENTE PACIFICO,2023-01-27,68,39,29,0.426470588235294
ORIENTE PACIFICO,2023-01-28,92,48,44,0.478260869565217
ORIENTE PACIFICO,2023-01-29,73,39,34,0.465753424657534
ORIENTE PACIFICO,2023-01-30,69,46,23,0.333333333333333
ORIENTE PACIFICO,2023-01-31,79,56,23,0.291139240506329
ORIENTE PACIFICO,2023-02-01,80,53,27,0.3375
ORIENTE PACIFICO,2023-02-02,61,42,19,0.311475409836066
ORIENTE PACIFICO,2023-02-03,67,43,24,0.358208955223881
ORIENTE PACIFICO,2023-02-04,75,48,27,0.36
ORIENTE PACIFICO,2023-02-05,50,38,12,0.24
ORIENTE PACIFICO,2023-02-06,47,35,12,0.25531914893617
ORIENTE PACIFICO,2023-02-07,68,45,23,0.338235294117647
ORIENTE PACIFICO,2023-02-08,83,59,24,0.289156626506024
ORIENTE PACIFICO,2023-02-09,73,50,23,0.315068493150685
ORIENTE PACIFICO,2023-02-10,72,51,21,0.291666666666667
ORIENTE PACIFICO,2023-02-11,66,56,10,0.151515151515152
ORIENTE PACIFICO,2023-02-12,48,23,25,0.520833333333333
ORIENTE PACIFICO,2023-02-13,49,31,18,0.36734693877551
ORIENTE PACIFICO,2023-02-14,60,41,19,0.316666666666667
ORIENTE PACIFICO,2023-02-15,60,41,19,0.316666666666667
ORIENTE PACIFICO,2023-02-16,68,48,20,0.294117647058824
ORIENTE PACIFICO,2023-02-17,47,34,13,0.276595744680851
ORIENTE PACIFICO,2023-02-18,77,62,15,0.194805194805195
ORIENTE PACIFICO,2023-02-19,52,35,17,0.326923076923077
ORIENTE PACIFICO,2023-02-20,52,40,12,0.230769230769231
ORIENTE PACIFICO,2023-02-21,62,44,18,0.290322580645161
ORIENTE PACIFICO,2023-02-22,53,42,11,0.207547169811321
ORIENTE PACIFICO,2023-02-23,61,47,14,0.229508196721311
ORIENTE PACIFICO,2023-02-24,67,51,16,0.238805970149254
ORIENTE PACIFICO,2023-02-25,78,67,11,0.141025641025641
ORIENTE PACIFICO,2023-02-26,54,40,14,0.259259259259259
ORIENTE PACIFICO,2023-02-27,86,59,27,0.313953488372093
ORIENTE PACIFICO,2023-02-28,88,68,20,0.227272727272727
ORIENTE PACIFICO,2023-03-01,48,28,20,0.416666666666667
ORIENTE PACIFICO,2023-03-02,48,32,16,0.333333333333333
ORIENTE PACIFICO,2023-03-03,69,57,12,0.173913043478261
ORIENTE PACIFICO,2023-03-04,50,34,16,0.32
ORIENTE PACIFICO,2023-03-05,48,33,15,0.3125
ORIENTE PACIFICO,2023-03-06,62,47,15,0.241935483870968
ORIENTE PACIFICO,2023-03-07,74,65,9,0.121621621621622
ORIENTE PACIFICO,2023-03-08,68,51,17,0.25
ORIENTE PACIFICO,2023-03-09,57,50,7,0.12280701754386
ORIENTE PACIFICO,2023-03-10,50,49,1,0.02
ORIENTE PACIFICO,2023-03-11,66,63,3,0.0454545454545455
ORIENTE PACIFICO,2023-03-12,62,58,4,0.0645161290322581
ORIENTE PACIFICO,2023-03-13,53,50,3,0.0566037735849057
ORIENTE PACIFICO,2023-03-14,59,54,5,0.0847457627118644
ORIENTE PACIFICO,2023-03-15,74,69,5,0.0675675675675676
ORIENTE PACIFICO,2023-03-16,80,70,10,0.125
ORIENTE PACIFICO,2023-03-17,79,63,16,0.20253164556962
ORIENTE PACIFICO,2023-03-18,110,98,12,0.109090909090909
ORIENTE PACIFICO,2023-03-19,89,76,13,0.146067415730337
ORIENTE PACIFICO,2023-03-20,82,73,9,0.109756097560976
ORIENTE PACIFICO,2023-03-21,71,64,7,0.0985915492957746
ORIENTE PACIFICO,2023-03-22,70,65,5,0.0714285714285714
ORIENTE PACIFICO,2023-03-23,67,62,5,0.0746268656716418
ORIENTE PACIFICO,2023-03-24,64,58,6,0.09375
ORIENTE PACIFICO,2023-03-25,63,60,3,0.0476190476190476
ORIENTE PACIFICO,2023-03-26,61,56,5,0.0819672131147541
ORIENTE PACIFICO,2023-03-27,58,55,3,0.0517241379310345
ORIENTE PACIFICO,2023-03-28,54,49,5,0.0925925925925926
ORIENTE PACIFICO,2023-03-29,61,59,2,0.0327868852459016
ORIENTE PACIFICO,2023-03-30,78,74,4,0.0512820512820513
ORIENTE PACIFICO,2023-03-31,97,91,6,0.0618556701030928
ORIENTE PACIFICO,2023-04-01,87,84,3,0.0344827586206897
ORIENTE PACIFICO,2023-04-02,49,48,1,0.0204081632653061
ORIENTE PACIFICO,2023-04-03,63,60,3,0.0476190476190476
ORIENTE PACIFICO,2023-04-04,64,62,2,0.03125
ORIENTE PACIFICO,2023-04-05,49,47,2,0.0408163265306122
ORIENTE PACIFICO,2023-04-06,75,75,0,0
ORIENTE PACIFICO,2023-04-07,57,54,3,0.0526315789473684
ORIENTE PACIFICO,2023-04-08,40,39,1,0.025
ORIENTE PACIFICO,2023-04-09,21,21,0,0
ORIENTE PACIFICO,2023-04-10,52,51,1,0.0192307692307692
ORIENTE PACIFICO,2023-04-11,67,61,6,0.0895522388059701
ORIENTE PACIFICO,2023-04-12,57,55,2,0.0350877192982456
ORIENTE PACIFICO,2023-04-13,59,57,2,0.0338983050847458
ORIENTE PACIFICO,2023-04-14,58,57,1,0.0172413793103448
ORIENTE PACIFICO,2023-04-15,84,83,1,0.0119047619047619
ORIENTE PACIFICO,2023-04-16,75,75,0,0
ORIENTE PACIFICO,2023-04-17,63,62,1,0.0158730158730159
ORIENTE PACIFICO,2023-04-18,60,60,0,0
ORIENTE PACIFICO,2023-04-19,61,60,1,0.0163934426229508
ORIENTE PACIFICO,2023-04-20,60,60,0,0
ORIENTE PACIFICO,2023-04-21,63,63,0,0
ORIENTE PACIFICO,2023-04-22,62,62,0,0
ORIENTE PACIFICO,2023-04-23,63,60,3,0.0476190476190476
ORIENTE PACIFICO,2023-04-24,66,66,0,0
ORIENTE PACIFICO,2023-04-25,77,76,1,0.012987012987013
ORIENTE PACIFICO,2023-04-26,68,67,1,0.0147058823529412
ORIENTE PACIFICO,2023-04-27,55,53,2,0.0363636363636364
ORIENTE PACIFICO,2023-04-28,84,80,4,0.0476190476190476
ORIENTE PACIFICO,2023-04-29,103,100,3,0.029126213592233
ORIENTE PACIFICO,2023-04-30,80,77,3,0.0375
ORIENTE PACIFICO,2023-05-01,54,52,2,0.037037037037037
ORIENTE PACIFICO,2023-05-02,69,66,3,0.0434782608695652
ORIENTE PACIFICO,2023-05-03,48,47,1,0.0208333333333333
ORIENTE PACIFICO,2023-05-04,53,50,3,0.0566037735849057
ORIENTE PACIFICO,2023-05-05,59,57,2,0.0338983050847458
ORIENTE PACIFICO,2023-05-06,65,64,1,0.0153846153846154
ORIENTE PACIFICO,2023-05-07,40,38,2,0.05
ORIENTE PACIFICO,2023-05-08,51,49,2,0.0392156862745098
ORIENTE PACIFICO,2023-05-09,68,67,1,0.0147058823529412
ORIENTE PACIFICO,2023-05-10,57,56,1,0.0175438596491228
ORIENTE PACIFICO,2023-05-11,58,56,2,0.0344827586206897
ORIENTE PACIFICO,2023-05-12,56,55,1,0.0178571428571429
ORIENTE PACIFICO,2023-05-13,99,98,1,0.0101010101010101
ORIENTE PACIFICO,2023-05-14,91,90,1,0.010989010989011
ORIENTE PACIFICO,2023-05-15,82,78,4,0.0487804878048781
ORIENTE PACIFICO,2023-05-16,99,97,2,0.0202020202020202
ORIENTE PACIFICO,2023-05-17,91,87,4,0.043956043956044
ORIENTE PACIFICO,2023-05-18,56,54,2,0.0357142857142857
ORIENTE PACIFICO,2023-05-19,54,53,1,0.0185185185185185
ORIENTE PACIFICO,2023-05-20,77,76,1,0.012987012987013
ORIENTE PACIFICO,2023-05-21,65,62,3,0.0461538461538462
ORIENTE PACIFICO,2023-05-22,88,87,1,0.0113636363636364
ORIENTE PACIFICO,2023-05-23,94,92,2,0.0212765957446809
ORIENTE PACIFICO,2023-05-24,62,59,3,0.0483870967741935
ORIENTE PACIFICO,2023-05-25,83,81,2,0.0240963855421687
ORIENTE PACIFICO,2023-05-26,155,152,3,0.0193548387096774
ORIENTE PACIFICO,2023-05-27,206,198,8,0.0388349514563107
ORIENTE PACIFICO,2023-05-28,111,101,10,0.0900900900900901
ORIENTE PACIFICO,2023-05-29,146,138,8,0.0547945205479452
ORIENTE PACIFICO,2023-05-30,162,150,12,0.0740740740740741
ORIENTE PACIFICO,2023-05-31,187,179,8,0.0427807486631016
ORIENTE PACIFICO,2023-06-01,281,273,8,0.0284697508896797
ORIENTE PACIFICO,2023-06-02,129,128,1,0.00775193798449612
ORIENTE PACIFICO,2023-06-03,270,262,8,0.0296296296296296
ORIENTE PACIFICO,2023-06-04,209,203,6,0.0287081339712919
ORIENTE PACIFICO,2023-06-05,122,121,1,0.00819672131147541
ORIENTE PACIFICO,2023-06-06,118,117,1,0.00847457627118644
ORIENTE PACIFICO,2023-06-07,119,117,2,0.0168067226890756
ORIENTE PACIFICO,2023-06-08,131,126,5,0.0381679389312977
ORIENTE PACIFICO,2023-06-09,131,129,2,0.0152671755725191
ORIENTE PACIFICO,2023-06-10,162,158,4,0.0246913580246914
ORIENTE PACIFICO,2023-06-11,144,144,0,0
ORIENTE PACIFICO,2023-06-12,115,115,0,0
ORIENTE PACIFICO,2023-06-13,117,116,1,0.00854700854700855
ORIENTE PACIFICO,2023-06-14,132,129,3,0.0227272727272727
ORIENTE PACIFICO,2023-06-15,153,151,2,0.0130718954248366
ORIENTE PACIFICO,2023-06-16,131,129,2,0.0152671755725191
ORIENTE PACIFICO,2023-06-17,141,135,6,0.0425531914893617
ORIENTE PACIFICO,2023-06-18,136,132,4,0.0294117647058824
ORIENTE PACIFICO,2023-06-19,142,138,4,0.028169014084507
ORIENTE PACIFICO,2023-06-20,144,142,2,0.0138888888888889
ORIENTE PACIFICO,2023-06-21,142,138,4,0.028169014084507
ORIENTE PACIFICO,2023-06-22,135,131,4,0.0296296296296296
ORIENTE PACIFICO,2023-06-23,129,128,1,0.00775193798449612
ORIENTE PACIFICO,2023-06-24,125,122,3,0.024
ORIENTE PACIFICO,2023-06-25,108,108,0,0
ORIENTE PACIFICO,2023-06-26,113,110,3,0.0265486725663717
ORIENTE PACIFICO,2023-06-27,163,159,4,0.0245398773006135
ORIENTE PACIFICO,2023-06-28,155,150,5,0.032258064516129
ORIENTE PACIFICO,2023-06-29,174,170,4,0.0229885057471264
ORIENTE PACIFICO,2023-06-30,98,91,7,0.0714285714285714
ORIENTE PACIFICO,2023-07-01,173,170,3,0.0173410404624277
ORIENTE PACIFICO,2023-07-02,77,77,0,0
ORIENTE PACIFICO,2023-07-03,136,135,1,0.00735294117647059
ORIENTE PACIFICO,2023-07-04,175,170,5,0.0285714285714286
ORIENTE PACIFICO,2023-07-05,203,194,9,0.0443349753694581
ORIENTE PACIFICO,2023-07-06,160,156,4,0.025
ORIENTE PACIFICO,2023-07-07,206,202,4,0.0194174757281553
ORIENTE PACIFICO,2023-07-08,230,226,4,0.0173913043478261
ORIENTE PACIFICO,2023-07-09,160,155,5,0.03125
ORIENTE PACIFICO,2023-07-10,166,161,5,0.0301204819277108
ORIENTE PACIFICO,2023-07-11,186,181,5,0.0268817204301075
ORIENTE PACIFICO,2023-07-12,194,189,5,0.0257731958762887
ORIENTE PACIFICO,2023-07-13,147,140,7,0.0476190476190476
ORIENTE PACIFICO,2023-07-14,183,179,4,0.0218579234972678
ORIENTE PACIFICO,2023-07-15,218,216,2,0.00917431192660551
ORIENTE PACIFICO,2023-07-16,176,172,4,0.0227272727272727
ORIENTE PACIFICO,2023-07-17,172,166,6,0.0348837209302326
ORIENTE PACIFICO,2023-07-18,149,146,3,0.0201342281879195
ORIENTE PACIFICO,2023-07-19,174,171,3,0.0172413793103448
ORIENTE PACIFICO,2023-07-20,205,198,7,0.0341463414634146
ORIENTE PACIFICO,2023-07-21,175,173,2,0.0114285714285714
ORIENTE PACIFICO,2023-07-22,192,187,5,0.0260416666666667
ORIENTE PACIFICO,2023-07-23,171,168,3,0.0175438596491228
ORIENTE PACIFICO,2023-07-24,192,188,4,0.0208333333333333
ORIENTE PACIFICO,2023-07-25,206,206,0,0
ORIENTE PACIFICO,2023-07-26,191,187,4,0.0209424083769634
ORIENTE PACIFICO,2023-07-27,209,203,6,0.0287081339712919
ORIENTE PACIFICO,2023-07-28,196,192,4,0.0204081632653061
ORIENTE PACIFICO,2023-07-29,244,240,4,0.0163934426229508
ORIENTE PACIFICO,2023-07-30,188,186,2,0.0106382978723404
ORIENTE PACIFICO,2023-07-31,237,236,1,0.00421940928270042
ORIENTE PACIFICO,2023-08-01,189,186,3,0.0158730158730159
ORIENTE PACIFICO,2023-08-02,199,196,3,0.0150753768844221
ORIENTE PACIFICO,2023-08-03,189,170,19,0.100529100529101
ORIENTE PACIFICO,2023-08-04,154,147,7,0.0454545454545455
ORIENTE PACIFICO,2023-08-05,199,195,4,0.0201005025125628
ORIENTE PACIFICO,2023-08-06,174,170,4,0.0229885057471264
ORIENTE PACIFICO,2023-08-07,192,186,6,0.03125
ORIENTE PACIFICO,2023-08-08,180,177,3,0.0166666666666667
ORIENTE PACIFICO,2023-08-09,222,214,8,0.036036036036036
ORIENTE PACIFICO,2023-08-10,225,222,3,0.0133333333333333
ORIENTE PACIFICO,2023-08-11,226,224,2,0.00884955752212389
ORIENTE PACIFICO,2023-08-12,202,199,3,0.0148514851485149
ORIENTE PACIFICO,2023-08-13,183,176,7,0.0382513661202186
ORIENTE PACIFICO,2023-08-14,203,197,6,0.0295566502463054
ORIENTE PACIFICO,2023-08-15,209,207,2,0.00956937799043062
ORIENTE PACIFICO,2023-08-16,204,200,4,0.0196078431372549
ORIENTE PACIFICO,2023-08-17,203,197,6,0.0295566502463054
ORIENTE PACIFICO,2023-08-18,208,204,4,0.0192307692307692
ORIENTE PACIFICO,2023-08-19,213,213,0,0
ORIENTE PACIFICO,2023-08-20,160,156,4,0.025
ORIENTE PACIFICO,2023-08-21,173,171,2,0.0115606936416185
ORIENTE PACIFICO,2023-08-22,165,165,0,0
ORIENTE PACIFICO,2023-08-23,163,163,0,0
ORIENTE PACIFICO,2023-08-24,189,189,0,0
ORIENTE PACIFICO,2023-08-25,216,216,0,0
ORIENTE PACIFICO,2023-08-26,219,218,1,0.0045662100456621
ORIENTE PACIFICO,2023-08-27,185,184,1,0.00540540540540541
ORIENTE PACIFICO,2023-08-28,201,201,0,0
ORIENTE PACIFICO,2023-08-29,208,207,1,0.00480769230769231
ORIENTE PACIFICO,2023-08-30,195,195,0,0
ORIENTE PACIFICO,2023-08-31,183,182,1,0.00546448087431694
ORIENTE PACIFICO,2023-09-01,150,150,0,0
ORIENTE PACIFICO,2023-09-02,169,169,0,0
ORIENTE PACIFICO,2023-09-03,138,138,0,0
ORIENTE PACIFICO,2023-09-04,172,172,0,0
ORIENTE PACIFICO,2023-09-05,181,181,0,0
ORIENTE PACIFICO,2023-09-06,178,178,0,0
ORIENTE PACIFICO,2023-09-07,167,167,0,0
ORIENTE PACIFICO,2023-09-08,160,159,1,0.00625
ORIENTE PACIFICO,2023-09-09,205,205,0,0
ORIENTE PACIFICO,2023-09-10,156,156,0,0
ORIENTE PACIFICO,2023-09-11,189,188,1,0.00529100529100529
ORIENTE PACIFICO,2023-09-12,186,185,1,0.00537634408602151
ORIENTE PACIFICO,2023-09-13,163,162,1,0.00613496932515337
ORIENTE PACIFICO,2023-09-14,205,205,0,0
ORIENTE PACIFICO,2023-09-15,223,223,0,0
ORIENTE PACIFICO,2023-09-16,156,156,0,0
ORIENTE PACIFICO,2023-09-17,136,136,0,0
ORIENTE PACIFICO,2023-09-18,173,173,0,0
ORIENTE PACIFICO,2023-09-19,184,184,0,0
ORIENTE PACIFICO,2023-09-20,162,161,1,0.00617283950617284
ORIENTE PACIFICO,2023-09-21,166,165,1,0.00602409638554217
ORIENTE PACIFICO,2023-09-22,168,168,0,0
ORIENTE PACIFICO,2023-09-23,229,228,1,0.00436681222707424
ORIENTE PACIFICO,2023-09-24,176,176,0,0
ORIENTE PACIFICO,2023-09-25,198,196,2,0.0101010101010101
ORIENTE PACIFICO,2023-09-26,216,216,0,0
ORIENTE PACIFICO,2023-09-27,177,177,0,0
ORIENTE PACIFICO,2023-09-28,173,172,1,0.00578034682080925
ORIENTE PACIFICO,2023-09-29,220,220,0,0
ORIENTE PACIFICO,2023-09-30,293,292,1,0.00341296928327645
ORIENTE PACIFICO,2023-10-01,177,177,0,0
ORIENTE PACIFICO,2023-10-02,150,150,0,0
ORIENTE PACIFICO,2023-10-03,150,148,2,0.0133333333333333
ORIENTE PACIFICO,2023-10-04,176,175,1,0.00568181818181818
ORIENTE PACIFICO,2023-10-05,154,152,2,0.012987012987013
ORIENTE PACIFICO,2023-10-06,201,198,3,0.0149253731343284
ORIENTE PACIFICO,2023-10-07,190,187,3,0.0157894736842105
ORIENTE PACIFICO,2023-10-08,114,110,4,0.0350877192982456
ORIENTE PACIFICO,2023-10-09,137,136,1,0.0072992700729927
ORIENTE PACIFICO,2023-10-10,144,143,1,0.00694444444444444
ORIENTE PACIFICO,2023-10-11,168,166,2,0.0119047619047619
ORIENTE PACIFICO,2023-10-12,135,134,1,0.00740740740740741
ORIENTE PACIFICO,2023-10-13,153,149,4,0.0261437908496732
ORIENTE PACIFICO,2023-10-14,192,190,2,0.0104166666666667
ORIENTE PACIFICO,2023-10-15,155,155,0,0
ORIENTE PACIFICO,2023-10-16,185,183,2,0.0108108108108108
ORIENTE PACIFICO,2023-10-17,167,163,4,0.0239520958083832
ORIENTE PACIFICO,2023-10-18,171,163,8,0.0467836257309941
ORIENTE PACIFICO,2023-10-19,174,170,4,0.0229885057471264
ORIENTE PACIFICO,2023-10-20,159,151,8,0.050314465408805
ORIENTE PACIFICO,2023-10-21,225,217,8,0.0355555555555556
ORIENTE PACIFICO,2023-10-22,165,163,2,0.0121212121212121
ORIENTE PACIFICO,2023-10-23,180,176,4,0.0222222222222222
ORIENTE PACIFICO,2023-10-24,190,185,5,0.0263157894736842
ORIENTE PACIFICO,2023-10-25,125,124,1,0.008
ORIENTE PACIFICO,2023-10-26,143,138,5,0.034965034965035
ORIENTE PACIFICO,2023-10-27,164,155,9,0.0548780487804878
ORIENTE PACIFICO,2023-10-28,189,183,6,0.0317460317460317
ORIENTE PACIFICO,2023-10-29,137,130,7,0.0510948905109489
ORIENTE PACIFICO,2023-10-30,134,133,1,0.00746268656716418
ORIENTE PACIFICO,2023-10-31,200,197,3,0.015
ORIENTE PACIFICO,2023-11-01,164,157,7,0.0426829268292683
ORIENTE PACIFICO,2023-11-02,131,127,4,0.0305343511450382
ORIENTE PACIFICO,2023-11-03,135,132,3,0.0222222222222222
ORIENTE PACIFICO,2023-11-04,167,164,3,0.0179640718562874
ORIENTE PACIFICO,2023-11-05,139,137,2,0.0143884892086331
ORIENTE PACIFICO,2023-11-06,177,175,2,0.0112994350282486
ORIENTE PACIFICO,2023-11-07,175,173,2,0.0114285714285714
ORIENTE PACIFICO,2023-11-08,160,158,2,0.0125
ORIENTE PACIFICO,2023-11-09,161,158,3,0.0186335403726708
ORIENTE PACIFICO,2023-11-10,159,156,3,0.0188679245283019
ORIENTE PACIFICO,2023-11-11,216,212,4,0.0185185185185185
ORIENTE PACIFICO,2023-11-12,148,143,5,0.0337837837837838
ORIENTE PACIFICO,2023-11-13,129,124,5,0.0387596899224806
ORIENTE PACIFICO,2023-11-14,187,185,2,0.0106951871657754
ORIENTE PACIFICO,2023-11-15,194,190,4,0.0206185567010309
ORIENTE PACIFICO,2023-11-16,171,167,4,0.0233918128654971
ORIENTE PACIFICO,2023-11-17,192,189,3,0.015625
ORIENTE PACIFICO,2023-11-18,192,188,4,0.0208333333333333
ORIENTE PACIFICO,2023-11-19,173,172,1,0.00578034682080925
ORIENTE PACIFICO,2023-11-20,169,167,2,0.0118343195266272
ORIENTE PACIFICO,2023-11-21,182,179,3,0.0164835164835165
ORIENTE PACIFICO,2023-11-22,152,150,2,0.0131578947368421
ORIENTE PACIFICO,2023-11-23,164,160,4,0.024390243902439
ORIENTE PACIFICO,2023-11-24,167,164,3,0.0179640718562874
ORIENTE PACIFICO,2023-11-25,211,210,1,0.004739336492891
ORIENTE PACIFICO,2023-11-26,124,122,2,0.0161290322580645
ORIENTE PACIFICO,2023-11-27,185,182,3,0.0162162162162162
ORIENTE PACIFICO,2023-11-28,157,151,6,0.0382165605095541
ORIENTE PACIFICO,2023-11-29,208,200,8,0.0384615384615385
ORIENTE PACIFICO,2023-11-30,241,237,4,0.016597510373444
ORIENTE PACIFICO,2023-12-01,167,161,6,0.0359281437125748
ORIENTE PACIFICO,2023-12-02,219,214,5,0.0228310502283105
ORIENTE PACIFICO,2023-12-03,146,140,6,0.0410958904109589
ORIENTE PACIFICO,2023-12-04,171,168,3,0.0175438596491228
ORIENTE PACIFICO,2023-12-05,197,192,5,0.0253807106598985
ORIENTE PACIFICO,2023-12-06,205,200,5,0.024390243902439
ORIENTE PACIFICO,2023-12-07,191,187,4,0.0209424083769634
ORIENTE PACIFICO,2023-12-08,195,187,8,0.041025641025641
ORIENTE PACIFICO,2023-12-09,213,210,3,0.0140845070422535
ORIENTE PACIFICO,2023-12-10,170,164,6,0.0352941176470588
ORIENTE PACIFICO,2023-12-11,177,173,4,0.0225988700564972
ORIENTE PACIFICO,2023-12-12,214,208,6,0.0280373831775701
ORIENTE PACIFICO,2023-12-13,169,167,2,0.0118343195266272
ORIENTE PACIFICO,2023-12-14,173,169,4,0.023121387283237
ORIENTE PACIFICO,2023-12-15,177,174,3,0.0169491525423729
ORIENTE PACIFICO,2023-12-16,225,222,3,0.0133333333333333
ORIENTE PACIFICO,2023-12-17,198,191,7,0.0353535353535354
ORIENTE PACIFICO,2023-12-18,208,205,3,0.0144230769230769
ORIENTE PACIFICO,2023-12-19,219,211,8,0.0365296803652968
ORIENTE PACIFICO,2023-12-20,199,195,4,0.0201005025125628
ORIENTE PACIFICO,2023-12-21,219,215,4,0.0182648401826484
ORIENTE PACIFICO,2023-12-22,187,185,2,0.0106951871657754
ORIENTE PACIFICO,2023-12-23,217,211,6,0.0276497695852535
ORIENTE PACIFICO,2023-12-24,132,129,3,0.0227272727272727
ORIENTE PACIFICO,2023-12-25,43,43,0,0
ORIENTE PACIFICO,2023-12-26,176,175,1,0.00568181818181818
ORIENTE PACIFICO,2023-12-27,225,219,6,0.0266666666666667
ORIENTE PACIFICO,2023-12-28,214,210,4,0.0186915887850467
ORIENTE PACIFICO,2023-12-29,232,225,7,0.0301724137931034
ORIENTE PACIFICO,2023-12-30,231,225,6,0.025974025974026
ORIENTE PACIFICO,2023-12-31,97,97,0,0
ORIENTE PACIFICO,2024-01-01,37,34,3,0.0810810810810811
ORIENTE PACIFICO,2024-01-02,131,130,1,0.00763358778625954
ORIENTE PACIFICO,2024-01-03,181,175,6,0.0331491712707182
ORIENTE PACIFICO,2024-01-04,218,215,3,0.0137614678899083
ORIENTE PACIFICO,2024-01-05,201,195,6,0.0298507462686567
ORIENTE PACIFICO,2024-01-06,223,222,1,0.00448430493273543
ORIENTE PACIFICO,2024-01-07,149,147,2,0.0134228187919463
ORIENTE PACIFICO,2024-01-08,195,195,0,0
ORIENTE PACIFICO,2024-01-09,230,223,7,0.0304347826086957
ORIENTE PACIFICO,2024-01-10,232,228,4,0.0172413793103448
ORIENTE PACIFICO,2024-01-11,215,207,8,0.0372093023255814
ORIENTE PACIFICO,2024-01-12,217,214,3,0.0138248847926267
ORIENTE PACIFICO,2024-01-13,287,282,5,0.0174216027874564
ORIENTE PACIFICO,2024-01-14,216,212,4,0.0185185185185185
PACIFICO,2023-01-02,86,58,28,0.325581395348837
PACIFICO,2023-01-03,101,71,30,0.297029702970297
PACIFICO,2023-01-04,107,71,36,0.336448598130841
PACIFICO,2023-01-05,56,38,18,0.321428571428571
PACIFICO,2023-01-06,72,45,27,0.375
PACIFICO,2023-01-07,134,98,36,0.26865671641791
PACIFICO,2023-01-08,94,61,33,0.351063829787234
PACIFICO,2023-01-09,106,78,28,0.264150943396226
PACIFICO,2023-01-10,120,89,31,0.258333333333333
PACIFICO,2023-01-11,111,72,39,0.351351351351351
PACIFICO,2023-01-12,103,76,27,0.262135922330097
PACIFICO,2023-01-13,92,65,27,0.293478260869565
PACIFICO,2023-01-14,119,90,29,0.243697478991597
PACIFICO,2023-01-15,92,67,25,0.271739130434783
PACIFICO,2023-01-16,98,76,22,0.224489795918367
PACIFICO,2023-01-17,91,67,24,0.263736263736264
PACIFICO,2023-01-18,98,55,43,0.438775510204082
PACIFICO,2023-01-19,106,59,47,0.443396226415094
PACIFICO,2023-01-20,87,50,37,0.425287356321839
PACIFICO,2023-01-21,115,53,62,0.539130434782609
PACIFICO,2023-01-22,99,47,52,0.525252525252525
PACIFICO,2023-01-23,95,54,41,0.431578947368421
PACIFICO,2023-01-24,106,62,44,0.415094339622642
PACIFICO,2023-01-25,110,60,50,0.454545454545455
PACIFICO,2023-01-26,77,39,38,0.493506493506494
PACIFICO,2023-01-27,117,54,63,0.538461538461538
PACIFICO,2023-01-28,92,47,45,0.489130434782609
PACIFICO,2023-01-29,101,56,45,0.445544554455446
PACIFICO,2023-01-30,123,59,64,0.520325203252033
PACIFICO,2023-01-31,131,67,64,0.488549618320611
PACIFICO,2023-02-01,108,65,43,0.398148148148148
PACIFICO,2023-02-02,104,64,40,0.384615384615385
PACIFICO,2023-02-03,110,61,49,0.445454545454545
PACIFICO,2023-02-04,118,60,58,0.491525423728814
PACIFICO,2023-02-05,73,39,34,0.465753424657534
PACIFICO,2023-02-06,98,51,47,0.479591836734694
PACIFICO,2023-02-07,109,60,49,0.44954128440367
PACIFICO,2023-02-08,103,64,39,0.378640776699029
PACIFICO,2023-02-09,106,47,59,0.556603773584906
PACIFICO,2023-02-10,106,57,49,0.462264150943396
PACIFICO,2023-02-11,125,58,67,0.536
PACIFICO,2023-02-12,60,28,32,0.533333333333333
PACIFICO,2023-02-13,79,46,33,0.417721518987342
PACIFICO,2023-02-14,86,38,48,0.558139534883721
PACIFICO,2023-02-15,111,62,49,0.441441441441441
PACIFICO,2023-02-16,102,54,48,0.470588235294118
PACIFICO,2023-02-17,116,52,64,0.551724137931034
PACIFICO,2023-02-18,113,56,57,0.504424778761062
PACIFICO,2023-02-19,53,29,24,0.452830188679245
PACIFICO,2023-02-20,90,43,47,0.522222222222222
PACIFICO,2023-02-21,93,55,38,0.408602150537634
PACIFICO,2023-02-22,103,55,48,0.466019417475728
PACIFICO,2023-02-23,104,57,47,0.451923076923077
PACIFICO,2023-02-24,114,63,51,0.447368421052632
PACIFICO,2023-02-25,110,65,45,0.409090909090909
PACIFICO,2023-02-26,73,45,28,0.383561643835616
PACIFICO,2023-02-27,112,62,50,0.446428571428571
PACIFICO,2023-02-28,125,67,58,0.464
PACIFICO,2023-03-01,103,60,43,0.41747572815534
PACIFICO,2023-03-02,115,68,47,0.408695652173913
PACIFICO,2023-03-03,108,68,40,0.37037037037037
PACIFICO,2023-03-04,122,72,50,0.409836065573771
PACIFICO,2023-03-05,82,45,37,0.451219512195122
PACIFICO,2023-03-06,112,63,49,0.4375
PACIFICO,2023-03-07,126,69,57,0.452380952380952
PACIFICO,2023-03-08,118,59,59,0.5
PACIFICO,2023-03-09,100,68,32,0.32
PACIFICO,2023-03-10,103,72,31,0.300970873786408
PACIFICO,2023-03-11,131,76,55,0.419847328244275
PACIFICO,2023-03-12,60,35,25,0.416666666666667
PACIFICO,2023-03-13,85,61,24,0.282352941176471
PACIFICO,2023-03-14,109,92,17,0.155963302752294
PACIFICO,2023-03-15,82,74,8,0.0975609756097561
PACIFICO,2023-03-16,111,98,13,0.117117117117117
PACIFICO,2023-03-17,140,129,11,0.0785714285714286
PACIFICO,2023-03-18,161,138,23,0.142857142857143
PACIFICO,2023-03-19,108,98,10,0.0925925925925926
PACIFICO,2023-03-20,134,116,18,0.134328358208955
PACIFICO,2023-03-21,121,104,17,0.140495867768595
PACIFICO,2023-03-22,121,109,12,0.0991735537190083
PACIFICO,2023-03-23,107,98,9,0.0841121495327103
PACIFICO,2023-03-24,123,112,11,0.0894308943089431
PACIFICO,2023-03-25,149,144,5,0.0335570469798658
PACIFICO,2023-03-26,130,120,10,0.0769230769230769
PACIFICO,2023-03-27,69,65,4,0.0579710144927536
PACIFICO,2023-03-28,101,89,12,0.118811881188119
PACIFICO,2023-03-29,129,115,14,0.108527131782946
PACIFICO,2023-03-30,146,138,8,0.0547945205479452
PACIFICO,2023-03-31,157,144,13,0.0828025477707006
PACIFICO,2023-04-01,111,106,5,0.045045045045045
PACIFICO,2023-04-02,83,79,4,0.0481927710843374
PACIFICO,2023-04-03,130,120,10,0.0769230769230769
PACIFICO,2023-04-04,139,131,8,0.0575539568345324
PACIFICO,2023-04-05,87,77,10,0.114942528735632
PACIFICO,2023-04-06,95,92,3,0.0315789473684211
PACIFICO,2023-04-07,57,53,4,0.0701754385964912
PACIFICO,2023-04-08,48,48,0,0
PACIFICO,2023-04-09,42,41,1,0.0238095238095238
PACIFICO,2023-04-10,94,81,13,0.138297872340426
PACIFICO,2023-04-11,97,83,14,0.144329896907216
PACIFICO,2023-04-12,93,84,9,0.0967741935483871
PACIFICO,2023-04-13,100,92,8,0.08
PACIFICO,2023-04-14,139,125,14,0.100719424460432
PACIFICO,2023-04-15,199,180,19,0.0954773869346734
PACIFICO,2023-04-16,163,155,8,0.049079754601227
PACIFICO,2023-04-17,106,99,7,0.0660377358490566
PACIFICO,2023-04-18,118,116,2,0.0169491525423729
PACIFICO,2023-04-19,111,106,5,0.045045045045045
PACIFICO,2023-04-20,96,91,5,0.0520833333333333
PACIFICO,2023-04-21,99,94,5,0.0505050505050505
PACIFICO,2023-04-22,109,103,6,0.055045871559633
PACIFICO,2023-04-23,88,86,2,0.0227272727272727
PACIFICO,2023-04-24,108,108,0,0
PACIFICO,2023-04-25,144,140,4,0.0277777777777778
PACIFICO,2023-04-26,125,121,4,0.032
PACIFICO,2023-04-27,94,92,2,0.0212765957446809
PACIFICO,2023-04-28,141,133,8,0.0567375886524823
PACIFICO,2023-04-29,164,156,8,0.0487804878048781
PACIFICO,2023-04-30,117,109,8,0.0683760683760684
PACIFICO,2023-05-01,104,95,9,0.0865384615384615
PACIFICO,2023-05-02,104,100,4,0.0384615384615385
PACIFICO,2023-05-03,119,115,4,0.0336134453781513
PACIFICO,2023-05-04,119,116,3,0.0252100840336134
PACIFICO,2023-05-05,110,101,9,0.0818181818181818
PACIFICO,2023-05-06,114,110,4,0.0350877192982456
PACIFICO,2023-05-07,84,75,9,0.107142857142857
PACIFICO,2023-05-08,98,93,5,0.0510204081632653
PACIFICO,2023-05-09,127,124,3,0.0236220472440945
PACIFICO,2023-05-10,88,83,5,0.0568181818181818
PACIFICO,2023-05-11,113,109,4,0.0353982300884956
PACIFICO,2023-05-12,106,100,6,0.0566037735849057
PACIFICO,2023-05-13,143,137,6,0.041958041958042
PACIFICO,2023-05-14,114,106,8,0.0701754385964912
PACIFICO,2023-05-15,149,138,11,0.0738255033557047
PACIFICO,2023-05-16,142,136,6,0.0422535211267606
PACIFICO,2023-05-17,108,105,3,0.0277777777777778
PACIFICO,2023-05-18,108,106,2,0.0185185185185185
PACIFICO,2023-05-19,109,105,4,0.036697247706422
PACIFICO,2023-05-20,126,123,3,0.0238095238095238
PACIFICO,2023-05-21,97,94,3,0.0309278350515464
PACIFICO,2023-05-22,98,95,3,0.0306122448979592
PACIFICO,2023-05-23,106,102,4,0.0377358490566038
PACIFICO,2023-05-24,106,102,4,0.0377358490566038
PACIFICO,2023-05-25,116,111,5,0.0431034482758621
PACIFICO,2023-05-26,152,147,5,0.0328947368421053
PACIFICO,2023-05-27,176,167,9,0.0511363636363636
PACIFICO,2023-05-28,104,99,5,0.0480769230769231
PACIFICO,2023-05-29,123,119,4,0.032520325203252
PACIFICO,2023-05-30,138,132,6,0.0434782608695652
PACIFICO,2023-05-31,165,152,13,0.0787878787878788
PACIFICO,2023-06-01,287,277,10,0.0348432055749129
PACIFICO,2023-06-02,198,180,18,0.0909090909090909
PACIFICO,2023-06-03,236,216,20,0.0847457627118644
PACIFICO,2023-06-04,201,184,17,0.0845771144278607
PACIFICO,2023-06-05,107,104,3,0.0280373831775701
PACIFICO,2023-06-06,134,129,5,0.0373134328358209
PACIFICO,2023-06-07,119,109,10,0.0840336134453782
PACIFICO,2023-06-08,143,138,5,0.034965034965035
PACIFICO,2023-06-09,138,125,13,0.0942028985507246
PACIFICO,2023-06-10,154,144,10,0.0649350649350649
PACIFICO,2023-06-11,107,99,8,0.0747663551401869
PACIFICO,2023-06-12,127,122,5,0.0393700787401575
PACIFICO,2023-06-13,139,134,5,0.0359712230215827
PACIFICO,2023-06-14,141,135,6,0.0425531914893617
PACIFICO,2023-06-15,153,147,6,0.0392156862745098
PACIFICO,2023-06-16,135,127,8,0.0592592592592593
PACIFICO,2023-06-17,169,160,9,0.0532544378698225
PACIFICO,2023-06-18,124,116,8,0.0645161290322581
PACIFICO,2023-06-19,156,148,8,0.0512820512820513
PACIFICO,2023-06-20,146,141,5,0.0342465753424658
PACIFICO,2023-06-21,157,147,10,0.0636942675159236
PACIFICO,2023-06-22,135,125,10,0.0740740740740741
PACIFICO,2023-06-23,135,129,6,0.0444444444444444
PACIFICO,2023-06-24,154,151,3,0.0194805194805195
PACIFICO,2023-06-25,109,106,3,0.0275229357798165
PACIFICO,2023-06-26,105,104,1,0.00952380952380952
PACIFICO,2023-06-27,150,145,5,0.0333333333333333
PACIFICO,2023-06-28,161,158,3,0.0186335403726708
PACIFICO,2023-06-29,131,126,5,0.0381679389312977
PACIFICO,2023-06-30,93,84,9,0.0967741935483871
PACIFICO,2023-07-01,161,156,5,0.031055900621118
PACIFICO,2023-07-02,148,143,5,0.0337837837837838
PACIFICO,2023-07-03,102,100,2,0.0196078431372549
PACIFICO,2023-07-04,71,71,0,0
PACIFICO,2023-07-05,74,72,2,0.027027027027027
PACIFICO,2023-07-06,104,101,3,0.0288461538461538
PACIFICO,2023-07-07,101,100,1,0.0099009900990099
PACIFICO,2023-07-08,150,145,5,0.0333333333333333
PACIFICO,2023-07-09,142,138,4,0.028169014084507
PACIFICO,2023-07-10,138,136,2,0.0144927536231884
PACIFICO,2023-07-11,133,130,3,0.0225563909774436
PACIFICO,2023-07-12,135,131,4,0.0296296296296296
PACIFICO,2023-07-13,116,112,4,0.0344827586206897
PACIFICO,2023-07-14,105,97,8,0.0761904761904762
PACIFICO,2023-07-15,146,142,4,0.0273972602739726
PACIFICO,2023-07-16,103,99,4,0.0388349514563107
PACIFICO,2023-07-17,126,124,2,0.0158730158730159
PACIFICO,2023-07-18,113,108,5,0.0442477876106195
PACIFICO,2023-07-19,135,128,7,0.0518518518518519
PACIFICO,2023-07-20,134,128,6,0.0447761194029851
PACIFICO,2023-07-21,145,139,6,0.0413793103448276
PACIFICO,2023-07-22,137,133,4,0.0291970802919708
PACIFICO,2023-07-23,110,102,8,0.0727272727272727
PACIFICO,2023-07-24,115,112,3,0.0260869565217391
PACIFICO,2023-07-25,151,147,4,0.0264900662251656
PACIFICO,2023-07-26,130,124,6,0.0461538461538462
PACIFICO,2023-07-27,155,154,1,0.00645161290322581
PACIFICO,2023-07-28,148,144,4,0.027027027027027
PACIFICO,2023-07-29,166,164,2,0.0120481927710843
PACIFICO,2023-07-30,129,127,2,0.0155038759689922
PACIFICO,2023-07-31,144,135,9,0.0625
PACIFICO,2023-08-01,131,127,4,0.0305343511450382
PACIFICO,2023-08-02,143,135,8,0.0559440559440559
PACIFICO,2023-08-03,143,117,26,0.181818181818182
PACIFICO,2023-08-04,143,137,6,0.041958041958042
PACIFICO,2023-08-05,158,154,4,0.0253164556962025
PACIFICO,2023-08-06,120,115,5,0.0416666666666667
PACIFICO,2023-08-07,147,140,7,0.0476190476190476
PACIFICO,2023-08-08,150,146,4,0.0266666666666667
PACIFICO,2023-08-09,143,137,6,0.041958041958042
PACIFICO,2023-08-10,132,124,8,0.0606060606060606
PACIFICO,2023-08-11,160,155,5,0.03125
PACIFICO,2023-08-12,147,139,8,0.054421768707483
PACIFICO,2023-08-13,122,117,5,0.040983606557377
PACIFICO,2023-08-14,126,123,3,0.0238095238095238
PACIFICO,2023-08-15,144,134,10,0.0694444444444444
PACIFICO,2023-08-16,165,155,10,0.0606060606060606
PACIFICO,2023-08-17,142,138,4,0.028169014084507
PACIFICO,2023-08-18,167,157,10,0.0598802395209581
PACIFICO,2023-08-19,152,144,8,0.0526315789473684
PACIFICO,2023-08-20,127,121,6,0.047244094488189
PACIFICO,2023-08-21,140,138,2,0.0142857142857143
PACIFICO,2023-08-22,126,126,0,0
PACIFICO,2023-08-23,120,117,3,0.025
PACIFICO,2023-08-24,159,154,5,0.0314465408805031
PACIFICO,2023-08-25,136,133,3,0.0220588235294118
PACIFICO,2023-08-26,162,156,6,0.037037037037037
PACIFICO,2023-08-27,120,120,0,0
PACIFICO,2023-08-28,126,123,3,0.0238095238095238
PACIFICO,2023-08-29,110,109,1,0.00909090909090909
PACIFICO,2023-08-30,94,92,2,0.0212765957446809
PACIFICO,2023-08-31,150,148,2,0.0133333333333333
PACIFICO,2023-09-01,75,72,3,0.04
PACIFICO,2023-09-02,158,157,1,0.00632911392405063
PACIFICO,2023-09-03,113,112,1,0.00884955752212389
PACIFICO,2023-09-04,122,122,0,0
PACIFICO,2023-09-05,142,140,2,0.0140845070422535
PACIFICO,2023-09-06,159,158,1,0.00628930817610063
PACIFICO,2023-09-07,129,129,0,0
PACIFICO,2023-09-08,130,127,3,0.0230769230769231
PACIFICO,2023-09-09,157,156,1,0.00636942675159236
PACIFICO,2023-09-10,116,116,0,0
PACIFICO,2023-09-11,113,113,0,0
PACIFICO,2023-09-12,150,150,0,0
PACIFICO,2023-09-13,127,126,1,0.0078740157480315
PACIFICO,2023-09-14,129,126,3,0.0232558139534884
PACIFICO,2023-09-15,121,120,1,0.00826446280991736
PACIFICO,2023-09-16,127,125,2,0.015748031496063
PACIFICO,2023-09-17,99,98,1,0.0101010101010101
PACIFICO,2023-09-18,105,104,1,0.00952380952380952
PACIFICO,2023-09-19,112,111,1,0.00892857142857143
PACIFICO,2023-09-20,104,104,0,0
PACIFICO,2023-09-21,133,132,1,0.0075187969924812
PACIFICO,2023-09-22,127,126,1,0.0078740157480315
PACIFICO,2023-09-23,149,147,2,0.0134228187919463
PACIFICO,2023-09-24,111,109,2,0.018018018018018
PACIFICO,2023-09-25,122,118,4,0.0327868852459016
PACIFICO,2023-09-26,116,115,1,0.00862068965517241
PACIFICO,2023-09-27,124,123,1,0.00806451612903226
PACIFICO,2023-09-28,143,141,2,0.013986013986014
PACIFICO,2023-09-29,141,141,0,0
PACIFICO,2023-09-30,166,166,0,0
PACIFICO,2023-10-01,94,94,0,0
PACIFICO,2023-10-02,99,98,1,0.0101010101010101
PACIFICO,2023-10-03,129,126,3,0.0232558139534884
PACIFICO,2023-10-04,138,135,3,0.0217391304347826
PACIFICO,2023-10-05,124,122,2,0.0161290322580645
PACIFICO,2023-10-06,147,142,5,0.0340136054421769
PACIFICO,2023-10-07,159,152,7,0.0440251572327044
PACIFICO,2023-10-08,105,99,6,0.0571428571428571
PACIFICO,2023-10-09,119,119,0,0
PACIFICO,2023-10-10,104,101,3,0.0288461538461538
PACIFICO,2023-10-11,115,110,5,0.0434782608695652
PACIFICO,2023-10-12,104,100,4,0.0384615384615385
PACIFICO,2023-10-13,125,122,3,0.024
PACIFICO,2023-10-14,144,140,4,0.0277777777777778
PACIFICO,2023-10-15,105,104,1,0.00952380952380952
PACIFICO,2023-10-16,104,98,6,0.0576923076923077
PACIFICO,2023-10-17,115,112,3,0.0260869565217391
PACIFICO,2023-10-18,105,103,2,0.019047619047619
PACIFICO,2023-10-19,112,110,2,0.0178571428571429
PACIFICO,2023-10-20,99,96,3,0.0303030303030303
PACIFICO,2023-10-21,92,92,0,0
PACIFICO,2023-10-22,60,59,1,0.0166666666666667
PACIFICO,2023-10-23,57,54,3,0.0526315789473684
PACIFICO,2023-10-24,117,115,2,0.0170940170940171
PACIFICO,2023-10-25,104,98,6,0.0576923076923077
PACIFICO,2023-10-26,122,122,0,0
PACIFICO,2023-10-27,113,110,3,0.0265486725663717
PACIFICO,2023-10-28,123,121,2,0.016260162601626
PACIFICO,2023-10-29,78,75,3,0.0384615384615385
PACIFICO,2023-10-30,105,103,2,0.019047619047619
PACIFICO,2023-10-31,151,150,1,0.00662251655629139
PACIFICO,2023-11-01,139,139,0,0
PACIFICO,2023-11-02,132,128,4,0.0303030303030303
PACIFICO,2023-11-03,122,118,4,0.0327868852459016
PACIFICO,2023-11-04,141,140,1,0.00709219858156028
PACIFICO,2023-11-05,100,98,2,0.02
PACIFICO,2023-11-06,136,133,3,0.0220588235294118
PACIFICO,2023-11-07,159,156,3,0.0188679245283019
PACIFICO,2023-11-08,146,143,3,0.0205479452054795
PACIFICO,2023-11-09,143,138,5,0.034965034965035
PACIFICO,2023-11-10,134,131,3,0.0223880597014925
PACIFICO,2023-11-11,141,141,0,0
PACIFICO,2023-11-12,106,103,3,0.0283018867924528
PACIFICO,2023-11-13,138,133,5,0.036231884057971
PACIFICO,2023-11-14,137,135,2,0.0145985401459854
PACIFICO,2023-11-15,158,153,5,0.0316455696202532
PACIFICO,2023-11-16,165,161,4,0.0242424242424242
PACIFICO,2023-11-17,128,125,3,0.0234375
PACIFICO,2023-11-18,147,145,2,0.0136054421768707
PACIFICO,2023-11-19,98,97,1,0.0102040816326531
PACIFICO,2023-11-20,135,133,2,0.0148148148148148
PACIFICO,2023-11-21,121,117,4,0.0330578512396694
PACIFICO,2023-11-22,145,141,4,0.0275862068965517
PACIFICO,2023-11-23,151,149,2,0.0132450331125828
PACIFICO,2023-11-24,147,146,1,0.00680272108843537
PACIFICO,2023-11-25,152,148,4,0.0263157894736842
PACIFICO,2023-11-26,104,104,0,0
PACIFICO,2023-11-27,96,92,4,0.0416666666666667
PACIFICO,2023-11-28,128,123,5,0.0390625
PACIFICO,2023-11-29,155,154,1,0.00645161290322581
PACIFICO,2023-11-30,154,150,4,0.025974025974026
PACIFICO,2023-12-01,140,139,1,0.00714285714285714
PACIFICO,2023-12-02,158,155,3,0.0189873417721519
PACIFICO,2023-12-03,122,119,3,0.0245901639344262
PACIFICO,2023-12-04,120,116,4,0.0333333333333333
PACIFICO,2023-12-05,151,144,7,0.0463576158940397
PACIFICO,2023-12-06,149,143,6,0.0402684563758389
PACIFICO,2023-12-07,161,161,0,0
PACIFICO,2023-12-08,155,151,4,0.0258064516129032
PACIFICO,2023-12-09,149,148,1,0.00671140939597315
PACIFICO,2023-12-10,131,131,0,0
PACIFICO,2023-12-11,138,137,1,0.0072463768115942
PACIFICO,2023-12-12,136,133,3,0.0220588235294118
PACIFICO,2023-12-13,144,144,0,0
PACIFICO,2023-12-14,118,115,3,0.0254237288135593
PACIFICO,2023-12-15,137,134,3,0.0218978102189781
PACIFICO,2023-12-16,142,139,3,0.0211267605633803
PACIFICO,2023-12-17,108,106,2,0.0185185185185185
PACIFICO,2023-12-18,150,147,3,0.02
PACIFICO,2023-12-19,144,143,1,0.00694444444444444
PACIFICO,2023-12-20,144,142,2,0.0138888888888889
PACIFICO,2023-12-21,172,167,5,0.0290697674418605
PACIFICO,2023-12-22,121,119,2,0.0165289256198347
PACIFICO,2023-12-23,127,126,1,0.0078740157480315
PACIFICO,2023-12-24,94,94,0,0
PACIFICO,2023-12-25,18,18,0,0
PACIFICO,2023-12-26,115,114,1,0.00869565217391304
PACIFICO,2023-12-27,134,132,2,0.0149253731343284
PACIFICO,2023-12-28,130,128,2,0.0153846153846154
PACIFICO,2023-12-29,137,134,3,0.0218978102189781
PACIFICO,2023-12-30,136,134,2,0.0147058823529412
PACIFICO,2023-12-31,80,80,0,0
PACIFICO,2024-01-01,18,18,0,0
PACIFICO,2024-01-02,103,100,3,0.029126213592233
PACIFICO,2024-01-03,137,135,2,0.0145985401459854
PACIFICO,2024-01-04,145,144,1,0.00689655172413793
PACIFICO,2024-01-05,147,143,4,0.0272108843537415
PACIFICO,2024-01-06,169,163,6,0.0355029585798817
PACIFICO,2024-01-07,101,100,1,0.0099009900990099
PACIFICO,2024-01-08,146,142,4,0.0273972602739726
PACIFICO,2024-01-09,159,154,5,0.0314465408805031
PACIFICO,2024-01-10,138,136,2,0.0144927536231884
PACIFICO,2024-01-11,128,124,4,0.03125
PACIFICO,2024-01-12,151,149,2,0.0132450331125828
PACIFICO,2024-01-13,158,155,3,0.0189873417721519
PACIFICO,2024-01-14,112,108,4,0.0357142857142857
SURESTE,2023-01-02,69,52,17,0.246376811594203
SURESTE,2023-01-03,106,62,44,0.415094339622642
SURESTE,2023-01-04,122,71,51,0.418032786885246
SURESTE,2023-01-05,122,76,46,0.377049180327869
SURESTE,2023-01-06,108,68,40,0.37037037037037
SURESTE,2023-01-07,117,80,37,0.316239316239316
SURESTE,2023-01-08,98,54,44,0.448979591836735
SURESTE,2023-01-09,98,62,36,0.36734693877551
SURESTE,2023-01-10,133,68,65,0.488721804511278
SURESTE,2023-01-11,123,69,54,0.439024390243902
SURESTE,2023-01-12,112,70,42,0.375
SURESTE,2023-01-13,88,50,38,0.431818181818182
SURESTE,2023-01-14,116,72,44,0.379310344827586
SURESTE,2023-01-15,113,63,50,0.442477876106195
SURESTE,2023-01-16,110,47,63,0.572727272727273
SURESTE,2023-01-17,109,44,65,0.596330275229358
SURESTE,2023-01-18,87,46,41,0.471264367816092
SURESTE,2023-01-19,100,61,39,0.39
SURESTE,2023-01-20,93,52,41,0.440860215053763
SURESTE,2023-01-21,102,54,48,0.470588235294118
SURESTE,2023-01-22,90,48,42,0.466666666666667
SURESTE,2023-01-23,124,54,70,0.564516129032258
SURESTE,2023-01-24,109,51,58,0.532110091743119
SURESTE,2023-01-25,125,57,68,0.544
SURESTE,2023-01-26,91,40,51,0.56043956043956
SURESTE,2023-01-27,82,31,51,0.621951219512195
SURESTE,2023-01-28,85,36,49,0.576470588235294
SURESTE,2023-01-29,95,45,50,0.526315789473684
SURESTE,2023-01-30,102,37,65,0.637254901960784
SURESTE,2023-01-31,110,38,72,0.654545454545455
SURESTE,2023-02-01,103,42,61,0.592233009708738
SURESTE,2023-02-02,114,51,63,0.552631578947368
SURESTE,2023-02-03,116,36,80,0.689655172413793
SURESTE,2023-02-04,116,34,82,0.706896551724138
SURESTE,2023-02-05,119,45,74,0.621848739495798
SURESTE,2023-02-06,111,32,79,0.711711711711712
SURESTE,2023-02-07,93,37,56,0.602150537634409
SURESTE,2023-02-08,103,34,69,0.669902912621359
SURESTE,2023-02-09,93,32,61,0.655913978494624
SURESTE,2023-02-10,94,29,65,0.691489361702128
SURESTE,2023-02-11,114,41,73,0.640350877192982
SURESTE,2023-02-12,119,56,63,0.529411764705882
SURESTE,2023-02-13,89,36,53,0.595505617977528
SURESTE,2023-02-14,108,36,73,0.675925925925926
SURESTE,2023-02-15,99,39,60,0.606060606060606
SURESTE,2023-02-16,106,36,70,0.660377358490566
SURESTE,2023-02-17,87,32,55,0.632183908045977
SURESTE,2023-02-18,115,46,69,0.6
SURESTE,2023-02-19,105,33,72,0.685714285714286
SURESTE,2023-02-20,99,51,48,0.484848484848485
SURESTE,2023-02-21,117,58,59,0.504273504273504
SURESTE,2023-02-22,93,41,52,0.559139784946237
SURESTE,2023-02-23,103,51,52,0.504854368932039
SURESTE,2023-02-24,82,54,28,0.341463414634146
SURESTE,2023-02-25,102,51,51,0.5
SURESTE,2023-02-26,117,59,58,0.495726495726496
SURESTE,2023-02-27,109,67,42,0.385321100917431
SURESTE,2023-02-28,86,47,39,0.453488372093023
SURESTE,2023-03-01,84,52,32,0.380952380952381
SURESTE,2023-03-02,112,59,53,0.473214285714286
SURESTE,2023-03-03,112,66,46,0.410714285714286
SURESTE,2023-03-04,144,76,68,0.472222222222222
SURESTE,2023-03-05,122,54,68,0.557377049180328
SURESTE,2023-03-06,100,65,35,0.35
SURESTE,2023-03-07,111,69,42,0.378378378378378
SURESTE,2023-03-08,100,75,25,0.25
SURESTE,2023-03-09,109,78,31,0.284403669724771
SURESTE,2023-03-10,100,73,27,0.27
SURESTE,2023-03-11,124,89,35,0.282258064516129
SURESTE,2023-03-12,109,77,32,0.293577981651376
SURESTE,2023-03-13,107,79,28,0.261682242990654
SURESTE,2023-03-14,119,92,27,0.226890756302521
SURESTE,2023-03-15,99,79,20,0.202020202020202
SURESTE,2023-03-16,106,91,15,0.141509433962264
SURESTE,2023-03-17,152,116,36,0.236842105263158
SURESTE,2023-03-18,151,127,24,0.158940397350993
SURESTE,2023-03-19,115,94,21,0.182608695652174
SURESTE,2023-03-20,125,100,25,0.2
SURESTE,2023-03-21,143,128,15,0.104895104895105
SURESTE,2023-03-22,123,113,10,0.0813008130081301
SURESTE,2023-03-23,113,106,7,0.0619469026548673
SURESTE,2023-03-24,137,126,11,0.0802919708029197
SURESTE,2023-03-25,133,128,5,0.037593984962406
SURESTE,2023-03-26,102,92,10,0.0980392156862745
SURESTE,2023-03-27,105,98,7,0.0666666666666667
SURESTE,2023-03-28,104,98,6,0.0576923076923077
SURESTE,2023-03-29,115,109,6,0.0521739130434783
SURESTE,2023-03-30,141,138,3,0.0212765957446809
SURESTE,2023-03-31,164,149,15,0.0914634146341463
SURESTE,2023-04-01,135,128,7,0.0518518518518519
SURESTE,2023-04-02,95,93,2,0.0210526315789474
SURESTE,2023-04-03,103,102,1,0.00970873786407767
SURESTE,2023-04-04,106,102,4,0.0377358490566038
SURESTE,2023-04-05,90,66,24,0.266666666666667
SURESTE,2023-04-06,104,98,6,0.0576923076923077
SURESTE,2023-04-07,88,86,2,0.0227272727272727
SURESTE,2023-04-08,83,79,4,0.0481927710843374
SURESTE,2023-04-09,51,48,3,0.0588235294117647
SURESTE,2023-04-10,94,89,5,0.0531914893617021
SURESTE,2023-04-11,102,96,6,0.0588235294117647
SURESTE,2023-04-12,115,104,11,0.0956521739130435
SURESTE,2023-04-13,105,101,4,0.0380952380952381
SURESTE,2023-04-14,124,119,5,0.0403225806451613
SURESTE,2023-04-15,168,159,9,0.0535714285714286
SURESTE,2023-04-16,160,160,0,0
SURESTE,2023-04-17,147,143,4,0.0272108843537415
SURESTE,2023-04-18,128,124,4,0.03125
SURESTE,2023-04-19,135,128,7,0.0518518518518519
SURESTE,2023-04-20,134,123,11,0.082089552238806
SURESTE,2023-04-21,133,130,3,0.0225563909774436
SURESTE,2023-04-22,126,119,7,0.0555555555555556
SURESTE,2023-04-23,101,97,4,0.0396039603960396
SURESTE,2023-04-24,147,143,4,0.0272108843537415
SURESTE,2023-04-25,182,175,7,0.0384615384615385
SURESTE,2023-04-26,151,146,5,0.033112582781457
SURESTE,2023-04-27,131,124,7,0.0534351145038168
SURESTE,2023-04-28,120,114,6,0.05
SURESTE,2023-04-29,185,178,7,0.0378378378378378
SURESTE,2023-04-30,133,125,8,0.0601503759398496
SURESTE,2023-05-01,128,124,4,0.03125
SURESTE,2023-05-02,123,118,5,0.040650406504065
SURESTE,2023-05-03,110,105,5,0.0454545454545455
SURESTE,2023-05-04,90,84,6,0.0666666666666667
SURESTE,2023-05-05,106,102,4,0.0377358490566038
SURESTE,2023-05-06,118,115,3,0.0254237288135593
SURESTE,2023-05-07,95,90,5,0.0526315789473684
SURESTE,2023-05-08,100,95,5,0.05
SURESTE,2023-05-09,105,104,1,0.00952380952380952
SURESTE,2023-05-10,94,89,5,0.0531914893617021
SURESTE,2023-05-11,108,98,10,0.0925925925925926
SURESTE,2023-05-12,119,117,2,0.0168067226890756
SURESTE,2023-05-13,161,158,3,0.0186335403726708
SURESTE,2023-05-14,159,150,9,0.0566037735849057
SURESTE,2023-05-15,150,146,4,0.0266666666666667
SURESTE,2023-05-16,188,179,9,0.0478723404255319
SURESTE,2023-05-17,128,123,5,0.0390625
SURESTE,2023-05-18,98,91,7,0.0714285714285714
SURESTE,2023-05-19,116,110,6,0.0517241379310345
SURESTE,2023-05-20,154,153,1,0.00649350649350649
SURESTE,2023-05-21,136,131,5,0.0367647058823529
SURESTE,2023-05-22,118,110,8,0.0677966101694915
SURESTE,2023-05-23,128,120,8,0.0625
SURESTE,2023-05-24,121,117,4,0.0330578512396694
SURESTE,2023-05-25,106,100,6,0.0566037735849057
SURESTE,2023-05-26,149,145,4,0.0268456375838926
SURESTE,2023-05-27,176,173,3,0.0170454545454545
SURESTE,2023-05-28,116,115,1,0.00862068965517241
SURESTE,2023-05-29,158,152,6,0.0379746835443038
SURESTE,2023-05-30,191,190,1,0.00523560209424084
SURESTE,2023-05-31,169,161,8,0.0473372781065089
SURESTE,2023-06-01,261,255,6,0.0229885057471264
SURESTE,2023-06-02,183,176,7,0.0382513661202186
SURESTE,2023-06-03,200,196,4,0.02
SURESTE,2023-06-04,244,235,9,0.0368852459016393
SURESTE,2023-06-05,151,148,3,0.0198675496688742
SURESTE,2023-06-06,129,123,6,0.0465116279069767
SURESTE,2023-06-07,117,111,6,0.0512820512820513
SURESTE,2023-06-08,134,132,2,0.0149253731343284
SURESTE,2023-06-09,134,128,6,0.0447761194029851
SURESTE,2023-06-10,152,144,8,0.0526315789473684
SURESTE,2023-06-11,155,151,4,0.0258064516129032
SURESTE,2023-06-12,124,120,4,0.032258064516129
SURESTE,2023-06-13,120,118,2,0.0166666666666667
SURESTE,2023-06-14,113,109,4,0.0353982300884956
SURESTE,2023-06-15,149,147,2,0.0134228187919463
SURESTE,2023-06-16,146,143,3,0.0205479452054795
SURESTE,2023-06-17,193,188,5,0.0259067357512953
SURESTE,2023-06-18,182,178,4,0.021978021978022
SURESTE,2023-06-19,166,163,3,0.0180722891566265
SURESTE,2023-06-20,174,168,6,0.0344827586206897
SURESTE,2023-06-21,166,158,8,0.0481927710843374
SURESTE,2023-06-22,150,142,8,0.0533333333333333
SURESTE,2023-06-23,128,122,6,0.046875
SURESTE,2023-06-24,145,144,1,0.00689655172413793
SURESTE,2023-06-25,158,155,3,0.0189873417721519
SURESTE,2023-06-26,154,150,4,0.025974025974026
SURESTE,2023-06-27,158,153,5,0.0316455696202532
SURESTE,2023-06-28,157,152,5,0.0318471337579618
SURESTE,2023-06-29,169,168,1,0.00591715976331361
SURESTE,2023-06-30,93,84,9,0.0967741935483871
SURESTE,2023-07-01,182,177,5,0.0274725274725275
SURESTE,2023-07-02,166,166,0,0
SURESTE,2023-07-03,176,170,6,0.0340909090909091
SURESTE,2023-07-04,122,118,4,0.0327868852459016
SURESTE,2023-07-05,126,123,3,0.0238095238095238
SURESTE,2023-07-06,147,144,3,0.0204081632653061
SURESTE,2023-07-07,158,154,4,0.0253164556962025
SURESTE,2023-07-08,171,168,3,0.0175438596491228
SURESTE,2023-07-09,141,138,3,0.0212765957446809
SURESTE,2023-07-10,270,262,8,0.0296296296296296
SURESTE,2023-07-11,221,218,3,0.0135746606334842
SURESTE,2023-07-12,210,205,5,0.0238095238095238
SURESTE,2023-07-13,198,192,6,0.0303030303030303
SURESTE,2023-07-14,199,195,4,0.0201005025125628
SURESTE,2023-07-15,222,218,4,0.018018018018018
SURESTE,2023-07-16,207,205,2,0.00966183574879227
SURESTE,2023-07-17,222,217,5,0.0225225225225225
SURESTE,2023-07-18,196,192,4,0.0204081632653061
SURESTE,2023-07-19,172,167,5,0.0290697674418605
SURESTE,2023-07-20,235,229,6,0.025531914893617
SURESTE,2023-07-21,189,183,6,0.0317460317460317
SURESTE,2023-07-22,228,226,2,0.0087719298245614
SURESTE,2023-07-23,200,198,2,0.01
SURESTE,2023-07-24,207,206,1,0.00483091787439614
SURESTE,2023-07-25,216,208,8,0.037037037037037
SURESTE,2023-07-26,209,203,6,0.0287081339712919
SURESTE,2023-07-27,181,176,5,0.0276243093922652
SURESTE,2023-07-28,201,197,4,0.0199004975124378
SURESTE,2023-07-29,264,262,2,0.00757575757575758
SURESTE,2023-07-30,217,216,1,0.00460829493087558
SURESTE,2023-07-31,271,267,4,0.014760147601476
SURESTE,2023-08-01,213,206,7,0.0328638497652582
SURESTE,2023-08-02,214,211,3,0.014018691588785
SURESTE,2023-08-03,181,159,22,0.121546961325967
SURESTE,2023-08-04,191,186,5,0.0261780104712042
SURESTE,2023-08-05,201,190,11,0.054726368159204
SURESTE,2023-08-06,202,200,2,0.0099009900990099
SURESTE,2023-08-07,200,192,8,0.04
SURESTE,2023-08-08,181,175,6,0.0331491712707182
SURESTE,2023-08-09,205,202,3,0.0146341463414634
SURESTE,2023-08-10,198,194,4,0.0202020202020202
SURESTE,2023-08-11,178,165,13,0.0730337078651685
SURESTE,2023-08-12,201,193,8,0.0398009950248756
SURESTE,2023-08-13,217,210,7,0.032258064516129
SURESTE,2023-08-14,187,180,7,0.0374331550802139
SURESTE,2023-08-15,198,195,3,0.0151515151515152
SURESTE,2023-08-16,209,203,6,0.0287081339712919
SURESTE,2023-08-17,195,185,10,0.0512820512820513
SURESTE,2023-08-18,252,245,7,0.0277777777777778
SURESTE,2023-08-19,236,228,8,0.0338983050847458
SURESTE,2023-08-20,211,204,7,0.033175355450237
SURESTE,2023-08-21,199,199,0,0
SURESTE,2023-08-22,178,175,3,0.0168539325842697
SURESTE,2023-08-23,178,177,1,0.00561797752808989
SURESTE,2023-08-24,219,218,1,0.0045662100456621
SURESTE,2023-08-25,209,206,3,0.0143540669856459
SURESTE,2023-08-26,241,238,3,0.012448132780083
SURESTE,2023-08-27,199,199,0,0
SURESTE,2023-08-28,209,204,5,0.0239234449760766
SURESTE,2023-08-29,207,206,1,0.00483091787439614
SURESTE,2023-08-30,198,197,1,0.00505050505050505
SURESTE,2023-08-31,200,199,1,0.005
SURESTE,2023-09-01,191,191,0,0
SURESTE,2023-09-02,203,201,2,0.00985221674876847
SURESTE,2023-09-03,176,175,1,0.00568181818181818
SURESTE,2023-09-04,162,161,1,0.00617283950617284
SURESTE,2023-09-05,223,222,1,0.00448430493273543
SURESTE,2023-09-06,202,201,1,0.00495049504950495
SURESTE,2023-09-07,228,227,1,0.0043859649122807
SURESTE,2023-09-08,220,220,0,0
SURESTE,2023-09-09,225,224,1,0.00444444444444444
SURESTE,2023-09-10,180,180,0,0
SURESTE,2023-09-11,202,200,2,0.0099009900990099
SURESTE,2023-09-12,234,233,1,0.00427350427350427
SURESTE,2023-09-13,211,209,2,0.00947867298578199
SURESTE,2023-09-14,204,202,2,0.00980392156862745
SURESTE,2023-09-15,222,220,2,0.00900900900900901
SURESTE,2023-09-16,207,206,1,0.00483091787439614
SURESTE,2023-09-17,169,168,1,0.00591715976331361
SURESTE,2023-09-18,189,189,0,0
SURESTE,2023-09-19,189,188,1,0.00529100529100529
SURESTE,2023-09-20,182,179,3,0.0164835164835165
SURESTE,2023-09-21,187,186,1,0.0053475935828877
SURESTE,2023-09-22,196,195,1,0.00510204081632653
SURESTE,2023-09-23,224,222,2,0.00892857142857143
SURESTE,2023-09-24,180,178,2,0.0111111111111111
SURESTE,2023-09-25,192,190,2,0.0104166666666667
SURESTE,2023-09-26,205,204,1,0.0048780487804878
SURESTE,2023-09-27,212,212,0,0
SURESTE,2023-09-28,188,186,2,0.0106382978723404
SURESTE,2023-09-29,238,237,1,0.00420168067226891
SURESTE,2023-09-30,249,248,1,0.00401606425702811
SURESTE,2023-10-01,196,196,0,0
SURESTE,2023-10-02,198,198,0,0
SURESTE,2023-10-03,195,192,3,0.0153846153846154
SURESTE,2023-10-04,167,164,3,0.0179640718562874
SURESTE,2023-10-05,176,172,4,0.0227272727272727
SURESTE,2023-10-06,187,182,5,0.0267379679144385
SURESTE,2023-10-07,199,196,3,0.0150753768844221
SURESTE,2023-10-08,156,152,4,0.0256410256410256
SURESTE,2023-10-09,162,158,4,0.0246913580246914
SURESTE,2023-10-10,155,149,6,0.0387096774193548
SURESTE,2023-10-11,176,169,7,0.0397727272727273
SURESTE,2023-10-12,144,142,2,0.0138888888888889
SURESTE,2023-10-13,180,179,1,0.00555555555555556
SURESTE,2023-10-14,189,189,0,0
SURESTE,2023-10-15,174,170,4,0.0229885057471264
SURESTE,2023-10-16,179,177,2,0.0111731843575419
SURESTE,2023-10-17,189,182,7,0.037037037037037
SURESTE,2023-10-18,214,207,7,0.0327102803738318
SURESTE,2023-10-19,193,188,5,0.0259067357512953
SURESTE,2023-10-20,197,193,4,0.0203045685279188
SURESTE,2023-10-21,212,207,5,0.0235849056603774
SURESTE,2023-10-22,160,151,9,0.05625
SURESTE,2023-10-23,144,140,4,0.0277777777777778
SURESTE,2023-10-24,174,168,6,0.0344827586206897
SURESTE,2023-10-25,181,177,4,0.0220994475138122
SURESTE,2023-10-26,189,183,6,0.0317460317460317
SURESTE,2023-10-27,195,189,6,0.0307692307692308
SURESTE,2023-10-28,214,213,1,0.00467289719626168
SURESTE,2023-10-29,146,142,4,0.0273972602739726
SURESTE,2023-10-30,209,202,7,0.0334928229665072
SURESTE,2023-10-31,211,207,4,0.018957345971564
SURESTE,2023-11-01,202,199,3,0.0148514851485149
SURESTE,2023-11-02,184,181,3,0.016304347826087
SURESTE,2023-11-03,197,192,5,0.0253807106598985
SURESTE,2023-11-04,185,178,7,0.0378378378378378
SURESTE,2023-11-05,174,171,3,0.0172413793103448
SURESTE,2023-11-06,200,193,7,0.035
SURESTE,2023-11-07,211,209,2,0.00947867298578199
SURESTE,2023-11-08,229,220,9,0.0393013100436681
SURESTE,2023-11-09,217,214,3,0.0138248847926267
SURESTE,2023-11-10,190,187,3,0.0157894736842105
SURESTE,2023-11-11,223,220,3,0.0134529147982063
SURESTE,2023-11-12,218,215,3,0.0137614678899083
SURESTE,2023-11-13,203,195,8,0.0394088669950739
SURESTE,2023-11-14,229,223,6,0.0262008733624454
SURESTE,2023-11-15,275,260,15,0.0545454545454545
SURESTE,2023-11-16,240,233,7,0.0291666666666667
SURESTE,2023-11-17,232,224,8,0.0344827586206897
SURESTE,2023-11-18,285,279,6,0.0210526315789474
SURESTE,2023-11-19,246,238,8,0.032520325203252
SURESTE,2023-11-20,256,254,2,0.0078125
SURESTE,2023-11-21,234,229,5,0.0213675213675214
SURESTE,2023-11-22,212,206,6,0.0283018867924528
SURESTE,2023-11-23,228,225,3,0.0131578947368421
SURESTE,2023-11-24,201,196,5,0.0248756218905473
SURESTE,2023-11-25,237,230,7,0.029535864978903
SURESTE,2023-11-26,209,205,4,0.0191387559808612
SURESTE,2023-11-27,242,236,6,0.0247933884297521
SURESTE,2023-11-28,242,237,5,0.0206611570247934
SURESTE,2023-11-29,247,239,8,0.0323886639676113
SURESTE,2023-11-30,263,255,8,0.0304182509505703
SURESTE,2023-12-01,223,212,11,0.0493273542600897
SURESTE,2023-12-02,238,233,5,0.0210084033613445
SURESTE,2023-12-03,164,160,4,0.024390243902439
SURESTE,2023-12-04,180,179,1,0.00555555555555556
SURESTE,2023-12-05,199,192,7,0.0351758793969849
SURESTE,2023-12-06,209,204,5,0.0239234449760766
SURESTE,2023-12-07,227,222,5,0.0220264317180617
SURESTE,2023-12-08,232,224,8,0.0344827586206897
SURESTE,2023-12-09,248,242,6,0.0241935483870968
SURESTE,2023-12-10,195,188,7,0.0358974358974359
SURESTE,2023-12-11,196,191,5,0.0255102040816327
SURESTE,2023-12-12,198,191,7,0.0353535353535354
SURESTE,2023-12-13,197,194,3,0.0152284263959391
SURESTE,2023-12-14,213,205,8,0.0375586854460094
SURESTE,2023-12-15,177,174,3,0.0169491525423729
SURESTE,2023-12-16,212,210,2,0.00943396226415094
SURESTE,2023-12-17,199,197,2,0.0100502512562814
SURESTE,2023-12-18,210,202,8,0.0380952380952381
SURESTE,2023-12-19,240,238,2,0.00833333333333333
SURESTE,2023-12-20,210,203,7,0.0333333333333333
SURESTE,2023-12-21,224,218,6,0.0267857142857143
SURESTE,2023-12-22,202,200,2,0.0099009900990099
SURESTE,2023-12-23,246,240,6,0.024390243902439
SURESTE,2023-12-24,176,172,4,0.0227272727272727
SURESTE,2023-12-25,60,60,0,0
SURESTE,2023-12-26,203,200,3,0.0147783251231527
SURESTE,2023-12-27,250,244,6,0.024
SURESTE,2023-12-28,252,248,4,0.0158730158730159
SURESTE,2023-12-29,225,222,3,0.0133333333333333
SURESTE,2023-12-30,262,259,3,0.0114503816793893
SURESTE,2023-12-31,110,108,2,0.0181818181818182
SURESTE,2024-01-01,42,41,1,0.0238095238095238
SURESTE,2024-01-02,174,172,2,0.0114942528735632
SURESTE,2024-01-03,231,228,3,0.012987012987013
SURESTE,2024-01-04,219,214,5,0.0228310502283105
SURESTE,2024-01-05,214,210,4,0.0186915887850467
SURESTE,2024-01-06,242,237,5,0.0206611570247934
SURESTE,2024-01-07,170,166,4,0.0235294117647059
SURESTE,2024-01-08,220,214,6,0.0272727272727273
SURESTE,2024-01-09,208,205,3,0.0144230769230769
SURESTE,2024-01-10,209,208,1,0.00478468899521531
SURESTE,2024-01-11,229,224,5,0.0218340611353712
SURESTE,2024-01-12,217,213,4,0.0184331797235023
SURESTE,2024-01-13,241,236,5,0.020746887966805
SURESTE,2024-01-14,214,209,5,0.0233644859813084